ibge,anomes,cadunico_tot_fam,cadunico_tot_pes,cadunico_tot_fam_rpc_ate_meio_sm,cadunico_tot_pes_rpc_ate_meio_sm,cadunico_tot_fam_pob,cadunico_tot_pes_pob,cadunico_tot_fam_ext_pob,cadunico_tot_pes_ext_pob,cadunico_tot_fam_pob_e_ext_pob,cadunico_tot_pes_pob_e_ext_pob
110001,201901,3528,10380,2512,8439,669,2401,968,3226,1637,5627
110002,201901,10867,29540,7867,24381,2312,7626,2492,7763,4804,15389
110003,201901,604,1815,437,1465,122,441,89,289,211,730
110004,201901,9116,25581,6355,20367,1636,5553,1675,5630,3311,11183
110005,201901,2331,6294,1458,4651,360,1222,428,1470,788,2692
110006,201901,1694,4792,1065,3505,245,899,168,536,413,1435
110007,201901,1003,2892,775,2527,288,967,230,844,518,1811
110008,201901,2991,8710,2217,7501,277,915,1513,5348,1790,6263
110009,201901,3918,11361,2573,8898,726,2597,874,3160,1600,5757
110010,201901,6162,21125,4837,18605,1167,4353,2270,9727,3437,14080
110011,201901,6023,16805,4336,13744,1542,5001,762,2542,2304,7543
110012,201901,13098,34482,8459,26239,2266,7352,1064,3531,3330,10883
110013,201901,4922,14965,3868,12845,1702,5774,580,2174,2282,7948
110014,201901,3533,9676,2478,7695,698,2202,947,2932,1645,5134
110015,201901,4706,12822,2678,8674,746,2642,405,1177,1151,3819
110018,201901,3220,8525,1950,6266,465,1676,503,1556,968,3232
110020,201901,69786,174478,48397,144391,10744,33303,19519,62613,30263,95916
110025,201901,4683,11883,3101,9075,695,2149,1409,4047,2104,6196
110026,201901,434,1245,331,1083,101,353,127,403,228,756
110028,201901,5669,15425,3716,11732,1063,3579,560,1771,1623,5350
110029,201901,1302,3227,761,2326,183,571,312,976,495,1547
110030,201901,11687,28350,7687,22608,1592,5411,2394,7365,3986,12776
110032,201901,2749,8209,1924,6471,660,2241,474,1660,1134,3901
110033,201901,3572,11672,2862,10311,1046,3854,701,2802,1747,6656
110034,201901,3232,8025,2192,6563,677,2179,910,2804,1587,4983
110037,201901,1553,4957,1246,4360,304,1082,584,2046,888,3128
110040,201901,2809,8224,2075,6854,652,2281,528,1691,1180,3972
110045,201901,4713,14141,3739,12400,1041,3732,1412,4724,2453,8456
110050,201901,1637,4849,1213,4016,529,1833,245,818,774,2651
110060,201901,737,2253,521,1795,211,773,65,225,276,998
110070,201901,1687,5426,1323,4602,457,1682,271,868,728,2550
110080,201901,5730,13834,4132,11962,514,1398,2819,8624,3333,10022
110090,201901,541,1499,378,1211,113,393,138,428,251,821
110092,201901,1115,3395,849,2891,147,515,447,1598,594,2113
110094,201901,2761,8386,2137,7262,788,2792,562,2032,1350,4824
110100,201901,1657,5163,1380,4569,337,1173,650,2147,987,3320
110110,201901,1641,4783,1156,3892,380,1333,252,909,632,2242
110120,201901,1208,3706,925,3125,252,880,272,921,524,1801
110130,201901,2468,6503,1551,4800,349,1181,540,1649,889,2830
110140,201901,1967,6214,1428,5084,399,1462,376,1373,775,2835
110143,201901,1268,3515,877,2745,308,968,201,649,509,1617
110145,201901,856,2377,564,1824,142,491,185,618,327,1109
110146,201901,426,1184,295,978,56,183,148,522,204,705
110147,201901,746,1975,471,1423,70,213,190,503,260,716
110148,201901,752,2230,460,1588,118,452,54,188,172,640
110149,201901,2814,8111,2050,6908,797,2687,504,1871,1301,4558
110150,201901,2256,6030,1575,5054,556,1938,485,1594,1041,3532
110155,201901,619,1919,481,1608,126,444,158,503,284,947
110160,201901,1473,4666,1099,3831,371,1298,251,922,622,2220
110170,201901,2128,5648,1327,4069,251,810,679,2028,930,2838
110175,201901,1420,4208,1058,3597,195,690,511,1817,706,2507
110180,201901,1249,3547,866,2760,188,605,388,1244,576,1849
120001,201901,3027,9695,2589,9065,423,1419,1701,6207,2124,7626
120005,201901,1868,7236,1689,6947,166,752,1295,5439,1461,6191
120010,201901,5125,16029,4392,14834,569,1884,3025,10504,3594,12388
120013,201901,2102,7900,1964,7705,493,1838,1161,4867,1654,6705
120017,201901,2094,7139,1885,6800,336,1243,1161,4375,1497,5618
120020,201901,14016,58344,13130,56516,1278,5985,10077,44023,11355,50008
120025,201901,2801,8428,2317,7811,443,1510,1507,5209,1950,6719
120030,201901,6446,25731,6130,25161,425,2255,4876,20071,5301,22326
120032,201901,1606,7432,1543,7287,99,607,1266,5921,1365,6528
120033,201901,3962,14987,3721,14564,145,781,3192,12427,3337,13208
120034,201901,2494,9364,2173,8770,126,731,1737,6883,1863,7614
120035,201901,3453,14466,3298,14169,303,1408,2656,11584,2959,12992
120038,201901,2649,8796,2306,8206,564,2127,1192,4286,1756,6413
120039,201901,1915,8611,1808,8406,156,957,1401,6487,1557,7444
120040,201901,40262,133293,35662,125616,6042,22408,21687,77566,27729,99974
120042,201901,3259,12569,3003,12029,175,935,2379,9495,2554,10430
120043,201901,1361,5659,1240,5444,53,308,1092,4801,1145,5109
120045,201901,5705,15846,5039,15101,148,596,4599,13646,4747,14242
120050,201901,8851,32845,8137,31720,534,2648,6573,25708,7107,28356
120060,201901,8889,35966,8252,34958,438,2532,7039,29786,7477,32318
120070,201901,2986,9930,2626,9430,282,1062,1834,6830,2116,7892
120080,201901,4200,14379,3785,13702,593,2307,2543,9345,3136,11652
130002,201901,3098,12468,2798,12056,115,621,2489,10752,2604,11373
130006,201901,2325,8964,1906,8205,164,798,1437,6156,1601,6954
130008,201901,2514,8994,2269,8624,77,405,1925,7306,2002,7711
130010,201901,3852,11273,3311,10657,62,209,3096,10050,3158,10259
130014,201901,2924,9104,2348,8122,426,1506,1444,5099,1870,6605
130020,201901,2640,10574,2402,10188,157,950,1887,7929,2044,8879
130030,201901,9497,31905,8718,31000,199,850,7917,28394,8116,29244
130040,201901,3624,11071,3071,10326,161,599,2482,8415,2643,9014
130050,201901,7356,27282,6178,25769,205,964,5563,23448,5768,24412
130060,201901,7091,29188,6182,27957,549,3178,4874,21899,5423,25077
130063,201901,5982,20207,5360,19514,132,638,4959,18097,5091,18735
130068,201901,3368,13024,2967,12315,220,1233,2226,9135,2446,10368
130070,201901,7535,21996,6329,20665,298,970,5373,17874,5671,18844
130080,201901,6669,25725,5965,24865,318,1868,4963,20821,5281,22689
130083,201901,2540,8863,2320,8588,183,801,1944,7146,2127,7947
130090,201901,3375,10756,3026,10295,63,292,2633,9133,2696,9425
130100,201901,7557,23423,6538,22342,74,193,6121,21473,6195,21666
130110,201901,8067,23507,6770,21899,802,2151,5270,17959,6072,20110
130115,201901,5366,17154,4705,16369,109,435,4155,14659,4264,15094
130120,201901,14091,51805,12890,50233,1235,5237,10499,41276,11734,46513
130130,201901,5080,16990,4025,15607,455,1987,3016,11686,3471,13673
130140,201901,6693,24649,6223,24117,234,1247,5530,21452,5764,22699
130150,201901,3613,13776,3400,13518,97,617,3085,12246,3182,12863
130160,201901,4861,18101,4242,17289,314,1490,3529,14555,3843,16045
130165,201901,3087,12068,2936,11851,109,580,2624,10580,2733,11160
130170,201901,11457,34602,9418,32159,642,2576,7822,26812,8464,29388
130180,201901,4390,14035,4150,13766,43,232,4002,13233,4045,13465
130185,201901,17702,44485,14459,41024,750,1406,12619,37277,13369,38683
130190,201901,18543,62055,15284,57191,1829,7031,10875,41860,12704,48891
130195,201901,2336,8690,1888,8108,74,412,1665,7148,1739,7560
130200,201901,2440,7267,2044,6723,120,491,1650,5432,1770,5923
130210,201901,1281,4900,1157,4754,100,601,937,3748,1037,4349
130220,201901,2113,7871,1899,7553,102,531,1585,6295,1687,6826
130230,201901,4191,18241,3747,17591,326,1882,3090,14546,3416,16428
130240,201901,10979,34885,9116,32305,223,1327,8028,28344,8251,29671
130250,201901,25397,77967,22282,74488,1574,5010,18398,63751,19972,68761
130255,201901,4134,14405,3706,13632,192,896,2970,10934,3162,11830
130260,201901,241737,711417,202761,653234,57510,197120,91210,299434,148720,496554
130270,201901,8420,31813,7282,30022,1027,4454,5072,21531,6099,25985
130280,201901,3463,14121,3211,13842,129,624,2946,12863,3075,13487
130290,201901,12816,43829,11365,42061,552,2351,9961,37282,10513,39633
130300,201901,4594,16652,4238,16123,169,909,3666,13847,3835,14756
130310,201901,5673,20335,5034,19434,362,1583,4122,16108,4484,17691
130320,201901,3273,10942,2842,10409,292,1043,2202,8302,2494,9345
130330,201901,4496,14648,3720,13707,206,934,3181,11722,3387,12656
130340,201901,21650,72302,19021,69244,1501,5190,15809,59358,17310,64548
130350,201901,3887,14388,3526,13913,152,889,3066,11971,3218,12860
130353,201901,6516,18926,5433,17548,807,2545,3801,12702,4608,15247
130356,201901,4771,16181,4123,15143,586,2212,2757,10434,3343,12646
130360,201901,3131,9402,2694,8910,62,193,2526,8429,2588,8622
130370,201901,5607,22126,5026,21339,291,1474,4240,17978,4531,19452
130380,201901,7138,30169,6782,29612,435,2484,5736,24751,6171,27235
130390,201901,5853,24720,5173,23516,573,3099,3776,17116,4349,20215
130395,201901,2301,7543,2002,7024,238,891,1461,5102,1699,5993
130400,201901,2611,8552,2271,8097,119,454,1996,7182,2115,7636
130406,201901,10637,39257,9272,37463,1724,7172,6297,26107,8021,33279
130410,201901,4000,14616,3496,13774,1086,4431,1657,6792,2743,11223
130420,201901,12756,46848,10933,44616,1039,5382,8628,35005,9667,40387
130423,201901,4022,13303,3576,12779,180,898,3147,11083,3327,11981
130426,201901,2814,11090,2682,10894,91,483,2482,10087,2573,10570
130430,201901,4038,12169,3559,11500,345,1238,2810,8969,3155,10207
130440,201901,4660,14842,4089,14173,103,425,3785,13188,3888,13613
140002,201901,2024,6095,1777,5768,98,395,1472,4705,1570,5100
140005,201901,3054,8612,2802,8333,137,401,2472,7390,2609,7791
140010,201901,53170,142997,41977,126497,10905,34480,16523,51718,27428,86198
140015,201901,3208,10450,2853,10015,214,765,2416,8631,2630,9396
140017,201901,3677,11148,3251,10592,332,1057,2440,8252,2772,9309
140020,201901,5006,15217,4279,14228,309,1324,3349,11066,3658,12390
140023,201901,2234,6935,1842,6374,237,873,1310,4575,1547,5448
140028,201901,2070,5371,1761,4967,133,434,1366,3776,1499,4210
140030,201901,4551,12468,4058,11871,335,828,3371,10171,3706,10999
140040,201901,2164,9107,1986,8839,129,805,1708,7444,1837,8249
140045,201901,2507,9438,2117,8878,414,1668,1372,6107,1786,7775
140047,201901,5756,17127,4934,15888,771,2655,3298,10721,4069,13376
140050,201901,1358,4058,1162,3770,130,440,831,2736,961,3176
140060,201901,1553,4221,1315,3874,109,323,1032,3082,1141,3405
140070,201901,1773,9491,1714,9340,149,990,1357,7316,1506,8306
150010,201901,43604,111088,39849,106260,987,2897,35502,94002,36489,96899
150013,201901,1861,4989,1545,4634,138,355,1199,3777,1337,4132
150020,201901,13933,42908,13055,41768,1129,2795,11059,36553,12188,39348
150030,201901,8577,32799,7861,31911,370,1758,6950,28343,7320,30101
150034,201901,4177,10800,3497,9920,234,661,2911,8374,3145,9035
150040,201901,15527,41012,13607,38853,1342,2352,11097,34445,12439,36797
150050,201901,6637,23905,6145,23212,136,660,5647,21455,5783,22115
150060,201901,20236,57044,16790,51914,2983,9202,10278,32746,13261,41948
150070,201901,6386,24903,5766,24149,182,961,5231,22163,5413,23124
150080,201901,87243,204712,74164,187223,17389,46595,26550,78836,43939,125431
150085,201901,6645,20542,6098,19862,186,610,5640,18499,5826,19109
150090,201901,9926,37357,9334,36243,657,2887,7575,29436,8232,32323
150095,201901,5512,16773,4887,15949,287,769,4068,13753,4355,14522
150100,201901,2999,10598,2657,10011,200,768,2058,7821,2258,8589
150110,201901,4061,17788,3929,17621,221,1078,3560,16022,3781,17100
150120,201901,7464,24584,7240,24281,302,810,6430,22296,6732,23106
150125,201901,743,2061,564,1813,110,402,324,1031,434,1433
150130,201901,22635,66584,19908,62534,2633,7398,14351,46857,16984,54255
150140,201901,220232,534699,190963,494568,31204,79233,111572,303244,142776,382477
150145,201901,4494,13551,3851,12655,776,2291,2527,8892,3303,11183
150150,201901,14607,39188,13057,37239,832,2465,10630,30514,11462,32979
150157,201901,3235,9179,2689,8468,276,951,1927,6259,2203,7210
150160,201901,2923,9039,2744,8745,656,2052,1548,5147,2204,7199
150170,201901,24109,80247,20975,75038,3919,13341,12652,48208,16571,61549
150172,201901,4339,12446,3538,11312,273,793,2619,8675,2892,9468
150175,201901,1668,5220,1429,4775,237,849,915,3090,1152,3939
150178,201901,9970,28444,8386,26569,336,1056,7210,23217,7546,24273
150180,201901,20493,76614,19091,74872,998,4016,16681,66489,17679,70505
150190,201901,6790,23142,6401,22636,302,1312,5606,19741,5908,21053
150195,201901,5344,17245,5102,16884,97,481,4714,15477,4811,15958
150200,201901,5488,16483,5042,16000,56,166,4746,15197,4802,15363
150210,201901,24430,88925,23033,86990,1848,6983,18808,72892,20656,79875
150215,201901,6841,20484,5948,19166,1493,4742,3082,10523,4575,15265
150220,201901,11416,33866,10237,32145,1485,4570,6528,21019,8013,25589
150230,201901,12133,35371,10591,33313,1251,3723,7333,24042,8584,27765
150240,201901,31137,88594,25810,79411,8061,25250,7728,24537,15789,49787
150250,201901,3979,16164,3798,15911,542,2284,2922,12494,3464,14778
150260,201901,2494,8639,2308,8335,207,746,1757,6444,1964,7190
150270,201901,8496,24713,6092,20842,2039,7280,1963,7077,4002,14357
150275,201901,6516,21550,6045,20846,280,1107,5172,17758,5452,18865
150276,201901,2244,6197,1929,5824,249,678,1352,4435,1601,5113
150277,201901,5116,13743,4185,12666,363,1030,3232,10352,3595,11382
150280,201901,6389,26611,6211,26277,547,2266,5143,22040,5690,24306
150285,201901,3178,11449,2817,10890,308,1257,1986,7830,2294,9087
150290,201901,10664,29174,9844,28280,380,874,8869,26046,9249,26920
150293,201901,9372,23665,6928,20398,1381,4056,3643,11574,5024,15630
150295,201901,7790,21432,5721,18676,2022,7169,1990,7115,4012,14284
150300,201901,2135,6755,1924,6471,52,252,1709,5723,1761,5975
150304,201901,3967,12296,3330,11232,591,1896,2104,7397,2695,9293
150307,201901,6210,20255,5789,19586,406,1341,4723,16192,5129,17533
150309,201901,6045,18968,4938,17057,1016,3398,2603,9467,3619,12865
150310,201901,7105,28327,6790,27935,235,1337,6013,24920,6248,26257
150320,201901,9324,25516,8499,24391,466,1463,6600,18877,7066,20340
150330,201901,13672,45187,12706,43541,1524,5099,9344,32819,10868,37918
150340,201901,2579,7626,2327,7268,342,999,1629,5197,1971,6196
150345,201901,7614,22955,6931,22064,400,1361,5942,19035,6342,20396
150350,201901,8822,23777,8103,22852,823,1680,6592,19327,7415,21007
150360,201901,23141,66318,18760,60712,2140,6323,12997,44097,15137,50420
150370,201901,9876,32233,8405,30175,968,3276,6162,23264,7130,26540
150375,201901,3241,13594,2939,13134,287,1420,2351,10559,2638,11979
150380,201901,10380,27891,8722,25647,261,884,7555,22327,7816,23211
150390,201901,7661,31751,6984,30624,1153,4720,4842,22337,5995,27057
150400,201901,6160,22821,5915,22354,284,1178,5098,19306,5382,20484
150405,201901,9070,24503,8055,23248,506,1138,6506,19474,7012,20612
150410,201901,1836,6076,1583,5630,219,745,1019,3732,1238,4477
150420,201901,38019,110843,29253,97357,9351,32536,8724,33719,18075,66255
150430,201901,8166,24686,7539,23848,801,2093,5931,19455,6732,21548
150440,201901,5537,18321,5221,17841,530,1661,4059,14170,4589,15831
150442,201901,24043,61348,20218,56264,2341,6340,13564,38789,15905,45129
150445,201901,5923,18995,5330,18074,255,940,4502,15321,4757,16261
150450,201901,4822,21465,4563,21106,367,1795,3874,18054,4241,19849
150460,201901,8252,27500,7664,26729,250,1042,6623,23881,6873,24923
150470,201901,19848,53832,17662,51329,723,1963,16023,46886,16746,48849
150475,201901,4495,14846,4008,14094,187,711,3343,11899,3530,12610
150480,201901,13601,45386,12212,43247,2068,6806,8403,31364,10471,38170
150490,201901,7980,28499,7493,27869,240,1132,6691,24966,6931,26098
150495,201901,5068,18052,4927,17853,121,586,4529,16365,4650,16951
150497,201901,2702,8978,2201,8071,561,2149,1082,4176,1643,6325
150500,201901,3260,8580,2902,8063,292,747,2220,6217,2512,6964
150503,201901,4242,11841,3048,10187,947,3309,1022,3820,1969,7129
150506,201901,9716,30863,8455,29061,1798,5496,5415,20232,7213,25728
150510,201901,9697,36089,8506,33794,1202,4615,5742,23878,6944,28493
150520,201901,7276,27573,6973,27189,189,1049,6425,24991,6614,26040
150530,201901,12209,41933,10705,39766,1608,4940,7653,30172,9261,35112
150540,201901,4864,13724,4196,12742,148,437,3601,10933,3749,11370
150543,201901,6926,19114,5678,17488,861,2718,3860,12468,4721,15186
150548,201901,9769,31164,8874,29947,322,1130,7878,26719,8200,27849
150549,201901,2010,6190,1745,5837,53,229,1521,5090,1574,5319
150550,201901,19072,57734,16340,53223,4095,13645,7288,25286,11383,38931
150553,201901,22714,71209,18203,62900,6133,21678,5532,21057,11665,42735
150555,201901,1776,4906,1405,4308,128,347,990,3108,1118,3455
150560,201901,1796,5638,1614,5279,299,937,904,3068,1203,4005
150563,201901,2404,7665,2086,7082,450,1651,1157,3900,1607,5551
150565,201901,4192,13783,3734,13031,103,502,3108,10900,3211,11402
150570,201901,6070,20373,5815,19990,281,1127,5020,17185,5301,18312
150580,201901,10001,41060,9072,40013,626,3122,7553,34059,8179,37181
150590,201901,7176,26423,6578,25647,208,1136,5967,23177,6175,24313
150600,201901,9034,31275,8446,30529,250,1104,7716,27958,7966,29062
150610,201901,2668,8197,2399,7723,131,514,1937,6145,2068,6659
150611,201901,2938,8810,2654,8383,108,435,2300,7192,2408,7627
150613,201901,12554,35282,9573,30210,1885,6310,4568,14593,6453,20903
150616,201901,3200,8981,2359,7591,592,2015,889,2806,1481,4821
150618,201901,6765,20359,5505,18380,679,2253,3410,11897,4089,14150
150619,201901,5916,17623,4947,16177,237,916,3981,13028,4218,13944
150620,201901,6386,21435,5560,20134,813,2876,3835,14281,4648,17157
150630,201901,6059,16880,5596,16315,396,1125,4713,13926,5109,15051
150635,201901,4443,12825,3841,11820,614,1894,2364,7417,2978,9311
150640,201901,2183,6373,2009,6169,34,111,1878,5838,1912,5949
150650,201901,11247,32248,9978,30116,3045,8617,4478,14618,7523,23235
150655,201901,5690,16696,5192,15952,215,675,4451,13679,4666,14354
150658,201901,4324,12430,3474,11190,621,2096,2068,6960,2689,9056
150660,201901,5624,16460,5068,15693,547,1658,3508,11069,4055,12727
150670,201901,7905,19183,6284,17321,626,1451,4971,14310,5597,15761
150680,201901,63191,194139,48870,171249,12600,43728,21659,84813,34259,128541
150690,201901,2578,7045,2314,6698,126,324,1990,5844,2116,6168
150700,201901,6157,18636,5544,17847,395,1182,4394,14473,4789,15655
150710,201901,3710,12551,3391,12031,239,928,2636,9433,2875,10361
150715,201901,4904,14633,4144,13440,359,1111,3230,10652,3589,11763
150720,201901,6446,24438,6079,23808,445,2018,5005,19625,5450,21643
150730,201901,11141,35373,9812,33345,1084,3860,7423,25704,8507,29564
150740,201901,3720,10830,3305,10123,387,1086,2357,7376,2744,8462
150745,201901,5077,14832,4134,13435,801,2763,2683,8745,3484,11508
150746,201901,1527,4866,1417,4687,88,288,1146,3805,1234,4093
150747,201901,4811,15753,4313,14949,785,2439,2789,10221,3574,12660
150750,201901,3568,11400,3044,10591,226,843,2329,8302,2555,9145
150760,201901,11632,34777,10679,33561,1345,3951,7918,25509,9263,29460
150770,201901,6167,22704,5882,22321,180,570,5409,21097,5589,21667
150775,201901,881,2576,703,2309,137,513,380,1234,517,1747
150780,201901,4472,13571,4063,13076,114,369,3721,12129,3835,12498
150790,201901,5421,16062,4752,15338,222,553,3945,13834,4167,14387
150795,201901,13368,43440,12156,41393,3213,10372,6805,24689,10018,35061
150796,201901,3523,9223,3068,8677,175,487,2604,7446,2779,7933
150797,201901,3855,12258,3349,11498,142,450,2783,9672,2925,10122
150800,201901,12740,41149,11820,40000,1588,4977,8969,31438,10557,36415
150803,201901,6704,22758,6317,22162,393,1418,5361,18906,5754,20324
150805,201901,3293,10581,2823,9836,284,1043,2132,7486,2416,8529
150808,201901,5656,16894,4208,14376,1631,6040,576,2194,2207,8234
150810,201901,20175,55775,15585,50132,2768,8805,8855,30829,11623,39634
150812,201901,5269,15313,4687,14283,456,1514,3436,10252,3892,11766
150815,201901,8811,27491,7598,25954,714,2454,6016,20872,6730,23326
150820,201901,11874,32643,9974,30366,936,2478,7805,24617,8741,27095
150830,201901,11329,43140,10777,42449,384,2047,9399,37554,9783,39601
150835,201901,2132,7383,1908,6983,406,1484,967,3600,1373,5084
150840,201901,7156,21185,5760,18724,1160,3973,2996,9724,4156,13697
160005,201901,1169,3236,1062,3084,30,130,983,2821,1013,2951
160010,201901,2406,6226,2296,6112,18,94,2231,5869,2249,5963
160015,201901,2291,7319,2095,7054,93,339,1892,6390,1985,6729
160020,201901,1959,6711,1755,6433,229,857,1336,4961,1565,5818
160021,201901,1057,4201,987,4099,76,448,800,3235,876,3683
160023,201901,1192,4408,1059,4186,117,432,743,3097,860,3529
160025,201901,1918,5394,1857,5321,12,37,1824,5230,1836,5267
160027,201901,8623,24383,7833,23414,534,1530,6521,19847,7055,21377
160030,201901,60012,179173,49508,165220,11198,35238,26342,97146,37540,132384
160040,201901,5165,18426,4704,17815,95,526,4318,16384,4413,16910
160050,201901,4345,14058,3531,12863,1435,4960,1227,5497,2662,10457
160053,201901,3516,11646,3261,11319,306,992,2640,9404,2946,10396
160055,201901,743,2470,726,2452,27,98,673,2275,700,2373
160060,201901,22549,62993,18889,58782,1110,3446,15299,49350,16409,52796
160070,201901,2871,11014,2602,10583,193,814,2066,8608,2259,9422
160080,201901,2952,10095,2735,9840,66,336,2453,8880,2519,9216
170025,201901,610,1665,453,1434,93,293,228,738,321,1031
170030,201901,1190,3739,945,3258,167,582,460,1623,627,2205
170035,201901,1445,3798,1047,3138,110,362,600,1809,710,2171
170040,201901,1793,5282,1454,4828,120,450,825,2869,945,3319
170070,201901,1696,4066,1195,3430,113,370,682,1973,795,2343
170100,201901,2427,7069,2011,6345,196,587,1319,4236,1515,4823
170105,201901,722,2159,503,1681,126,392,168,576,294,968
170110,201901,926,2942,718,2540,103,389,345,1226,448,1615
170130,201901,1299,4009,934,3276,175,634,460,1664,635,2298
170190,201901,1370,3971,935,3261,321,1098,186,860,507,1958
170200,201901,1732,4355,1060,3208,262,853,269,811,531,1664
170210,201901,24089,66935,18321,57284,6553,22102,1920,7125,8473,29227
170215,201901,1311,3642,1098,3348,61,253,820,2471,881,2724
170220,201901,5804,18271,4933,16635,1159,3641,2383,8702,3542,12343
170230,201901,1222,3748,936,3167,243,840,201,718,444,1558
170240,201901,2632,7501,2038,6539,170,661,1364,4254,1534,4915
170255,201901,3930,11670,2764,9436,503,1803,1269,4472,1772,6275
170270,201901,1036,2521,667,2008,31,98,419,1244,450,1342
170290,201901,2968,8690,2538,8177,129,376,2052,6882,2181,7258
170300,201901,1880,5350,1553,4848,181,595,1019,3220,1200,3815
170305,201901,711,2057,567,1789,72,257,276,855,348,1112
170307,201901,944,3310,757,2917,117,468,405,1595,522,2063
170310,201901,1605,4156,1103,3311,198,653,498,1512,696,2165
170320,201901,982,2626,737,2245,75,239,459,1395,534,1634
170330,201901,874,2757,781,2609,53,239,618,1999,671,2238
170360,201901,464,1321,334,1101,47,176,192,598,239,774
170370,201901,1278,3485,938,2917,216,646,377,1256,593,1902
170380,201901,1766,5270,1323,4567,122,495,733,2591,855,3086
170382,201901,541,1665,441,1496,54,213,296,974,350,1187
170384,201901,1482,5581,1225,5063,303,1322,539,2253,842,3575
170386,201901,823,2316,520,1713,83,327,146,434,229,761
170388,201901,621,1806,444,1480,59,222,202,676,261,898
170389,201901,1051,3439,891,3163,45,192,700,2515,745,2707
170390,201901,1616,3841,1191,3319,76,205,933,2682,1009,2887
170410,201901,551,1649,402,1373,23,102,260,862,283,964
170460,201901,367,992,290,862,48,141,173,526,221,667
170510,201901,862,2649,635,2200,56,261,383,1269,439,1530
170550,201901,6384,17457,4584,14415,1324,4465,898,3023,2222,7488
170555,201901,1330,3743,1047,3291,62,212,562,1825,624,2037
170560,201901,1018,2954,761,2581,83,325,437,1606,520,1931
170600,201901,1358,3798,1096,3400,239,614,616,2094,855,2708
170610,201901,1749,4813,1276,4056,77,297,784,2455,861,2752
170625,201901,436,1198,277,863,36,103,87,263,123,366
170650,201901,1273,3863,995,3378,184,615,471,1693,655,2308
170700,201901,3347,9954,2520,8432,546,1926,1058,3627,1604,5553
170710,201901,1470,4080,1140,3496,193,663,631,1898,824,2561
170720,201901,1870,4810,1503,4280,65,135,1242,3663,1307,3798
170730,201901,1001,2856,746,2430,167,529,321,1104,488,1633
170740,201901,2017,6953,1724,6371,222,858,1137,4216,1359,5074
170755,201901,866,2503,608,2008,66,239,293,944,359,1183
170765,201901,1230,3225,838,2613,201,637,323,1068,524,1705
170770,201901,1763,5379,1492,4945,190,585,974,3325,1164,3910
170820,201901,3401,10880,2851,9822,492,1774,1467,5146,1959,6920
170825,201901,914,2212,740,1967,86,232,502,1340,588,1572
170830,201901,1368,3776,1143,3412,22,67,946,2835,968,2902
170900,201901,2586,8632,2231,8070,186,755,1734,6347,1920,7102
170930,201901,3641,10247,2841,8816,644,2124,1113,3454,1757,5578
170950,201901,10931,30945,7588,24853,2244,8305,1034,3630,3278,11935
170980,201901,413,1197,337,1069,26,122,227,673,253,795
171050,201901,1546,5042,1352,4680,60,299,1081,3691,1141,3990
171070,201901,1327,3939,1133,3652,224,683,645,2287,869,2970
171090,201901,1041,2586,844,2307,70,181,598,1637,668,1818
171110,201901,564,1590,403,1291,68,242,176,508,244,750
171150,201901,1050,2715,643,1990,74,254,405,1249,479,1503
171180,201901,739,2097,496,1620,89,276,192,655,281,931
171190,201901,1581,5626,1407,5318,234,904,853,3287,1087,4191
171195,201901,808,2699,680,2463,124,479,392,1422,516,1901
171200,201901,514,1523,387,1297,79,283,162,539,241,822
171215,201901,384,1102,297,945,53,188,168,515,221,703
171240,201901,738,2551,617,2304,44,226,383,1429,427,1655
171245,201901,627,1954,486,1656,59,226,267,885,326,1111
171250,201901,1072,2854,782,2400,187,618,367,1125,554,1743
171270,201901,381,1495,322,1345,74,324,131,589,205,913
171280,201901,844,2605,653,2260,101,344,343,1247,444,1591
171320,201901,3953,11296,3082,9772,577,1799,1339,4477,1916,6276
171330,201901,2652,7356,2034,6304,446,1332,968,3122,1414,4454
171360,201901,1412,4220,1162,3855,79,317,875,2896,954,3213
171370,201901,669,1772,520,1564,53,165,360,1101,413,1266
171380,201901,1454,4098,1211,3730,125,398,829,2576,954,2974
171395,201901,924,2722,631,2127,73,288,340,1113,413,1401
171420,201901,1871,5715,1367,4692,251,970,592,2036,843,3006
171430,201901,1004,3009,831,2666,77,290,560,1746,637,2036
171488,201901,2339,7083,1829,6231,295,1090,944,3307,1239,4397
171500,201901,953,2508,729,2151,47,149,540,1599,587,1748
171510,201901,754,2620,671,2451,47,215,465,1693,512,1908
171515,201901,472,1299,347,1088,32,135,208,619,240,754
171525,201901,653,1975,533,1762,39,183,316,973,355,1156
171550,201901,334,1009,236,833,37,143,126,441,163,584
171570,201901,1100,3409,923,3083,162,503,519,1808,681,2311
171575,201901,1810,4881,1154,3674,178,619,464,1434,642,2053
171610,201901,5560,15934,4175,13579,960,3413,1158,4034,2118,7447
171620,201901,2667,7635,2249,7028,150,590,1764,5497,1914,6087
171630,201901,946,2620,765,2356,123,392,493,1562,616,1954
171650,201901,2031,5981,1510,5021,378,1319,489,1741,867,3060
171660,201901,2327,6112,1619,4883,264,765,854,2618,1118,3383
171665,201901,1337,3794,1011,3256,179,660,474,1550,653,2210
171670,201901,1807,4974,1393,4296,197,701,791,2381,988,3082
171700,201901,1180,3480,871,2921,113,381,493,1643,606,2024
171720,201901,798,2132,620,1844,36,145,455,1331,491,1476
171750,201901,1231,3553,876,2893,225,771,128,512,353,1283
171780,201901,1208,3177,886,2707,70,260,615,1840,685,2100
171790,201901,1407,4804,1138,4227,259,942,495,1946,754,2888
171800,201901,717,2046,534,1752,69,270,292,950,361,1220
171820,201901,10608,30523,8010,25953,1919,6480,2716,9379,4635,15859
171830,201901,1454,4957,1224,4512,120,558,797,2867,917,3425
171840,201901,735,1973,579,1732,30,92,399,1186,429,1278
171845,201901,630,1642,464,1404,62,225,259,794,321,1019
171850,201901,854,2994,732,2715,71,340,513,1842,584,2182
171855,201901,1061,3282,910,3006,79,271,576,1874,655,2145
171865,201901,372,1209,307,1097,53,203,151,521,204,724
171870,201901,760,2191,550,1802,62,216,290,986,352,1202
171875,201901,1234,3743,995,3347,59,253,729,2415,788,2668
171880,201901,1069,3424,954,3268,41,177,777,2699,818,2876
171884,201901,795,2180,578,1842,116,429,211,732,327,1161
171886,201901,1405,4026,986,3302,297,1069,199,693,496,1762
171888,201901,734,2097,508,1664,48,166,296,977,344,1143
171889,201901,424,1353,363,1239,75,277,163,554,238,831
171890,201901,1144,3219,856,2754,179,509,469,1589,648,2098
171900,201901,508,1796,369,1454,89,349,132,551,221,900
172000,201901,564,1755,468,1570,59,247,263,837,322,1084
172010,201901,1041,3694,898,3394,78,381,559,2033,637,2414
172015,201901,345,1247,257,1059,56,215,108,488,164,703
172020,201901,2380,7283,2151,6957,174,671,1629,5318,1803,5989
172025,201901,744,2090,544,1756,49,189,342,1085,391,1274
172030,201901,1244,3719,1071,3458,29,120,869,2796,898,2916
172049,201901,1241,3127,866,2584,230,721,434,1318,664,2039
172065,201901,1486,3741,1177,3368,92,196,986,2960,1078,3156
172080,201901,2268,6931,1855,6169,132,515,1255,4171,1387,4686
172085,201901,483,1348,310,985,51,147,96,300,147,447
172090,201901,3949,10270,3049,9057,131,477,2329,6901,2460,7378
172093,201901,495,1496,362,1253,48,204,185,610,233,814
172097,201901,586,1581,426,1323,69,227,206,661,275,888
172100,201901,46513,118109,31572,93661,6667,21625,10036,30688,16703,52313
172110,201901,1567,5914,1352,5565,155,680,983,4208,1138,4888
172120,201901,4781,14600,3799,12977,606,2098,2030,7193,2636,9291
172125,201901,301,861,218,719,29,102,115,379,144,481
172130,201901,713,1949,586,1736,25,96,427,1220,452,1316
172208,201901,2433,6238,1956,5598,232,604,1308,3824,1540,4428
172210,201901,2713,7307,2079,6472,427,1412,1080,3403,1507,4815
210005,201901,19113,56711,15094,50109,4462,15335,5861,20396,10323,35731
210010,201901,1835,5844,1662,5597,53,239,1444,4890,1497,5129
210015,201901,3356,10099,2984,9590,129,340,2575,8433,2704,8773
210020,201901,7487,17173,6633,16212,97,248,6172,15092,6269,15340
210030,201901,4741,15936,4465,15531,197,951,3896,13454,4093,14405
210040,201901,1882,4711,1699,4500,28,48,1587,4247,1615,4295
210043,201901,6316,17689,5251,16353,630,1885,3829,12352,4459,14237
210047,201901,6563,21473,5620,20135,196,984,4867,17307,5063,18291
210050,201901,2204,7639,1747,6802,208,910,1143,4445,1351,5355
210055,201901,1826,6011,1672,5750,72,291,1383,4723,1455,5014
210060,201901,6911,26211,6165,24806,765,3224,4311,17834,5076,21058
210070,201901,7245,20734,6838,20247,34,117,6560,19542,6594,19659
210080,201901,4010,13996,3876,13841,47,289,3655,13072,3702,13361
210083,201901,5424,16094,4596,15212,65,352,4348,14321,4413,14673
210087,201901,2971,8280,2619,7814,123,315,2220,6807,2343,7122
210090,201901,9499,29765,8937,28801,330,1141,7886,25333,8216,26474
210095,201901,6265,20688,5803,20126,249,1034,4836,17369,5085,18403
210100,201901,6718,20394,6132,19480,239,937,5188,16378,5427,17315
210110,201901,2830,9058,2652,8828,35,197,2479,8220,2514,8417
210120,201901,22943,63887,19468,59398,2332,6088,13111,42433,15443,48521
210125,201901,4131,11752,3718,11227,777,1903,2650,8527,3427,10430
210130,201901,4202,11436,3542,10588,152,400,3016,9071,3168,9471
210135,201901,1435,4416,1269,4143,58,197,1052,3466,1110,3663
210140,201901,17160,48227,13534,43449,2729,8730,7588,25336,10317,34066
210150,201901,4470,10958,4000,10307,112,318,3545,9033,3657,9351
210160,201901,15829,48014,14138,45717,1368,4540,10215,33942,11583,38482
210170,201901,14568,47174,13642,45931,627,2232,12088,40692,12715,42924
210173,201901,2295,8601,2125,8314,53,321,1926,7567,1979,7888
210177,201901,3283,9364,2971,8979,106,204,2690,8406,2796,8610
210180,201901,1416,3966,1283,3786,35,102,1146,3371,1181,3473
210190,201901,4900,14296,4364,13470,105,522,3659,11042,3764,11564
210193,201901,1248,3780,1119,3579,38,134,898,2927,936,3061
210197,201901,1990,6538,1860,6353,175,602,1480,5167,1655,5769
210200,201901,7508,24712,6858,23673,621,2220,5428,18910,6049,21130
210203,201901,6934,20991,6132,19888,563,1824,4907,16176,5470,18000
210207,201901,3377,9411,2997,8931,151,394,2485,7566,2636,7960
210210,201901,8167,26736,7632,26013,125,746,7002,23741,7127,24487
210215,201901,2179,7227,1992,6967,66,324,1762,6139,1828,6463
210220,201901,6005,21113,5709,20641,224,1350,4946,17488,5170,18838
210230,201901,5122,15858,4681,15210,279,755,4059,13403,4338,14158
210232,201901,11351,36350,9432,33518,1495,5401,6114,23080,7609,28481
210235,201901,3499,10532,3080,9956,85,383,2720,8774,2805,9157
210237,201901,2506,8768,2297,8506,26,159,2150,7943,2176,8102
210240,201901,2647,8440,2430,8062,90,379,2102,6899,2192,7278
210250,201901,5500,17091,5064,16555,81,464,4541,14812,4622,15276
210255,201901,2512,7806,2161,7153,241,845,1484,4869,1725,5714
210260,201901,5294,16381,4701,15499,270,1042,3914,12842,4184,13884
210270,201901,4755,13426,4277,12798,97,483,3843,11391,3940,11874
210275,201901,3582,9085,3215,8636,48,113,2968,8061,3016,8174
210280,201901,5459,16060,4415,14416,246,1180,3238,10277,3484,11457
210290,201901,6725,19253,6131,18513,160,493,5536,16748,5696,17241
210300,201901,33268,91242,27757,83874,1812,5563,20880,65672,22692,71235
210310,201901,3001,7910,2669,7434,115,264,2315,6506,2430,6770
210312,201901,2622,6965,2326,6627,47,203,2143,6025,2190,6228
210315,201901,2877,8221,2467,7748,72,196,2213,7122,2285,7318
210317,201901,4091,13086,3752,12698,122,598,3381,11375,3503,11973
210320,201901,18593,58046,17142,56113,460,2263,15124,49202,15584,51465
210325,201901,3398,10146,3004,9614,88,309,2692,8720,2780,9029
210330,201901,23833,71096,20597,66569,5736,16987,10350,37840,16086,54827
210340,201901,9870,30356,8937,28961,819,2655,6772,22490,7591,25145
210350,201901,9337,27342,8280,26025,192,710,7314,23097,7506,23807
210355,201901,4376,15498,3897,14736,134,697,3343,12719,3477,13416
210360,201901,14041,43291,12592,41246,557,2432,10162,32959,10719,35391
210370,201901,10395,23762,8226,21453,255,473,7464,19909,7719,20382
210375,201901,3157,8684,2380,7641,619,1953,1154,4053,1773,6006
210380,201901,5487,14491,4853,13708,239,624,4154,11798,4393,12422
210390,201901,2564,9350,2396,9041,137,658,1975,7381,2112,8039
210400,201901,4425,14011,4036,13519,132,411,3583,12103,3715,12514
210405,201901,7012,19273,5681,17364,1039,3011,3224,10449,4263,13460
210407,201901,1933,6589,1624,5992,106,485,1297,4698,1403,5183
210408,201901,2420,9304,2267,9061,154,779,1816,7288,1970,8067
210409,201901,3678,13000,3385,12603,116,660,2800,10426,2916,11086
210410,201901,3423,10730,2942,9959,219,844,2158,7278,2377,8122
210420,201901,3935,12680,3557,12023,193,610,3018,10305,3211,10915
210430,201901,2235,6608,2044,6375,103,309,1784,5583,1887,5892
210440,201901,4142,11716,3807,11252,72,261,3554,10460,3626,10721
210450,201901,2453,7482,2185,7062,106,408,1811,5819,1917,6227
210455,201901,4119,11023,3164,9815,887,2723,1625,5246,2512,7969
210460,201901,3439,10308,3000,9725,83,357,2616,8437,2699,8794
210462,201901,1538,4973,1356,4661,47,223,1091,3721,1138,3944
210465,201901,2575,7731,2259,7290,78,294,1942,6271,2020,6565
210467,201901,5530,18580,5075,18007,281,1174,4426,15750,4707,16924
210470,201901,2113,5549,1467,4625,87,210,1103,3607,1190,3817
210480,201901,15435,47089,13050,44076,1313,4212,9551,34160,10864,38372
210490,201901,3734,9632,3060,8676,87,261,2652,7513,2739,7774
210500,201901,5972,24197,5612,23553,373,2015,4564,18926,4937,20941
210510,201901,5983,20386,5435,19775,122,593,4895,17986,5017,18579
210515,201901,3675,10898,3231,10405,106,388,2866,9306,2972,9694
210520,201901,2492,7298,2258,7002,92,325,1984,6123,2076,6448
210530,201901,50389,125639,40486,110878,6688,23230,11341,39694,18029,62924
210535,201901,3109,10656,2904,10342,112,445,2452,8809,2564,9254
210540,201901,14091,42047,11876,39017,1446,4521,8425,28821,9871,33342
210542,201901,6224,15470,5119,14241,291,499,4444,12964,4735,13463
210545,201901,2244,7083,2113,6861,49,216,1865,5966,1914,6182
210547,201901,3542,12773,3145,11986,309,1167,2278,8930,2587,10097
210550,201901,6099,18574,4984,16879,366,1372,3780,13095,4146,14467
210560,201901,3412,10667,3105,10150,122,436,2633,8540,2755,8976
210565,201901,1468,5033,1240,4688,74,380,959,3672,1033,4052
210570,201901,10946,30067,9795,28687,293,841,8811,26152,9104,26993
210580,201901,2995,8326,2601,7854,209,415,2108,6673,2317,7088
210590,201901,4246,12881,3732,12190,92,497,3309,10719,3401,11216
210592,201901,2580,7718,2426,7476,35,179,2154,6574,2189,6753
210594,201901,2524,6884,1987,6066,83,213,1512,4775,1595,4988
210596,201901,2331,8576,2173,8249,142,607,1748,6660,1890,7267
210598,201901,1851,5327,1702,5121,31,140,1550,4630,1581,4770
210600,201901,2964,8181,2428,7392,77,205,2000,6181,2077,6386
210610,201901,2522,7470,2225,7115,71,343,1925,6099,1996,6442
210620,201901,2484,7147,2149,6744,53,178,1952,6221,2005,6399
210630,201901,3038,10522,2776,10124,154,804,2267,8101,2421,8905
210632,201901,4244,14081,3806,13441,289,1250,2962,10342,3251,11592
210635,201901,1768,6312,1685,6172,139,476,1385,5208,1524,5684
210637,201901,2291,7885,2066,7548,165,715,1568,5773,1733,6488
210640,201901,4504,16488,4311,16265,58,346,4078,15312,4136,15658
210650,201901,7249,20848,6698,20141,82,359,6210,18645,6292,19004
210660,201901,8222,24102,7318,22690,317,1168,6313,19385,6630,20553
210663,201901,2535,7668,2382,7493,107,279,2097,6763,2204,7042
210667,201901,1871,6173,1749,5992,57,238,1583,5456,1640,5694
210670,201901,4418,15386,4086,14837,140,684,3534,12737,3674,13421
210675,201901,4987,13787,4372,12959,303,773,3593,10940,3896,11713
210680,201901,4083,10611,3464,9841,129,255,3074,8944,3203,9199
210690,201901,7389,23780,6615,22887,264,1176,5810,20170,6074,21346
210700,201901,2694,7420,2220,6814,140,375,1768,5769,1908,6144
210710,201901,5007,15759,4434,14917,130,666,3870,12861,4000,13527
210720,201901,2799,9409,2630,9197,53,308,2390,8287,2443,8595
210725,201901,1338,4585,1178,4333,45,213,816,3134,861,3347
210730,201901,1192,3241,1010,2993,87,222,786,2386,873,2608
210735,201901,4593,13929,3956,13045,282,974,3284,11004,3566,11978
210740,201901,5260,14473,4639,13786,146,526,3809,11201,3955,11727
210745,201901,4490,12483,4191,12083,149,386,3794,10986,3943,11372
210750,201901,21369,55062,18649,51753,1495,4068,13608,39283,15103,43351
210760,201901,5755,15574,5073,14842,21,88,4838,14228,4859,14316
210770,201901,5955,15753,5198,14897,54,232,4875,13938,4929,14170
210780,201901,7010,23240,6309,22037,580,1887,4954,17658,5534,19545
210790,201901,4406,13901,4050,13446,210,654,3211,11278,3421,11932
210800,201901,4936,13274,4263,12386,71,293,3850,11032,3921,11325
210805,201901,3884,14503,3742,14290,104,584,3369,12805,3473,13389
210810,201901,4935,14749,4533,14231,218,484,3898,12625,4116,13109
210820,201901,6993,20245,5953,18580,798,2497,3742,11893,4540,14390
210825,201901,6506,20550,6048,19956,233,811,5293,17668,5526,18479
210830,201901,7612,21966,7162,21409,478,1079,6142,19002,6620,20081
210840,201901,3249,8705,2951,8299,83,261,2587,7181,2670,7442
210845,201901,6264,17272,5769,16726,25,78,5621,16341,5646,16419
210850,201901,5751,19962,5000,18807,302,1487,3917,14659,4219,16146
210860,201901,19261,52134,16382,48448,758,2115,13449,41209,14207,43324
210870,201901,6723,18743,5800,17657,241,739,5074,15475,5315,16214
210880,201901,4350,13482,3952,13032,252,960,3263,10754,3515,11714
210890,201901,4030,12294,3669,11865,221,584,3063,10190,3284,10774
210900,201901,4574,13512,3507,11593,1385,4852,618,2298,2003,7150
210905,201901,1911,5447,1634,5074,50,113,1474,4670,1524,4783
210910,201901,7149,22083,6138,20448,815,2827,4150,13885,4965,16712
210920,201901,3198,10693,2827,10197,86,462,2506,8962,2592,9424
210923,201901,1422,4498,1270,4252,63,246,968,3242,1031,3488
210927,201901,5159,16258,4588,15635,146,527,4032,13939,4178,14466
210930,201901,2442,8642,2224,8251,142,670,1742,6400,1884,7070
210940,201901,3904,11372,3676,11090,106,484,3345,9915,3451,10399
210945,201901,5985,17913,5554,17402,236,725,4833,15323,5069,16048
210950,201901,5057,14832,3953,13208,613,1736,2613,9289,3226,11025
210955,201901,1565,5034,1391,4749,130,416,1026,3585,1156,4001
210960,201901,8667,26633,7672,25144,1369,4118,4884,16930,6253,21048
210970,201901,1240,3964,1023,3589,69,313,776,2636,845,2949
210975,201901,1644,5354,1491,5099,109,392,1168,4005,1277,4397
210980,201901,10270,23343,9036,22075,111,230,8578,21087,8689,21317
210990,201901,15942,46366,12869,42306,1083,3808,9366,31323,10449,35131
211000,201901,14041,42953,12116,40737,607,2470,9958,34204,10565,36674
211003,201901,5299,16698,4540,15762,159,616,3929,13936,4088,14552
211010,201901,6314,22957,5757,22240,70,418,5257,20489,5327,20907
211020,201901,7682,24059,7144,23407,288,1150,6171,20277,6459,21427
211023,201901,1977,6633,1886,6507,99,414,1592,5435,1691,5849
211027,201901,2845,9469,2762,9334,176,666,2394,8011,2570,8677
211030,201901,3858,10908,3475,10450,243,575,2857,8836,3100,9411
211040,201901,4470,16414,4216,16005,136,775,3748,14109,3884,14884
211050,201901,9302,23964,8515,22974,167,442,7873,21246,8040,21688
211060,201901,6668,21116,6197,20474,140,569,5734,18965,5874,19534
211065,201901,2102,6100,1797,5696,84,296,1498,4798,1582,5094
211070,201901,7308,24388,6462,23034,508,1848,5086,18284,5594,20132
211080,201901,1266,3627,1024,3242,42,247,794,2368,836,2615
211085,201901,1932,5798,1703,5478,90,249,1486,4859,1576,5108
211090,201901,3219,8949,2902,8538,44,202,2649,7728,2693,7930
211100,201901,6599,17057,6168,16516,44,140,5675,15261,5719,15401
211102,201901,2875,10420,2675,10115,161,782,2290,8575,2451,9357
211105,201901,2294,7460,1928,6784,188,686,1349,4708,1537,5394
211107,201901,4381,14013,3837,13223,150,630,3143,11071,3293,11701
211110,201901,5839,16542,4561,14562,514,1521,3199,10504,3713,12025
211120,201901,39923,104205,36235,99928,4716,12163,23705,69991,28421,82154
211125,201901,2009,6132,1708,5664,52,209,1424,4726,1476,4935
211130,201901,188790,461535,173191,441994,25277,65301,75001,220004,100278,285305
211140,201901,4881,14911,4336,14172,196,618,3704,12142,3900,12760
211150,201901,9179,25791,7939,24158,315,1021,6719,20516,7034,21537
211153,201901,2520,7467,2045,6881,288,1042,1377,4800,1665,5842
211157,201901,1060,3402,884,3093,40,226,639,2202,679,2428
211160,201901,3802,11434,3073,10304,175,784,2282,7507,2457,8291
211163,201901,1770,5725,1633,5527,14,71,1521,5238,1535,5309
211167,201901,1543,5014,1439,4852,31,154,1329,4442,1360,4596
211170,201901,6242,15628,5930,15279,50,161,5650,14508,5700,14669
211172,201901,2368,6735,2074,6284,84,302,1689,4969,1773,5271
211174,201901,2749,8265,2535,7998,60,302,2295,7182,2355,7484
211176,201901,4162,12287,3272,10985,209,856,2545,8488,2754,9344
211178,201901,4622,10816,4024,10146,41,187,3780,9410,3821,9597
211180,201901,3954,13415,3679,12994,202,826,3142,11086,3344,11912
211190,201901,3006,9095,2609,8475,49,257,2249,7226,2298,7483
211195,201901,1344,3948,1146,3664,65,185,955,3126,1020,3311
211200,201901,2053,6160,1687,5675,183,649,1175,4021,1358,4670
211210,201901,6461,19809,5874,19034,272,985,5089,16469,5361,17454
211220,201901,34830,91375,29189,84419,2854,8064,21582,63972,24436,72036
211223,201901,4770,13324,4185,12488,456,1303,3075,9297,3531,10600
211227,201901,1716,5878,1569,5662,44,219,1372,5001,1416,5220
211230,201901,7012,21650,6312,20550,402,1280,5110,16800,5512,18080
211240,201901,8115,26251,7680,25685,153,793,7016,23242,7169,24035
211245,201901,6579,17030,6210,16652,66,188,6058,16246,6124,16434
211250,201901,13342,40260,12210,38902,469,2004,10462,32921,10931,34925
211260,201901,7619,25259,7010,24435,204,930,6322,22108,6526,23038
211270,201901,10241,33270,8965,31542,379,1799,7381,26029,7760,27828
211280,201901,12842,36592,11574,34998,945,2332,9344,29502,10289,31834
211285,201901,1630,5755,1436,5449,211,851,838,3283,1049,4134
211290,201901,7043,22235,6557,21544,183,835,5649,18424,5832,19259
211300,201901,7961,22805,7253,21862,153,491,6659,20062,6812,20553
211400,201901,11059,32918,9170,30234,1349,4477,5822,20255,7171,24732
220005,201901,1815,4922,1645,4672,35,147,1360,3793,1395,3940
220010,201901,1443,4150,1214,3748,36,154,942,2874,978,3028
220020,201901,3285,9765,2929,9189,267,914,2250,6986,2517,7900
220025,201901,2193,5070,1874,4582,26,80,1584,3765,1610,3845
220027,201901,1236,3222,1067,2999,27,94,882,2438,909,2532
220030,201901,3253,8525,3095,8297,96,284,2709,7145,2805,7429
220040,201901,6778,20832,6093,19553,1176,3569,3729,12286,4905,15855
220045,201901,1425,4480,1205,4093,35,190,980,3255,1015,3445
220050,201901,4518,12845,3867,11895,100,456,3468,10544,3568,11000
220060,201901,2363,5095,2006,4683,29,82,1877,4360,1906,4442
220070,201901,2459,6396,2116,5893,77,174,1768,4940,1845,5114
220080,201901,683,1955,590,1813,28,106,505,1520,533,1626
220090,201901,1769,4339,1468,3918,17,66,1251,3419,1268,3485
220095,201901,638,1674,607,1639,13,28,557,1505,570,1533
220100,201901,1349,3820,1104,3410,47,192,885,2654,932,2846
220105,201901,1975,6278,1725,5747,148,489,1297,4344,1445,4833
220110,201901,3396,9421,3177,9022,45,221,2829,7903,2874,8124
220115,201901,2655,8029,2463,7742,74,304,2215,6855,2289,7159
220117,201901,1350,3314,1041,2872,16,67,884,2388,900,2455
220120,201901,11849,33631,10953,32518,103,412,10275,30493,10378,30905
220130,201901,1072,3043,913,2819,15,108,813,2452,828,2560
220140,201901,1942,4308,1675,3984,147,390,1432,3357,1579,3747
220150,201901,6409,19173,5991,18514,124,634,5141,15556,5265,16190
220155,201901,1095,3216,869,2797,22,92,621,1962,643,2054
220157,201901,1035,2569,861,2293,15,69,698,1798,713,1867
220160,201901,2671,7728,2311,7071,45,242,1916,5718,1961,5960
220170,201901,1479,3975,1256,3648,13,68,1103,3159,1116,3227
220173,201901,1987,5738,1653,5119,39,171,1314,3986,1353,4157
220177,201901,1932,5569,1856,5478,14,46,1813,5361,1827,5407
220180,201901,1119,2836,894,2438,7,37,664,1698,671,1735
220190,201901,6032,16345,5168,15131,399,1302,3879,11309,4278,12611
220191,201901,1380,4428,1272,4236,72,314,949,3082,1021,3396
220192,201901,1818,4978,1437,4301,29,104,1142,3353,1171,3457
220194,201901,1678,4878,1499,4576,67,275,1239,3687,1306,3962
220196,201901,1881,5158,1706,4876,33,160,1453,4044,1486,4204
220198,201901,1283,3564,1068,3284,7,19,994,3093,1001,3112
220200,201901,4763,14341,4277,13696,226,824,3510,11247,3736,12071
220202,201901,2165,6135,1863,5623,31,151,1580,4676,1611,4827
220205,201901,2518,7108,2245,6656,34,151,1938,5648,1972,5799
220207,201901,775,2337,651,2122,55,197,429,1399,484,1596
220208,201901,1671,5247,1360,4628,242,878,685,2323,927,3201
220209,201901,1570,4573,1366,4230,28,141,1103,3365,1131,3506
220210,201901,1575,4118,1379,3795,15,73,1142,3053,1157,3126
220211,201901,1540,4044,1427,3890,15,59,1269,3473,1284,3532
220213,201901,1733,4710,1507,4284,26,95,1211,3340,1237,3435
220217,201901,2023,6216,1924,6102,36,119,1797,5756,1833,5875
220220,201901,10032,26822,8425,24302,544,1482,6044,17853,6588,19335
220225,201901,1090,2855,886,2592,10,49,809,2338,819,2387
220230,201901,5687,14282,4918,13227,195,513,4244,11436,4439,11949
220240,201901,2889,8601,2662,8165,95,325,2164,6629,2259,6954
220245,201901,1594,4003,1286,3609,11,54,1162,3293,1173,3347
220250,201901,2802,8190,2469,7751,27,156,2244,6992,2271,7148
220253,201901,1628,4490,1394,4077,75,231,1152,3293,1227,3524
220255,201901,1851,4598,1556,4151,36,173,1295,3291,1331,3464
220260,201901,4166,13125,3682,12289,184,673,2937,9801,3121,10474
220265,201901,1190,3975,1104,3842,55,232,888,3056,943,3288
220270,201901,6375,20161,5986,19465,269,1175,4975,15657,5244,16832
220271,201901,1453,3805,1263,3534,38,127,1110,3102,1148,3229
220272,201901,1698,4916,1515,4568,60,187,1149,3378,1209,3565
220273,201901,1197,3454,992,3079,39,149,753,2287,792,2436
220275,201901,2205,5398,1732,4753,40,154,1490,4067,1530,4221
220277,201901,2085,5422,1815,5004,36,122,1540,4170,1576,4292
220280,201901,1581,3888,1312,3512,31,92,1113,2928,1144,3020
220285,201901,1465,3824,1238,3536,17,78,1107,3125,1124,3203
220290,201901,5870,17585,4763,16023,346,1320,3554,12033,3900,13353
220300,201901,1906,5785,1585,5340,50,302,1305,4291,1355,4593
220310,201901,2890,8010,2293,7338,55,285,1917,6033,1972,6318
220320,201901,2974,8923,2342,7709,119,517,1766,5648,1885,6165
220323,201901,1585,4906,1288,4415,76,300,1041,3523,1117,3823
220325,201901,1259,3740,1072,3418,33,150,898,2812,931,2962
220327,201901,1435,4224,1284,3972,48,209,1046,3164,1094,3373
220330,201901,4137,10310,3416,9403,100,315,2949,8029,3049,8344
220335,201901,1760,5270,1563,5034,26,90,1416,4554,1442,4644
220340,201901,1810,4802,1429,4163,45,151,1019,2844,1064,2995
220342,201901,1161,3500,1033,3302,43,197,819,2581,862,2778
220345,201901,3082,7093,2475,6245,17,50,2299,5787,2316,5837
220350,201901,3327,8716,2662,7666,137,438,1956,5591,2093,6029
220360,201901,1236,3176,983,2774,23,75,791,2213,814,2288
220370,201901,8733,25083,7965,23977,189,824,7020,20853,7209,21677
220375,201901,1523,4494,1373,4304,8,30,1310,4132,1318,4162
220380,201901,1500,3636,1243,3264,23,70,1082,2796,1105,2866
220385,201901,810,1978,655,1700,12,42,557,1417,569,1459
220390,201901,8253,23371,6805,20955,1776,5375,2952,9723,4728,15098
220400,201901,1450,3576,1122,3069,30,101,851,2263,881,2364
220410,201901,1140,3192,943,2866,51,149,757,2270,808,2419
220415,201901,805,2148,679,1943,13,43,526,1482,539,1525
220420,201901,1958,5473,1601,4800,50,152,1243,3673,1293,3825
220430,201901,2505,6754,2395,6602,81,257,2108,5731,2189,5988
220435,201901,1672,4492,1465,4177,54,186,1166,3252,1220,3438
220440,201901,2362,7590,2076,7110,112,458,1702,5752,1814,6210
220450,201901,2328,6322,1922,5797,144,514,1515,4550,1659,5064
220455,201901,1307,4054,1236,3960,22,109,1094,3479,1116,3588
220460,201901,911,2332,851,2263,28,103,736,1912,764,2015
220465,201901,2336,7360,2071,6939,166,593,1559,5285,1725,5878
220470,201901,3385,9658,3045,9111,83,281,2488,7334,2571,7615
220480,201901,2486,6671,1986,5842,140,372,1428,4150,1568,4522
220490,201901,2351,6188,2122,5888,45,209,1875,5110,1920,5319
220500,201901,2495,6699,2302,6397,45,191,1929,5184,1974,5375
220510,201901,2484,7171,2017,6342,88,259,1580,4969,1668,5228
220515,201901,1653,4025,1490,3799,29,57,1309,3328,1338,3385
220520,201901,4932,12952,4466,12275,100,308,3940,10765,4040,11073
220525,201901,1273,3324,1142,3146,14,59,1042,2834,1056,2893
220527,201901,1279,3637,1139,3417,17,59,977,2971,994,3030
220530,201901,1333,3463,1174,3259,24,96,1087,2970,1111,3066
220535,201901,786,2221,724,2141,42,157,588,1712,630,1869
220540,201901,3290,10453,3089,10085,104,397,2670,8658,2774,9055
220545,201901,1344,4242,1254,4077,82,338,1034,3292,1116,3630
220550,201901,8454,26202,7623,24831,587,2098,5733,18471,6320,20569
220551,201901,1402,4140,1234,3852,40,155,985,3026,1025,3181
220552,201901,1561,4581,1282,4051,49,241,1005,3052,1054,3293
220553,201901,1542,4261,1368,4013,53,123,1093,3300,1146,3423
220554,201901,850,2288,621,1905,38,101,428,1300,466,1401
220555,201901,2037,6518,1902,6290,59,282,1533,5168,1592,5450
220556,201901,1250,3693,1070,3329,63,256,749,2223,812,2479
220557,201901,1558,4762,1325,4304,80,296,959,3030,1039,3326
220558,201901,1377,3642,1078,3223,23,106,905,2665,928,2771
220559,201901,1589,4141,1359,3777,6,35,1102,3104,1108,3139
220560,201901,1760,4021,1416,3571,32,72,1262,3175,1294,3247
220570,201901,7100,21635,6480,20725,454,1533,5146,16404,5600,17937
220580,201901,6773,19125,6287,18323,113,408,5638,16261,5751,16669
220585,201901,1885,6178,1691,5823,58,222,1388,4776,1446,4998
220590,201901,1263,3553,1055,3238,95,288,753,2319,848,2607
220595,201901,2436,6774,2248,6527,15,78,2049,5896,2064,5974
220600,201901,1393,3130,1159,2831,116,176,944,2390,1060,2566
220605,201901,1647,4806,1396,4372,23,121,1116,3398,1139,3519
220610,201901,2789,8712,2625,8480,35,150,2425,7844,2460,7994
220620,201901,7821,24645,7291,23927,227,1082,6588,21381,6815,22463
220630,201901,359,1073,284,940,33,109,178,606,211,715
220635,201901,1613,5195,1425,4781,65,274,1076,3537,1141,3811
220640,201901,2612,7216,2240,6668,92,358,1815,5328,1907,5686
220650,201901,2047,5748,1761,5293,54,195,1372,4104,1426,4299
220660,201901,2610,8221,2272,7667,90,456,1865,6110,1955,6566
220665,201901,1281,3949,1100,3652,32,173,907,2949,939,3122
220667,201901,1605,5126,1431,4800,70,291,1138,3796,1208,4087
220669,201901,1668,5161,1602,5048,74,340,1365,4194,1439,4534
220670,201901,2183,5792,1754,5202,31,105,1509,4441,1540,4546
220672,201901,3089,7680,2508,6978,140,389,2160,5995,2300,6384
220675,201901,1197,3328,1100,3142,50,145,882,2496,932,2641
220680,201901,2644,7313,2518,7128,109,274,2273,6457,2382,6731
220690,201901,1490,4034,1314,3766,104,273,1006,2916,1110,3189
220695,201901,858,2431,799,2323,16,58,689,1985,705,2043
220700,201901,9150,23320,7274,20662,353,1081,5595,15753,5948,16834
220710,201901,860,2441,658,2050,33,102,476,1463,509,1565
220720,201901,2059,5009,1848,4712,21,87,1585,3979,1606,4066
220730,201901,1270,3626,1083,3330,22,107,912,2741,934,2848
220735,201901,957,2290,740,1943,24,80,615,1549,639,1629
220740,201901,1374,3829,1107,3475,35,122,940,2969,975,3091
220750,201901,3697,9812,3303,9238,213,527,2860,8026,3073,8553
220755,201901,1205,3082,1007,2772,33,122,797,2107,830,2229
220760,201901,2946,8638,2610,8178,108,353,2250,7138,2358,7491
220770,201901,20280,63189,17453,58181,5894,20312,6179,21444,12073,41756
220775,201901,1090,2895,1014,2799,13,50,980,2694,993,2744
220777,201901,1633,4187,1254,3586,33,99,928,2649,961,2748
220779,201901,1308,3242,1151,3018,27,87,994,2570,1021,2657
220780,201901,5573,14369,4848,13207,213,684,3945,10468,4158,11152
220785,201901,1437,3232,1285,3023,10,16,1236,2906,1246,2922
220790,201901,10025,28905,9020,27478,271,1290,7622,22796,7893,24086
220793,201901,858,2312,706,2044,21,65,578,1682,599,1747
220795,201901,1387,3663,1248,3492,22,91,1107,3072,1129,3163
220800,201901,16352,39343,13794,35695,755,1987,10214,26159,10969,28146
220810,201901,2907,8285,2512,7572,51,213,2105,6211,2156,6424
220820,201901,5087,13290,4366,12292,402,1007,3203,9061,3605,10068
220830,201901,7132,19288,6453,18313,255,818,5422,15238,5677,16056
220840,201901,11980,37217,10205,33546,2386,7499,4993,17102,7379,24601
220850,201901,2975,9494,2700,9144,59,332,2412,8079,2471,8411
220855,201901,592,1629,522,1512,14,74,453,1278,467,1352
220860,201901,1011,2541,868,2313,16,62,781,2056,797,2118
220865,201901,2534,6755,1965,5783,63,237,1517,4346,1580,4583
220870,201901,2786,8117,2314,7478,35,181,2103,6757,2138,6938
220880,201901,5132,12446,4516,11689,76,252,4167,10684,4243,10936
220885,201901,1311,4198,1110,3852,57,242,877,3067,934,3309
220887,201901,1475,3298,1244,2995,9,30,1164,2770,1173,2800
220890,201901,1419,4535,1220,4191,71,271,963,3303,1034,3574
220900,201901,1959,4829,1652,4413,33,79,1429,3791,1462,3870
220910,201901,1466,4160,1252,3841,36,127,1059,3235,1095,3362
220915,201901,952,2570,770,2215,12,51,605,1689,617,1740
220920,201901,1358,4509,1162,4238,74,338,934,3389,1008,3727
220930,201901,1584,4535,1389,4236,29,113,1257,3788,1286,3901
220935,201901,1037,2988,835,2571,28,109,552,1603,580,1712
220937,201901,1343,3665,1167,3391,28,113,955,2716,983,2829
220940,201901,1442,4171,1175,3665,38,154,884,2681,922,2835
220945,201901,414,1436,368,1340,22,115,272,963,294,1078
220950,201901,1385,3266,911,2508,13,48,705,1883,718,1931
220955,201901,1560,4080,1341,3699,30,84,1157,3178,1187,3262
220960,201901,825,2096,635,1800,13,55,483,1315,496,1370
220965,201901,1752,4823,1542,4529,22,138,1326,3793,1348,3931
220970,201901,1823,4644,1398,3972,43,119,1123,3180,1166,3299
220975,201901,700,2109,616,2010,22,140,543,1685,565,1825
220980,201901,1144,3280,1029,3116,33,148,865,2578,898,2726
220985,201901,1152,3192,1040,3030,37,143,822,2290,859,2433
220987,201901,1488,4418,1276,4047,57,246,1034,3216,1091,3462
220990,201901,1669,4719,1458,4394,28,151,1193,3508,1221,3659
220995,201901,1158,3462,909,3021,49,197,644,2132,693,2329
220997,201901,2431,7134,2241,6852,55,246,2019,6075,2074,6321
221000,201901,4111,11630,3780,11155,92,454,3242,9369,3334,9823
221005,201901,1445,3922,1321,3710,46,191,1110,2988,1156,3179
221010,201901,1175,2827,959,2551,27,74,828,2160,855,2234
221020,201901,1506,4649,1392,4424,31,137,1048,3283,1079,3420
221030,201901,1556,4110,1342,3827,32,141,1169,3305,1201,3446
221035,201901,1420,3769,1248,3530,24,45,1097,3191,1121,3236
221037,201901,615,1785,524,1630,9,53,347,1023,356,1076
221038,201901,513,1463,410,1260,17,57,282,860,299,917
221039,201901,865,2356,765,2186,19,74,628,1719,647,1793
221040,201901,4052,12317,3629,11576,159,566,2904,9258,3063,9824
221050,201901,3740,10056,3347,9547,56,222,3050,8620,3106,8842
221060,201901,8230,22969,6826,20802,237,740,5497,16892,5734,17632
221062,201901,1146,3817,997,3537,46,224,799,2780,845,3004
221063,201901,1107,3193,947,2960,69,263,694,2089,763,2352
221065,201901,2584,6759,2277,6220,25,116,2001,5363,2026,5479
221070,201901,3286,10485,2743,9386,310,1075,1763,6120,2073,7195
221080,201901,3454,8483,2807,7530,55,222,2317,6106,2372,6328
221090,201901,1384,3661,1136,3232,17,64,973,2696,990,2760
221093,201901,1335,3812,1226,3586,116,346,852,2452,968,2798
221095,201901,894,2363,750,2138,7,20,620,1745,627,1765
221097,201901,814,2148,630,1819,24,89,453,1246,477,1335
221100,201901,101067,277028,87155,254378,12544,38216,54641,156630,67185,194846
221110,201901,9772,29492,9025,28519,205,1072,8020,24899,8225,25971
221120,201901,4395,12702,3990,12015,197,661,3379,10107,3576,10768
221130,201901,4906,13094,3669,10658,839,2365,1692,4952,2531,7317
221135,201901,1570,4331,1413,4118,45,172,1246,3596,1291,3768
221140,201901,1294,3131,1114,2887,10,46,986,2481,996,2527
221150,201901,1085,2701,887,2365,25,116,685,1706,710,1822
221160,201901,773,1918,682,1796,25,45,550,1453,575,1498
221170,201901,978,2884,901,2755,19,60,770,2351,789,2411
230010,201901,3122,8336,2522,7289,101,358,1946,5485,2047,5843
230015,201901,2891,9564,2606,9011,220,899,1806,6153,2026,7052
230020,201901,12900,40951,12220,39872,397,1676,10315,33227,10712,34903
230030,201901,12447,32223,10739,29861,199,642,9474,26279,9673,26921
230040,201901,4381,11527,3685,10378,89,365,3021,8357,3110,8722
230050,201901,2749,8725,2023,6941,371,1245,803,2713,1174,3958
230060,201901,2290,6329,1857,5519,47,209,1501,4358,1548,4567
230070,201901,3770,10393,3100,9071,147,500,2123,6160,2270,6660
230075,201901,9002,29357,8328,28189,368,1874,6796,22372,7164,24246
230080,201901,2919,6274,2244,5419,13,58,1994,4788,2007,4846
230090,201901,4091,10484,3529,9566,160,465,2761,7408,2921,7873
230100,201901,17327,46663,15502,44080,1411,4238,10758,30637,12169,34875
230110,201901,12079,36537,10488,33346,1730,5478,5770,18450,7500,23928
230120,201901,7191,19946,6356,18560,570,1491,4630,13737,5200,15228
230125,201901,3074,8302,2509,7371,79,301,1919,5570,1998,5871
230130,201901,5539,17485,4588,15370,376,1421,3029,9946,3405,11367
230140,201901,3336,10198,2872,9273,116,509,2176,6824,2292,7333
230150,201901,1579,4746,1334,4205,230,650,733,2405,963,3055
230160,201901,6424,17054,5588,15760,152,586,4680,12919,4832,13505
230170,201901,5879,17163,5024,15502,301,995,3684,11152,3985,12147
230180,201901,1596,4491,1365,4032,22,100,1092,3122,1114,3222
230185,201901,4124,12253,3542,11264,286,1019,2596,8248,2882,9267
230190,201901,12595,37434,10778,34030,1688,5445,5839,18489,7527,23934
230195,201901,4929,14851,4503,14052,316,1079,3470,10706,3786,11785
230200,201901,4920,13617,4213,12245,145,486,3257,9241,3402,9727
230205,201901,3888,12124,3517,11506,158,675,2709,8685,2867,9360
230210,201901,9930,24835,8480,22792,431,1388,6508,17228,6939,18616
230220,201901,13137,34090,11778,32077,502,1475,9814,26417,10316,27892
230230,201901,6756,20692,6087,19299,429,1446,4453,14014,4882,15460
230240,201901,12201,33096,10904,31007,348,1195,9078,25468,9426,26663
230250,201901,8732,25416,8484,25020,287,1046,6772,19467,7059,20513
230260,201901,14047,43454,12428,40490,1563,5285,7351,24184,8914,29469
230270,201901,7332,20390,5775,17427,508,1527,3837,11612,4345,13139
230280,201901,20064,54526,16648,48797,597,2418,13054,36963,13651,39381
230290,201901,4683,13252,3988,11893,353,941,2940,8835,3293,9776
230300,201901,4533,12534,4198,12063,71,300,3709,10478,3780,10778
230310,201901,4622,13247,3941,12082,140,592,2824,8434,2964,9026
230320,201901,7554,21971,6564,20098,304,1181,5052,15171,5356,16352
230330,201901,4562,12669,3779,11171,165,532,2815,8173,2980,8705
230340,201901,3526,11217,3016,10177,287,998,2009,6729,2296,7727
230350,201901,18127,50756,16012,47352,1049,3624,10382,30921,11431,34545
230360,201901,2806,7816,2259,6796,155,511,1524,4546,1679,5057
230365,201901,3010,7604,2537,6860,48,236,2137,5680,2185,5916
230370,201901,53301,155177,45957,143775,8270,26251,24819,79740,33089,105991
230380,201901,6331,17716,5046,15299,162,615,3685,10993,3847,11608
230390,201901,3208,9717,2824,9083,118,487,2183,6936,2301,7423
230393,201901,2937,9095,2439,8099,94,509,1882,5994,1976,6503
230395,201901,5686,15608,4970,14372,400,1112,3424,9956,3824,11068
230400,201901,5739,16118,5091,15063,154,747,3939,11241,4093,11988
230410,201901,14174,42748,11657,37897,1122,3866,7580,24648,8702,28514
230420,201901,26126,75076,22057,67545,2754,8827,12794,38922,15548,47749
230423,201901,4692,14066,4109,12870,101,462,3318,10179,3419,10641
230425,201901,5387,17002,4921,16014,445,1509,3505,11370,3950,12879
230426,201901,2602,7025,1953,5732,41,174,1484,4257,1525,4431
230427,201901,1839,5252,1325,4110,66,225,890,2674,956,2899
230428,201901,9501,26110,8411,24453,1135,3356,5160,14952,6295,18308
230430,201901,4620,13367,3794,11958,170,634,2850,8808,3020,9442
230435,201901,5411,14870,4658,13587,513,1527,3014,8770,3527,10297
230440,201901,385009,992403,323835,899364,43119,125795,192123,530157,235242,655952
230445,201901,4263,11391,3509,10083,211,568,2426,6864,2637,7432
230450,201901,3533,10431,3090,9729,238,911,2239,6913,2477,7824
230460,201901,2041,5871,1806,5489,78,295,1490,4521,1568,4816
230465,201901,3911,11164,3343,10126,92,423,2480,7221,2572,7644
230470,201901,11030,37128,10017,35176,870,3723,7292,25128,8162,28851
230480,201901,1393,4096,1184,3726,98,387,856,2588,954,2975
230490,201901,2376,6809,2046,6192,197,655,1271,3674,1468,4329
230495,201901,5729,17338,5051,16079,399,1602,3321,10368,3720,11970
230500,201901,8719,29131,8056,27848,332,1401,6442,22177,6774,23578
230510,201901,1611,5089,1202,4144,226,821,525,1802,751,2623
230520,201901,4378,12742,3865,11765,311,986,2722,8211,3033,9197
230523,201901,13925,41953,11573,36937,2744,8707,3157,10683,5901,19390
230526,201901,3862,11171,3277,10122,157,597,2427,7369,2584,7966
230530,201901,5243,16456,4497,15034,369,1355,3157,10517,3526,11872
230533,201901,4077,10423,3518,9449,98,286,2881,7635,2979,7921
230535,201901,5214,14707,4464,13424,244,746,3188,9698,3432,10444
230540,201901,15681,43748,13884,41067,267,1172,11741,34222,12008,35394
230550,201901,19504,53592,16138,47691,1736,5349,9861,28976,11597,34325
230560,201901,7723,19641,6419,17465,82,326,5389,14495,5471,14821
230565,201901,2997,8401,2534,7554,84,354,1925,5638,2009,5992
230570,201901,3481,8867,3025,8276,61,190,2590,7061,2651,7251
230580,201901,10077,27338,8882,25633,332,1123,7460,21370,7792,22493
230590,201901,8711,25491,7281,22808,496,1776,5194,15761,5690,17537
230600,201901,3629,9589,2767,7967,88,279,1855,5403,1943,5682
230610,201901,6468,18286,5761,17147,508,1451,4398,13144,4906,14595
230620,201901,2059,5641,1575,4681,132,434,953,2761,1085,3195
230625,201901,7674,22576,6590,20535,2053,6615,1768,5832,3821,12447
230630,201901,10146,31171,8992,28750,2057,6130,4288,14515,6345,20645
230640,201901,27288,83625,24731,79450,1580,6129,19320,61168,20900,67297
230650,201901,4934,13881,4188,12517,163,679,3279,9536,3442,10215
230655,201901,9172,31978,8732,31184,685,2705,6838,24500,7523,27205
230660,201901,6087,18089,5000,16153,167,902,4056,12794,4223,13696
230670,201901,6061,14805,4486,12209,162,487,3523,9369,3685,9856
230680,201901,2502,7082,2156,6456,166,519,1509,4515,1675,5034
230690,201901,6749,20460,5975,18866,478,1709,3708,11424,4186,13133
230700,201901,9438,24852,8065,22324,353,1118,6088,16396,6441,17514
230710,201901,6752,21371,5878,19557,553,1981,4143,13556,4696,15537
230720,201901,1908,5721,1584,5042,124,371,1053,3283,1177,3654
230725,201901,3735,11619,3309,10773,508,1784,1622,5189,2130,6973
230730,201901,53420,149213,43595,133657,10328,34010,15310,49337,25638,83347
230740,201901,5980,17036,5186,15711,141,598,4152,12445,4293,13043
230750,201901,8269,22520,6975,20379,192,755,5495,15616,5687,16371
230760,201901,10914,29667,9712,27805,638,2100,7215,20153,7853,22253
230763,201901,4339,12472,3740,11335,151,633,2960,8681,3111,9314
230765,201901,39744,112080,33652,101860,6254,19671,14861,45126,21115,64797
230770,201901,24957,64113,21212,59008,2585,7517,13440,37442,16025,44959
230780,201901,5901,21298,5539,20520,844,3184,3287,12476,4131,15660
230790,201901,2902,8545,2587,8017,134,551,1913,5761,2047,6312
230800,201901,7643,25054,6889,23489,802,3055,4143,13834,4945,16889
230810,201901,11588,35169,10356,33125,440,1738,7938,24836,8378,26574
230820,201901,3178,10538,2697,9438,298,1241,1644,5487,1942,6728
230830,201901,7495,20903,6403,18959,155,684,5206,15022,5361,15706
230835,201901,4108,9976,3218,8593,100,317,2574,6764,2674,7081
230837,201901,3030,9534,2625,8781,115,558,2068,6736,2183,7294
230840,201901,8858,26574,7757,24751,587,2003,5791,18531,6378,20534
230850,201901,9176,27333,7956,24873,441,1583,5678,17565,6119,19148
230860,201901,5141,13458,4330,12268,102,373,3701,10369,3803,10742
230870,201901,16395,40606,14106,37009,457,1303,11423,29725,11880,31028
230880,201901,2062,6388,1880,6070,59,324,1474,4616,1533,4940
230890,201901,4347,14340,4039,13727,339,1289,2960,9891,3299,11180
230900,201901,2987,8871,2555,8014,216,747,1669,5098,1885,5845
230910,201901,2868,8054,2379,7219,77,369,1906,5656,1983,6025
230920,201901,4394,12674,3801,11736,147,574,2926,8826,3073,9400
230930,201901,6337,18186,5332,16258,357,1162,3694,11192,4051,12354
230940,201901,7631,20212,6754,18842,195,597,5688,15735,5883,16332
230945,201901,6484,18915,5616,17158,390,1333,3899,11826,4289,13159
230950,201901,6186,15801,5631,15096,140,322,5021,13657,5161,13979
230960,201901,12759,37978,11500,35621,1841,5820,5915,18555,7756,24375
230970,201901,12757,35224,10911,32353,2058,6265,5552,16628,7610,22893
230980,201901,2671,7954,2339,7346,447,1334,1360,4442,1807,5776
230990,201901,1686,4816,1404,4251,75,299,956,2759,1031,3058
231000,201901,2442,6562,2040,5782,75,208,1478,4108,1553,4316
231010,201901,3240,7995,2638,6955,86,292,2178,5557,2264,5849
231020,201901,7680,24938,6977,23458,1235,3877,4096,14324,5331,18201
231025,201901,7148,20559,6304,19181,852,2629,4224,12922,5076,15551
231030,201901,6988,21349,5633,18428,948,3058,2976,9782,3924,12840
231040,201901,3035,8939,2643,8198,97,370,2051,6227,2148,6597
231050,201901,11714,30959,9565,27119,667,1883,6988,19475,7655,21358
231060,201901,2633,7710,2351,7233,80,313,1893,5798,1973,6111
231070,201901,7940,23495,6745,21345,919,2960,3973,12552,4892,15512
231080,201901,3958,11505,3491,10725,142,665,2668,7949,2810,8614
231085,201901,6169,15852,5065,14509,248,721,3877,11159,4125,11880
231090,201901,4255,11401,3251,9389,111,417,2267,6339,2378,6756
231095,201901,2131,6525,1746,5658,137,471,1192,3856,1329,4327
231100,201901,2933,8764,2471,7895,143,508,1867,5902,2010,6410
231110,201901,3436,10509,3204,10065,137,545,2388,7387,2525,7932
231120,201901,2112,6389,1803,5841,97,372,1227,3918,1324,4290
231123,201901,1884,4982,1593,4463,82,228,1162,3216,1244,3444
231126,201901,5522,15473,4471,13426,225,718,3233,9543,3458,10261
231130,201901,19890,53585,16770,49459,1290,4638,11862,34367,13152,39005
231135,201901,4113,11617,3466,10422,143,519,2513,7404,2656,7923
231140,201901,16494,47529,13469,42062,744,3127,9313,28199,10057,31326
231150,201901,5349,15162,4307,13064,784,2369,1947,6031,2731,8400
231160,201901,5892,18349,5305,17234,1045,3186,2873,9675,3918,12861
231170,201901,4332,12986,3583,11469,220,810,2429,7528,2649,8338
231180,201901,13674,39849,11510,35124,2974,8991,4347,13431,7321,22422
231190,201901,3734,10749,3221,9774,116,499,2512,7396,2628,7895
231195,201901,4500,14148,3882,12854,208,865,2903,9385,3111,10250
231200,201901,7722,24760,6784,22763,274,1395,5145,16729,5419,18124
231210,201901,4676,14154,4051,13051,188,730,3057,9630,3245,10360
231220,201901,11839,31798,9450,27180,498,1543,6752,18701,7250,20244
231230,201901,8947,28751,7980,27108,505,2023,5924,20127,6429,22150
231240,201901,11435,34212,10166,31716,1681,5254,5765,18140,7446,23394
231250,201901,2048,5395,1350,3813,105,295,807,2241,912,2536
231260,201901,3201,9302,2805,8667,289,891,1850,5854,2139,6745
231270,201901,6366,16800,5302,15046,136,537,4029,11152,4165,11689
231280,201901,1631,5191,1533,5001,127,434,1128,3660,1255,4094
231290,201901,36490,111412,31472,101083,5567,18121,14601,46621,20168,64742
231300,201901,3938,11114,3121,9431,256,820,1996,5922,2252,6742
231310,201901,7115,19074,5815,16604,557,1591,3826,10787,4383,12378
231320,201901,7555,21271,6032,18444,111,511,4659,14028,4770,14539
231325,201901,2441,6711,2035,6045,308,843,1221,3717,1529,4560
231330,201901,9494,29208,7966,26124,1521,4892,4168,14071,5689,18963
231335,201901,5586,14912,4746,13514,92,438,4126,11530,4218,11968
231340,201901,17212,54229,15500,51234,1278,4325,11342,37847,12620,42172
231350,201901,15475,42542,14063,40565,332,1189,12570,35921,12902,37110
231355,201901,4358,13315,3918,12528,216,802,3027,9594,3243,10396
231360,201901,7440,22849,6484,21149,402,1437,4892,15922,5294,17359
231370,201901,2231,6070,1776,5257,39,118,1369,4016,1408,4134
231375,201901,4307,13651,3934,13003,149,692,3260,10620,3409,11312
231380,201901,5794,15928,5331,15331,204,562,4387,12788,4591,13350
231390,201901,3326,9852,2991,9285,175,665,2162,6519,2337,7184
231395,201901,3894,11808,3280,10805,552,1810,1800,6058,2352,7868
231400,201901,9050,26586,7930,24476,342,1369,6072,18357,6414,19726
231410,201901,14514,45914,13143,43638,754,2922,10270,33609,11024,36531
240010,201901,2455,6702,1914,5690,202,662,1184,3420,1386,4082
240020,201901,11292,33004,9819,30374,823,3070,6402,19427,7225,22497
240030,201901,2698,6976,2498,6674,105,300,2182,5763,2287,6063
240040,201901,803,2305,671,2067,16,79,500,1495,516,1574
240050,201901,3092,8366,2606,7477,56,162,2068,5817,2124,5979
240060,201901,1367,3715,1160,3336,32,104,937,2650,969,2754
240070,201901,2074,6267,1944,6004,205,691,1455,4416,1660,5107
240080,201901,2715,7489,2336,6789,63,254,1829,5212,1892,5466
240090,201901,2230,5590,1815,4882,20,63,1506,3992,1526,4055
240100,201901,9253,23701,7586,20574,337,1025,5853,15387,6190,16412
240110,201901,4227,12425,3703,11461,208,801,2703,8176,2911,8977
240120,201901,3498,9576,2593,8530,219,878,1716,5772,1935,6650
240130,201901,3502,7530,2967,6793,45,144,2700,6067,2745,6211
240140,201901,1920,5807,1653,5304,184,659,1099,3451,1283,4110
240145,201901,6219,17900,5219,16134,706,2267,3247,10131,3953,12398
240150,201901,863,2555,787,2404,55,199,611,1806,666,2005
240160,201901,1416,4355,1216,3949,61,286,872,2816,933,3102
240165,201901,912,2555,781,2308,61,192,590,1715,651,1907
240170,201901,2295,6501,1966,5914,219,743,1266,3684,1485,4427
240180,201901,3020,8955,2434,7787,515,1596,1220,4076,1735,5672
240185,201901,1233,4009,1117,3816,57,247,908,3054,965,3301
240190,201901,1004,3017,883,2810,24,106,730,2304,754,2410
240200,201901,10409,27671,8656,24629,1055,3210,4703,13210,5758,16420
240210,201901,2850,7395,2533,6892,35,162,2135,5623,2170,5785
240220,201901,7236,22398,6538,21296,409,1747,5001,15995,5410,17742
240230,201901,5693,14708,4671,12964,235,642,3697,10238,3932,10880
240240,201901,1926,5930,1240,4186,131,435,465,1539,596,1974
240250,201901,2787,7635,2520,7245,146,399,2035,5881,2181,6280
240260,201901,13199,40062,11568,37214,1685,5279,7089,23821,8774,29100
240270,201901,2231,6668,1992,6294,102,284,1554,5029,1656,5313
240280,201901,1647,4276,1396,3883,45,133,1131,3098,1176,3231
240290,201901,1187,3506,989,3082,37,174,684,1988,721,2162
240300,201901,2137,5602,1570,4517,85,269,1000,2800,1085,3069
240310,201901,8589,23157,6984,20326,874,2614,3790,10950,4664,13564
240320,201901,2004,5524,1506,4552,29,140,1115,3219,1144,3359
240325,201901,28712,79592,22625,68782,5322,16980,7847,24562,13169,41542
240330,201901,1639,4538,1299,3881,47,161,915,2619,962,2780
240340,201901,1890,4569,1560,4056,53,144,1270,3227,1323,3371
240350,201901,2013,5372,1883,5220,29,113,1682,4673,1711,4786
240360,201901,7744,22281,6946,21011,1037,3076,4385,13740,5422,16816
240370,201901,1938,5241,1528,4403,85,255,1047,2956,1132,3211
240375,201901,871,2221,740,1967,27,105,589,1485,616,1590
240380,201901,2222,6340,1646,5071,155,478,968,2931,1123,3409
240390,201901,936,2429,683,1917,17,50,456,1209,473,1259
240400,201901,1338,3409,1059,2891,35,137,738,1902,773,2039
240410,201901,538,1691,454,1503,54,223,262,830,316,1053
240420,201901,4541,16379,4033,15231,560,2484,2218,8232,2778,10716
240430,201901,3264,8842,2790,7924,234,749,2017,5535,2251,6284
240440,201901,2485,5653,2110,5116,135,316,1675,4007,1810,4323
240450,201901,4061,11452,3343,10145,324,1138,2051,6008,2375,7146
240460,201901,2850,8336,2646,8009,259,830,2095,6324,2354,7154
240470,201901,3511,10785,2764,9216,368,1256,1542,5148,1910,6404
240480,201901,539,1510,395,1208,35,115,174,517,209,632
240485,201901,2044,5988,1705,5322,167,551,1106,3449,1273,4000
240490,201901,1723,4342,1374,3712,50,116,1113,3020,1163,3136
240500,201901,2139,5780,1885,5414,43,155,1625,4630,1668,4785
240510,201901,1649,4409,1485,4178,78,257,1234,3389,1312,3646
240520,201901,1283,3338,1062,3032,43,155,850,2380,893,2535
240530,201901,1951,6004,1807,5754,111,398,1440,4550,1551,4948
240540,201901,2198,5605,1935,5202,91,222,1638,4392,1729,4614
240550,201901,655,1865,604,1776,29,109,463,1316,492,1425
240560,201901,3217,8590,2762,7978,258,683,2041,5980,2299,6663
240570,201901,2826,7489,1912,5447,255,782,843,2204,1098,2986
240580,201901,7567,22437,6901,21244,511,1638,5597,17215,6108,18853
240590,201901,687,1857,602,1711,11,44,452,1264,463,1308
240600,201901,1741,4770,1289,3838,59,216,844,2407,903,2623
240610,201901,4247,11672,3587,10464,141,491,2731,7807,2872,8298
240615,201901,1074,2994,862,2570,70,248,583,1649,653,1897
240620,201901,1834,5225,1575,4763,90,269,1252,3757,1342,4026
240630,201901,1990,5799,1795,5465,131,327,1261,3972,1392,4299
240640,201901,897,2460,724,2173,33,138,534,1558,567,1696
240650,201901,3831,10749,3383,9955,203,613,2644,7739,2847,8352
240660,201901,2819,7540,2546,7181,57,226,2313,6440,2370,6666
240670,201901,2411,6852,2002,6033,142,459,1301,3828,1443,4287
240680,201901,1593,4332,1276,3775,64,234,938,2678,1002,2912
240690,201901,913,2358,730,2040,17,68,588,1586,605,1654
240700,201901,2315,6785,1932,6086,71,290,1519,4691,1590,4981
240710,201901,15780,41598,13418,37492,2256,6130,7661,21751,9917,27881
240720,201901,5029,13061,4375,12048,499,1481,2984,8061,3483,9542
240725,201901,1067,3083,828,2586,34,123,560,1695,594,1818
240730,201901,2040,5871,1749,5285,83,272,1360,4039,1443,4311
240740,201901,1822,4935,1522,4380,56,225,1132,3088,1188,3313
240750,201901,2212,7432,1864,6696,280,1096,1011,3657,1291,4753
240760,201901,1496,3697,1086,3072,57,146,838,2397,895,2543
240770,201901,3018,8619,2645,8081,132,533,2113,6328,2245,6861
240780,201901,5185,14275,4141,12542,518,1568,2526,7844,3044,9412
240790,201901,838,2435,705,2179,15,59,525,1595,540,1654
240800,201901,42227,106800,33946,93970,4958,14305,16627,46203,21585,60508
240810,201901,79446,214613,69997,198710,12389,35413,40468,114897,52857,150310
240820,201901,5518,16894,4789,15605,776,2617,2792,9236,3568,11853
240830,201901,8521,25154,7816,24048,312,1378,6362,19159,6674,20537
240840,201901,1129,2871,905,2488,53,142,625,1663,678,1805
240850,201901,1215,3418,891,2726,41,140,518,1549,559,1689
240860,201901,1210,3340,923,2799,20,92,694,2008,714,2100
240870,201901,1148,2885,898,2465,80,245,617,1654,697,1899
240880,201901,1266,3985,1149,3764,81,305,914,2948,995,3253
240890,201901,4438,12234,3399,10244,506,1634,1707,4965,2213,6599
240895,201901,2645,8489,2401,8125,177,625,2003,6771,2180,7396
240910,201901,3121,8797,2710,8002,65,225,2218,6456,2283,6681
240920,201901,787,2337,681,2136,65,201,384,1245,449,1446
240930,201901,3619,8464,3032,7745,180,256,2384,6304,2564,6560
240933,201901,1756,4214,1453,3757,46,177,1246,3155,1292,3332
240940,201901,6089,15176,4858,13095,271,775,3512,9151,3783,9926
240950,201901,921,2825,804,2593,38,163,641,2010,679,2173
240960,201901,691,2121,617,1970,39,146,474,1467,513,1613
240970,201901,1822,4775,1507,4228,53,210,1258,3418,1311,3628
240980,201901,2903,9122,2655,8650,176,708,2035,6470,2211,7178
240990,201901,2499,7286,2291,6854,272,887,1633,4767,1905,5654
241000,201901,931,2492,755,2149,43,109,524,1492,567,1601
241010,201901,2727,8802,2511,8339,193,772,1838,5982,2031,6754
241020,201901,2033,5512,1508,4430,141,414,958,2744,1099,3158
241025,201901,1725,4988,1390,4334,69,266,938,2879,1007,3145
241030,201901,2426,7749,2008,6858,213,764,1321,4493,1534,5257
241040,201901,2239,7180,2014,6797,99,445,1611,5403,1710,5848
241050,201901,1247,3502,1026,3076,37,123,792,2321,829,2444
241060,201901,703,2008,632,1870,42,121,447,1299,489,1420
241070,201901,631,1758,556,1624,24,89,434,1210,458,1299
241080,201901,1104,3165,850,2655,10,42,636,1974,646,2016
241090,201901,1993,5801,1612,5155,57,283,1268,3979,1325,4262
241100,201901,1129,3230,898,2726,48,161,616,1806,664,1967
241105,201901,1020,3098,832,2733,263,874,277,955,540,1829
241110,201901,895,2612,687,2149,38,145,454,1357,492,1502
241120,201901,7293,21145,6292,19352,1076,3207,3509,11216,4585,14423
241140,201901,3193,8556,2596,7367,153,451,1902,5244,2055,5695
241142,201901,744,2028,548,1642,26,97,313,875,339,972
241150,201901,5660,15298,5067,14305,179,645,4122,11361,4301,12006
241160,201901,1306,3660,1104,3315,140,413,742,2214,882,2627
241170,201901,1278,3269,1110,2997,38,142,924,2379,962,2521
241180,201901,958,2537,704,2041,77,236,408,1149,485,1385
241190,201901,1068,2871,894,2523,26,95,658,1778,684,1873
241200,201901,18097,48409,15764,44897,2811,8174,8804,25244,11615,33418
241210,201901,1315,3677,998,3038,106,349,597,1778,703,2127
241220,201901,8469,25900,7483,24178,1997,6433,3301,11238,5298,17671
241230,201901,2873,7800,2565,7306,110,398,2121,5906,2231,6304
241240,201901,1153,3313,693,2237,43,157,337,1088,380,1245
241250,201901,5397,16035,4480,14291,182,855,3337,10204,3519,11059
241255,201901,1948,6474,1720,5975,133,567,1231,4157,1364,4724
241260,201901,4773,12720,3782,11043,98,447,2954,8411,3052,8858
241270,201901,1771,5186,1476,4612,133,488,1027,3144,1160,3632
241280,201901,2103,5401,1835,4920,68,196,1551,4111,1619,4307
241290,201901,3367,8408,2598,7128,83,316,2028,5387,2111,5703
241300,201901,1429,3913,1152,3415,42,161,775,2223,817,2384
241310,201901,1994,5196,1702,4779,23,95,1445,4054,1468,4149
241320,201901,971,3162,809,2830,93,383,502,1743,595,2126
241330,201901,1746,4532,1376,4074,26,109,1178,3483,1204,3592
241335,201901,3018,8617,2731,8100,89,317,2307,6764,2396,7081
241340,201901,1639,4759,1285,4008,280,897,535,1639,815,2536
241350,201901,1946,5726,1732,5336,111,380,1328,4027,1439,4407
241355,201901,1267,3502,1058,3107,22,81,817,2370,839,2451
241360,201901,2053,5377,1601,4483,62,191,1147,3081,1209,3272
241370,201901,1335,3737,1053,3169,65,229,701,2017,766,2246
241380,201901,634,1783,499,1516,78,237,270,828,348,1065
241390,201901,2671,8118,2439,7740,205,636,1868,5953,2073,6589
241400,201901,3459,9738,3136,9265,185,604,2559,7492,2744,8096
241410,201901,2286,6910,1892,6123,351,1187,1028,3313,1379,4500
241415,201901,1605,4784,1326,4240,79,309,954,2958,1033,3267
241420,201901,2134,7079,1831,6513,472,1831,781,2764,1253,4595
241430,201901,551,1587,386,1187,25,88,237,701,262,789
241440,201901,7087,22826,6380,21544,432,1722,4980,16549,5412,18271
241445,201901,1055,2770,967,2659,25,67,886,2482,911,2549
241450,201901,2699,6843,2357,6300,266,628,1734,4689,2000,5317
241460,201901,3557,9851,3002,8663,162,537,2138,5989,2300,6526
241470,201901,1409,3732,1124,3318,30,123,923,2702,953,2825
241475,201901,1193,3419,944,2940,30,159,684,2021,714,2180
241480,201901,2681,8562,2295,7759,821,2728,655,2556,1476,5284
241490,201901,651,1595,521,1402,24,71,352,922,376,993
241500,201901,805,2320,694,2175,12,52,608,1904,620,1956
250010,201901,2566,7739,2152,6879,79,320,1575,4913,1654,5233
250020,201901,1588,4358,1154,3506,54,147,816,2457,870,2604
250030,201901,6681,18664,6025,17652,467,1438,4634,13357,5101,14795
250040,201901,3987,12483,3464,11504,224,905,2483,8073,2707,8978
250050,201901,3433,9525,3154,9117,154,537,2585,7377,2739,7914
250053,201901,1156,3367,1053,3199,79,258,772,2367,851,2625
250057,201901,638,2339,603,2287,5,33,548,2100,553,2133
250060,201901,5171,14064,4743,13526,417,1122,3723,10799,4140,11921
250070,201901,3858,11109,3405,10306,55,257,2699,7936,2754,8193
250073,201901,722,1989,597,1796,8,30,493,1429,501,1459
250077,201901,2181,5972,1641,5060,89,306,1191,3639,1280,3945
250080,201901,4399,11711,3949,11091,95,363,3405,9422,3500,9785
250090,201901,2998,7651,2654,7185,70,218,2267,6026,2337,6244
250100,201901,3673,11438,3414,10957,151,622,2769,8641,2920,9263
250110,201901,4713,13397,4308,12805,354,1275,3328,9627,3682,10902
250115,201901,524,1539,455,1420,10,54,345,1036,355,1090
250120,201901,1818,5348,1507,4833,46,207,1196,3795,1242,4002
250130,201901,5368,15220,4598,14083,89,479,3797,11417,3886,11896
250135,201901,1136,3153,1023,2976,15,62,924,2682,939,2744
250140,201901,2074,6403,1974,6259,94,449,1725,5353,1819,5802
250150,201901,4695,15021,4265,14244,175,814,3422,11175,3597,11989
250153,201901,1438,3727,1208,3396,26,94,991,2743,1017,2837
250157,201901,1702,5181,1528,4828,90,313,1183,3690,1273,4003
250160,201901,3807,9724,3081,8738,32,128,2774,7818,2806,7946
250170,201901,1735,4537,1566,4284,38,138,1353,3639,1391,3777
250180,201901,17891,45799,15800,43034,886,2722,12210,32612,13096,35334
250190,201901,3991,10999,3415,10090,390,1108,2293,6734,2683,7842
250200,201901,1817,5052,1563,4655,52,191,1335,3950,1387,4141
250205,201901,800,2587,709,2433,22,117,586,1984,608,2101
250210,201901,1540,4681,1395,4444,54,269,1108,3451,1162,3720
250215,201901,1539,4375,1271,3927,67,223,792,2432,859,2655
250220,201901,674,1924,557,1747,27,115,397,1205,424,1320
250230,201901,1586,3693,1163,3051,25,78,928,2363,953,2441
250240,201901,2127,6593,1947,6273,43,199,1665,5280,1708,5479
250250,201901,4411,12419,3862,11628,96,331,3261,9786,3357,10117
250260,201901,1700,4740,1425,4279,42,140,1140,3392,1182,3532
250270,201901,1182,3649,1063,3507,75,254,791,2706,866,2960
250280,201901,3195,9180,2793,8559,93,321,2237,6826,2330,7147
250290,201901,1587,4211,1361,3901,27,75,1102,3173,1129,3248
250300,201901,5370,14669,4966,14200,225,987,4117,11306,4342,12293
250310,201901,1142,3209,972,2919,35,114,747,2203,782,2317
250320,201901,10246,25031,9094,23638,409,1208,7775,19948,8184,21156
250330,201901,2279,6612,1941,6153,129,434,1539,4848,1668,5282
250340,201901,1081,2832,951,2654,5,21,847,2329,852,2350
250350,201901,3950,11119,3630,10631,144,383,2991,8981,3135,9364
250355,201901,1974,6058,1773,5787,33,185,1603,5188,1636,5373
250360,201901,1768,5011,1607,4771,40,150,1323,3892,1363,4042
250370,201901,11902,32270,10234,29779,371,1431,8485,24194,8856,25625
250375,201901,1115,2963,935,2743,9,31,863,2550,872,2581
250380,201901,1588,4203,1462,4036,42,171,1228,3264,1270,3435
250390,201901,1738,4562,1466,4117,144,392,1061,2986,1205,3378
250400,201901,68159,169345,49506,140748,13726,41117,15316,45643,29042,86760
250403,201901,1619,4742,1480,4562,94,453,1154,3390,1248,3843
250407,201901,1212,3110,1011,2821,71,162,744,2107,815,2269
250410,201901,585,1631,512,1509,3,18,428,1234,431,1252
250415,201901,1843,5276,1627,4925,47,191,1355,4061,1402,4252
250420,201901,1206,3473,1089,3315,14,62,1021,3104,1035,3166
250430,201901,6059,15222,5262,14109,163,528,4384,11532,4547,12060
250435,201901,1494,4199,1251,3791,23,98,959,2843,982,2941
250440,201901,4433,11999,3868,11304,72,262,3386,9851,3458,10113
250450,201901,1775,4853,1512,4495,33,131,1265,3743,1298,3874
250460,201901,7124,19499,6434,18517,361,1082,5293,15198,5654,16280
250470,201901,1525,3936,1265,3559,59,187,972,2665,1031,2852
250480,201901,3921,10832,3440,10253,22,105,3100,9332,3122,9437
250485,201901,715,1639,531,1384,33,74,382,960,415,1034
250490,201901,4675,11924,4235,11389,200,668,3651,9653,3851,10321
250500,201901,1893,5312,1697,4985,74,246,1393,4078,1467,4324
250510,201901,5332,13541,4648,12660,81,265,4126,11242,4207,11507
250520,201901,1733,4831,1514,4515,140,440,1060,3141,1200,3581
250523,201901,2184,5395,1969,5129,83,349,1669,4203,1752,4552
250527,201901,1661,4333,1516,4162,31,93,1343,3710,1374,3803
250530,201901,597,1640,516,1528,13,45,453,1331,466,1376
250535,201901,1310,3919,1206,3718,36,158,983,2940,1019,3098
250540,201901,2844,6767,2366,6223,63,145,2068,5491,2131,5636
250550,201901,810,2624,714,2442,18,89,565,1883,583,1972
250560,201901,1617,4579,1459,4356,48,175,1225,3578,1273,3753
250570,201901,2579,7804,2239,7186,81,330,1781,5593,1862,5923
250580,201901,1035,2718,950,2595,55,183,770,2076,825,2259
250590,201901,806,2302,721,2177,18,88,599,1791,617,1879
250600,201901,8113,21028,6829,19366,334,972,5647,15974,5981,16946
250610,201901,2936,8311,2678,7939,117,449,2224,6487,2341,6936
250620,201901,685,1900,587,1717,15,70,455,1292,470,1362
250625,201901,2526,7384,2280,6992,50,263,1896,5647,1946,5910
250630,201901,9321,26629,7870,23973,867,2775,5180,15343,6047,18118
250640,201901,3253,9387,3007,9046,88,412,2555,7481,2643,7893
250650,201901,884,2209,741,2011,34,98,621,1642,655,1740
250660,201901,1600,4048,1382,3747,46,122,1154,3072,1200,3194
250670,201901,2289,7221,2122,6939,51,250,1843,5888,1894,6138
250680,201901,5775,13532,5159,12820,102,395,4683,11343,4785,11738
250690,201901,6611,15405,5803,14370,121,316,5167,12623,5288,12939
250700,201901,4242,12050,3745,11297,328,997,2805,8374,3133,9371
250710,201901,4379,12706,3794,11907,287,998,2810,8800,3097,9798
250720,201901,2700,7212,2452,6860,42,195,2178,6014,2220,6209
250730,201901,3967,10723,3506,10104,129,473,2910,8135,3039,8608
250740,201901,1921,4924,1578,4463,100,313,1242,3462,1342,3775
250750,201901,95428,246065,83600,229337,7662,22844,59744,160833,67406,183677
250760,201901,2310,6061,2021,5604,115,337,1563,4222,1678,4559
250770,201901,3781,11786,3446,11330,322,1120,2524,8292,2846,9412
250780,201901,1672,4616,1407,4120,82,274,1038,2969,1120,3243
250790,201901,2394,7257,2091,6812,239,898,1347,4310,1586,5208
250800,201901,2415,6500,2106,6015,93,221,1752,5028,1845,5249
250810,201901,1231,3365,1017,3050,26,74,872,2638,898,2712
250820,201901,1791,5392,1713,5300,51,228,1553,4760,1604,4988
250830,201901,5563,16819,4731,15179,315,1196,3304,10342,3619,11538
250840,201901,786,2514,670,2271,21,95,487,1649,508,1744
250850,201901,1810,5471,1638,5178,41,207,1356,4182,1397,4389
250855,201901,950,2787,830,2590,69,239,609,1884,678,2123
250860,201901,2893,8989,2458,8221,414,1465,1400,4687,1814,6152
250870,201901,1045,2870,895,2613,33,120,731,2108,764,2228
250880,201901,1535,4058,1269,3665,142,414,878,2548,1020,2962
250890,201901,9561,26405,8777,25312,485,2053,7046,19316,7531,21369
250900,201901,2725,7932,2357,7255,77,298,1965,5918,2042,6216
250905,201901,2264,6542,2089,6280,46,194,1866,5580,1912,5774
250910,201901,5731,14590,4744,13425,114,436,3994,11291,4108,11727
250915,201901,1885,4673,1425,4175,13,31,1299,3863,1312,3894
250920,201901,3378,8809,2980,8191,328,837,2158,5874,2486,6711
250930,201901,2110,5793,1938,5553,67,254,1661,4666,1728,4920
250933,201901,1117,3415,993,3186,27,140,747,2326,774,2466
250937,201901,707,1944,600,1766,28,101,434,1288,462,1389
250939,201901,1673,4638,1492,4362,52,175,1200,3455,1252,3630
250940,201901,3794,10413,3391,9852,58,251,2931,8435,2989,8686
250950,201901,1664,4270,1346,3874,29,123,1146,3263,1175,3386
250960,201901,1048,3144,949,2994,33,155,776,2359,809,2514
250970,201901,8135,21656,7058,19900,336,1108,5566,15376,5902,16484
250980,201901,2452,6640,2208,6251,48,186,1850,5109,1898,5295
250990,201901,1892,5993,1644,5518,81,359,1216,4031,1297,4390
251000,201901,2053,5784,1698,5204,34,140,1419,4314,1453,4454
251010,201901,2584,7386,2348,7007,29,126,2127,6316,2156,6442
251020,201901,1680,4518,1529,4311,32,129,1355,3757,1387,3886
251030,201901,961,2613,828,2378,34,106,591,1653,625,1759
251040,201901,1830,5331,1564,4870,50,243,1251,3824,1301,4067
251050,201901,1075,2954,891,2607,44,144,659,1868,703,2012
251060,201901,1020,2227,771,1916,12,49,638,1552,650,1601
251065,201901,433,1194,348,1057,13,36,250,737,263,773
251070,201901,728,1975,630,1841,8,29,536,1548,544,1577
251080,201901,18110,47484,15034,42943,2009,6073,9612,27519,11621,33592
251090,201901,2663,7784,2285,7095,53,197,1846,5692,1899,5889
251100,201901,792,2480,707,2337,27,112,544,1730,571,1842
251110,201901,1667,4581,1456,4196,51,146,1134,3232,1185,3378
251120,201901,6927,20337,5932,19029,265,1109,4669,14820,4934,15929
251130,201901,3782,8917,3407,8494,180,479,2972,7376,3152,7855
251140,201901,4122,11802,3760,11284,100,392,3124,9274,3224,9666
251150,201901,2631,7749,2370,7334,110,486,1901,5699,2011,6185
251160,201901,2030,6143,1795,5798,135,476,1422,4568,1557,5044
251170,201901,1507,4213,1358,4041,41,171,1197,3531,1238,3702
251180,201901,2485,6947,2092,6393,183,592,1403,4226,1586,4818
251190,201901,4305,11422,4029,11105,54,247,3681,9962,3735,10209
251200,201901,4009,12307,3676,11886,90,380,3209,10420,3299,10800
251203,201901,923,3040,873,2930,32,148,672,2190,704,2338
251207,201901,1024,2936,817,2575,20,91,582,1780,602,1871
251210,201901,7256,19128,5963,17468,259,739,4631,13681,4890,14420
251220,201901,1139,2850,892,2501,43,114,709,2000,752,2114
251230,201901,4499,12491,3969,11660,133,544,3225,9202,3358,9746
251240,201901,3540,9855,2971,8978,164,554,2238,6610,2402,7164
251250,201901,9581,26474,8568,24832,763,2350,6333,17771,7096,20121
251260,201901,466,1403,427,1329,14,72,327,982,341,1054
251270,201901,4002,12698,3634,12219,103,443,3099,10517,3202,10960
251272,201901,1308,3637,1195,3475,38,160,1030,2913,1068,3073
251274,201901,868,2493,721,2239,48,184,494,1465,542,1649
251275,201901,1208,3386,1037,3114,44,196,777,2226,821,2422
251276,201901,1309,3521,1150,3318,34,172,951,2638,985,2810
251278,201901,554,1584,495,1486,39,101,370,1117,409,1218
251280,201901,2181,6144,1962,5791,49,201,1616,4662,1665,4863
251290,201901,5617,13949,5221,13437,201,734,4492,11081,4693,11815
251300,201901,791,2415,738,2335,13,56,625,1970,638,2026
251310,201901,2758,7968,2414,7409,64,307,1924,5754,1988,6061
251315,201901,1664,5298,1536,5074,68,262,1179,3821,1247,4083
251320,201901,1632,4345,1136,3482,34,119,831,2527,865,2646
251330,201901,1983,4709,1643,4303,22,76,1513,3983,1535,4059
251335,201901,994,3091,911,2969,29,121,775,2473,804,2594
251340,201901,3564,8958,2861,8004,119,387,2137,5878,2256,6265
251350,201901,1053,3135,946,2959,31,148,792,2406,823,2554
251360,201901,1788,5145,1487,4737,23,104,1295,4137,1318,4241
251365,201901,691,1989,557,1700,13,42,429,1306,442,1348
251370,201901,21657,60567,19418,57442,2284,7029,13009,38668,15293,45697
251380,201901,1172,3408,1044,3194,23,127,885,2600,908,2727
251385,201901,704,1846,557,1581,22,76,415,1128,437,1204
251390,201901,6157,18643,5397,17359,676,2340,3254,10361,3930,12701
251392,201901,935,2618,781,2374,24,121,613,1816,637,1937
251394,201901,582,1756,479,1566,25,101,355,1138,380,1239
251396,201901,689,1880,590,1721,26,71,410,1184,436,1255
251398,201901,900,2365,653,1911,16,71,495,1410,511,1481
251400,201901,1151,2958,948,2672,29,108,737,2002,766,2110
251410,201901,1540,3701,1298,3356,23,112,1115,2787,1138,2899
251420,201901,1864,5067,1540,4693,44,186,1202,3607,1246,3793
251430,201901,1515,4746,1359,4489,36,180,1180,3854,1216,4034
251440,201901,1086,3092,886,2713,27,92,703,2146,730,2238
251445,201901,1478,4280,1376,4130,55,234,1137,3282,1192,3516
251450,201901,4201,12745,3847,12222,98,419,3222,10121,3320,10540
251455,201901,896,2719,812,2569,27,107,623,1938,650,2045
251460,201901,883,2575,786,2417,26,107,656,2008,682,2115
251465,201901,425,1272,365,1143,7,33,284,876,291,909
251470,201901,1142,3218,859,2618,77,258,527,1533,604,1791
251480,201901,931,2514,784,2265,23,105,596,1656,619,1761
251490,201901,1856,5055,1492,4549,56,199,1095,3321,1151,3520
251500,201901,1863,5465,1726,5254,62,256,1490,4466,1552,4722
251510,201901,2610,8081,2204,7250,155,584,1455,4692,1610,5276
251520,201901,928,2457,712,2041,71,185,471,1337,542,1522
251530,201901,13785,33963,11524,31121,133,719,10193,26972,10326,27691
251540,201901,2740,8256,2531,7864,106,416,2053,6265,2159,6681
251550,201901,3609,8729,2880,7808,88,249,2427,6568,2515,6817
251560,201901,568,1716,508,1627,81,278,322,987,403,1265
251570,201901,889,2588,742,2287,20,98,572,1692,592,1790
251580,201901,1876,4574,1673,4282,71,231,1430,3543,1501,3774
251590,201901,1562,4090,1351,3840,59,195,1089,2991,1148,3186
251593,201901,881,2667,824,2568,91,307,526,1587,617,1894
251597,201901,2072,5850,1892,5607,29,112,1657,4835,1686,4947
251600,201901,6228,17195,5573,16199,169,559,4690,13411,4859,13970
251610,201901,3227,9289,2781,8481,305,902,1895,5835,2200,6737
251615,201901,1196,3044,967,2668,22,72,773,2082,795,2154
251620,201901,17500,41738,14049,37618,163,491,12076,32996,12239,33487
251630,201901,4598,11065,3723,9872,190,567,2905,7603,3095,8170
251640,201901,2039,5874,1852,5535,51,243,1584,4615,1635,4858
251650,201901,4027,10721,3535,10114,138,485,3056,8693,3194,9178
251660,201901,3397,10238,2994,9524,87,426,2497,7758,2584,8184
251670,201901,4060,11555,3580,10901,53,266,3196,9640,3249,9906
251675,201901,642,1899,581,1822,86,301,383,1187,469,1488
251680,201901,2541,6923,2127,6363,51,193,1714,5098,1765,5291
251690,201901,3160,9007,2694,8165,81,261,2024,6012,2105,6273
251700,201901,1871,5720,1701,5500,48,233,1453,4595,1501,4828
251710,201901,793,2091,543,1577,51,183,311,886,362,1069
251720,201901,1316,3740,1088,3338,30,132,822,2428,852,2560
251740,201901,626,1768,503,1532,38,143,359,1052,397,1195
260005,201901,29049,62025,23839,55396,1750,4239,18163,41271,19913,45510
260010,201901,9721,25749,8057,23225,473,1452,4962,14476,5435,15928
260020,201901,6724,16136,5743,14712,133,578,4785,12034,4918,12612
260030,201901,6346,16952,5429,15547,201,709,4333,12293,4534,13002
260040,201901,7749,21239,6428,19158,557,1718,4291,12937,4848,14655
260050,201901,12945,35002,11283,33126,279,950,10051,29806,10330,30756
260060,201901,3863,10073,3334,9205,196,555,2612,7164,2808,7719
260070,201901,10165,26371,8754,24297,464,1568,6789,18425,7253,19993
260080,201901,6435,15011,5610,13839,156,514,4651,11186,4807,11700
260090,201901,4878,12688,4373,12022,658,1796,2954,8205,3612,10001
260100,201901,3108,8411,2615,7672,94,380,2119,6087,2213,6467
260105,201901,5137,13856,4568,13055,167,620,3756,10529,3923,11149
260110,201901,22188,60368,19976,57254,1120,3603,16450,46415,17570,50018
260120,201901,13954,38424,11760,35012,1536,4649,7279,22064,8815,26713
260130,201901,2940,7878,2653,7424,204,617,1973,5400,2177,6017
260140,201901,12998,30118,11130,27806,592,1654,9213,22692,9805,24346
260150,201901,3485,8403,2986,7783,126,418,2533,6477,2659,6895
260160,201901,6530,17384,5558,16146,109,438,4869,14251,4978,14689
260170,201901,17964,45462,15450,41903,1558,4100,11410,30929,12968,35029
260180,201901,3257,9154,2884,8649,111,397,2405,7088,2516,7485
260190,201901,18258,37630,15403,34291,184,529,13513,29459,13697,29988
260200,201901,10929,26806,9525,25036,454,1140,8116,21400,8570,22540
260210,201901,11773,33821,10005,30952,361,1469,7978,24440,8339,25909
260220,201901,10119,25082,9374,24143,197,701,8199,20768,8396,21469
260230,201901,10249,26158,8945,24349,242,791,7415,19855,7657,20646
260240,201901,2710,8126,2373,7534,171,599,1802,5682,1973,6281
260250,201901,2178,5823,1891,5406,107,312,1444,4077,1551,4389
260260,201901,12646,33621,11120,31255,493,1721,8709,23997,9202,25718
260270,201901,3865,9991,3398,9388,149,641,2717,7277,2866,7918
260280,201901,12820,39262,11538,37457,553,2312,9720,31159,10273,33471
260290,201901,37948,100460,33060,93083,4005,11665,21578,60188,25583,71853
260300,201901,9397,25816,8194,24119,251,1079,6778,19786,7029,20865
260310,201901,4601,12358,4135,11735,355,961,3152,9076,3507,10037
260320,201901,7231,21404,6437,20026,285,881,5266,16443,5551,17324
260330,201901,2469,7677,2211,7139,65,252,1797,5682,1862,5934
260340,201901,2025,5483,1758,5068,34,162,1487,4165,1521,4327
260345,201901,23795,64476,20190,59085,3547,11167,9841,28142,13388,39309
260350,201901,5050,12516,4489,11824,105,327,3950,10317,4055,10644
260360,201901,2465,6544,2243,6147,48,213,1556,4179,1604,4392
260370,201901,5391,15749,4665,14509,220,804,3566,10998,3786,11802
260380,201901,4841,14682,4177,13580,197,722,3101,9933,3298,10655
260390,201901,4257,13012,3631,11772,242,845,2490,7937,2732,8782
260392,201901,3424,10986,3056,10521,132,752,2448,8423,2580,9175
260400,201901,15913,38969,13952,36377,667,2051,10826,27218,11493,29269
260410,201901,66084,166640,52188,146978,10296,30411,23544,68004,33840,98415
260415,201901,4192,11675,3569,10558,96,435,2763,7907,2859,8342
260420,201901,12643,26960,10710,24784,189,543,9635,22034,9824,22577
260430,201901,2799,8698,2411,7964,135,521,1670,5461,1805,5982
260440,201901,3568,9715,3124,8951,115,417,2492,6960,2607,7377
260450,201901,5580,14407,5067,13766,294,697,4170,11486,4464,12183
260460,201901,5086,15688,4409,14402,540,2002,2556,8131,3096,10133
260470,201901,4932,13014,4195,12158,111,278,3767,11105,3878,11383
260480,201901,4040,10847,3396,9936,284,1028,2284,6688,2568,7716
260490,201901,5204,12343,4595,11401,67,262,4098,9934,4165,10196
260500,201901,5990,15515,5117,14230,474,1240,3538,9958,4012,11198
260510,201901,9350,23326,7921,21339,161,577,6935,18430,7096,19007
260515,201901,4226,11943,3290,10124,159,544,2185,6563,2344,7107
260520,201901,17323,40982,15305,38324,972,2523,12244,30271,13216,32794
260530,201901,9547,27825,8255,25792,196,897,6974,21497,7170,22394
260540,201901,6977,15490,6209,14508,391,843,5289,12350,5680,13193
260545,201901,40,129,17,79,3,11,4,18,7,29
260550,201901,2804,8174,2375,7406,150,651,1560,4730,1710,5381
260560,201901,5934,15347,5086,14128,136,590,4278,11578,4414,12168
260570,201901,7387,20940,6583,19804,479,1536,5102,15319,5581,16855
260580,201901,4325,10548,3856,9910,36,161,3502,8915,3538,9076
260590,201901,6669,15817,5640,14643,252,673,4648,12147,4900,12820
260600,201901,29661,78948,24415,70821,1386,4449,18037,51535,19423,55984
260610,201901,6885,18685,6297,17893,426,1361,4701,13188,5127,14549
260620,201901,15177,41492,13469,38968,1564,4932,9129,25969,10693,30901
260630,201901,2322,6385,1932,5750,45,191,1558,4530,1603,4721
260640,201901,20058,47487,17236,44167,940,2614,13644,34555,14584,37169
260650,201901,5584,15634,4688,14414,172,745,3942,11963,4114,12708
260660,201901,7221,19329,6227,17996,172,727,5259,14884,5431,15611
260670,201901,2185,5731,1801,5160,82,223,1338,3791,1420,4014
260680,201901,25163,62434,21234,56573,1908,5399,13944,36438,15852,41837
260690,201901,3600,9328,2949,8344,120,431,2356,6563,2476,6994
260700,201901,5905,17355,5620,17031,21,55,5454,16668,5475,16723
260710,201901,1294,3476,1183,3343,49,161,888,2528,937,2689
260720,201901,20623,55525,18249,52157,2633,7777,11719,33225,14352,41002
260730,201901,7229,21564,6403,20386,326,1241,5257,16452,5583,17693
260740,201901,1317,3703,1105,3360,19,105,872,2656,891,2761
260750,201901,6784,19285,5882,18091,119,413,5263,16386,5382,16799
260760,201901,5516,13343,4792,12434,223,649,3866,10065,4089,10714
260765,201901,7568,22826,6657,21516,573,2402,4526,14184,5099,16586
260770,201901,3767,9852,3235,8950,98,336,2570,7014,2668,7350
260775,201901,5135,13968,4602,13174,246,938,3497,9663,3743,10601
260780,201901,3580,10871,3200,10233,320,1208,2011,6234,2331,7442
260790,201901,112719,259664,94472,235429,15119,36913,57337,142802,72456,179715
260795,201901,3002,8076,2602,7514,132,448,1966,5680,2098,6128
260800,201901,5375,12593,4875,11901,170,528,4263,10071,4433,10599
260805,201901,3531,10335,2988,9378,177,667,2149,6612,2326,7279
260810,201901,6502,17866,5799,16520,567,1614,4126,11519,4693,13133
260820,201901,4343,10544,3831,9858,177,617,3088,7715,3265,8332
260825,201901,2846,8701,2475,8025,128,486,1834,5902,1962,6388
260830,201901,4242,12499,3547,11235,482,1400,2273,7397,2755,8797
260840,201901,3987,10813,3566,10204,188,568,2968,8443,3156,9011
260845,201901,4074,11099,3682,10414,266,749,2720,7613,2986,8362
260850,201901,4729,13707,4063,12408,405,1322,2539,7554,2944,8876
260860,201901,3354,9692,2881,8853,104,379,2321,6995,2425,7374
260870,201901,4429,10785,3840,10055,103,407,3383,8665,3486,9072
260875,201901,6602,17241,5535,15606,648,1829,3687,10396,4335,12225
260880,201901,9605,27236,8433,25188,444,1313,6717,20147,7161,21460
260890,201901,13093,34612,11605,32423,891,2773,8252,22525,9143,25298
260900,201901,5149,14996,4335,13737,331,1226,2905,9082,3236,10308
260910,201901,3139,8705,2741,8078,107,374,2155,6273,2262,6647
260915,201901,5108,15092,4510,14388,66,303,4074,13043,4140,13346
260920,201901,3296,8600,2838,8062,103,326,2421,6870,2524,7196
260930,201901,3452,11268,3075,10594,162,678,2359,8007,2521,8685
260940,201901,14382,35233,12555,32588,877,2479,9371,23788,10248,26267
260950,201901,6384,17857,5181,15635,512,1752,3021,8685,3533,10437
260960,201901,63945,149654,51745,133335,6851,18557,30926,78517,37777,97074
260970,201901,5130,14035,4607,13332,164,445,3601,10463,3765,10908
260980,201901,4357,13067,3949,12544,69,274,3576,11427,3645,11701
260990,201901,17386,49729,14899,46346,841,3065,11506,35413,12347,38478
261000,201901,15879,38852,13461,35599,508,1885,10513,27148,11021,29033
261010,201901,2411,6363,2130,5987,80,223,1855,5206,1935,5429
261020,201901,6000,16696,5176,15199,264,932,4111,11636,4375,12568
261030,201901,4047,11491,3511,10600,152,547,2795,8266,2947,8813
261040,201901,5089,15254,4178,13440,203,813,3038,9599,3241,10412
261050,201901,7548,20363,6827,19154,597,1415,4806,13634,5403,15049
261060,201901,13329,34610,11794,32622,458,1496,9614,26305,10072,27801
261070,201901,58239,130259,48488,117240,3258,7713,35893,85539,39151,93252
261080,201901,6065,15534,5601,14908,172,467,5093,13550,5265,14017
261090,201901,17892,44254,16019,41816,401,1387,13686,35140,14087,36527
261100,201901,8005,23001,6987,21482,595,1995,5027,15463,5622,17458
261110,201901,57841,166685,49283,152225,9490,30848,25710,79724,35200,110572
261120,201901,3762,9440,3229,8738,87,278,2804,7556,2891,7834
261130,201901,7397,18008,6563,16958,110,367,5840,14958,5950,15325
261140,201901,3467,8269,3101,7778,190,545,2491,6115,2681,6660
261150,201901,5196,14021,4610,13110,99,409,3958,11079,4057,11488
261153,201901,1921,5703,1658,5254,83,328,1141,3591,1224,3919
261160,201901,202456,483462,167004,434199,42175,112833,66777,177148,108952,289981
261170,201901,5797,14953,5194,14054,359,948,4091,11010,4450,11958
261180,201901,9691,24888,8568,23412,519,1574,6146,16635,6665,18209
261190,201901,4640,13950,4176,13144,279,1125,3099,9434,3378,10559
261200,201901,3331,7796,2962,7306,161,413,2449,5931,2610,6344
261210,201901,1904,4660,1623,4273,58,172,1378,3589,1436,3761
261220,201901,13496,39275,11267,34995,1469,4954,6362,19496,7831,24450
261230,201901,4224,12145,3519,11183,77,333,2899,9269,2976,9602
261240,201901,5037,13187,4449,12269,264,766,3622,9887,3886,10653
261245,201901,3467,10028,2971,9168,104,487,2344,6963,2448,7450
261247,201901,2893,8740,2442,7915,148,563,1690,5424,1838,5987
261250,201901,20416,48136,17663,44912,1969,4664,12954,33775,14923,38439
261255,201901,3951,11866,3370,10737,162,712,2490,7640,2652,8352
261260,201901,12862,34751,11118,32527,409,1672,9384,27098,9793,28770
261270,201901,3900,10388,3468,9810,216,762,2819,7773,3035,8535
261280,201901,2530,7213,2242,6708,79,328,1754,5105,1833,5433
261290,201901,2932,7796,2500,7281,85,345,2015,5886,2100,6231
261300,201901,11617,33551,9927,30598,623,2369,7103,21411,7726,23780
261310,201901,8300,22010,7113,20297,852,2671,4854,13490,5706,16161
261320,201901,5891,16840,5150,15566,92,422,4306,12757,4398,13179
261330,201901,5920,14870,5374,14140,169,603,4651,11998,4820,12601
261340,201901,4102,12130,3568,11389,198,792,2788,8804,2986,9596
261350,201901,8499,25302,7654,23884,128,657,6213,18996,6341,19653
261360,201901,8195,20287,6954,18531,261,840,5519,14244,5780,15084
261370,201901,21024,54831,17928,50543,2591,7340,10906,31001,13497,38341
261380,201901,3893,12188,3514,11508,468,1707,2299,7388,2767,9095
261390,201901,15773,46056,13502,42338,1291,4397,8774,27436,10065,31833
261400,201901,4544,14666,3969,13478,182,854,2923,9644,3105,10498
261410,201901,9256,23979,7753,21581,517,1452,6087,16765,6604,18217
261420,201901,7034,22007,6427,21232,875,3333,4313,14128,5188,17461
261430,201901,3382,9657,2825,8808,89,375,2317,7111,2406,7486
261440,201901,1429,4346,1234,3973,49,246,866,2684,915,2930
261450,201901,14676,40255,13138,37757,259,1071,10918,31108,11177,32179
261460,201901,7246,20143,6509,19093,221,787,5483,15973,5704,16760
261470,201901,4193,10584,3730,9994,43,201,3156,8462,3199,8663
261480,201901,4831,15192,4206,14134,238,982,3188,10499,3426,11481
261485,201901,4942,14176,4254,13096,400,1432,2900,8715,3300,10147
261500,201901,5519,14733,4878,13845,491,1257,3316,9788,3807,11045
261510,201901,1820,5550,1579,5120,68,254,1158,3796,1226,4050
261520,201901,2370,7299,2209,6978,83,306,1549,4942,1632,5248
261530,201901,10978,33474,9139,29971,1260,4784,4259,13596,5519,18380
261540,201901,7618,22378,6876,21243,1092,3268,3947,12700,5039,15968
261550,201901,3542,9536,3105,8829,226,732,2206,6143,2432,6875
261560,201901,7571,22982,6617,21551,409,1615,4912,15926,5321,17541
261570,201901,3377,9307,2759,8309,212,779,1892,5578,2104,6357
261580,201901,6530,17458,5778,16458,125,590,5187,14543,5312,15133
261590,201901,2668,6967,2132,6177,83,257,1589,4575,1672,4832
261600,201901,5059,13162,4252,11954,428,1134,2822,8191,3250,9325
261610,201901,2368,6493,1975,5856,99,368,1447,4252,1546,4620
261618,201901,2549,6535,2251,6110,85,259,1779,4762,1864,5021
261620,201901,3941,11546,3657,11123,823,2297,2230,7110,3053,9407
261630,201901,6377,18024,5458,16327,445,1673,3549,10040,3994,11713
261640,201901,35693,82196,30957,76312,1656,3534,24181,60731,25837,64265
261650,201901,4063,10347,3572,9717,151,549,2655,7141,2806,7690
270010,201901,4213,14603,3724,13732,184,1042,2890,10336,3074,11378
270020,201901,3830,9880,3388,9297,199,626,2791,7495,2990,8121
270030,201901,33258,92679,28801,85639,4243,12418,18676,55994,22919,68412
270040,201901,11147,30203,9637,28397,438,1772,7888,22920,8326,24692
270050,201901,5453,12672,4637,11760,171,434,4116,10457,4287,10891
270060,201901,2006,5266,1720,4924,131,357,1363,3942,1494,4299
270070,201901,4544,13102,3997,12322,149,653,3358,10122,3507,10775
270080,201901,1421,3963,1178,3544,54,185,889,2573,943,2758
270090,201901,1863,5757,1651,5344,79,360,1298,4054,1377,4414
270100,201901,5473,15061,4792,14035,226,894,3848,10980,4074,11874
270110,201901,3246,7945,2592,7169,129,350,2048,5850,2177,6200
270120,201901,2975,8056,2586,7557,74,291,2233,6475,2307,6766
270130,201901,5143,13693,4492,12929,185,597,3766,10899,3951,11496
270135,201901,2009,4919,1711,4574,56,172,1532,4063,1588,4235
270140,201901,9659,22543,7962,20232,361,1348,6449,15501,6810,16849
270150,201901,2704,8150,2530,7899,7,28,2429,7572,2436,7600
270160,201901,5557,16048,4914,15280,74,447,4511,13854,4585,14301
270170,201901,3459,10218,2955,9533,237,1057,2160,6699,2397,7756
270180,201901,2234,6937,2032,6668,47,231,1789,5774,1836,6005
270190,201901,1646,4973,1481,4760,57,263,1266,4007,1323,4270
270200,201901,2426,7391,2085,6931,123,492,1542,5011,1665,5503
270210,201901,5581,13618,4859,12799,148,526,4388,11393,4536,11919
270220,201901,1418,3906,1163,3542,229,723,635,1931,864,2654
270230,201901,9097,26296,7620,23963,746,2744,5195,16008,5941,18752
270235,201901,5830,18189,5100,16977,172,755,4122,13579,4294,14334
270240,201901,10382,28626,8538,26272,960,3250,6116,18758,7076,22008
270250,201901,2837,7351,2507,6900,234,611,1908,5297,2142,5908
270255,201901,4573,13222,3501,11228,173,716,2521,7910,2694,8626
270260,201901,5581,16723,5101,15940,117,595,4398,13348,4515,13943
270270,201901,1042,2768,897,2576,117,342,628,1785,745,2127
270280,201901,3821,9416,3069,8459,446,795,2152,6333,2598,7128
270290,201901,7690,24639,6933,23375,263,1202,5848,19452,6111,20654
270300,201901,4048,11018,3205,10094,181,584,2435,7793,2616,8377
270310,201901,6987,19722,6041,18348,155,787,5094,15039,5249,15826
270320,201901,5583,16439,4895,15151,569,1867,3394,10226,3963,12093
270330,201901,3752,12548,3387,11981,265,1084,2631,9249,2896,10333
270340,201901,1615,4568,1377,4248,60,194,1124,3447,1184,3641
270350,201901,1835,4513,1536,4149,187,552,1050,2865,1237,3417
270360,201901,2398,6319,2159,6044,60,171,1971,5536,2031,5707
270370,201901,1396,4356,1265,4114,47,203,1020,3274,1067,3477
270375,201901,3036,7278,2603,6782,18,55,2423,6316,2441,6371
270380,201901,5525,16275,4721,15188,440,1470,3298,10845,3738,12315
270390,201901,1193,3063,973,2791,25,132,800,2253,825,2385
270400,201901,6074,16601,5190,15211,234,768,4019,11522,4253,12290
270410,201901,4516,13425,3945,12481,206,776,3169,9887,3375,10663
270420,201901,5509,16560,5017,15849,186,813,4218,13055,4404,13868
270430,201901,135431,336265,108693,301794,22931,66515,49405,139710,72336,206225
270440,201901,4755,13088,4089,12264,109,505,3455,10214,3564,10719
270450,201901,6685,18616,6002,17792,269,1027,5015,14734,5284,15761
270460,201901,3654,8335,3192,7797,50,203,2970,7123,3020,7326
270470,201901,10750,31210,9472,29324,879,2893,6942,21581,7821,24474
270480,201901,2797,7721,2431,7174,145,563,1932,5510,2077,6073
270490,201901,958,2761,844,2620,49,181,664,2027,713,2208
270500,201901,4815,15053,4349,14370,225,937,3503,11421,3728,12358
270510,201901,5538,15324,4783,14290,423,1622,3476,9909,3899,11531
270520,201901,3916,11460,3130,10096,728,2413,1186,4035,1914,6448
270530,201901,1180,3546,1042,3324,66,198,764,2469,830,2667
270540,201901,2104,6345,1861,6025,63,312,1603,5083,1666,5395
270550,201901,6615,17675,5441,16371,527,1402,4131,12847,4658,14249
270560,201901,3060,8322,2716,7846,172,543,2117,6015,2289,6558
270570,201901,4019,11434,3424,10508,99,415,2808,8467,2907,8882
270580,201901,2273,6520,2073,6229,105,327,1779,5309,1884,5636
270590,201901,1607,4799,1485,4635,13,68,1406,4367,1419,4435
270600,201901,2704,8499,2452,8100,71,364,2149,6972,2220,7336
270610,201901,3661,9696,3111,8984,92,351,2745,7819,2837,8170
270620,201901,1230,3844,1134,3669,47,206,957,3003,1004,3209
270630,201901,15884,41530,13933,38750,777,2574,11333,30984,12110,33558
270640,201901,5384,15634,4692,14570,194,829,3754,11297,3948,12126
270642,201901,2403,7914,2148,7496,139,698,1673,5624,1812,6322
270644,201901,3485,8822,2873,8035,244,666,2166,6156,2410,6822
270650,201901,3164,9500,2828,9004,433,1572,1895,5822,2328,7394
270660,201901,2105,5248,1705,4691,76,295,1289,3463,1365,3758
270670,201901,15541,37837,13178,34969,586,1822,10916,28472,11502,30294
270680,201901,5192,13119,4662,12524,140,223,4327,11808,4467,12031
270690,201901,9025,22797,7546,20972,1020,2672,5355,15011,6375,17683
270700,201901,540,1640,469,1518,38,159,337,1069,375,1228
270710,201901,5613,17065,5129,16370,259,1158,4217,13112,4476,14270
270720,201901,3316,10157,2961,9564,79,462,2591,8140,2670,8602
270730,201901,7768,18245,6973,17367,328,807,5590,15004,5918,15811
270740,201901,2329,6260,2078,5948,107,377,1705,4773,1812,5150
270750,201901,5419,14846,4790,14012,172,688,4097,11863,4269,12551
270760,201901,3339,9461,2905,8861,68,338,2459,7395,2527,7733
270770,201901,21109,51770,16604,46277,3094,7970,9389,27993,12483,35963
270780,201901,1736,5165,1633,5023,88,310,1370,4174,1458,4484
270790,201901,1532,4503,1322,4196,108,359,893,2823,1001,3182
270800,201901,10538,29531,9481,28057,387,1611,8088,23322,8475,24933
270810,201901,3216,9387,2543,8229,192,799,1739,5490,1931,6289
270820,201901,1677,5070,1417,4635,66,277,1107,3532,1173,3809
270830,201901,5291,12968,4333,11780,189,677,3452,9248,3641,9925
270840,201901,8101,24243,7291,23108,200,1086,6365,19609,6565,20695
270850,201901,8702,21669,7866,20619,531,1704,6590,16806,7121,18510
270860,201901,12159,29603,10046,27077,470,1565,8211,21686,8681,23251
270870,201901,2038,5921,1759,5439,207,686,1218,3791,1425,4477
270880,201901,7989,24209,7185,23016,242,1072,5937,18669,6179,19741
270890,201901,2605,7250,2267,6788,175,614,1611,4739,1786,5353
270895,201901,2874,9453,2671,9182,81,463,2366,7936,2447,8399
270900,201901,1790,4682,1370,4025,57,195,1058,3055,1115,3250
270910,201901,3745,11151,3228,10273,120,487,2520,7889,2640,8376
270915,201901,9077,27243,7556,24656,802,3088,4976,15795,5778,18883
270920,201901,5344,16757,4889,15986,235,1099,3963,12493,4198,13592
270930,201901,17020,40895,13424,36637,1913,4806,9113,25691,11026,30497
270940,201901,6063,17176,5327,16254,254,1184,4175,12329,4429,13513
280010,201901,679,1869,558,1626,21,91,383,1007,404,1098
280020,201901,4633,12239,4004,11266,548,1456,2615,7439,3163,8895
280030,201901,71325,172085,56307,150962,13673,37050,22929,64341,36602,101391
280040,201901,3021,8589,2648,8031,292,937,1770,5317,2062,6254
280050,201901,3861,11120,3340,10255,529,1694,1980,6051,2509,7745
280060,201901,5268,14438,4272,12913,760,2385,2162,6776,2922,9161
280067,201901,6882,17561,5822,15942,387,1137,4162,11138,4549,12275
280070,201901,1874,5739,1761,5545,81,297,1476,4566,1557,4863
280100,201901,3699,10394,3178,9535,343,1091,2193,6562,2536,7653
280110,201901,1326,3719,1177,3480,21,107,1016,2921,1037,3028
280120,201901,7399,22036,6719,20921,707,2037,5050,15967,5757,18004
280130,201901,8733,21427,7673,19891,599,1634,5896,15228,6495,16862
280140,201901,5443,13461,4806,12603,243,685,4027,10479,4270,11164
280150,201901,3851,10033,3407,9453,217,626,2772,7617,2989,8243
280160,201901,1203,3529,994,3170,130,440,613,1908,743,2348
280170,201901,5140,13676,4580,12936,247,694,3714,10490,3961,11184
280190,201901,1177,2722,1012,2492,56,155,809,1936,865,2091
280200,201901,1309,3478,1059,3077,105,392,726,2035,831,2427
280210,201901,15350,40142,13420,37396,1845,5455,8142,22651,9987,28106
280220,201901,1710,4652,1487,4365,36,192,1225,3569,1261,3761
280230,201901,3757,9843,3358,9275,255,680,2465,6759,2720,7439
280240,201901,3390,9094,3049,8588,66,324,2577,7060,2643,7384
280250,201901,793,2065,653,1851,73,232,388,1041,461,1273
280260,201901,2100,5207,1893,4944,37,101,1744,4569,1781,4670
280270,201901,2276,6538,2028,6147,118,439,1700,5018,1818,5457
280280,201901,3905,12337,3524,11784,494,1532,2394,8338,2888,9870
280290,201901,16886,46282,14760,43217,1513,4817,9861,29062,11374,33879
280300,201901,10938,27884,9493,26312,276,930,7482,21850,7758,22780
280310,201901,1321,3517,1112,3166,32,120,828,2277,860,2397
280320,201901,8399,23427,7298,21736,872,2680,4800,14119,5672,16799
280330,201901,4738,11929,4019,10878,259,743,3001,8029,3260,8772
280340,201901,5433,11353,4621,10473,237,478,3993,9115,4230,9593
280350,201901,24039,58928,20962,54681,1437,4021,15876,40809,17313,44830
280360,201901,5733,16459,5054,15292,884,2697,2801,8539,3685,11236
280370,201901,2181,5397,1791,4698,72,197,1430,3686,1502,3883
280380,201901,959,2723,835,2551,96,338,535,1611,631,1949
280390,201901,3496,9021,2894,8032,139,426,2256,6157,2395,6583
280400,201901,3888,10246,3365,9484,489,1306,2082,6049,2571,7355
280410,201901,2084,6002,1697,5329,186,627,1030,3166,1216,3793
280420,201901,4268,11617,3890,11104,98,357,3494,9913,3592,10270
280430,201901,2006,5050,1758,4717,76,295,1404,3658,1480,3953
280440,201901,4344,11810,3798,10979,205,700,3094,8713,3299,9413
280445,201901,2290,5895,2038,5445,59,195,1515,3862,1574,4057
280450,201901,10219,23530,9060,22008,383,768,7659,18730,8042,19498
280460,201901,6640,16296,6022,15424,464,1116,4904,12499,5368,13615
280470,201901,1739,4972,1493,4524,69,275,1097,3223,1166,3498
280480,201901,38366,96404,33744,89986,2874,8387,24247,63465,27121,71852
280490,201901,3740,10794,3228,9940,105,494,2454,7271,2559,7765
280500,201901,954,2329,815,2137,41,133,669,1740,710,1873
280510,201901,2527,6719,2184,6212,94,363,1649,4608,1743,4971
280520,201901,1602,4129,1413,3879,78,216,1138,3087,1216,3303
280530,201901,2667,6524,2288,6052,304,709,1620,4374,1924,5083
280540,201901,8927,24204,8159,23091,239,955,7152,19818,7391,20773
280550,201901,6661,15844,5432,14084,254,819,4306,10809,4560,11628
280560,201901,7012,20086,6584,19457,160,609,5734,16701,5894,17310
280570,201901,6328,15976,5153,14458,234,881,3766,10408,4000,11289
280580,201901,5379,14962,4649,13832,589,1653,3154,9540,3743,11193
280590,201901,2944,6940,2472,6363,140,555,1851,4505,1991,5060
280600,201901,3359,9339,2995,8804,189,633,2157,6313,2346,6946
280610,201901,2522,6330,2284,5995,172,429,1824,4747,1996,5176
280620,201901,5287,13508,4517,12457,419,1013,3232,9210,3651,10223
280630,201901,3738,10967,3393,10450,185,679,2718,8340,2903,9019
280640,201901,2431,6636,2190,6369,61,193,1964,5728,2025,5921
280650,201901,1233,3232,970,2837,71,242,705,1993,776,2235
280660,201901,3166,7496,2800,7062,89,242,2465,6159,2554,6401
280670,201901,19158,43996,16678,40814,1039,2732,13143,31965,14182,34697
280680,201901,2708,6743,2320,6154,193,425,1675,4433,1868,4858
280690,201901,939,2417,786,2199,36,112,583,1587,619,1699
280700,201901,1096,2846,944,2610,22,88,739,2005,761,2093
280710,201901,14980,33933,12779,31412,483,991,11056,27576,11539,28567
280720,201901,2664,6038,2155,5445,111,337,1450,3813,1561,4150
280730,201901,1059,2746,953,2583,73,236,718,1883,791,2119
280740,201901,13908,34604,11890,31508,992,2721,8260,21501,9252,24222
280750,201901,3482,10015,3091,9320,169,622,2236,6608,2405,7230
280760,201901,6079,16977,5380,15876,574,1673,3616,10927,4190,12600
290010,201901,3108,6660,2130,5125,9,31,1739,3990,1748,4021
290020,201901,5362,14451,4930,13862,378,766,4123,11933,4501,12699
290030,201901,4185,10277,3503,9500,175,441,2934,8015,3109,8456
290035,201901,5184,11557,4180,10255,314,538,3319,8477,3633,9015
290040,201901,4228,10430,3593,9661,131,389,2818,7810,2949,8199
290050,201901,2085,6697,1744,5983,146,590,1181,3959,1327,4549
290060,201901,1290,3207,963,2656,92,330,642,1687,734,2017
290070,201901,34252,79008,29602,73117,2225,5692,21613,53095,23838,58787
290080,201901,5347,16007,4557,14818,508,1750,3103,10186,3611,11936
290090,201901,2197,4230,1581,3570,33,87,1424,3180,1457,3267
290100,201901,9651,25997,8038,23564,1066,2946,4805,14496,5871,17442
290110,201901,5035,13761,4552,12912,428,1232,3201,9008,3629,10240
290115,201901,4157,12201,3551,11183,231,823,2665,8308,2896,9131
290120,201901,6622,16457,5503,15033,140,505,4767,12797,4907,13302
290130,201901,4538,11247,3631,10103,119,455,2912,7975,3031,8430
290135,201901,4230,10116,3455,8854,223,588,2605,6490,2828,7078
290140,201901,4600,12423,3673,11198,112,423,3125,9454,3237,9877
290150,201901,2435,6559,2137,6183,177,566,1596,4567,1773,5133
290160,201901,3087,7489,2803,7123,295,670,2155,5517,2450,6187
290170,201901,3170,8484,2826,8082,104,348,2526,7217,2630,7565
290180,201901,2934,8036,2426,7249,87,316,1945,5745,2032,6061
290190,201901,4088,11936,3616,11287,160,658,2942,9031,3102,9689
290195,201901,2299,5875,1843,5216,42,183,1509,4228,1551,4411
290200,201901,3970,11268,3309,10185,232,777,2534,7755,2766,8532
290205,201901,3397,8821,3004,8253,150,568,2366,6275,2516,6843
290210,201901,13055,37063,11632,34948,983,2673,8868,27389,9851,30062
290220,201901,2726,7064,2463,6736,179,520,1967,5322,2146,5842
290225,201901,3471,7369,2763,6608,29,102,2507,5877,2536,5979
290230,201901,2422,6610,2209,6364,43,161,1952,5603,1995,5764
290240,201901,3583,9198,2949,8382,118,397,2417,6812,2535,7209
290250,201901,4032,11795,3524,11088,150,494,2884,9303,3034,9797
290260,201901,5309,13444,4397,12140,209,755,3568,9644,3777,10399
290265,201901,3586,10547,2924,9285,151,571,2175,6815,2326,7386
290270,201901,11263,38593,10660,37543,633,2771,8496,29495,9129,32266
290280,201901,5954,17945,5194,16514,356,1309,3749,11741,4105,13050
290290,201901,9957,29438,8205,26170,813,2822,5544,17500,6357,20322
290300,201901,4209,11616,3145,9614,171,593,2217,6759,2388,7352
290310,201901,1477,3871,1247,3563,83,319,940,2605,1023,2924
290320,201901,23505,63597,19271,57118,4451,13199,9250,28604,13701,41803
290323,201901,3681,10078,3248,9440,80,279,2648,7621,2728,7900
290327,201901,4158,12088,3584,10999,273,823,2566,7858,2839,8681
290330,201901,2048,4445,1646,3999,40,95,1451,3517,1491,3612
290340,201901,5592,14862,4440,13406,524,1678,3169,9659,3693,11337
290350,201901,4580,12965,3824,11684,304,1000,2722,8307,3026,9307
290360,201901,4959,13302,4349,12488,129,407,3750,10747,3879,11154
290370,201901,5298,13013,3967,11288,200,498,2964,8596,3164,9094
290380,201901,5533,14957,4738,13857,119,375,4137,12177,4256,12552
290390,201901,13881,39952,11899,37012,1256,3948,8164,25781,9420,29729
290395,201901,2728,8184,2290,7425,66,317,1797,5753,1863,6070
290400,201901,3557,9849,2895,8775,98,409,2196,6504,2294,6913
290405,201901,4579,13500,3848,12227,273,940,2723,8750,2996,9690
290410,201901,5629,15707,4458,13774,123,588,3420,10204,3543,10792
290420,201901,2949,8383,2430,7557,108,387,1889,5837,1997,6224
290430,201901,3054,8670,2539,7848,291,947,1646,5067,1937,6014
290440,201901,2721,7004,2016,5894,48,163,1462,4322,1510,4485
290450,201901,3237,8721,2646,7856,145,514,2034,5951,2179,6465
290460,201901,11444,32359,9905,29486,2232,6742,4541,13525,6773,20267
290470,201901,4313,11140,3218,9572,355,1190,1831,5489,2186,6679
290475,201901,6327,18588,5391,16892,110,571,4377,13378,4487,13949
290480,201901,1716,4495,1463,4117,122,383,966,2577,1088,2960
290485,201901,4450,13273,3950,12528,122,646,3361,10423,3483,11069
290490,201901,8904,21455,7978,20196,524,1268,6234,15919,6758,17187
290500,201901,3888,11881,3044,10066,516,1789,1409,4548,1925,6337
290510,201901,3311,8593,2818,7940,86,312,2420,6715,2506,7027
290515,201901,3721,10079,3157,9373,64,191,2788,8470,2852,8661
290520,201901,11016,32251,8583,27494,447,1705,5482,17207,5929,18912
290530,201901,4919,14125,4234,13012,154,549,3513,10792,3667,11341
290540,201901,3543,9492,3186,9056,70,257,2910,8215,2980,8472
290550,201901,4316,11266,3797,10658,22,84,3528,10000,3550,10084
290560,201901,6524,17189,5067,15012,469,1669,3346,9614,3815,11283
290570,201901,42109,106738,38238,101834,2716,7595,30556,80853,33272,88448
290580,201901,7767,23370,6833,22002,649,2084,5018,16498,5667,18582
290590,201901,6932,21637,5998,19981,155,664,4889,16254,5044,16918
290600,201901,18120,51490,16364,48779,708,2317,13133,39054,13841,41371
290610,201901,2471,7949,1986,6946,106,447,1372,4720,1478,5167
290620,201901,6556,18355,5695,16935,212,639,4768,14098,4980,14737
290630,201901,8914,22002,7167,19725,601,1657,5543,15311,6144,16968
290640,201901,2720,7199,2067,6197,90,284,1528,4560,1618,4844
290650,201901,12173,32045,11016,30613,2853,7534,6161,18220,9014,25754
290660,201901,3638,9436,3072,8620,65,179,2331,6800,2396,6979
290670,201901,6565,18720,5676,17278,438,1301,4342,13355,4780,14656
290680,201901,10403,29481,8951,27342,237,1214,7294,21697,7531,22911
290682,201901,4529,12153,4009,11416,145,374,3380,9675,3525,10049
290685,201901,3547,8009,2376,6381,186,468,1522,4329,1708,4797
290687,201901,6589,18222,5318,16120,754,2243,3307,10305,4061,12548
290689,201901,2756,7926,2261,7063,132,455,1670,5221,1802,5676
290690,201901,5574,14642,4555,13239,450,1323,3168,9164,3618,10487
290700,201901,2624,7278,2350,6915,90,317,1948,5740,2038,6057
290710,201901,8506,24096,7227,22326,192,790,6125,18806,6317,19596
290720,201901,18773,51440,17272,49232,957,3090,14010,39510,14967,42600
290730,201901,7050,17390,6039,16200,260,633,4737,12735,4997,13368
290740,201901,1056,2915,801,2467,39,158,607,1865,646,2023
290750,201901,10616,27647,9249,25283,844,2462,6519,17334,7363,19796
290755,201901,2084,5893,1684,5155,96,316,1199,3666,1295,3982
290760,201901,3824,11214,3051,9736,270,797,1938,6409,2208,7206
290770,201901,2576,8454,2354,8179,56,286,1969,6903,2025,7189
290780,201901,8218,20618,7093,19092,321,747,5646,15373,5967,16120
290790,201901,4484,12479,3943,11757,139,456,3358,10074,3497,10530
290800,201901,7219,15118,5209,12800,337,785,3850,9607,4187,10392
290810,201901,5550,14994,4476,13354,117,443,3347,10005,3464,10448
290820,201901,4971,13381,4450,12617,231,721,3298,9410,3529,10131
290830,201901,4553,10551,4075,9923,61,182,3525,8447,3586,8629
290840,201901,16357,44840,14385,41781,1748,4404,9549,29051,11297,33455
290850,201901,6255,15895,5673,15250,348,811,4747,13067,5095,13878
290860,201901,5782,17373,5056,16498,231,823,4258,14101,4489,14924
290870,201901,4771,13238,3673,11261,118,422,2649,8050,2767,8472
290880,201901,1386,3523,1089,3121,76,208,763,2237,839,2445
290890,201901,8424,18089,7606,17140,185,465,7051,15778,7236,16243
290900,201901,2278,6096,1748,5198,107,321,1136,3331,1243,3652
290910,201901,5026,12444,3901,10731,52,207,3209,8696,3261,8903
290920,201901,5113,12672,4701,12179,60,138,4418,11471,4478,11609
290930,201901,7832,22105,6385,19585,214,965,5071,15071,5285,16036
290940,201901,3634,10359,3046,9519,170,632,2420,7575,2590,8207
290950,201901,1462,3760,1221,3405,62,171,888,2488,950,2659
290960,201901,5316,14427,4779,13754,135,440,4076,11702,4211,12142
290970,201901,3509,10247,2893,9190,157,547,2197,6938,2354,7485
290980,201901,11179,27919,9448,25234,919,2652,5672,14749,6591,17401
290990,201901,9125,25065,8045,23317,359,1391,6562,18414,6921,19805
291000,201901,3345,9011,2673,8166,221,631,2059,6420,2280,7051
291005,201901,14778,36572,13162,34504,794,2148,10814,28178,11608,30326
291010,201901,2980,9075,2419,7908,139,499,1600,5132,1739,5631
291020,201901,1262,3182,1012,2706,27,93,720,1824,747,1917
291030,201901,2383,5979,1663,4679,94,278,1079,2934,1173,3212
291040,201901,5223,14872,4516,13869,197,826,3592,10887,3789,11713
291050,201901,7179,19782,6221,18384,863,2787,4141,12052,5004,14839
291060,201901,5684,18529,4943,17473,393,1729,3643,12724,4036,14453
291070,201901,15536,42648,13131,38926,518,1870,10602,31127,11120,32997
291072,201901,22959,61166,16965,50345,3490,10774,6870,20637,10360,31411
291075,201901,5062,13326,4500,12416,124,390,3678,9939,3802,10329
291077,201901,1560,4138,1235,3557,51,151,861,2481,912,2632
291080,201901,82815,225328,68318,203734,25370,77271,13405,43075,38775,120346
291085,201901,5644,14409,4735,13082,178,565,4000,10958,4178,11523
291090,201901,1907,3726,1426,3190,33,96,1197,2630,1230,2726
291100,201901,3113,6921,2143,5758,118,377,1632,4291,1750,4668
291110,201901,5747,17738,4953,16355,383,1551,3647,11592,4030,13143
291120,201901,7689,19135,6605,17713,381,1119,4975,13292,5356,14411
291125,201901,2136,3805,1568,3176,120,178,1188,2506,1308,2684
291130,201901,3095,9139,2369,7718,86,414,1698,5339,1784,5753
291140,201901,4656,12932,3505,10766,416,1135,2250,6991,2666,8126
291150,201901,2193,5081,1843,4679,20,57,1712,4331,1732,4388
291160,201901,4934,14012,4183,12908,375,1279,2848,8674,3223,9953
291165,201901,2148,5967,1674,5071,37,149,1241,3641,1278,3790
291170,201901,20298,52110,17201,47018,1009,3031,11297,30587,12306,33618
291180,201901,5764,14056,4494,12252,431,1148,3290,9027,3721,10175
291185,201901,3156,8703,2750,8022,85,276,2139,6170,2224,6446
291190,201901,7566,18944,6303,17250,365,1079,4920,13426,5285,14505
291200,201901,2858,8002,2132,6630,95,311,1309,4019,1404,4330
291210,201901,6820,15135,5256,13293,167,525,3938,9949,4105,10474
291220,201901,3902,11423,3529,10840,235,838,2728,8283,2963,9121
291230,201901,4423,9743,3422,8639,76,161,3036,7773,3112,7934
291240,201901,4179,10925,3654,10039,62,219,3140,8490,3202,8709
291250,201901,3394,10076,2677,8769,173,574,1758,5795,1931,6369
291260,201901,1373,3252,1178,3002,33,104,975,2499,1008,2603
291270,201901,4952,13853,4031,12406,708,2119,2512,7922,3220,10041
291280,201901,2389,6277,1807,5342,174,593,1077,3065,1251,3658
291290,201901,5832,15639,4652,13794,430,1338,3132,9242,3562,10580
291300,201901,3919,10644,2956,9034,138,453,2181,6623,2319,7076
291310,201901,5002,13668,4329,12402,131,456,3596,10103,3727,10559
291320,201901,5926,17188,4675,14755,1109,3279,2252,7482,3361,10761
291330,201901,1786,4573,1518,4131,71,198,1124,2974,1195,3172
291340,201901,4102,10799,3453,9724,83,300,2685,7418,2768,7718
291345,201901,2959,9133,2715,8753,127,451,2225,7180,2352,7631
291350,201901,6713,17177,5230,15260,93,289,4440,13163,4533,13452
291360,201901,34168,82858,27602,74562,3410,9547,16919,46627,20329,56174
291370,201901,7797,21613,7041,20525,484,1581,5346,15414,5830,16995
291380,201901,3279,9471,2952,8967,105,469,2445,7271,2550,7740
291390,201901,12672,28631,10091,25722,441,1207,8180,20781,8621,21988
291400,201901,13516,36011,11421,32852,1653,4322,6868,21093,8521,25415
291410,201901,2861,7567,2190,6441,56,256,1618,4620,1674,4876
291420,201901,1887,4753,1527,4306,46,199,1301,3619,1347,3818
291430,201901,2925,8246,2538,7642,98,433,2025,5926,2123,6359
291440,201901,6328,18447,5457,16987,313,1080,4313,13436,4626,14516
291450,201901,8627,22447,7259,20843,129,255,6362,18826,6491,19081
291460,201901,14785,40399,13064,37832,776,2487,9761,28104,10537,30591
291465,201901,8718,22517,7015,20525,230,1000,5869,16998,6099,17998
291470,201901,15148,36185,12931,33664,619,1590,9751,26038,10370,27628
291480,201901,39104,89034,29020,75318,3768,10354,15292,39704,19060,50058
291490,201901,5207,13610,4578,12827,187,606,4044,11299,4231,11905
291500,201901,5020,12408,4197,11287,64,285,3801,10130,3865,10415
291510,201901,3754,10170,2946,9064,96,467,2346,7159,2442,7626
291520,201901,4359,10247,3379,8948,163,466,2557,6749,2720,7215
291530,201901,2200,5263,1610,4471,290,728,953,2865,1243,3593
291535,201901,3067,9392,2850,9022,180,556,2202,7082,2382,7638
291540,201901,2235,5054,1579,4286,53,214,1332,3500,1385,3714
291550,201901,5345,12610,4209,11108,405,956,2807,7532,3212,8488
291560,201901,19043,43639,13358,36713,983,2564,8967,25734,9950,28298
291570,201901,2270,5492,1848,4979,80,185,1528,4223,1608,4408
291580,201901,6100,16399,4842,14691,295,1018,3519,10480,3814,11498
291590,201901,1831,5033,1645,4777,126,400,1328,3815,1454,4215
291600,201901,5066,12735,3812,10761,488,1511,2331,6365,2819,7876
291610,201901,5542,15297,5186,14901,80,300,4819,13821,4899,14121
291620,201901,3178,7067,2303,6101,120,329,1741,4708,1861,5037
291630,201901,3213,7448,2396,6386,187,602,1834,4782,2021,5384
291640,201901,15081,38811,11574,33573,1850,5271,4935,15133,6785,20404
291650,201901,8868,23405,7856,22150,457,1042,6630,19009,7087,20051
291660,201901,2041,5027,1501,4176,131,434,1004,2645,1135,3079
291670,201901,2029,5358,1721,4936,103,267,1347,3910,1450,4177
291680,201901,3989,10193,3264,9090,288,872,2368,6494,2656,7366
291685,201901,4597,11183,3685,10024,246,519,2798,7925,3044,8444
291690,201901,4103,9355,2955,7718,181,448,2294,5951,2475,6399
291700,201901,8469,24947,7564,23355,433,1522,6143,18702,6576,20224
291710,201901,5108,12624,3834,10811,302,973,2676,7369,2978,8342
291720,201901,4315,13467,3639,12090,420,1524,2377,7690,2797,9214
291730,201901,6265,16601,5419,15484,240,810,4481,12727,4721,13537
291733,201901,2899,7533,2451,6929,68,236,1824,5363,1892,5599
291735,201901,2959,7674,2431,6830,78,220,1947,5445,2025,5665
291740,201901,3789,9888,2926,8415,100,312,2224,6300,2324,6612
291750,201901,19286,47092,15701,41723,1635,4423,10404,27716,12039,32139
291760,201901,10102,30162,8065,26733,2600,9729,2091,6955,4691,16684
291770,201901,6881,19210,5759,17167,470,1497,4114,12008,4584,13505
291780,201901,4989,13517,4507,12815,109,402,3909,10961,4018,11363
291790,201901,2614,7532,2414,7264,250,678,1811,5556,2061,6234
291800,201901,28502,73748,21998,63855,3365,9446,11825,35369,15190,44815
291810,201901,10369,25505,8742,23468,235,763,7599,20210,7834,20973
291820,201901,3746,10103,3286,9455,111,369,2603,7518,2714,7887
291830,201901,4151,10279,3552,9439,215,558,2862,7637,3077,8195
291835,201901,6258,18896,4926,16307,741,2537,2842,9628,3583,12165
291840,201901,45658,126886,39725,118421,4736,14721,27371,82048,32107,96769
291845,201901,2397,6516,1970,5994,102,325,1611,4940,1713,5265
291850,201901,3973,11442,3288,10296,279,816,2355,7577,2634,8393
291855,201901,2101,4340,1661,3826,52,142,1464,3344,1516,3486
291860,201901,2245,5926,1558,4600,36,125,1058,3000,1094,3125
291870,201901,1297,3290,877,2554,54,172,589,1653,643,1825
291875,201901,2634,8024,2335,7434,101,382,1778,5511,1879,5893
291880,201901,5481,16041,4747,14739,309,977,3442,10683,3751,11660
291890,201901,1519,3259,991,2629,156,388,639,1682,795,2070
291900,201901,1173,2996,912,2575,22,88,730,2005,752,2093
291905,201901,2632,6635,2056,5703,83,284,1551,4179,1634,4463
291910,201901,2808,7310,2394,6808,73,253,2057,5841,2130,6094
291915,201901,7202,20856,5976,18758,228,888,4529,14181,4757,15069
291920,201901,24680,67228,21480,62783,2622,8167,14284,41195,16906,49362
291930,201901,2400,6758,2066,6233,244,791,1360,4051,1604,4842
291940,201901,3758,9911,2525,7778,230,687,1461,4435,1691,5122
291950,201901,8868,27296,7646,24928,470,1762,5122,16611,5592,18373
291955,201901,14069,36379,12721,34625,1232,3392,9846,27101,11078,30493
291960,201901,3104,8369,2525,7553,147,461,1925,5870,2072,6331
291970,201901,4197,11252,3621,10469,189,683,2721,7829,2910,8512
291980,201901,10047,28614,7979,25366,671,2073,5385,17360,6056,19433
291990,201901,2115,5660,1858,5372,22,104,1766,5092,1788,5196
291992,201901,4144,10129,3108,8699,261,662,2413,6859,2674,7521
291995,201901,2142,5844,1736,5237,56,264,1371,4032,1427,4296
292000,201901,2544,6243,2050,5621,133,486,1533,4120,1666,4606
292010,201901,5936,13894,4888,12428,215,647,4021,10028,4236,10675
292020,201901,4477,13270,3771,12026,248,886,2750,8548,2998,9434
292030,201901,1693,5389,1624,5273,76,302,1043,3267,1119,3569
292040,201901,4195,11086,3402,9936,243,672,2647,7900,2890,8572
292045,201901,3942,10518,2936,9023,50,129,2569,8050,2619,8179
292050,201901,6395,18326,5155,16019,327,1137,3239,9923,3566,11060
292060,201901,11967,27718,11114,26673,608,1418,9570,22696,10178,24114
292070,201901,5641,15003,4977,14188,275,845,4285,12146,4560,12991
292080,201901,3180,8087,2633,7396,101,306,2300,6468,2401,6774
292090,201901,4500,9859,3261,8398,242,635,2501,6534,2743,7169
292100,201901,10131,25764,8696,23908,1141,3305,5539,15150,6680,18455
292105,201901,3314,8711,2939,8162,85,286,2414,6632,2499,6918
292110,201901,6046,15268,4339,12450,1017,2952,1983,5710,3000,8662
292120,201901,6763,17715,5536,15599,412,1212,4091,11342,4503,12554
292130,201901,3299,8108,2707,7380,147,443,2089,5646,2236,6089
292140,201901,5061,12079,4217,10870,269,642,3379,8714,3648,9356
292145,201901,2296,6859,1944,6213,75,257,1457,4681,1532,4938
292150,201901,13083,36854,11695,34708,277,1218,9760,28491,10037,29709
292160,201901,2836,7231,2214,6422,61,196,1847,5433,1908,5629
292170,201901,8037,21904,6749,19756,497,1571,4831,13981,5328,15552
292180,201901,2781,7664,2036,6351,257,785,1216,3754,1473,4539
292190,201901,2860,7674,2453,7079,170,507,1813,5289,1983,5796
292200,201901,7650,20194,5862,17546,998,3051,3208,9783,4206,12834
292205,201901,3841,10718,3329,9964,72,330,2900,8578,2972,8908
292210,201901,6163,14948,5082,13537,94,423,4527,11858,4621,12281
292220,201901,2046,5116,1807,4758,78,223,1399,3605,1477,3828
292225,201901,3155,9290,2806,8768,74,312,2369,7285,2443,7597
292230,201901,8278,20099,7424,18994,177,651,6318,15801,6495,16452
292240,201901,4792,13951,4144,12739,349,1055,2801,8632,3150,9687
292250,201901,5122,14204,4634,13441,585,1606,3092,9132,3677,10738
292260,201901,3272,8809,2931,8371,122,331,2542,7320,2664,7651
292265,201901,3308,9300,2803,8511,78,378,2193,6491,2271,6869
292270,201901,4185,9889,3357,8895,189,530,2707,7183,2896,7713
292273,201901,2576,5692,2073,5076,58,106,1596,4088,1654,4194
292275,201901,1631,4289,1305,3826,58,146,999,2984,1057,3130
292280,201901,2579,6191,2101,5648,103,242,1738,4817,1841,5059
292285,201901,2502,6165,1984,5438,92,230,1561,4326,1653,4556
292290,201901,7024,19441,5791,17635,181,702,4729,14342,4910,15044
292300,201901,9863,25805,7836,23206,879,2838,5196,15411,6075,18249
292303,201901,2843,8262,2509,7738,69,190,2151,6671,2220,6861
292305,201901,2461,6612,2280,6356,46,229,2023,5513,2069,5742
292310,201901,6569,17110,5646,15975,191,640,4806,13504,4997,14144
292320,201901,6149,16879,5002,14754,292,931,3704,10637,3996,11568
292330,201901,2730,6104,2139,5436,106,258,1659,4305,1765,4563
292335,201901,4680,12225,4186,11518,277,710,3480,9654,3757,10364
292340,201901,5718,16038,4854,14391,225,744,3652,10640,3877,11384
292350,201901,2499,6738,2051,6142,85,320,1689,5060,1774,5380
292360,201901,4828,12998,4077,11698,317,1023,2831,7908,3148,8931
292370,201901,10904,24949,9486,23054,133,469,8727,20755,8860,21224
292380,201901,6728,19080,6046,17886,408,1233,4590,13474,4998,14707
292390,201901,4314,8540,3149,7176,107,232,2751,6276,2858,6508
292400,201901,21428,62748,18853,58503,1851,6128,13113,40582,14964,46710
292405,201901,4284,10602,3546,9533,158,405,2872,7701,3030,8106
292410,201901,2119,5168,1839,4820,60,190,1616,4225,1676,4415
292420,201901,3602,11007,3296,10508,158,725,2749,8575,2907,9300
292430,201901,4674,14241,3631,12382,302,1099,2403,8210,2705,9309
292440,201901,8386,26944,7757,25980,126,638,6993,23378,7119,24016
292450,201901,3766,11153,3081,9784,122,449,2389,7556,2511,8005
292460,201901,4782,13440,3962,12038,374,1097,2813,8567,3187,9664
292465,201901,2533,6772,2100,6182,93,239,1468,4562,1561,4801
292467,201901,1761,5126,1591,4899,210,607,1110,3528,1320,4135
292470,201901,2949,7535,2310,6521,71,171,1813,5128,1884,5299
292480,201901,6397,15317,5149,13805,82,317,4613,12174,4695,12491
292490,201901,2064,5522,1727,5024,104,310,1316,3861,1420,4171
292500,201901,6333,17773,5205,15734,577,1766,3415,10285,3992,12051
292510,201901,12328,33781,9916,30153,549,2001,7262,22020,7811,24021
292520,201901,6611,16837,5871,15761,623,1692,4303,11550,4926,13242
292525,201901,5670,13654,4702,12534,115,330,4122,11027,4237,11357
292530,201901,25758,69982,20461,61180,5583,16868,7334,22832,12917,39700
292540,201901,3982,7943,3163,7054,113,221,2784,6210,2897,6431
292550,201901,7736,21393,6073,19296,411,1451,4505,14666,4916,16117
292560,201901,4232,10875,3626,10031,93,340,2990,8221,3083,8561
292570,201901,3797,9936,3248,9061,65,230,2841,7795,2906,8025
292575,201901,6865,20250,6371,19592,266,918,5339,16379,5605,17297
292580,201901,7349,19041,6239,17401,162,546,5243,14478,5405,15024
292590,201901,7283,19434,6407,18047,261,846,5430,14964,5691,15810
292593,201901,2788,6908,2338,6166,74,182,1939,5097,2013,5279
292595,201901,5328,14197,4632,13355,175,601,3881,11054,4056,11655
292600,201901,10822,29689,9381,27545,424,1180,7391,21782,7815,22962
292610,201901,4230,11161,3563,10010,221,530,2565,7365,2786,7895
292620,201901,6308,17652,5367,16554,78,200,5066,15796,5144,15996
292630,201901,8500,21007,6954,18543,536,1426,4813,12870,5349,14296
292640,201901,8080,24245,7103,22655,226,980,5128,16329,5354,17309
292650,201901,4567,11218,4127,10647,138,410,3721,9460,3859,9870
292660,201901,10886,30109,9403,27941,481,1579,7357,21770,7838,23349
292665,201901,2165,6487,1938,6205,72,231,1661,5400,1733,5631
292670,201901,3518,9575,2712,8077,121,421,1867,5465,1988,5886
292680,201901,3917,10643,3154,9231,186,568,2299,6556,2485,7124
292690,201901,2595,6886,1844,5646,177,517,1133,3631,1310,4148
292700,201901,9696,26752,8436,24833,815,2344,5748,17360,6563,19704
292710,201901,2404,7648,2221,7401,53,192,1992,6687,2045,6879
292720,201901,9152,22123,7718,20518,284,764,6247,16785,6531,17549
292730,201901,4342,10435,4085,10122,198,348,3559,8942,3757,9290
292740,201901,313423,784231,280439,735512,45023,119627,170426,444553,215449,564180
292750,201901,6150,16548,5351,15389,284,861,4056,11769,4340,12630
292760,201901,3808,11132,3368,10370,249,832,2459,7524,2708,8356
292770,201901,5841,16038,4756,14463,750,2386,2890,9094,3640,11480
292780,201901,1952,4070,1460,3432,46,143,1175,2637,1221,2780
292790,201901,4085,8742,3175,7758,141,384,2728,6631,2869,7015
292800,201901,10814,27432,9372,25237,364,1022,7758,20659,8122,21681
292805,201901,3400,8482,2683,7516,191,517,1996,5609,2187,6126
292810,201901,10380,28031,8245,24739,250,997,6173,18119,6423,19116
292820,201901,7391,20422,5392,17226,517,1813,3685,11556,4202,13369
292830,201901,2862,6734,2444,6214,79,266,2142,5404,2221,5670
292840,201901,8764,23133,7657,21638,177,651,6632,18331,6809,18982
292850,201901,2503,6787,2098,6160,145,489,1464,4182,1609,4671
292860,201901,16270,37575,14614,35527,714,1754,12118,29256,12832,31010
292870,201901,16791,43350,14656,40351,1057,3243,9747,26466,10804,29709
292880,201901,11093,30399,9632,28261,345,1463,7525,21290,7870,22753
292890,201901,6342,18379,5652,17309,254,987,4732,14341,4986,15328
292895,201901,2944,6474,2151,5280,90,230,1693,4108,1783,4338
292900,201901,2626,7258,2427,6941,58,256,1974,5472,2032,5728
292905,201901,4228,11459,3348,10130,197,693,2401,7187,2598,7880
292910,201901,4856,13496,4432,12842,263,860,3334,9561,3597,10421
292920,201901,9689,26892,9138,26131,278,1062,7950,22342,8228,23404
292925,201901,5305,15192,4610,13991,252,791,3411,10182,3663,10973
292930,201901,6350,19212,5500,17566,483,1828,3440,10652,3923,12480
292935,201901,2288,6023,1791,5463,39,204,1581,4818,1620,5022
292937,201901,3059,7365,2678,6911,68,196,2392,6175,2460,6371
292940,201901,2980,7673,2415,6799,175,405,1743,5051,1918,5456
292950,201901,9602,24877,8475,23184,453,1218,6424,17396,6877,18614
292960,201901,5186,12598,4422,11542,111,329,3581,9148,3692,9477
292970,201901,3789,11173,3325,10469,113,501,2749,8649,2862,9150
292975,201901,4428,9710,3931,9144,174,323,3512,8268,3686,8591
292980,201901,3264,8018,2616,7041,107,338,2081,5514,2188,5852
292990,201901,11244,31036,9534,28029,705,2256,7056,20573,7761,22829
293000,201901,2524,6141,2215,5718,38,145,1764,4592,1802,4737
293010,201901,17891,46486,14595,41241,1953,5764,8956,25143,10909,30907
293015,201901,7768,24484,6237,21444,462,1949,4253,14503,4715,16452
293020,201901,9651,28565,8768,27320,140,662,7784,24505,7924,25167
293030,201901,5305,14416,4080,12525,118,404,2769,8764,2887,9168
293040,201901,3891,11019,3397,10340,96,361,2944,8931,3040,9292
293050,201901,21394,53633,19090,50362,1286,3519,14116,37040,15402,40559
293060,201901,3458,9156,2838,8098,200,609,2070,5789,2270,6398
293070,201901,24359,60563,20703,55702,2746,7546,13483,36812,16229,44358
293075,201901,3279,10611,2925,10038,211,863,2307,7877,2518,8740
293076,201901,3555,8919,3170,8441,96,258,2704,7266,2800,7524
293077,201901,5944,16814,4827,15102,470,1536,3138,10120,3608,11656
293080,201901,4798,14256,4184,13216,127,563,3329,10286,3456,10849
293090,201901,3139,9269,2437,8109,260,908,1565,5223,1825,6131
293100,201901,5651,15406,4571,13482,282,858,3517,10293,3799,11151
293105,201901,3615,11525,3181,10663,213,760,2326,7703,2539,8463
293110,201901,2452,6080,2088,5590,71,288,1742,4507,1813,4795
293120,201901,4293,11891,3834,11155,114,308,3189,9297,3303,9605
293130,201901,3736,10404,3318,9864,96,410,2847,8366,2943,8776
293135,201901,28488,68931,21205,58866,3811,11582,9423,26329,13234,37911
293140,201901,2310,5369,2011,4996,77,202,1673,4128,1750,4330
293150,201901,5313,16236,4413,14540,426,1464,3000,9910,3426,11374
293160,201901,3838,9484,3278,8840,252,474,2687,7587,2939,8061
293170,201901,4352,9873,3798,9143,102,276,3229,7673,3331,7949
293180,201901,4542,12506,3734,11131,121,527,3001,8689,3122,9216
293190,201901,13869,38420,12154,35964,235,1038,10575,31030,10810,32068
293200,201901,7904,20004,6583,18003,226,864,5227,13981,5453,14845
293210,201901,5176,13746,4385,12494,303,849,3354,9557,3657,10406
293220,201901,4853,13037,3658,10966,841,2544,1462,4551,2303,7095
293230,201901,3838,10139,2903,8765,252,837,1962,6007,2214,6844
293240,201901,4359,11652,3562,10353,97,280,2723,8118,2820,8398
293245,201901,3839,10457,3474,9943,176,538,2949,8356,3125,8894
293250,201901,5498,13477,4691,12380,240,652,3803,10022,4043,10674
293260,201901,4354,12182,3609,11033,110,361,2565,7809,2675,8170
293270,201901,6818,15781,5515,14370,476,818,4265,11826,4741,12644
293280,201901,4779,12648,4113,11734,260,654,3175,9113,3435,9767
293290,201901,13211,40546,11841,38351,2333,7497,6757,22607,9090,30104
293300,201901,5829,14117,4974,12918,320,776,3645,9595,3965,10371
293305,201901,3956,9932,3506,9344,46,140,3130,8309,3176,8449
293310,201901,2101,5460,1735,4841,69,209,1337,3668,1406,3877
293315,201901,4075,9971,3339,8854,170,436,2694,7112,2864,7548
293317,201901,2456,6155,2172,5733,132,291,1696,4498,1828,4789
293320,201901,10561,27438,9755,26497,399,1138,8515,23086,8914,24224
293325,201901,1678,4351,1341,3871,187,552,858,2490,1045,3042
293330,201901,42742,132187,36816,121634,8295,27771,16454,55804,24749,83575
293340,201901,2330,6543,1899,5812,124,432,1285,3884,1409,4316
293345,201901,3237,9129,2661,8288,300,717,1883,6254,2183,6971
293350,201901,6669,19012,5895,18146,60,232,5442,17029,5502,17261
293360,201901,14989,38931,12876,36224,460,1712,11149,30869,11609,32581
310010,201901,835,2001,575,1626,61,208,264,695,325,903
310020,201901,2297,6576,1690,5462,367,1314,281,847,648,2161
310030,201901,1995,5843,1560,5068,232,836,959,3008,1191,3844
310040,201901,934,2457,762,2175,38,145,530,1434,568,1579
310050,201901,1543,4807,1354,4489,191,782,790,2520,981,3302
310060,201901,3232,9250,2827,8729,136,586,2321,7055,2457,7641
310070,201901,354,807,242,638,7,18,185,482,192,500
310080,201901,807,2197,542,1652,73,254,225,635,298,889
310090,201901,4437,12247,3648,10932,302,997,2627,7712,2929,8709
310100,201901,3226,9223,2744,8423,109,489,2200,6533,2309,7022
310110,201901,4713,12721,3731,11003,776,2508,1664,4697,2440,7205
310120,201901,635,1583,398,1180,65,236,210,547,275,783
310130,201901,363,1005,309,919,41,156,197,542,238,698
310140,201901,222,698,161,580,34,143,48,145,82,288
310150,201901,4648,13079,3567,11032,624,2158,1457,4343,2081,6501
310160,201901,6908,18312,5131,15363,1164,3847,1619,4763,2783,8610
310163,201901,960,2831,769,2483,232,847,219,624,451,1471
310170,201901,8780,23148,7170,20633,697,2093,5057,14512,5754,16605
310180,201901,1658,4284,1266,3639,111,407,873,2397,984,2804
310190,201901,2837,8718,2297,7672,556,2063,323,1005,879,3068
310200,201901,1711,5234,1280,4369,243,919,507,1707,750,2626
310205,201901,1060,2947,783,2503,171,613,284,887,455,1500
310210,201901,2628,6998,2161,6239,106,316,1651,4714,1757,5030
310220,201901,1099,3044,889,2691,98,329,613,1809,711,2138
310230,201901,2245,6452,1842,5674,224,816,1103,3168,1327,3984
310240,201901,878,2846,755,2626,57,256,526,1787,583,2043
310250,201901,1003,2731,819,2435,40,159,582,1691,622,1850
310260,201901,2694,7292,1685,5520,493,1838,338,845,831,2683
310270,201901,2638,6732,2067,5945,115,440,1669,4728,1784,5168
310280,201901,2306,5534,1791,4791,296,859,993,2509,1289,3368
310285,201901,1848,6141,1599,5704,161,687,988,3489,1149,4176
310290,201901,1132,3054,948,2724,205,674,498,1293,703,1967
310300,201901,1422,4391,1258,4107,198,810,658,1948,856,2758
310310,201901,307,795,208,615,32,99,112,327,144,426
310320,201901,502,1312,319,997,31,125,153,455,184,580
310330,201901,481,1154,292,804,39,133,131,325,170,458
310340,201901,7556,21186,6057,18621,968,2894,3031,9630,3999,12524
310350,201901,11916,29606,8121,23409,1901,5856,2847,7991,4748,13847
310360,201901,485,1172,372,1029,12,42,276,751,288,793
310370,201901,1248,4006,1040,3601,215,799,331,1175,546,1974
310375,201901,830,2207,557,1782,100,343,224,710,324,1053
310380,201901,386,907,204,588,36,97,78,210,114,307
310390,201901,439,1340,353,1179,92,332,89,239,181,571
310400,201901,9230,23088,6515,18912,950,3140,3447,9719,4397,12859
310410,201901,770,2263,475,1706,102,377,128,421,230,798
310420,201901,3901,10266,2518,7505,451,1528,780,2088,1231,3616
310430,201901,1419,3963,921,3019,194,703,288,877,482,1580
310440,201901,565,1455,392,1152,25,109,231,660,256,769
310445,201901,1311,3873,1001,3269,48,184,714,2290,762,2474
310450,201901,4637,11961,3494,10138,209,758,2608,7355,2817,8113
310460,201901,1566,4256,1076,3329,216,715,307,922,523,1637
310470,201901,3817,8398,3039,7382,302,807,2285,5485,2587,6292
310480,201901,980,2661,751,2245,107,369,470,1357,577,1726
310490,201901,2833,8060,2211,6953,322,1211,1094,3176,1416,4387
310500,201901,1405,4051,1017,3329,204,737,471,1522,675,2259
310510,201901,1829,4975,1186,3752,243,840,388,1237,631,2077
310520,201901,1276,3249,919,2648,125,349,531,1515,656,1864
310530,201901,748,1967,425,1302,61,219,105,245,166,464
310540,201901,3222,9351,2666,8378,646,2129,1119,3390,1765,5519
310550,201901,1231,3233,848,2565,80,304,501,1423,581,1727
310560,201901,13684,37002,10058,30656,2035,6990,3607,9948,5642,16938
310570,201901,1111,2996,883,2666,85,326,582,1693,667,2019
310590,201901,4047,11101,3279,9713,274,933,1900,5351,2174,6284
310600,201901,1394,4216,1138,3697,176,644,556,1681,732,2325
310610,201901,490,1327,311,1027,56,208,163,495,219,703
310620,201901,157355,416094,115752,340979,22099,73904,47932,126486,70031,200390
310630,201901,4394,12351,3625,10905,270,962,2434,7105,2704,8067
310640,201901,975,2998,814,2673,195,720,283,877,478,1597
310650,201901,2394,7096,1778,5913,213,796,1005,3224,1218,4020
310660,201901,1233,3391,1045,3155,46,161,859,2554,905,2715
310665,201901,1322,3493,1047,3096,45,177,852,2478,897,2655
310670,201901,49301,132575,41405,118665,5216,17076,26039,70878,31255,87954
310680,201901,663,1657,565,1522,27,81,445,1165,472,1246
310690,201901,1675,4584,1242,3861,134,480,695,2061,829,2541
310700,201901,473,1087,362,954,37,123,251,625,288,748
310710,201901,5206,15333,3693,13133,880,3659,465,1553,1345,5212
310720,201901,901,2285,715,2037,48,164,514,1410,562,1574
310730,201901,9205,25908,7945,23828,497,1875,5655,16591,6152,18466
310740,201901,5177,14762,3503,11201,670,2319,1033,3079,1703,5398
310750,201901,1189,2941,849,2452,133,446,368,968,501,1414
310760,201901,545,1475,400,1244,30,103,195,622,225,725
310770,201901,1063,2981,714,2435,106,417,341,1110,447,1527
310780,201901,3978,10133,3272,9025,135,415,2400,6514,2535,6929
310790,201901,1749,5584,1539,5151,417,1491,500,1660,917,3151
310800,201901,2203,6698,1583,5428,419,1685,97,303,516,1988
310810,201901,1115,2915,891,2506,51,175,608,1648,659,1823
310820,201901,1132,3010,685,2184,153,519,143,451,296,970
310825,201901,2434,7833,1996,7066,83,472,1569,5332,1652,5804
310830,201901,1476,4350,1026,3423,215,798,417,1322,632,2120
310840,201901,1850,5146,1303,4178,346,1230,320,904,666,2134
310850,201901,1522,4219,1285,3896,66,318,996,2871,1062,3189
310855,201901,3213,8737,2504,7582,216,768,1719,5066,1935,5834
310860,201901,6789,19992,5435,17274,522,1774,3365,10727,3887,12501
310870,201901,1037,2510,784,2139,86,241,560,1533,646,1774
310880,201901,1014,3083,794,2632,90,318,472,1524,562,1842
310890,201901,2224,6312,1419,4777,310,1146,174,486,484,1632
310900,201901,4110,11618,3051,9593,481,1676,1380,3985,1861,5661
310910,201901,1728,4493,1125,3429,125,452,175,467,300,919
310920,201901,1826,4936,1404,4264,255,799,720,2184,975,2983
310925,201901,939,2694,780,2408,100,337,504,1509,604,1846
310930,201901,5707,15484,4146,12939,781,2536,2070,6618,2851,9154
310940,201901,6158,15707,4973,13940,279,1007,3593,9745,3872,10752
310945,201901,1194,3193,983,2885,106,365,587,1679,693,2044
310950,201901,1809,5483,1239,4211,237,901,425,1300,662,2201
310960,201901,713,1867,426,1336,59,201,149,478,208,679
310970,201901,1144,3459,800,2706,201,747,166,502,367,1249
310980,201901,329,784,219,613,25,74,139,372,164,446
310990,201901,1198,3520,933,2993,208,687,388,1202,596,1889
311000,201901,3960,11371,2952,9641,772,2703,1115,3479,1887,6182
311010,201901,748,2343,604,2019,242,871,166,533,408,1404
311020,201901,966,2569,655,1996,72,246,305,900,377,1146
311030,201901,1459,3855,991,3018,246,845,376,1025,622,1870
311040,201901,324,1032,257,867,71,245,73,228,144,473
311050,201901,2397,6316,1826,5450,408,1362,793,2255,1201,3617
311060,201901,2774,7484,1922,5756,306,1092,751,2022,1057,3114
311070,201901,1942,5217,1412,4337,193,735,670,1940,863,2675
311080,201901,971,2389,805,2108,58,231,580,1399,638,1630
311090,201901,2005,6583,1577,5795,385,1579,451,1624,836,3203
311100,201901,2016,5920,1260,4393,306,1199,187,585,493,1784
311110,201901,3584,7654,2032,5433,444,1279,744,1999,1188,3278
311115,201901,1252,3103,1022,2782,65,219,812,2151,877,2370
311120,201901,6330,17067,4739,14120,808,2749,1651,4385,2459,7134
311130,201901,1831,4944,1416,4349,135,553,767,2247,902,2800
311140,201901,1369,3409,1011,2893,85,288,625,1779,710,2067
311150,201901,1513,4862,1212,4288,188,761,639,2175,827,2936
311160,201901,3574,10651,2495,8642,687,2657,705,2384,1392,5041
311170,201901,837,2273,669,2029,42,133,418,1300,460,1433
311180,201901,1288,2980,822,2293,187,551,341,952,528,1503
311190,201901,996,2778,735,2258,114,409,305,859,419,1268
311200,201901,1731,4760,1220,3795,297,1020,339,939,636,1959
311205,201901,867,2688,713,2377,55,245,414,1330,469,1575
311210,201901,983,2969,868,2823,122,393,631,2096,753,2489
311220,201901,728,2096,603,1871,79,280,325,929,404,1209
311230,201901,7434,22828,5601,19175,1048,3782,1992,7039,3040,10821
311240,201901,955,2628,738,2319,178,617,362,1116,540,1733
311250,201901,859,2489,674,2161,157,528,302,935,459,1463
311260,201901,2352,5902,1512,4464,296,922,543,1522,839,2444
311265,201901,1221,3266,932,2790,64,225,651,1881,715,2106
311270,201901,2958,9051,2594,8457,207,939,1887,5831,2094,6770
311280,201901,1145,3078,542,1760,95,343,87,257,182,600
311290,201901,1859,5807,1716,5491,170,589,1177,3725,1347,4314
311300,201901,4511,13094,3780,11873,225,985,2924,8948,3149,9933
311310,201901,551,1601,466,1441,62,208,236,690,298,898
311320,201901,3071,9656,2615,8622,432,1615,1187,3633,1619,5248
311330,201901,4688,12929,3883,11609,451,1504,2158,6515,2609,8019
311340,201901,9816,28658,7801,24956,2353,8101,1937,6062,4290,14163
311350,201901,2162,5608,1545,4484,160,561,819,2124,979,2685
311360,201901,1063,2682,669,2051,208,710,188,545,396,1255
311370,201901,4301,10993,3203,9170,172,698,2009,5460,2181,6158
311380,201901,372,1156,299,1008,74,254,107,367,181,621
311390,201901,1665,5280,1334,4836,567,2362,352,1104,919,3466
311400,201901,1365,3942,982,3194,141,533,407,1183,548,1716
311410,201901,1571,4784,1307,4415,232,869,693,2372,925,3241
311420,201901,1523,4583,1038,3554,190,706,175,474,365,1180
311430,201901,3355,9236,2210,6924,429,1387,647,2044,1076,3431
311440,201901,2393,7002,1679,5733,372,1459,540,1801,912,3260
311450,201901,1694,5267,1265,4457,329,1297,301,910,630,2207
311455,201901,938,2215,652,1780,178,494,240,671,418,1165
311460,201901,478,1536,326,1226,70,339,95,318,165,657
311470,201901,424,1357,304,1062,75,313,55,172,130,485
311480,201901,1142,3205,988,2987,43,118,817,2509,860,2627
311490,201901,219,670,171,569,48,184,73,216,121,400
311500,201901,403,1060,297,887,31,105,180,530,211,635
311510,201901,2809,7681,1870,5966,343,1239,664,1960,1007,3199
311520,201901,563,1691,512,1585,106,374,277,820,383,1194
311530,201901,8407,20178,5301,15076,1322,4144,1360,3840,2682,7984
311535,201901,722,2000,497,1586,89,322,145,424,234,746
311540,201901,503,1601,439,1486,93,320,256,875,349,1195
311545,201901,1970,5672,1717,5329,95,378,1316,4006,1411,4384
311547,201901,1460,3818,1279,3535,45,144,935,2611,980,2755
311550,201901,2649,7624,2105,6587,324,1160,845,2525,1169,3685
311560,201901,275,624,190,506,29,84,103,245,132,329
311570,201901,1815,4306,1313,3599,58,171,1023,2864,1081,3035
311580,201901,2112,4007,1372,3149,153,314,901,2123,1054,2437
311590,201901,470,1333,377,1194,61,221,201,621,262,842
311600,201901,1666,3876,1399,3544,52,157,1199,2974,1251,3131
311610,201901,2328,7888,1959,7069,327,1219,952,3426,1279,4645
311615,201901,2906,8746,2407,7899,171,671,1801,5803,1972,6474
311620,201901,401,1108,344,1031,23,82,268,793,291,875
311630,201901,1335,3722,1077,3226,86,272,720,2076,806,2348
311640,201901,536,1566,421,1355,82,308,195,575,277,883
311650,201901,1868,4967,1576,4510,126,447,1082,2958,1208,3405
311660,201901,2663,7760,1951,6443,382,1374,443,1265,825,2639
311670,201901,1532,4064,1140,3396,187,629,499,1506,686,2135
311680,201901,2046,6027,1575,5198,295,987,906,2999,1201,3986
311690,201901,555,1225,430,1071,51,128,307,803,358,931
311700,201901,2210,5412,1731,4741,30,129,1446,3844,1476,3973
311710,201901,1471,4348,1004,3431,255,950,338,1146,593,2096
311720,201901,409,1264,329,1112,35,151,178,576,213,727
311730,201901,4030,10304,2569,7679,816,2679,405,1199,1221,3878
311740,201901,802,2328,695,2191,37,104,615,1968,652,2072
311750,201901,3827,11843,3098,10616,508,1884,1562,5137,2070,7021
311760,201901,593,1745,494,1564,93,374,209,549,302,923
311770,201901,1913,5704,1493,4915,288,1019,589,1830,877,2849
311780,201901,1222,3662,847,2880,171,671,226,659,397,1330
311783,201901,2144,6147,1777,5492,54,251,1431,4298,1485,4549
311787,201901,678,2012,492,1594,73,267,183,519,256,786
311790,201901,1413,3765,924,2920,223,776,315,966,538,1742
311800,201901,4639,14316,3782,12433,725,2637,648,1951,1373,4588
311810,201901,945,2960,744,2581,60,252,451,1542,511,1794
311820,201901,732,1916,561,1621,75,244,335,915,410,1159
311830,201901,7896,23377,5523,18194,1552,5470,644,2012,2196,7482
311840,201901,3130,8454,2666,7778,281,893,1920,5535,2201,6428
311850,201901,307,865,252,770,20,64,157,472,177,536
311860,201901,53869,140653,41574,119865,6651,20432,22865,63931,29516,84363
311870,201901,1860,5083,1243,3970,211,744,456,1302,667,2046
311880,201901,6101,16344,5189,15069,340,938,3952,11585,4292,12523
311890,201901,1519,3895,1191,3415,111,367,791,2183,902,2550
311900,201901,698,1859,533,1626,59,208,354,1048,413,1256
311910,201901,4097,10723,3092,9408,589,1791,1599,4986,2188,6777
311920,201901,1944,5544,1562,4931,146,458,938,2991,1084,3449
311930,201901,3123,7861,2394,6817,873,2671,713,1900,1586,4571
311940,201901,13562,37110,10124,30555,1504,5008,4647,13194,6151,18202
311950,201901,2109,6009,1586,5091,97,436,1068,3331,1165,3767
311960,201901,551,1364,449,1205,31,143,292,653,323,796
311970,201901,435,1428,293,1071,58,239,66,216,124,455
311980,201901,414,1169,224,766,33,125,61,208,94,333
311990,201901,526,1299,351,1053,77,268,155,436,232,704
311995,201901,966,2733,518,1701,21,71,56,126,77,197
312000,201901,572,1541,471,1391,33,114,336,995,369,1109
312010,201901,865,2469,662,2117,64,235,396,1224,460,1459
312015,201901,1298,3966,1159,3716,70,308,882,2725,952,3033
312020,201901,1127,3538,920,3146,230,827,325,1082,555,1909
312030,201901,1997,5029,1758,4753,31,139,1617,4320,1648,4459
312040,201901,773,2502,589,2076,67,256,250,852,317,1108
312050,201901,1215,3948,948,3386,220,919,248,774,468,1693
312060,201901,830,2127,553,1761,136,446,251,795,387,1241
312070,201901,860,2547,609,2045,70,271,311,1003,381,1274
312080,201901,2688,6777,2006,5749,141,465,1263,3435,1404,3900
312083,201901,866,2354,657,2021,70,242,416,1232,486,1474
312087,201901,2257,6178,1887,5621,67,242,1469,4370,1536,4612
312090,201901,9129,25119,6998,21600,1300,4342,3183,9712,4483,14054
312100,201901,1552,4687,1141,3937,143,615,518,1700,661,2315
312110,201901,975,3132,821,2816,226,867,240,728,466,1595
312120,201901,695,1977,501,1638,152,582,154,415,306,997
312125,201901,1553,4244,1313,3878,136,435,927,2655,1063,3090
312130,201901,893,2252,658,1860,60,193,269,716,329,909
312140,201901,741,2238,613,1968,129,444,252,743,381,1187
312150,201901,448,1284,382,1140,12,55,275,757,287,812
312160,201901,7665,22442,5931,19286,904,3366,2604,7975,3508,11341
312170,201901,833,2312,663,2005,42,147,449,1315,491,1462
312180,201901,1335,3719,1067,3192,157,500,549,1568,706,2068
312190,201901,548,1643,389,1319,82,294,79,258,161,552
312200,201901,4563,12612,3699,11097,734,2285,1936,5771,2670,8056
312210,201901,1332,3160,954,2604,55,196,662,1747,717,1943
312220,201901,1828,5737,1573,5253,120,444,969,3226,1089,3670
312230,201901,11342,30676,7496,23529,2099,7213,1237,3472,3336,10685
312235,201901,1735,4726,1418,4247,107,391,1008,2948,1115,3339
312240,201901,650,2129,483,1777,104,400,143,515,247,915
312245,201901,2481,6675,2068,6049,77,275,1670,4846,1747,5121
312247,201901,874,2247,615,1853,128,407,303,913,431,1320
312250,201901,934,2464,604,1824,103,317,237,709,340,1026
312260,201901,890,2549,721,2275,53,213,510,1557,563,1770
312270,201901,689,1919,531,1612,29,122,289,798,318,920
312280,201901,414,1232,316,1051,103,353,38,118,141,471
312290,201901,714,2210,581,1945,126,468,185,592,311,1060
312300,201901,886,2666,619,2056,169,609,109,287,278,896
312310,201901,735,2469,625,2255,100,412,276,967,376,1379
312320,201901,1736,4631,1274,3820,374,1195,231,641,605,1836
312330,201901,847,2530,685,2209,70,241,463,1450,533,1691
312340,201901,241,650,180,553,44,159,65,175,109,334
312350,201901,271,576,208,509,24,69,140,325,164,394
312352,201901,1599,4788,1404,4446,113,384,884,2946,997,3330
312360,201901,2445,7335,1800,5987,389,1391,453,1447,842,2838
312370,201901,1679,4701,1404,4217,253,866,695,1986,948,2852
312380,201901,2160,5020,1803,4568,16,43,1619,4080,1635,4123
312385,201901,1273,3602,991,3072,151,542,481,1396,632,1938
312390,201901,1854,5548,1405,4698,230,848,484,1481,714,2329
312400,201901,2746,8291,2213,7273,733,2528,647,2169,1380,4697
312410,201901,11219,32261,9225,28776,1816,5924,4610,14189,6426,20113
312420,201901,3557,10202,3034,9283,568,1858,1589,4761,2157,6619
312430,201901,7895,21221,6316,18434,577,1876,4177,11970,4754,13846
312440,201901,888,2892,683,2403,357,1310,62,188,419,1498
312450,201901,1139,3453,866,2941,250,904,289,1007,539,1911
312460,201901,422,1111,285,898,38,146,162,519,200,665
312470,201901,475,1189,307,902,54,201,113,275,167,476
312480,201901,1142,2902,790,2399,115,370,413,1214,528,1584
312490,201901,2015,5010,1533,4279,225,637,780,2114,1005,2751
312500,201901,849,2185,680,1939,55,193,443,1231,498,1424
312510,201901,3486,9595,2643,8000,672,1994,854,2585,1526,4579
312520,201901,153,483,136,451,40,129,62,205,102,334
312530,201901,556,1453,479,1357,20,69,421,1190,441,1259
312540,201901,1451,4287,955,3196,179,649,440,1440,619,2089
312550,201901,745,2042,545,1605,38,119,356,973,394,1092
312560,201901,1918,5013,1572,4505,75,268,1236,3532,1311,3800
312570,201901,2105,5544,1639,4923,513,1626,594,1812,1107,3438
312580,201901,573,1686,432,1378,60,218,191,571,251,789
312590,201901,1600,4840,1302,4256,133,554,732,2240,865,2794
312595,201901,1557,4935,1403,4662,297,942,822,2870,1119,3812
312600,201901,947,2357,520,1685,77,294,189,611,266,905
312610,201901,6268,16393,3991,12107,615,2081,1273,3621,1888,5702
312620,201901,2447,6369,1783,5452,60,274,1395,4316,1455,4590
312630,201901,264,841,199,713,39,166,78,273,117,439
312640,201901,570,1561,376,1232,51,176,127,429,178,605
312650,201901,2050,5443,1400,4176,87,288,935,2644,1022,2932
312660,201901,1315,3253,998,2763,95,329,671,1761,766,2090
312670,201901,4884,13411,4001,12013,249,1067,2782,7957,3031,9024
312675,201901,1207,3383,980,3014,66,275,758,2261,824,2536
312680,201901,1352,3892,1132,3570,68,299,889,2718,957,3017
312690,201901,2368,5599,1869,4965,104,327,1491,3859,1595,4186
312695,201901,929,2749,793,2504,58,178,604,1920,662,2098
312700,201901,2026,5479,1476,4482,151,515,836,2443,987,2958
312705,201901,1296,3379,1081,3040,23,94,914,2521,937,2615
312707,201901,1365,4128,1064,3564,79,398,651,2037,730,2435
312710,201901,6121,14197,3595,10306,1039,3249,934,2764,1973,6013
312720,201901,1018,2904,752,2453,94,342,407,1273,501,1615
312730,201901,1610,3915,1190,3343,95,313,723,1965,818,2278
312733,201901,1438,3824,1091,3187,39,139,718,2009,757,2148
312735,201901,640,1763,547,1587,72,250,366,957,438,1207
312737,201901,812,1928,548,1532,83,268,293,743,376,1011
312738,201901,568,1540,403,1239,64,232,183,511,247,743
312740,201901,411,1037,231,726,60,198,55,138,115,336
312750,201901,1311,4230,1062,3741,177,703,440,1469,617,2172
312760,201901,1798,5487,1311,4488,252,923,430,1415,682,2338
312770,201901,42018,103000,26339,76534,6111,18807,8066,23130,14177,41937
312780,201901,2400,7525,2031,6878,225,877,1324,4455,1549,5332
312790,201901,257,645,159,511,13,61,52,137,65,198
312800,201901,4722,13934,3694,11898,769,2705,1514,4736,2283,7441
312810,201901,1666,4562,1093,3580,276,1014,340,988,616,2002
312820,201901,1752,4856,1449,4288,59,222,1032,2969,1091,3191
312825,201901,1320,3197,1131,2943,27,97,956,2452,983,2549
312830,201901,2179,6379,1415,4888,343,1317,337,1139,680,2456
312840,201901,1119,3354,879,2892,139,557,367,1113,506,1670
312850,201901,832,2128,591,1751,53,218,319,850,372,1068
312860,201901,1291,3328,853,2632,233,762,224,674,457,1436
312870,201901,6236,17421,3788,12446,626,2280,894,2759,1520,5039
312880,201901,1377,3589,1095,3137,50,186,609,1749,659,1935
312890,201901,1967,5243,1350,4135,165,529,570,1767,735,2296
312900,201901,1162,3116,934,2817,82,267,558,1771,640,2038
312910,201901,1468,2747,800,1874,133,295,378,886,511,1181
312920,201901,990,2747,691,2246,154,587,294,874,448,1461
312930,201901,2086,5517,1680,4902,369,1114,716,2077,1085,3191
312940,201901,881,2535,700,2244,97,347,339,1076,436,1423
312950,201901,3041,7757,1978,5981,515,1678,658,1919,1173,3597
312960,201901,1868,4987,1567,4546,110,314,1168,3475,1278,3789
312965,201901,1629,4848,1396,4417,132,427,894,2810,1026,3237
312970,201901,1067,3127,831,2730,175,681,378,1130,553,1811
312980,201901,21484,61991,17739,55121,2982,10422,9400,27698,12382,38120
312990,201901,436,1172,268,882,59,229,112,348,171,577
313000,201901,414,1238,326,1083,41,178,174,541,215,719
313005,201901,2539,7432,2173,6812,141,490,1593,4876,1734,5366
313010,201901,4549,13165,3724,11755,672,2396,2174,6630,2846,9026
313020,201901,888,2755,589,2070,97,366,95,280,192,646
313030,201901,1168,2870,777,2254,92,340,455,1240,547,1580
313040,201901,758,2414,615,2088,57,244,335,1065,392,1309
313050,201901,1696,4932,1207,4202,226,935,349,1073,575,2008
313055,201901,1772,5057,1608,4804,47,154,1372,4082,1419,4236
313060,201901,921,2385,624,1895,213,729,132,340,345,1069
313065,201901,1625,5127,1444,4822,84,372,1066,3451,1150,3823
313070,201901,941,2505,708,2078,82,262,408,1173,490,1435
313080,201901,362,1011,261,816,71,250,78,196,149,446
313090,201901,4563,12881,3916,11731,637,2092,2289,6714,2926,8806
313100,201901,1399,3714,1067,3221,56,210,764,2272,820,2482
313110,201901,1472,3990,1040,3203,96,364,569,1614,665,1978
313115,201901,2398,7292,2032,6594,310,1122,1018,3080,1328,4202
313120,201901,3626,8769,2699,7533,296,914,1656,4584,1952,5498
313130,201901,27137,73836,21292,62707,2903,9659,11281,31396,14184,41055
313140,201901,557,1283,347,967,26,87,231,626,257,713
313150,201901,1341,3883,982,3174,278,956,265,808,543,1764
313160,201901,941,2473,724,2105,51,181,505,1411,556,1592
313170,201901,11019,32938,7834,26713,1453,5269,2844,9194,4297,14463
313180,201901,2170,5910,1522,4589,201,670,800,2334,1001,3004
313190,201901,4150,12225,3060,9983,580,2002,1046,3170,1626,5172
313200,201901,1059,3060,919,2811,26,110,767,2259,793,2369
313210,201901,3746,11218,3076,9986,417,1462,1772,5595,2189,7057
313220,201901,1704,4592,1147,3544,190,674,417,1134,607,1808
313230,201901,2915,8275,2472,7735,82,269,2063,6518,2145,6787
313240,201901,8570,21964,5358,16680,1007,3589,2191,6304,3198,9893
313250,201901,5661,17117,4543,15003,608,2141,2371,7725,2979,9866
313260,201901,593,1584,412,1239,50,176,197,558,247,734
313270,201901,5390,14906,4331,13215,687,2199,2596,7969,3283,10168
313280,201901,419,1211,281,921,39,133,110,357,149,490
313290,201901,803,2626,630,2354,225,907,181,660,406,1567
313300,201901,1534,4434,1132,3676,330,1136,203,585,533,1721
313310,201901,1006,3086,805,2643,142,542,200,544,342,1086
313320,201901,2102,5662,1468,4636,299,1067,635,2004,934,3071
313330,201901,3918,10881,3038,9493,216,931,1976,5952,2192,6883
313340,201901,1270,2954,901,2424,107,290,613,1645,720,1935
313350,201901,2115,6084,1451,4691,220,817,559,1656,779,2473
313360,201901,1242,3206,861,2581,152,530,436,1230,588,1760
313370,201901,1282,3811,1128,3515,144,535,652,1891,796,2426
313375,201901,1637,4328,1033,3247,200,725,238,713,438,1438
313380,201901,5534,14467,3914,11468,817,2580,1634,4362,2451,6942
313390,201901,856,2828,762,2671,62,289,495,1649,557,1938
313400,201901,3540,9233,2822,8267,183,587,2167,6195,2350,6782
313410,201901,1231,3307,954,2838,74,251,684,2002,758,2253
313420,201901,14551,33191,7388,21023,1624,5071,979,2878,2603,7949
313430,201901,841,2501,635,2092,112,429,259,777,371,1206
313440,201901,5664,12545,3713,9981,320,933,2400,6439,2720,7372
313450,201901,608,1746,442,1417,95,338,141,395,236,733
313460,201901,2090,6255,1685,5606,354,1372,781,2445,1135,3817
313470,201901,2963,7525,2364,6678,208,577,1642,4669,1850,5246
313480,201901,864,2527,491,1682,85,317,116,349,201,666
313490,201901,1523,3575,725,2335,246,924,61,197,307,1121
313500,201901,395,1202,309,1001,39,135,119,358,158,493
313505,201901,9394,25587,8033,23788,305,1132,6642,19537,6947,20669
313507,201901,1451,3812,1200,3441,33,135,978,2767,1011,2902
313510,201901,12150,34333,10029,30453,1287,4205,5184,15325,6471,19530
313520,201901,13151,38714,10790,34534,774,2910,7698,24190,8472,27100
313530,201901,514,1492,407,1296,24,94,203,611,227,705
313535,201901,2304,6438,2012,5890,143,410,1438,4163,1581,4573
313540,201901,779,2429,594,1960,115,380,223,708,338,1088
313545,201901,1152,3930,986,3592,171,668,534,1869,705,2537
313550,201901,1662,5142,1431,4663,361,1305,661,2041,1022,3346
313560,201901,2521,5142,1872,4351,72,160,1592,3673,1664,3833
313570,201901,941,2910,765,2578,185,670,306,996,491,1666
313580,201901,5363,14597,4104,12485,578,1875,2237,6951,2815,8826
313590,201901,938,2713,719,2392,237,858,269,909,506,1767
313600,201901,3690,10341,3102,9399,117,473,2538,7553,2655,8026
313610,201901,953,2521,770,2188,103,293,474,1313,577,1606
313620,201901,5410,14712,4294,12783,722,2361,2228,6425,2950,8786
313630,201901,8002,20335,5538,16555,701,2409,3009,8882,3710,11291
313640,201901,957,2347,606,1865,172,576,203,612,375,1188
313650,201901,1757,5375,1454,4869,104,409,960,3234,1064,3643
313652,201901,759,2534,690,2375,123,474,413,1369,536,1843
313655,201901,1072,2936,864,2643,58,209,654,1980,712,2189
313657,201901,1235,3364,960,2904,49,203,695,1999,744,2202
313660,201901,835,2431,680,2135,103,391,361,1035,464,1426
313665,201901,4419,12266,3424,10509,515,1796,1901,5577,2416,7373
313670,201901,43240,110595,28039,84233,4947,16298,11296,32190,16243,48488
313680,201901,978,2686,824,2442,62,205,537,1533,599,1738
313690,201901,803,2646,641,2316,144,549,207,722,351,1271
313695,201901,1676,4757,1297,4139,95,344,883,2797,978,3141
313700,201901,3004,9945,2631,9448,254,969,2016,7241,2270,8210
313710,201901,1328,3259,958,2719,89,266,641,1811,730,2077
313720,201901,5108,14399,3744,11715,594,2092,1606,4636,2200,6728
313730,201901,1260,3013,965,2618,79,197,637,1691,716,1888
313740,201901,1638,5863,1327,5063,345,1492,204,661,549,2153
313750,201901,1858,5234,1447,4418,310,1044,569,1613,879,2657
313753,201901,2104,5104,1408,4002,158,497,806,2196,964,2693
313760,201901,4889,13873,3634,11408,837,2815,1379,4128,2216,6943
313770,201901,3592,10377,2883,9277,213,769,2026,6559,2239,7328
313780,201901,3959,10851,2926,9083,313,1133,820,2581,1133,3714
313790,201901,470,1494,413,1385,57,212,225,714,282,926
313800,201901,1300,3134,981,2648,127,389,554,1404,681,1793
313810,201901,1556,4141,1238,3684,87,325,895,2623,982,2948
313820,201901,13794,33577,9195,25433,1517,4589,3354,8946,4871,13535
313830,201901,341,991,265,847,59,201,112,326,171,527
313835,201901,897,2751,729,2423,86,337,342,1073,428,1410
313840,201901,6254,16856,4490,13802,1169,3814,974,3049,2143,6863
313850,201901,917,2314,738,2053,121,417,389,959,510,1376
313860,201901,2531,7090,1867,5764,312,1068,712,2043,1024,3111
313862,201901,1506,3373,770,2236,71,222,393,1082,464,1304
313865,201901,2224,6216,1918,5726,128,398,1463,4297,1591,4695
313867,201901,1085,3485,915,3154,268,980,443,1500,711,2480
313868,201901,1639,5139,1387,4659,77,361,1041,3378,1118,3739
313870,201901,758,2107,564,1768,114,386,189,536,303,922
313880,201901,1411,3823,1032,3191,193,660,443,1233,636,1893
313890,201901,1927,4469,1408,3798,97,296,955,2570,1052,2866
313900,201901,3565,10981,2692,9231,756,2857,665,2164,1421,5021
313910,201901,583,1793,426,1490,102,382,86,295,188,677
313920,201901,2829,9156,2374,8202,511,1735,1159,4059,1670,5794
313925,201901,1558,4100,1250,3528,227,610,744,2110,971,2720
313930,201901,4805,14691,3916,13103,352,1354,2560,8434,2912,9788
313940,201901,7866,23678,5669,19761,1116,4543,1361,5168,2477,9711
313950,201901,4683,10926,3410,9261,473,1649,2080,5468,2553,7117
313960,201901,5198,13238,3565,10455,782,2556,1198,3242,1980,5798
313970,201901,1302,3760,1150,3494,34,132,730,2210,764,2342
313980,201901,1298,3471,836,2708,124,467,302,935,426,1402
313990,201901,1707,5720,1261,4660,349,1434,366,1205,715,2639
314000,201901,9163,24908,7761,22507,512,1945,5326,15155,5838,17100
314010,201901,1306,3308,1055,2958,36,136,812,2208,848,2344
314015,201901,2015,5672,1546,4927,220,846,796,2441,1016,3287
314020,201901,485,1347,291,965,58,239,51,175,109,414
314030,201901,748,2241,591,1928,77,261,296,944,373,1205
314040,201901,641,1749,518,1517,98,318,252,700,350,1018
314050,201901,1624,4459,1176,3608,167,609,587,1658,754,2267
314053,201901,1728,5249,1399,4613,241,768,745,2572,986,3340
314055,201901,2261,6257,1943,5789,53,212,1578,4709,1631,4921
314060,201901,1185,3235,899,2774,43,161,614,1870,657,2031
314070,201901,4342,12314,3412,10603,765,2445,1402,4252,2167,6697
314080,201901,2101,5694,1340,4254,213,819,464,1270,677,2089
314085,201901,1996,6068,1657,5545,340,1183,814,2761,1154,3944
314090,201901,3913,11425,3331,10505,239,963,2207,6895,2446,7858
314100,201901,3098,7441,2437,6537,75,198,1904,5134,1979,5332
314110,201901,4124,12228,3425,10845,468,1683,1820,5417,2288,7100
314120,201901,734,1710,321,988,82,298,56,173,138,471
314130,201901,673,1831,379,1235,40,160,183,579,223,739
314140,201901,4490,13176,3462,11136,576,2000,1574,4947,2150,6947
314150,201901,1407,3661,1058,3055,94,304,700,1929,794,2233
314160,201901,2188,5976,1588,4901,252,827,645,2027,897,2854
314170,201901,980,2802,792,2425,72,256,482,1376,554,1632
314180,201901,5235,15094,4323,13597,414,1467,2520,7901,2934,9368
314190,201901,593,1556,424,1301,91,321,182,500,273,821
314200,201901,2810,8153,2317,7289,134,547,1645,4980,1779,5527
314210,201901,1913,5143,1538,4476,142,449,855,2439,997,2888
314220,201901,1238,3536,877,2885,215,818,289,873,504,1691
314225,201901,1108,3228,947,2978,76,248,689,2167,765,2415
314230,201901,754,2011,624,1849,88,287,375,1150,463,1437
314240,201901,1025,2819,802,2500,189,629,310,977,499,1606
314250,201901,508,1440,322,1055,48,167,121,362,169,529
314260,201901,904,2706,734,2433,165,622,350,1088,515,1710
314270,201901,3114,9059,2558,8183,102,398,1897,5997,1999,6395
314280,201901,3178,7518,2023,5689,299,926,901,2403,1200,3329
314290,201901,4349,11532,3633,10292,379,1082,2430,6794,2809,7876
314300,201901,1631,4878,1139,3783,268,974,343,1102,611,2076
314310,201901,4360,11807,3055,9531,951,3173,589,1734,1540,4907
314315,201901,879,3170,760,2908,65,313,521,1921,586,2234
314320,201901,2626,7282,1727,5630,365,1253,636,2063,1001,3316
314330,201901,45376,128875,34453,110078,10127,33759,7764,25719,17891,59478
314340,201901,2219,5627,1217,3757,275,1004,268,654,543,1658
314345,201901,1355,4166,1133,3764,160,557,672,2195,832,2752
314350,201901,886,2502,599,1983,127,460,158,485,285,945
314360,201901,556,1646,344,1190,62,239,95,309,157,548
314370,201901,674,1890,531,1656,27,121,393,1174,420,1295
314380,201901,1089,3139,754,2489,191,723,135,437,326,1160
314390,201901,11533,30867,7514,23254,1632,5393,2054,5700,3686,11093
314400,201901,3941,11851,3083,10293,834,2893,1116,3846,1950,6739
314410,201901,2650,7533,1815,5911,285,1051,642,2185,927,3236
314420,201901,773,1925,588,1676,20,102,434,1170,454,1272
314430,201901,6685,17478,4788,14122,853,2639,1948,5548,2801,8187
314435,201901,1456,4155,1197,3714,45,188,905,2747,950,2935
314437,201901,922,2419,643,1948,48,177,325,966,373,1143
314440,201901,568,1664,413,1358,113,410,92,261,205,671
314450,201901,1286,3548,1070,3208,114,407,654,1879,768,2286
314460,201901,3277,10209,2356,8188,606,2239,409,1385,1015,3624
314465,201901,2186,6454,1904,5899,59,263,1456,4329,1515,4592
314467,201901,809,2276,697,2080,24,79,561,1642,585,1721
314470,201901,2168,6399,1745,5510,318,1128,767,2255,1085,3383
314480,201901,5735,17211,4129,13697,761,2744,1189,3591,1950,6335
314490,201901,934,2628,699,2139,79,278,410,1209,489,1487
314500,201901,1584,4064,1149,3374,218,663,469,1352,687,2015
314505,201901,1906,4860,1586,4414,98,308,1165,3170,1263,3478
314510,201901,1744,4678,1195,3833,254,893,514,1617,768,2510
314520,201901,4027,12756,2835,10045,553,2146,343,1078,896,3224
314530,201901,5373,17907,4835,16846,451,1836,3376,11567,3827,13403
314535,201901,2538,6760,2077,6074,128,496,1570,4507,1698,5003
314537,201901,1088,3178,840,2751,61,240,585,1867,646,2107
314540,201901,413,1086,289,853,25,96,149,413,174,509
314545,201901,1695,4380,1505,4133,42,110,1273,3629,1315,3739
314550,201901,628,1580,467,1348,35,141,250,638,285,779
314560,201901,3824,12013,2943,10087,506,1862,926,2998,1432,4860
314570,201901,290,818,224,698,30,104,104,327,134,431
314580,201901,430,1326,330,1130,86,301,77,279,163,580
314585,201901,648,2087,499,1737,69,296,242,779,311,1075
314587,201901,1967,5550,1501,4801,213,612,826,2711,1039,3323
314590,201901,3252,9319,2298,7446,371,1349,856,2597,1227,3946
314600,201901,1790,5094,1051,3614,222,826,111,350,333,1176
314610,201901,8273,22007,5837,18395,1195,4384,2356,7205,3551,11589
314620,201901,2018,5011,1574,4422,69,253,1261,3453,1330,3706
314625,201901,1476,4338,1263,4035,65,345,1015,3139,1080,3484
314630,201901,4987,13378,4144,12173,121,499,3442,10087,3563,10586
314640,201901,620,1546,436,1236,78,251,211,543,289,794
314650,201901,856,2108,539,1603,47,165,257,686,304,851
314655,201901,1530,4355,1106,3568,224,731,495,1576,719,2307
314660,201901,321,772,204,546,8,14,122,308,130,322
314670,201901,1629,3824,1151,3139,41,151,720,1942,761,2093
314675,201901,1694,4662,1453,4246,103,385,1104,3116,1207,3501
314690,201901,2017,5910,1550,5170,480,1729,422,1421,902,3150
314700,201901,9554,27925,6117,20908,1325,4997,1531,5080,2856,10077
314710,201901,7285,20869,5230,16610,1162,4037,1224,3459,2386,7496
314720,201901,2045,6231,1442,4985,327,1240,345,1171,672,2411
314730,201901,1980,5640,1442,4580,377,1248,351,1085,728,2333
314740,201901,2695,7752,2136,6760,281,1009,1109,3429,1390,4438
314750,201901,317,894,248,758,24,94,130,361,154,455
314760,201901,1816,5670,1227,4301,181,733,301,874,482,1607
314770,201901,1057,3176,533,1770,48,164,133,396,181,560
314780,201901,337,816,220,646,42,139,117,315,159,454
314790,201901,9293,25789,6450,20653,1724,6259,1736,5134,3460,11393
314795,201901,1399,3842,1197,3503,42,181,933,2615,975,2796
314800,201901,10447,27113,6096,18893,1234,4162,1179,3282,2413,7444
314810,201901,8193,22628,6038,18866,1716,5659,1768,5597,3484,11256
314820,201901,927,2425,716,2083,63,252,455,1262,518,1514
314830,201901,1430,4500,1210,4048,276,993,553,1828,829,2821
314840,201901,863,2832,672,2515,67,357,457,1623,524,1980
314850,201901,1827,4669,1496,4194,51,186,1287,3583,1338,3769
314860,201901,3057,9490,2570,8530,372,1404,1560,5004,1932,6408
314870,201901,6005,16159,4657,14302,348,1205,3373,10373,3721,11578
314875,201901,1697,5216,1515,4973,112,328,1234,4095,1346,4423
314880,201901,872,2155,687,1894,31,86,469,1346,500,1432
314890,201901,394,1158,289,926,48,174,110,320,158,494
314900,201901,617,1691,471,1433,108,349,179,544,287,893
314910,201901,1601,4739,1216,4113,258,1015,584,1848,842,2863
314915,201901,2184,6643,1855,6059,128,482,1266,4032,1394,4514
314920,201901,447,1161,289,921,11,42,196,620,207,662
314930,201901,4952,14711,3787,12487,787,2838,1334,4185,2121,7023
314940,201901,399,1058,338,948,36,97,205,535,241,632
314950,201901,437,1157,280,903,28,126,120,339,148,465
314960,201901,771,2001,609,1705,45,147,421,1110,466,1257
314970,201901,726,2138,584,1879,103,379,285,857,388,1236
314980,201901,1223,3335,892,2821,257,914,262,805,519,1719
314990,201901,2176,6447,1483,4837,324,1174,313,894,637,2068
314995,201901,1584,4576,1267,4008,77,327,792,2376,869,2703
315000,201901,1068,2865,770,2390,78,264,487,1458,565,1722
315010,201901,376,1070,273,875,48,188,119,343,167,531
315015,201901,2088,6160,1867,5816,193,678,1228,3802,1421,4480
315020,201901,751,2299,565,1898,68,268,249,766,317,1034
315030,201901,562,1583,369,1204,95,323,78,236,173,559
315040,201901,798,2372,688,2108,96,316,434,1331,530,1647
315050,201901,1100,2932,836,2540,72,281,458,1361,530,1642
315053,201901,1100,2965,854,2525,66,222,500,1428,566,1650
315057,201901,1575,5094,1366,4673,171,588,873,3031,1044,3619
315060,201901,568,1785,407,1445,82,303,92,325,174,628
315070,201901,554,1500,393,1207,105,358,101,276,206,634
315080,201901,2533,7779,1991,6654,388,1325,977,3227,1365,4552
315090,201901,767,2412,574,2027,107,403,195,647,302,1050
315100,201901,1096,3438,705,2485,134,545,284,893,418,1438
315110,201901,1531,4030,1170,3434,148,445,563,1665,711,2110
315120,201901,11434,27448,8202,22601,1105,2988,4218,12104,5323,15092
315130,201901,1270,3769,1019,3277,160,603,392,1181,552,1784
315140,201901,2733,7798,2099,6635,421,1508,1003,2937,1424,4445
315150,201901,4098,10341,2886,8323,441,1422,1296,3633,1737,5055
315160,201901,1503,3834,973,2957,210,645,407,1212,617,1857
315170,201901,1375,4425,934,3350,237,875,170,610,407,1485
315180,201901,15847,39959,8253,25302,1245,4416,2263,6079,3508,10495
315190,201901,2014,4681,1601,4129,211,565,1176,3006,1387,3571
315200,201901,3556,10578,2589,8794,791,2883,602,2002,1393,4885
315210,201901,7761,20875,5540,16125,700,2256,2543,6708,3243,8964
315213,201901,1105,2982,951,2766,29,89,754,2172,783,2261
315217,201901,2466,7790,1975,6916,109,539,1324,4477,1433,5016
315220,201901,7769,21796,6255,19183,1612,5233,2313,7051,3925,12284
315230,201901,3072,7421,2631,6882,63,165,2288,6127,2351,6292
315240,201901,2303,7086,1992,6516,508,1781,1009,3221,1517,5002
315250,201901,10269,29053,7567,24022,1323,4583,3210,9855,4533,14438
315260,201901,940,2744,514,1736,90,301,39,112,129,413
315270,201901,768,2300,524,1819,79,324,156,456,235,780
315280,201901,2745,6983,1582,4789,369,1212,245,723,614,1935
315290,201901,1155,2952,691,2213,202,703,184,600,386,1303
315300,201901,685,1678,439,1328,151,501,135,413,286,914
315310,201901,1280,3709,954,3078,86,314,535,1625,621,1939
315320,201901,677,1993,468,1590,60,266,204,634,264,900
315330,201901,738,2599,416,1690,77,340,116,418,193,758
315340,201901,3048,7681,2268,6561,141,468,1500,4312,1641,4780
315350,201901,1461,4072,1103,3468,173,608,564,1730,737,2338
315360,201901,1626,5039,1179,4037,188,680,448,1458,636,2138
315370,201901,431,1288,342,1095,69,215,143,449,212,664
315380,201901,181,565,142,477,39,149,22,52,61,201
315390,201901,1140,3400,868,2868,172,635,326,1004,498,1639
315400,201901,3954,11268,3114,9714,459,1512,1573,4740,2032,6252
315410,201901,2236,5244,1758,4560,428,1197,457,1184,885,2381
315415,201901,1171,3350,937,2980,219,826,388,1213,607,2039
315420,201901,1093,3209,714,2469,144,517,89,288,233,805
315430,201901,3475,8703,2440,7099,486,1677,963,2576,1449,4253
315440,201901,960,2629,777,2313,92,333,423,1165,515,1498
315445,201901,1990,4885,1426,4059,120,387,992,2785,1112,3172
315450,201901,2152,6259,1793,5684,246,752,1128,3617,1374,4369
315460,201901,31253,91568,25943,81888,5820,20043,11319,33795,17139,53838
315470,201901,435,1250,352,1109,39,142,193,577,232,719
315480,201901,1266,3719,869,2864,177,604,263,837,440,1441
315490,201901,2915,7306,1973,5880,268,841,738,2174,1006,3015
315500,201901,487,1352,295,924,34,138,130,345,164,483
315510,201901,1237,3429,1062,3156,28,139,905,2613,933,2752
315520,201901,1057,2964,826,2575,52,198,593,1795,645,1993
315530,201901,603,1817,466,1543,174,618,166,523,340,1141
315540,201901,1291,3597,881,2805,114,448,371,1130,485,1578
315550,201901,1786,4816,1213,3839,272,983,342,1025,614,2008
315560,201901,6107,19335,5283,17809,350,1203,3506,11917,3856,13120
315570,201901,1813,5243,1524,4730,105,444,887,2633,992,3077
315580,201901,2196,5627,1677,4793,356,1144,565,1591,921,2735
315590,201901,886,2403,708,2118,99,359,340,948,439,1307
315600,201901,2349,7775,1737,6568,272,1031,936,3643,1208,4674
315610,201901,885,2299,683,1915,129,435,297,712,426,1147
315620,201901,304,996,278,958,45,159,168,602,213,761
315630,201901,841,2376,676,2090,158,542,233,647,391,1189
315640,201901,324,866,269,792,31,111,167,464,198,575
315645,201901,932,2458,620,1928,152,519,162,471,314,990
315650,201901,1675,4377,1341,3889,47,200,1083,3031,1130,3231
315660,201901,2439,6024,1839,4994,121,346,1283,3363,1404,3709
315670,201901,12960,37082,10084,31830,2154,7167,4359,13332,6513,20499
315680,201901,2962,9129,2193,7624,384,1475,971,3272,1355,4747
315690,201901,2411,6457,1593,4974,369,1184,483,1659,852,2843
315700,201901,7345,21208,5606,17717,990,3317,2461,7487,3451,10804
315710,201901,1824,4704,1315,3902,68,302,893,2497,961,2799
315720,201901,4172,12115,3537,10948,200,913,2472,7309,2672,8222
315725,201901,1790,5145,1400,4391,161,505,925,2944,1086,3449
315727,201901,526,1423,394,1195,58,204,165,470,223,674
315730,201901,618,1905,545,1761,63,232,246,755,309,987
315733,201901,1383,3609,953,2832,149,539,360,1000,509,1539
315737,201901,1073,3184,864,2783,48,201,607,1898,655,2099
315740,201901,909,2612,714,2214,124,442,373,1054,497,1496
315750,201901,1205,3324,975,2943,86,277,616,1869,702,2146
315760,201901,1185,2859,1088,2743,47,120,945,2372,992,2492
315765,201901,1825,4977,1504,4565,40,147,1302,3939,1342,4086
315770,201901,972,3010,825,2810,315,1163,259,819,574,1982
315780,201901,26837,76854,22611,69213,2001,7445,14213,41475,16214,48920
315790,201901,3500,11019,3009,10092,209,743,2000,6854,2209,7597
315800,201901,1174,4411,847,3485,167,771,189,712,356,1483
315810,201901,1306,3271,1100,2965,53,198,868,2200,921,2398
315820,201901,2474,7149,2027,6449,218,781,1367,4268,1585,5049
315830,201901,1030,3051,759,2548,63,262,344,1093,407,1355
315840,201901,795,1991,498,1435,60,206,227,592,287,798
315850,201901,1081,3325,886,2983,179,659,438,1390,617,2049
315860,201901,479,1462,339,1196,77,309,93,303,170,612
315870,201901,453,1203,358,1064,32,116,240,668,272,784
315880,201901,1085,2842,731,2236,61,241,217,608,278,849
315890,201901,1524,4593,1215,4132,334,1223,558,1837,892,3060
315895,201901,5760,16046,4463,13484,529,1837,2247,6326,2776,8163
315900,201901,829,2187,720,2036,55,177,543,1480,598,1657
315910,201901,504,1509,420,1363,69,247,267,841,336,1088
315920,201901,1560,4104,823,2562,147,495,232,669,379,1164
315930,201901,1029,2432,685,1909,129,366,296,820,425,1186
315935,201901,774,2419,635,2151,126,453,211,728,337,1181
315940,201901,594,1740,484,1547,57,189,248,781,305,970
315950,201901,1149,3244,978,2962,106,307,742,2271,848,2578
315960,201901,3798,11003,2206,7733,729,2958,147,315,876,3273
315970,201901,626,1694,481,1499,61,197,323,1020,384,1217
315980,201901,3962,8810,2159,5835,398,1164,732,1821,1130,2985
315990,201901,3489,9015,2727,7741,292,876,1617,4514,1909,5390
316000,201901,506,1398,393,1230,65,259,167,482,232,741
316010,201901,739,2036,562,1739,37,135,358,1030,395,1165
316020,201901,954,2964,777,2618,80,354,471,1460,551,1814
316030,201901,2804,7877,2058,6557,236,802,1299,4186,1535,4988
316040,201901,2508,7541,1813,6165,300,1109,458,1456,758,2565
316045,201901,1992,5388,1801,5137,105,241,1485,4343,1590,4584
316050,201901,362,1082,272,917,44,167,147,472,191,639
316060,201901,656,1801,494,1548,37,152,332,969,369,1121
316070,201901,5251,15172,4348,13419,801,2613,1974,5860,2775,8473
316080,201901,712,2271,563,1964,149,576,73,239,222,815
316090,201901,412,1250,289,987,37,148,128,406,165,554
316095,201901,1258,3980,1029,3440,237,830,402,1314,639,2144
316100,201901,2459,7539,1755,5933,321,1168,557,1719,878,2887
316105,201901,835,2266,642,1970,67,220,417,1309,484,1529
316110,201901,12396,37683,10454,34332,1090,3928,6902,22551,7992,26479
316120,201901,1047,3156,666,2192,122,426,169,454,291,880
316130,201901,1176,2679,720,1961,57,192,397,1044,454,1236
316140,201901,1066,2928,708,2288,127,436,328,1050,455,1486
316150,201901,1705,3956,1402,3551,236,727,582,1346,818,2073
316160,201901,1017,2857,825,2521,69,246,524,1539,593,1785
316165,201901,880,2251,659,1895,105,361,344,933,449,1294
316170,201901,1061,2793,787,2377,78,285,486,1394,564,1679
316180,201901,1202,3542,793,2686,172,662,125,341,297,1003
316190,201901,2568,7480,1511,4927,245,807,523,1484,768,2291
316200,201901,3164,9399,2281,7709,515,1954,533,1691,1048,3645
316210,201901,4071,12227,2896,9541,927,3275,340,1082,1267,4357
316220,201901,595,1814,392,1347,82,319,48,187,130,506
316225,201901,1405,3362,1073,2796,46,184,784,1897,830,2081
316230,201901,408,1101,311,948,39,117,162,509,201,626
316240,201901,5607,16585,5005,15600,425,1399,3807,11722,4232,13121
316245,201901,2895,9850,2623,9399,160,913,1973,6725,2133,7638
316250,201901,9099,23052,6444,18727,1590,5026,1936,5519,3526,10545
316255,201901,2742,7872,2394,7333,202,686,1712,5286,1914,5972
316257,201901,1184,2943,845,2403,135,396,436,1221,571,1617
316260,201901,1768,4717,1338,4030,80,261,745,2324,825,2585
316265,201901,1143,3140,890,2702,48,187,619,1823,667,2010
316270,201901,3455,11094,2958,9978,559,1996,1343,4339,1902,6335
316280,201901,2898,8786,2505,8042,379,1343,1341,4169,1720,5512
316290,201901,3205,9239,2498,7851,359,1309,960,2979,1319,4288
316292,201901,4578,12607,3769,11312,432,1488,2608,7623,3040,9111
316294,201901,761,2316,559,1967,111,453,107,353,218,806
316295,201901,2675,7709,2212,6882,124,512,1560,4635,1684,5147
316300,201901,934,2945,796,2693,57,226,532,1799,589,2025
316310,201901,937,2377,544,1708,90,335,133,360,223,695
316320,201901,578,1662,445,1420,51,201,205,628,256,829
316330,201901,1026,2879,760,2364,60,235,521,1544,581,1779
316340,201901,1011,2920,751,2419,78,319,389,1178,467,1497
316350,201901,1145,3454,976,3172,114,404,647,2066,761,2470
316360,201901,646,1715,512,1497,59,203,362,1030,421,1233
316370,201901,4615,12897,3500,10817,725,2593,1127,3083,1852,5676
316380,201901,1591,3942,1243,3461,43,117,898,2513,941,2630
316390,201901,844,2296,609,1875,212,736,143,402,355,1138
316400,201901,1165,3383,781,2626,131,484,277,851,408,1335
316410,201901,1062,3212,891,2934,65,247,688,2215,753,2462
316420,201901,1720,5070,1505,4802,62,277,1225,3810,1287,4087
316430,201901,823,2273,516,1690,121,431,121,376,242,807
316440,201901,672,2150,524,1898,138,563,77,262,215,825
316443,201901,538,1567,412,1320,110,387,100,322,210,709
316447,201901,1778,4942,1564,4605,60,221,1262,3666,1322,3887
316450,201901,2186,6818,1683,5773,203,740,1014,3429,1217,4169
316460,201901,914,2442,738,2168,193,612,370,1034,563,1646
316470,201901,5983,17656,4427,14459,836,3126,1568,4706,2404,7832
316480,201901,205,583,171,525,33,111,82,236,115,347
316490,201901,285,769,210,633,23,81,90,236,113,317
316500,201901,1174,3865,771,2830,163,645,130,447,293,1092
316510,201901,688,2337,542,2043,113,458,230,872,343,1330
316520,201901,1010,2722,788,2339,129,461,366,1007,495,1468
316530,201901,1015,2852,746,2357,118,474,327,904,445,1378
316540,201901,729,2038,591,1829,106,390,272,783,378,1173
316550,201901,1288,3966,1122,3635,83,331,836,2648,919,2979
316553,201901,3241,9936,2243,7589,512,1859,562,1740,1074,3599
316555,201901,2484,8355,2274,8054,150,618,1747,6287,1897,6905
316556,201901,572,1404,402,1117,22,62,231,584,253,646
316557,201901,909,3030,791,2814,311,1166,227,787,538,1953
316560,201901,260,797,200,712,55,228,56,177,111,405
316570,201901,1087,3362,951,3099,249,810,353,1159,602,1969
316580,201901,384,895,240,645,47,145,102,250,149,395
316590,201901,1285,3450,926,2752,157,470,503,1433,660,1903
316600,201901,950,3019,818,2737,144,524,427,1383,571,1907
316610,201901,578,1858,483,1708,59,278,299,998,358,1276
316620,201901,2001,5668,1736,5312,90,323,1269,3915,1359,4238
316630,201901,1498,4556,1191,3972,325,1079,463,1688,788,2767
316640,201901,138,380,109,338,23,73,51,139,74,212
316650,201901,998,3294,808,2992,71,281,504,1915,575,2196
316660,201901,193,493,87,269,12,42,10,35,22,77
316670,201901,1806,4743,1355,4011,365,1160,428,1226,793,2386
316680,201901,2032,5341,1584,4598,142,464,1140,3228,1282,3692
316690,201901,1025,3138,849,2812,163,586,386,1272,549,1858
316695,201901,977,2916,815,2626,39,171,559,1774,598,1945
316700,201901,359,882,299,816,13,59,230,592,243,651
316710,201901,2739,9362,2093,7969,542,2159,767,2944,1309,5103
316720,201901,19195,54780,14236,45085,2872,9808,5568,16852,8440,26660
316730,201901,389,1122,310,956,59,204,138,373,197,577
316740,201901,678,2075,601,1951,61,275,415,1323,476,1598
316750,201901,384,1192,293,998,64,236,113,360,177,596
316760,201901,3574,11568,2928,10224,1225,4573,763,2588,1988,7161
316770,201901,1491,3693,1209,3308,34,118,1024,2820,1058,2938
316780,201901,541,1669,422,1444,140,562,70,203,210,765
316790,201901,698,1893,485,1492,116,369,139,394,255,763
316800,201901,5793,16927,4698,14941,419,1568,2649,8159,3068,9727
316805,201901,970,2172,819,2009,18,36,719,1819,737,1855
316810,201901,568,1588,404,1288,86,326,200,610,286,936
316820,201901,319,790,160,494,16,55,50,158,66,213
316830,201901,666,1924,542,1714,85,330,333,1003,418,1333
316840,201901,2607,7267,2178,6506,308,1083,1287,3653,1595,4736
316850,201901,1971,5284,1428,4313,204,691,641,1885,845,2576
316860,201901,16563,45265,12682,39389,2374,8376,5735,17419,8109,25795
316870,201901,6572,18936,4938,15731,935,3319,1938,5714,2873,9033
316880,201901,765,2098,633,1916,135,460,288,862,423,1322
316890,201901,1098,2532,674,1953,131,457,364,926,495,1383
316900,201901,2191,6129,1703,5157,363,1224,565,1532,928,2756
316905,201901,504,1538,391,1312,89,322,157,529,246,851
316910,201901,836,2277,554,1802,152,552,51,156,203,708
316920,201901,1521,3960,1009,3129,178,599,428,1331,606,1930
316930,201901,7488,22877,5436,18917,1044,3936,1226,4132,2270,8068
316935,201901,3713,10473,2683,8589,597,2023,899,2810,1496,4833
316940,201901,6428,19527,4919,16255,882,3244,1696,5183,2578,8427
316950,201901,1736,4250,1339,3685,50,180,1054,2834,1104,3014
316960,201901,4785,11330,3540,9568,463,1371,2276,5987,2739,7358
316970,201901,3295,9819,2879,8991,644,2103,1076,3176,1720,5279
316980,201901,698,2140,508,1746,163,636,62,221,225,857
316990,201901,10003,28478,7163,22462,1982,6611,866,2471,2848,9082
317000,201901,2543,7881,2280,7485,153,507,1665,5507,1818,6014
317005,201901,2497,7358,2029,6405,362,1175,1024,3166,1386,4341
317010,201901,21464,51743,13162,39070,3242,10506,3837,11910,7079,22416
317020,201901,58335,141361,33038,96835,6304,20129,9057,24499,15361,44628
317030,201901,620,1752,498,1573,30,125,378,1168,408,1293
317040,201901,10078,26595,7237,21647,1783,5576,2607,7982,4390,13558
317043,201901,799,1909,593,1622,94,262,371,1043,465,1305
317047,201901,1153,2838,777,2224,117,304,436,1275,553,1579
317050,201901,1166,3705,806,2833,108,398,310,980,418,1378
317052,201901,2319,6819,1902,6106,268,928,1199,3799,1467,4727
317057,201901,1588,4042,1130,3247,54,206,717,2004,771,2210
317060,201901,418,1126,246,761,41,140,81,220,122,360
317065,201901,1208,3550,985,3129,60,231,636,1896,696,2127
317070,201901,7465,21008,5028,16219,1109,4034,1106,3406,2215,7440
317075,201901,846,2348,578,1844,114,392,157,464,271,856
317080,201901,5743,14082,4240,11624,1363,3958,1175,2993,2538,6951
317090,201901,4239,13318,3859,12688,369,1193,2777,9126,3146,10319
317100,201901,2320,5690,1580,4567,437,1367,561,1572,998,2939
317103,201901,1746,5531,1533,5139,166,798,1013,3157,1179,3955
317107,201901,1284,3617,1016,3080,56,239,612,1645,668,1884
317110,201901,675,1506,326,984,41,149,110,345,151,494
317115,201901,1077,3136,908,2816,59,182,648,2009,707,2191
317120,201901,11703,33890,9210,29653,1392,5099,4806,14942,6198,20041
317130,201901,9382,22738,5854,16969,1157,3711,1885,5389,3042,9100
317140,201901,620,1814,511,1630,47,159,323,1049,370,1208
317150,201901,982,2457,767,2178,33,132,604,1656,637,1788
317160,201901,3509,8653,2382,6938,222,678,1386,4070,1608,4748
317170,201901,1872,4833,1307,3805,232,795,477,1195,709,1990
317180,201901,1672,5497,1273,4508,283,1058,334,1117,617,2175
317190,201901,1210,3371,903,2879,116,392,531,1686,647,2078
317200,201901,4758,12913,3539,10745,941,3100,732,2051,1673,5151
317210,201901,1113,2845,878,2515,45,169,630,1827,675,1996
317220,201901,270,878,236,805,61,214,84,293,145,507
320010,201901,4387,13112,3584,11539,409,1457,2267,7117,2676,8574
320013,201901,1560,4710,1133,3747,192,607,515,1747,707,2354
320016,201901,2944,7780,2367,6946,109,319,1890,5517,1999,5836
320020,201901,3771,10371,2855,8757,715,2342,979,3112,1694,5454
320030,201901,1476,4439,1038,3519,226,849,345,1096,571,1945
320035,201901,1660,4758,1395,4304,391,1301,589,1768,980,3069
320040,201901,3456,10296,2843,9135,452,1580,1481,4661,1933,6241
320050,201901,1732,4063,1492,3705,246,701,858,2073,1104,2774
320060,201901,10238,29760,7708,24734,1337,4696,3239,9937,4576,14633
320070,201901,1338,3931,968,3172,204,723,324,1039,528,1762
320080,201901,5242,13918,3793,11121,814,2506,1367,3889,2181,6395
320090,201901,6896,19010,4954,15152,1147,3783,2078,5975,3225,9758
320100,201901,2500,7372,1983,6399,440,1509,925,2917,1365,4426
320110,201901,1302,3441,1010,2937,211,641,409,1174,620,1815
320115,201901,1734,5809,1514,5426,672,2491,465,1740,1137,4231
320120,201901,16264,43446,11262,34463,2037,6829,4342,12726,6379,19555
320130,201901,35658,105119,30237,95282,4880,16830,16819,51663,21699,68493
320140,201901,2764,8154,2064,6704,405,1503,803,2563,1208,4066
320150,201901,12256,33087,8719,26083,2517,7968,1460,4145,3977,12113
320160,201901,5165,15297,3966,12962,673,2351,1873,6051,2546,8402
320170,201901,1425,4297,1060,3540,306,1034,376,1268,682,2302
320180,201901,689,2272,554,1997,195,742,123,436,318,1178
320190,201901,2719,8991,2092,7511,508,1929,491,1710,999,3639
320200,201901,1035,2952,755,2431,198,729,248,784,446,1513
320210,201901,4323,11409,3388,9768,581,1839,1796,4954,2377,6793
320220,201901,2566,7198,1945,6122,368,1240,949,2928,1317,4168
320225,201901,1306,4206,905,3195,338,1288,131,446,469,1734
320230,201901,4424,12868,3382,11116,818,2928,1381,4496,2199,7424
320240,201901,13108,35314,10068,30277,2229,7130,4196,12497,6425,19627
320245,201901,2798,8748,2292,7696,948,3258,537,1797,1485,5055
320250,201901,1839,5320,1236,3893,303,1090,318,892,621,1982
320255,201901,1653,5467,1460,5125,537,1907,604,2244,1141,4151
320260,201901,995,2990,714,2311,198,707,182,500,380,1207
320265,201901,2305,7327,1948,6632,913,3249,415,1396,1328,4645
320270,201901,2115,6243,1609,5193,332,1165,736,2367,1068,3532
320280,201901,5503,15610,4488,13787,1137,3698,1625,4998,2762,8696
320290,201901,1228,3816,834,2847,246,917,193,615,439,1532
320300,201901,3407,10871,2796,9544,903,3299,565,1865,1468,5164
320305,201901,4578,13555,3662,11690,833,2828,1647,5108,2480,7936
320310,201901,1795,5137,1249,3962,251,851,526,1610,777,2461
320313,201901,2154,5700,1381,4135,326,1051,287,825,613,1876
320316,201901,1444,4233,1197,3755,205,656,672,2108,877,2764
320320,201901,19560,53207,14024,43638,3479,11357,5212,16276,8691,27633
320330,201901,2793,7930,2208,6853,547,1649,1010,3269,1557,4918
320332,201901,5174,15380,4249,13737,1042,3631,2085,6630,3127,10261
320334,201901,1815,5444,1289,4296,294,1138,278,775,572,1913
320335,201901,1588,4690,1019,3395,260,923,212,650,472,1573
320340,201901,4631,12198,3868,11002,574,1715,2152,6206,2726,7921
320350,201901,4922,12550,3443,9861,496,1541,1717,4667,2213,6208
320360,201901,1425,3724,1051,3006,149,407,507,1420,656,1827
320370,201901,2328,7595,1863,6507,557,2031,637,2181,1194,4212
320380,201901,2180,6153,1838,5580,289,947,1069,3166,1358,4113
320390,201901,7066,19898,5327,16285,1149,3713,2107,6179,3256,9892
320400,201901,3159,9273,2538,7962,688,2283,1004,3066,1692,5349
320405,201901,4255,11650,3265,9956,537,1745,1627,4914,2164,6659
320410,201901,4566,12405,3500,10694,571,1717,1803,5782,2374,7499
320420,201901,2649,7403,2089,6471,604,2056,587,1790,1191,3846
320425,201901,1917,4708,1484,3996,120,366,991,2558,1111,2924
320430,201901,2709,7006,2121,5886,328,977,1261,3344,1589,4321
320435,201901,2181,7041,1715,6085,615,2289,495,1789,1110,4078
320440,201901,1246,3628,926,2988,149,511,416,1310,565,1821
320450,201901,1522,4566,1212,3976,300,1079,530,1648,830,2727
320455,201901,3728,11673,2578,8916,739,2695,734,2448,1473,5143
320460,201901,2060,6375,1470,5040,373,1329,366,1188,739,2517
320465,201901,1180,3462,897,2886,114,400,516,1655,630,2055
320470,201901,3554,10056,2468,7788,635,2170,560,1647,1195,3817
320480,201901,1592,4620,1342,4148,240,832,708,2114,948,2946
320490,201901,18055,49346,13539,41324,2513,8550,5501,16591,8014,25141
320495,201901,1348,3808,923,2976,211,762,314,963,525,1725
320500,201901,45617,126543,37486,112259,6175,19844,20742,60043,26917,79887
320501,201901,4372,13020,3173,10802,897,3386,990,3306,1887,6692
320503,201901,1962,6176,1438,5039,449,1701,449,1449,898,3150
320506,201901,2562,7825,1789,6054,539,1970,156,504,695,2474
320510,201901,9275,26137,7559,23015,1089,3658,4304,12708,5393,16366
320515,201901,1679,4677,1303,3918,388,1234,397,1174,785,2408
320517,201901,1975,6250,1601,5426,561,2036,376,1268,937,3304
320520,201901,31301,85585,23641,72501,4519,15148,9773,29214,14292,44362
320530,201901,28179,77994,22344,67579,2685,9601,13290,37824,15975,47425
330010,201901,19123,53466,15817,47833,2843,9048,8993,26744,11836,35792
330015,201901,1434,3692,1117,3169,186,599,597,1613,783,2212
330020,201901,19029,49217,16674,45881,2307,7214,11879,31828,14186,39042
330022,201901,1898,5173,1448,4412,246,783,855,2562,1101,3345
330023,201901,4224,10473,2898,8526,608,1900,1313,3802,1921,5702
330025,201901,4623,11614,3130,9108,974,3020,951,2759,1925,5779
330030,201901,9810,27638,7457,23485,958,3509,4306,12847,5264,16356
330040,201901,12541,34268,10320,30386,1250,4183,6693,18956,7943,23139
330045,201901,79823,194794,66852,177826,6900,17773,50558,133744,57458,151517
330050,201901,2285,6197,1711,5230,389,1263,758,2212,1147,3475
330060,201901,4717,12996,3946,11717,875,2863,1708,4738,2583,7601
330070,201901,20958,56086,17357,50582,3229,10054,9423,27172,12652,37226
330080,201901,8319,22073,7261,20499,980,2884,4773,13317,5753,16201
330090,201901,3379,7192,2195,5609,200,554,1396,3510,1596,4064
330093,201901,2345,6091,1742,5150,177,551,1221,3612,1398,4163
330095,201901,1122,3362,891,2907,90,373,488,1456,578,1829
330100,201901,64123,177223,54691,162975,4001,14282,40419,118527,44420,132809
330110,201901,1914,5733,1707,5403,304,1080,875,2663,1179,3743
330115,201901,2020,5254,1536,4526,241,772,891,2549,1132,3321
330120,201901,3304,7678,2460,6556,208,627,1768,4583,1976,5210
330130,201901,3449,9856,2879,8998,459,1532,1748,5445,2207,6977
330140,201901,3319,9052,2719,8143,420,1425,1645,4755,2065,6180
330150,201901,1993,5530,1553,4809,337,1107,680,2053,1017,3160
330160,201901,1289,3618,1022,3172,190,661,527,1549,717,2210
330170,201901,91426,244208,77479,224838,11308,32752,50663,148448,61971,181200
330180,201901,2070,5313,1626,4620,121,408,1113,3064,1234,3472
330185,201901,9027,24338,7495,21874,781,2664,5392,15226,6173,17890
330187,201901,3724,9845,3005,8746,439,1404,1852,5360,2291,6764
330190,201901,29070,74160,25441,69098,2228,6485,19799,53071,22027,59556
330200,201901,13854,37659,11654,34861,2458,6984,7138,22040,9596,29024
330205,201901,2023,5174,1568,4415,110,370,1072,2915,1182,3285
330210,201901,3263,8576,2360,6888,423,1322,918,2483,1341,3805
330220,201901,10395,27142,7520,22128,1794,5794,2270,6112,4064,11906
330225,201901,3280,8864,2636,7895,236,869,1830,5329,2066,6198
330227,201901,16062,41143,13935,38434,867,2707,11550,31370,12417,34077
330230,201901,1618,3785,1178,3224,69,212,840,2271,909,2483
330240,201901,20331,55054,16431,48638,2915,9338,9326,26844,12241,36182
330245,201901,1614,4124,950,2977,228,745,263,838,491,1583
330250,201901,33379,90470,28356,82777,6495,19228,14591,43181,21086,62409
330260,201901,4126,11083,3231,9768,490,1629,1863,5414,2353,7043
330270,201901,24679,51924,15038,38055,2792,7659,6275,15573,9067,23232
330280,201901,2297,6193,1734,5206,205,687,971,2791,1176,3478
330285,201901,20269,51069,16359,45395,1748,5517,11342,30528,13090,36045
330290,201901,3374,8857,2727,7894,397,1249,1639,4611,2036,5860
330300,201901,5191,12943,3710,10699,427,1381,2302,6495,2729,7876
330310,201901,2168,5719,1664,4861,101,292,1098,3217,1199,3509
330320,201901,14314,36114,11526,32523,1519,4402,8143,23006,9662,27408
330330,201901,30104,71782,24352,63760,2898,8307,16827,43025,19725,51332
330340,201901,13336,34586,9870,28973,1883,6098,4683,13143,6566,19241
330350,201901,100460,253176,84920,233530,7717,22328,65041,178251,72758,200579
330360,201901,7320,18356,6343,17192,338,985,5305,14284,5643,15269
330370,201901,4516,13257,3338,11158,794,2798,1294,4459,2088,7257
330380,201901,4854,13810,3744,11826,815,2856,1621,4922,2436,7778
330385,201901,3812,11588,3168,10591,808,2949,1422,4790,2230,7739
330390,201901,22657,66104,18059,57421,3184,11202,9147,27808,12331,39010
330395,201901,3086,8043,2587,7370,239,752,1743,4865,1982,5617
330400,201901,2900,8121,2553,7521,193,715,1842,5121,2035,5836
330410,201901,2780,7806,2074,6532,437,1456,893,2679,1330,4135
330411,201901,2608,7238,2102,6285,170,586,1462,4202,1632,4788
330412,201901,1419,4308,1169,3863,165,600,647,1996,812,2596
330414,201901,22247,58218,18252,52659,2105,6084,12579,36194,14684,42278
330415,201901,3493,9865,2723,8555,385,1217,1501,4813,1886,6030
330420,201901,9434,24020,6301,18815,952,3132,2663,7531,3615,10663
330430,201901,8469,21749,7343,20086,583,1928,5430,14292,6013,16220
330440,201901,2026,5724,1537,4926,355,1278,706,2154,1061,3432
330450,201901,1277,3830,1039,3384,158,563,517,1643,675,2206
330452,201901,14333,37937,11408,33363,2018,6401,6462,18411,8480,24812
330455,201901,521972,1287706,399650,1105618,65759,192493,236482,644421,302241,836914
330460,201901,1145,3310,883,2900,187,658,424,1353,611,2011
330470,201901,4466,11684,3358,9968,955,2921,1257,3776,2212,6697
330475,201901,8529,22989,6873,20763,1351,4495,4046,11992,5397,16487
330480,201901,5741,15637,4929,14380,541,1782,3209,9088,3750,10870
330490,201901,111410,266820,93522,241967,10610,29402,66320,168819,76930,198221
330500,201901,5923,15937,5035,14662,666,2133,3515,10086,4181,12219
330510,201901,35619,95124,28361,84761,6872,21223,14708,43861,21580,65084
330513,201901,1235,3304,977,2913,245,783,433,1270,678,2053
330515,201901,2430,6796,1999,6100,541,1750,898,2658,1439,4408
330520,201901,10410,29010,8658,26074,1363,4572,4853,14093,6216,18665
330530,201901,1636,4138,1199,3400,262,805,519,1412,781,2217
330540,201901,2778,7608,2166,6527,640,1954,789,2371,1429,4325
330550,201901,7672,22437,6293,20309,2183,7500,1918,6113,4101,13613
330555,201901,13093,31275,10928,28535,1315,3786,7714,20200,9029,23986
330560,201901,4206,11582,3449,10276,501,1559,2055,5923,2556,7482
330570,201901,2812,7938,2312,7068,413,1369,1362,4106,1775,5475
330575,201901,5258,14108,4561,12897,373,1190,3458,9435,3831,10625
330580,201901,13114,37094,10128,31512,2261,7597,4434,13301,6695,20898
330590,201901,1465,4141,1274,3901,178,555,877,2725,1055,3280
330600,201901,11045,30529,8747,26637,1296,4137,4880,14730,6176,18867
330610,201901,8890,24723,7386,22332,767,2719,4859,14292,5626,17011
330615,201901,1986,5617,1527,4970,324,1162,894,2907,1218,4069
330620,201901,3662,11146,2994,9927,858,3086,1041,3217,1899,6303
330630,201901,23648,62037,18654,53896,1861,6355,12571,34850,14432,41205
350010,201901,1850,5024,919,2903,240,783,103,250,343,1033
350020,201901,668,1758,352,1121,46,156,128,365,174,521
350030,201901,3664,10643,2692,8768,713,2474,875,2746,1588,5220
350040,201901,625,1895,382,1362,66,268,116,344,182,612
350050,201901,891,2405,634,1929,134,484,205,491,339,975
350055,201901,760,2036,639,1865,46,159,502,1442,548,1601
350060,201901,105,282,77,234,15,46,39,114,54,160
350070,201901,3578,9546,2212,6976,437,1457,706,2050,1143,3507
350075,201901,594,1838,439,1519,185,672,54,169,239,841
350080,201901,600,1629,366,1152,45,161,163,467,208,628
350090,201901,620,1509,359,1029,79,238,115,307,194,545
350100,201901,2020,5515,1336,4246,165,617,672,2008,837,2625
350110,201901,384,1092,299,926,23,87,194,580,217,667
350115,201901,1283,3821,1039,3283,191,665,519,1496,710,2161
350120,201901,661,1626,356,1023,54,167,169,457,223,624
350130,201901,2994,8289,2403,7162,390,1254,1249,3521,1639,4775
350140,201901,647,1954,458,1588,41,197,243,771,284,968
350150,201901,506,1586,420,1417,103,347,102,322,205,669
350160,201901,10398,26247,6823,19891,848,2942,4031,11015,4879,13957
350170,201901,1743,5238,1346,4314,275,912,485,1461,760,2373
350180,201901,1090,2739,547,1680,123,390,163,471,286,861
350190,201901,2745,7916,1925,6231,415,1535,719,1915,1134,3450
350200,201901,407,1134,324,983,24,80,223,640,247,720
350210,201901,5180,12243,3452,9610,637,1867,1889,5085,2526,6952
350220,201901,2729,7557,1854,5860,423,1417,659,1896,1082,3313
350230,201901,917,2550,767,2309,153,493,390,1149,543,1642
350240,201901,673,2021,447,1472,77,263,151,482,228,745
350250,201901,2284,7080,1732,6079,610,2334,312,1147,922,3481
350260,201901,777,1923,498,1420,67,201,281,775,348,976
350270,201901,4498,12633,3595,10865,614,2018,1796,5075,2410,7093
350275,201901,2257,6422,1803,5604,317,1100,955,2803,1272,3903
350280,201901,18453,41959,10912,29803,2038,5930,3893,10309,5931,16239
350290,201901,2944,8289,1980,6307,383,1358,747,2223,1130,3581
350300,201901,646,1792,460,1402,87,284,190,531,277,815
350310,201901,770,2309,578,1873,92,361,235,668,327,1029
350315,201901,540,1472,373,1168,43,156,158,444,201,600
350320,201901,12146,32781,9310,27745,2383,7613,2771,8041,5154,15654
350330,201901,13272,33751,9491,26239,1322,3957,5493,14359,6815,18316
350335,201901,343,982,264,837,17,60,168,522,185,582
350340,201901,1075,2867,630,2019,116,397,223,713,339,1110
350350,201901,733,1981,578,1799,89,321,301,899,390,1220
350360,201901,939,2937,774,2560,236,774,237,798,473,1572
350370,201901,577,1512,388,1148,120,331,86,254,206,585
350380,201901,4288,11741,2849,8944,756,2421,732,2351,1488,4772
350390,201901,9104,25444,7345,22344,1907,6003,2899,8654,4806,14657
350395,201901,408,1056,192,630,22,66,56,171,78,237
350400,201901,7470,19338,5255,15563,1389,4487,1525,4305,2914,8792
350410,201901,8796,25515,6391,20721,1526,5565,2096,6246,3622,11811
350420,201901,619,1758,454,1449,88,318,100,292,188,610
350430,201901,663,1853,548,1656,64,231,339,940,403,1171
350440,201901,1654,4446,1328,3920,156,545,819,2340,975,2885
350450,201901,6219,17999,4896,15589,1139,3897,1858,5640,2997,9537
350460,201901,1587,4105,806,2533,141,485,155,417,296,902
350470,201901,256,654,193,540,7,31,126,324,133,355
350480,201901,825,2245,539,1678,112,381,86,225,198,606
350490,201901,1733,4796,1277,3984,309,999,406,1174,715,2173
350500,201901,653,1784,507,1525,89,293,242,688,331,981
350510,201901,1048,2841,751,2274,92,298,403,1169,495,1467
350520,201901,1864,5994,1436,5089,273,1089,599,1947,872,3036
350530,201901,2483,6420,1803,5090,272,849,987,2623,1259,3472
350535,201901,1410,4014,1226,3742,155,544,810,2406,965,2950
350540,201901,1667,4385,1213,3654,204,641,635,1904,839,2545
350550,201901,8844,21907,5886,17034,677,2270,3039,8252,3716,10522
350560,201901,3657,10650,2929,9268,270,930,1811,5561,2081,6491
350570,201901,20861,60686,16912,52837,3738,12744,7718,22965,11456,35709
350580,201901,1787,4996,960,3122,230,803,136,354,366,1157
350590,201901,4284,12114,3133,9535,552,1935,1673,4645,2225,6580
350600,201901,36253,87134,22863,62896,3206,9795,11025,27788,14231,37583
350610,201901,6314,17858,4602,14417,945,3118,1975,6035,2920,9153
350620,201901,406,1007,249,771,31,108,132,385,163,493
350630,201901,1442,3861,1049,3145,77,305,636,1783,713,2088
350635,201901,7431,19322,5635,16434,1025,3367,3090,8507,4115,11874
350640,201901,902,2495,486,1525,61,201,167,460,228,661
350650,201901,7452,20622,4956,15472,1013,3411,1541,4470,2554,7881
350660,201901,4349,11873,3407,10263,644,1956,1689,5140,2333,7096
350670,201901,1723,4752,1424,4316,183,593,886,2689,1069,3282
350680,201901,1083,2965,704,2239,143,488,301,915,444,1403
350690,201901,1113,3131,837,2608,153,501,426,1277,579,1778
350700,201901,4769,12217,3038,9505,574,2005,1176,3458,1750,5463
350710,201901,2554,7279,2158,6578,310,1075,1234,3599,1544,4674
350715,201901,857,2473,705,2177,79,296,332,921,411,1217
350720,201901,166,413,121,340,27,83,50,128,77,211
350730,201901,504,1505,397,1290,40,165,257,783,297,948
350740,201901,1551,4372,1029,3246,187,609,283,822,470,1431
350745,201901,523,1431,324,1024,34,129,143,408,177,537
350750,201901,8910,24546,6878,20840,1308,4457,2873,7788,4181,12245
350760,201901,12805,33393,8988,26694,2312,7430,2620,7030,4932,14460
350770,201901,853,2173,553,1639,60,182,327,947,387,1129
350775,201901,663,1675,469,1356,56,171,206,578,262,749
350780,201901,1898,4978,1347,4112,286,964,425,1445,711,2409
350790,201901,1616,4442,1006,3276,197,711,211,583,408,1294
350800,201901,3076,9331,2672,8612,429,1485,1431,4518,1860,6003
350810,201901,2358,6040,1866,5348,289,853,1039,3048,1328,3901
350820,201901,800,1955,457,1315,48,151,229,608,277,759
350830,201901,828,2371,458,1527,62,228,134,390,196,618
350840,201901,2680,8221,1989,6862,503,1878,726,2356,1229,4234
350850,201901,6375,18669,4854,15737,1251,4289,1639,5186,2890,9475
350860,201901,3156,8951,2802,8432,144,563,2109,6221,2253,6784
350870,201901,2638,7619,1930,6445,332,1242,985,3155,1317,4397
350880,201901,1167,3503,940,3010,224,735,311,966,535,1701
350890,201901,564,1510,353,1072,47,161,124,325,171,486
350900,201901,6107,17478,3937,12665,1167,4037,737,2238,1904,6275
350910,201901,822,2188,708,1990,106,348,469,1270,575,1618
350920,201901,11359,29558,9738,26794,563,1872,7636,20150,8199,22022
350925,201901,4260,12110,3066,9830,634,2168,1283,3731,1917,5899
350930,201901,1414,3645,943,2751,126,397,510,1416,636,1813
350940,201901,1950,5526,1562,4817,203,673,966,2906,1169,3579
350945,201901,847,2451,641,2040,118,417,274,800,392,1217
350950,201901,77540,208679,60391,174976,8942,28529,35071,96709,44013,125238
350960,201901,5419,15494,4221,13218,669,2355,2320,6873,2989,9228
350970,201901,3381,10302,2525,8484,850,3136,369,1088,1219,4224
350980,201901,582,1678,460,1444,145,490,171,530,316,1020
350990,201901,1677,5024,1263,4317,319,1238,431,1390,750,2628
350995,201901,744,2410,671,2254,47,209,453,1438,500,1647
351000,201901,2580,6867,1819,5483,371,1222,564,1637,935,2859
351010,201901,301,754,184,536,17,52,95,264,112,316
351015,201901,688,2135,561,1888,80,322,273,834,353,1156
351020,201901,8902,24978,6773,21360,1345,4436,3463,10706,4808,15142
351030,201901,2404,7427,1956,6509,322,1204,1000,3215,1322,4419
351040,201901,4399,11588,3752,10552,241,853,2941,7952,3182,8805
351050,201901,16300,40685,10925,32050,2398,7483,4229,12249,6627,19732
351060,201901,43763,114098,33687,96593,4485,14009,21084,58550,25569,72559
351070,201901,1291,3403,758,2428,235,807,102,311,337,1118
351080,201901,2522,6605,1842,5737,343,1240,1004,2907,1347,4147
351090,201901,323,980,223,785,43,157,51,190,94,347
351100,201901,2296,6398,1483,4717,366,1241,403,1301,769,2542
351110,201901,5778,15199,3761,11461,743,2467,1425,4017,2168,6484
351120,201901,725,1914,492,1496,80,263,215,611,295,874
351130,201901,1025,2668,478,1556,103,357,77,227,180,584
351140,201901,1731,5140,1228,4145,331,1224,338,1004,669,2228
351150,201901,1864,5574,1162,3957,239,869,353,1071,592,1940
351160,201901,1076,3519,859,3012,192,709,274,861,466,1570
351170,201901,1337,3893,1156,3522,136,457,728,2130,864,2587
351190,201901,826,2397,582,1849,113,346,228,678,341,1024
351200,201901,1560,3895,1190,3326,73,231,797,2137,870,2368
351210,201901,1506,3787,865,2474,85,285,480,1261,565,1546
351220,201901,3000,8862,2586,8141,357,1181,1645,5125,2002,6306
351230,201901,1735,4962,1283,4146,271,1005,513,1463,784,2468
351240,201901,1876,4978,1235,3628,240,752,553,1492,793,2244
351250,201901,1068,2835,586,1840,72,240,216,680,288,920
351260,201901,910,2444,672,2007,156,456,229,692,385,1148
351270,201901,371,1088,306,977,58,231,160,437,218,668
351280,201901,3879,10709,3000,8995,527,1740,1415,4022,1942,5762
351290,201901,993,2615,675,2034,121,367,309,908,430,1275
351300,201901,14311,40710,9878,31999,2073,7188,3699,11843,5772,19031
351310,201901,3000,7942,2296,6767,229,825,1494,4112,1723,4937
351320,201901,863,2636,645,2107,110,391,237,721,347,1112
351330,201901,606,1867,524,1715,48,136,393,1316,441,1452
351340,201901,6056,18011,4850,15865,1276,4303,1931,6365,3207,10668
351350,201901,11225,29694,9455,26711,1032,3132,6889,18931,7921,22063
351360,201901,3726,10357,3082,9307,797,2603,1061,2972,1858,5575
351370,201901,2080,6034,1406,4592,359,1202,458,1354,817,2556
351380,201901,43521,110182,31534,88451,5076,15076,16538,44729,21614,59805
351385,201901,276,710,156,476,32,86,53,164,85,250
351390,201901,1328,3369,837,2620,132,491,480,1398,612,1889
351400,201901,894,2603,719,2230,166,501,364,1120,530,1621
351410,201901,2211,6403,1666,5338,330,1084,711,2234,1041,3318
351420,201901,347,839,180,531,37,97,73,209,110,306
351430,201901,758,2299,691,2178,57,198,526,1619,583,1817
351440,201901,3181,8577,2084,6277,417,1358,532,1352,949,2710
351450,201901,1678,4455,1114,3422,241,805,236,643,477,1448
351460,201901,747,2050,599,1796,166,486,296,892,462,1378
351470,201901,1144,3034,873,2555,87,292,537,1480,624,1772
351480,201901,2506,7676,2045,6865,332,1253,947,3024,1279,4277
351490,201901,1793,5364,1552,4896,88,351,1155,3475,1243,3826
351492,201901,333,928,273,796,15,53,174,488,189,541
351495,201901,201,564,145,446,19,60,75,217,94,277
351500,201901,33867,87167,25137,71733,4749,14373,13116,35811,17865,50184
351510,201901,11358,29609,8333,24161,1237,4020,4918,13610,6155,17630
351512,201901,469,1322,315,964,50,155,101,281,151,436
351515,201901,3037,7096,1826,5098,359,1139,488,1368,847,2507
351518,201901,2238,5832,1448,4422,209,737,768,2118,977,2855
351519,201901,653,1863,389,1282,58,197,68,199,126,396
351520,201901,1118,2853,428,1357,58,202,163,452,221,654
351530,201901,343,974,195,633,37,131,61,152,98,283
351535,201901,2030,4991,1452,4020,199,626,810,2108,1009,2734
351540,201901,2041,5251,1329,4035,409,1400,274,683,683,2083
351550,201901,5802,15149,3928,11483,471,1606,2131,5746,2602,7352
351560,201901,396,1181,322,1034,78,292,97,290,175,582
351565,201901,173,538,135,465,35,128,42,138,77,266
351570,201901,17955,49888,13540,40461,1733,5650,8211,23526,9944,29176
351580,201901,270,714,157,490,17,49,58,192,75,241
351590,201901,490,1126,261,710,32,107,147,357,179,464
351600,201901,1461,3908,1124,3299,132,431,661,1795,793,2226
351610,201901,722,1742,472,1307,26,89,248,623,274,712
351620,201901,19575,55194,14623,45864,2596,9231,6014,16931,8610,26162
351630,201901,25013,69524,20471,61441,3602,11383,12180,35580,15782,46963
351640,201901,15144,41838,11832,35514,1440,4874,7581,21827,9021,26701
351650,201901,410,1124,183,607,25,81,39,124,64,205
351660,201901,745,2223,457,1514,82,296,85,252,167,548
351670,201901,5082,14183,3641,11006,737,2282,1699,4808,2436,7090
351680,201901,401,1201,255,827,49,138,64,194,113,332
351685,201901,421,1271,337,1122,77,264,112,353,189,617
351690,201901,1008,2612,583,1737,111,363,217,573,328,936
351700,201901,1073,2853,834,2393,124,361,463,1275,587,1636
351710,201901,719,1990,474,1507,48,185,212,601,260,786
351720,201901,1413,3806,914,2853,163,558,355,1045,518,1603
351730,201901,895,2461,738,2176,85,310,436,1205,521,1515
351740,201901,3566,9204,2778,7698,522,1524,1267,3251,1789,4775
351750,201901,1231,3434,751,2527,154,560,240,812,394,1372
351760,201901,3267,9480,2314,7471,502,1792,794,2340,1296,4132
351770,201901,1777,5368,1440,4710,347,1162,638,2077,985,3239
351780,201901,1382,3599,713,2197,123,446,201,577,324,1023
351790,201901,1220,3043,975,2705,162,432,586,1657,748,2089
351800,201901,528,1252,265,758,34,108,87,208,121,316
351810,201901,962,2618,787,2329,54,156,568,1620,622,1776
351820,201901,2364,6858,1627,5364,418,1493,309,980,727,2473
351830,201901,4101,11473,3161,9771,376,1357,1832,5404,2208,6761
351840,201901,7407,21679,5663,18427,974,3496,2608,8043,3582,11539
351850,201901,1759,4699,1088,3435,217,777,302,846,519,1623
351860,201901,2716,8156,2154,7037,398,1372,1141,3711,1539,5083
351870,201901,21840,58317,16845,49965,5424,16525,5836,18090,11260,34615
351880,201901,109139,300891,82290,252161,23157,76619,27198,79174,50355,155793
351885,201901,812,2346,639,2001,100,330,331,1003,431,1333
351890,201901,626,1823,480,1551,110,361,69,187,179,548
351900,201901,973,2736,760,2400,155,495,354,1117,509,1612
351905,201901,373,1063,251,810,26,90,88,244,114,334
351907,201901,20951,56326,16318,47979,1749,5669,10762,30657,12511,36326
351910,201901,1186,3180,831,2451,105,341,442,1179,547,1520
351920,201901,858,2306,621,1839,80,274,300,821,380,1095
351925,201901,894,2546,698,2172,116,388,322,944,438,1332
351930,201901,2994,8758,2744,8260,346,1186,2077,6093,2423,7279
351940,201901,1056,2782,758,2254,100,339,402,1140,502,1479
351950,201901,1367,3316,1051,2870,54,176,723,1926,777,2102
351960,201901,4967,13128,3698,10874,835,2654,1565,4307,2400,6961
351970,201901,5815,18512,4874,16801,873,3402,2601,8602,3474,12004
351980,201901,1022,2486,654,1866,86,290,375,994,461,1284
351990,201901,1351,3334,948,2705,97,350,397,1020,494,1370
352000,201901,2373,7112,2033,6394,251,944,1271,3684,1522,4628
352010,201901,2002,5715,1608,4990,416,1380,298,969,714,2349
352020,201901,1445,4061,1134,3533,193,637,545,1613,738,2250
352030,201901,5269,14490,4185,12740,881,2907,2151,6399,3032,9306
352040,201901,2402,6658,1515,4828,275,930,406,1127,681,2057
352042,201901,3059,7651,1828,5486,374,1200,713,2145,1087,3345
352044,201901,1939,5452,1126,3831,204,728,212,669,416,1397
352050,201901,11526,31754,7424,23413,1879,6658,1168,3225,3047,9883
352060,201901,695,1958,507,1590,76,270,232,672,308,942
352070,201901,768,1619,531,1306,76,212,289,672,365,884
352080,201901,455,1196,275,822,38,126,97,251,135,377
352090,201901,1379,4250,1107,3629,178,658,416,1222,594,1880
352100,201901,2906,8391,2423,7491,598,1970,1084,3186,1682,5156
352110,201901,543,1696,424,1427,92,333,165,515,257,848
352115,201901,497,1467,411,1326,71,267,222,696,293,963
352120,201901,850,2635,672,2239,78,295,371,1148,449,1443
352130,201901,1807,5189,1159,3559,233,732,420,1211,653,1943
352140,201901,1241,3410,819,2561,136,459,378,1145,514,1604
352150,201901,801,2219,606,1867,134,429,308,941,442,1370
352160,201901,958,2422,696,2013,91,317,357,967,448,1284
352170,201901,2903,8101,2292,6858,426,1409,1165,3218,1591,4627
352180,201901,2571,7156,2050,6170,500,1678,653,1724,1153,3402
352190,201901,1120,3083,840,2632,141,474,365,1148,506,1622
352200,201901,360,1112,247,867,31,123,84,281,115,404
352210,201901,17524,43169,13669,37817,1369,4136,9831,26862,11200,30998
352215,201901,526,1438,461,1356,50,152,315,911,365,1063
352220,201901,15892,41982,10818,32535,2834,8894,3440,10034,6274,18928
352230,201901,12010,36748,9188,31267,2347,8757,3089,9955,5436,18712
352240,201901,10711,28461,7982,23752,1812,6122,3203,8649,5015,14771
352250,201901,21229,61777,17275,54664,3737,12454,9070,28291,12807,40745
352260,201901,4747,12474,3269,9489,531,1816,1766,4634,2297,6450
352265,201901,892,2608,787,2432,55,204,567,1702,622,1906
352270,201901,1446,4499,1079,3687,242,917,342,1056,584,1973
352280,201901,2297,6084,1769,5293,193,712,968,2685,1161,3397
352290,201901,1045,3186,862,2802,156,551,414,1218,570,1769
352300,201901,936,2597,649,2007,97,343,302,827,399,1170
352310,201901,42703,115782,31689,96408,8236,25410,13418,41195,21654,66605
352320,201901,5956,16458,4600,13730,779,2576,2235,5994,3014,8570
352330,201901,2055,5785,1580,5096,327,1224,732,2236,1059,3460
352340,201901,4827,13427,3520,11035,721,2513,1487,4335,2208,6848
352350,201901,1945,5793,1572,4969,200,762,832,2363,1032,3125
352360,201901,1142,3124,976,2847,106,380,712,1973,818,2353
352370,201901,1007,3009,869,2749,35,150,658,2024,693,2174
352380,201901,799,2310,619,1961,144,491,207,625,351,1116
352390,201901,15448,38805,10443,30190,1700,5431,5597,15272,7297,20703
352400,201901,3406,9509,2848,8506,464,1710,1744,4819,2208,6529
352410,201901,2954,7987,2252,6777,251,897,1341,3862,1592,4759
352420,201901,862,2137,595,1718,119,364,204,563,323,927
352430,201901,6974,18443,5009,14960,1364,4469,1964,5506,3328,9975
352440,201901,16385,46441,12599,39009,2878,9377,5127,15295,8005,24672
352450,201901,798,2101,391,1309,54,188,107,337,161,525
352460,201901,2828,8095,1929,6357,422,1526,638,1998,1060,3524
352470,201901,3403,8658,2458,7097,310,1034,1375,3682,1685,4716
352480,201901,3334,8291,2228,6278,370,1168,1060,2745,1430,3913
352490,201901,697,2168,544,1845,114,434,236,751,350,1185
352500,201901,9564,25450,6725,20127,3179,10337,820,1549,3999,11886
352510,201901,3271,9189,2430,7693,571,1980,934,2777,1505,4757
352520,201901,2424,6943,1877,5940,436,1525,880,2558,1316,4083
352530,201901,8730,24247,5612,17691,1270,4539,1000,2399,2270,6938
352540,201901,521,1562,391,1269,79,266,93,276,172,542
352550,201901,945,2806,665,2232,134,505,185,566,319,1071
352560,201901,545,1560,388,1226,63,209,145,422,208,631
352570,201901,1919,5761,1242,4308,313,1150,180,563,493,1713
352580,201901,710,1978,575,1733,103,356,282,804,385,1160
352585,201901,232,687,175,566,20,84,92,276,112,360
352590,201901,13042,35269,9135,27542,2741,8848,3531,9872,6272,18720
352600,201901,1892,5338,1430,4404,252,822,715,2075,967,2897
352610,201901,2897,8384,2165,7065,489,1736,785,2439,1274,4175
352620,201901,5432,14688,4258,12869,1324,4070,1526,4673,2850,8743
352630,201901,808,2020,608,1723,100,332,278,716,378,1048
352640,201901,2860,7639,2094,6305,199,660,1293,3753,1492,4413
352650,201901,563,1655,401,1277,64,237,144,422,208,659
352660,201901,971,3022,791,2664,170,590,330,1095,500,1685
352670,201901,8021,22695,5145,16771,1462,5124,618,1977,2080,7101
352680,201901,3185,9810,2263,7590,399,1533,1002,3087,1401,4620
352690,201901,27375,70774,20219,57812,1946,6376,12838,34926,14784,41302
352700,201901,551,1434,407,1224,172,574,89,220,261,794
352710,201901,4821,12863,3450,10302,873,2875,1389,3875,2262,6750
352720,201901,7659,22226,6004,18866,2797,8974,841,2337,3638,11311
352725,201901,493,1277,253,770,19,63,106,300,125,363
352730,201901,2659,7691,2273,6809,373,1270,1298,3547,1671,4817
352740,201901,2142,5220,1592,4389,218,665,879,2318,1097,2983
352750,201901,399,993,209,637,41,122,69,186,110,308
352760,201901,1438,4177,1122,3502,155,511,565,1718,720,2229
352770,201901,893,2432,583,1810,117,370,209,615,326,985
352780,201901,647,1923,453,1528,93,339,144,467,237,806
352790,201901,514,1383,340,1029,36,113,123,318,159,431
352800,201901,1204,3831,883,3054,225,825,162,490,387,1315
352810,201901,1070,2590,643,1788,96,291,347,896,443,1187
352820,201901,498,1310,321,1002,75,238,69,222,144,460
352830,201901,583,1520,256,807,41,139,47,119,88,258
352840,201901,3721,11214,3101,10052,1075,3747,967,2998,2042,6745
352850,201901,9721,24977,6514,19709,1848,5978,1920,5528,3768,11506
352860,201901,1010,2849,721,2292,146,507,231,698,377,1205
352870,201901,867,2214,601,1650,48,162,381,995,429,1157
352880,201901,1804,4435,1252,3429,184,530,702,1768,886,2298
352885,201901,265,778,196,647,30,111,112,358,142,469
352890,201901,705,1721,426,1129,50,137,224,512,274,649
352900,201901,17067,45656,11506,34639,2055,6773,5069,14205,7124,20978
352910,201901,461,1230,219,696,23,70,53,156,76,226
352920,201901,2519,6701,1807,5383,161,548,1146,3254,1307,3802
352930,201901,5494,15402,4045,12492,767,2542,1765,5119,2532,7661
352940,201901,21542,62025,16183,50426,4180,14289,5088,14865,9268,29154
352950,201901,478,1266,269,854,58,194,30,80,88,274
352960,201901,679,1894,349,1146,57,202,65,203,122,405
352965,201901,267,715,154,506,43,139,30,83,73,222
352970,201901,2884,7010,2207,5942,229,634,1478,3951,1707,4585
352980,201901,1345,3780,1053,3305,251,839,475,1436,726,2275
352990,201901,3931,11241,3224,10079,621,2164,1697,5110,2318,7274
353000,201901,452,1240,219,700,35,125,49,136,84,261
353010,201901,2466,6374,1623,4821,410,1323,523,1431,933,2754
353020,201901,3552,9370,2073,6274,307,1028,733,2033,1040,3061
353030,201901,4014,10690,2737,8289,695,2235,609,1803,1304,4038
353040,201901,578,1416,423,1162,60,189,231,584,291,773
353050,201901,4926,14776,3635,12079,800,2865,1528,4844,2328,7709
353060,201901,44883,118735,36933,105867,3087,10716,26655,73376,29742,84092
353070,201901,8972,26139,6359,20717,1402,4885,2098,6484,3500,11369
353080,201901,4015,11585,2771,9100,613,2220,900,2669,1513,4889
353090,201901,507,1626,416,1432,44,168,231,765,275,933
353100,201901,298,820,122,400,23,80,34,96,57,176
353110,201901,7106,20187,5801,18235,997,3303,3363,10735,4360,14038
353120,201901,448,1129,294,840,44,142,122,308,166,450
353130,201901,2282,5744,1527,4537,443,1438,476,1329,919,2767
353140,201901,2283,5915,1701,4825,166,546,1040,2749,1206,3295
353150,201901,1421,3687,1017,3007,223,691,416,1149,639,1840
353160,201901,551,1474,389,1203,77,265,158,438,235,703
353170,201901,495,1429,394,1281,77,302,187,556,264,858
353180,201901,9333,23660,7380,20595,936,2944,5108,13837,6044,16781
353190,201901,3244,8996,2582,7664,291,967,1585,4381,1876,5348
353200,201901,2005,5428,898,2965,121,432,209,625,330,1057
353205,201901,315,1016,266,896,59,220,119,392,178,612
353210,201901,959,2304,604,1698,28,97,386,1049,414,1146
353215,201901,389,1131,306,957,44,149,134,372,178,521
353220,201901,730,2001,454,1425,105,317,77,233,182,550
353230,201901,783,2279,642,2056,176,634,255,723,431,1357
353240,201901,2158,6102,1741,5327,249,883,1011,2957,1260,3840
353250,201901,1250,2842,730,1977,109,302,360,948,469,1250
353260,201901,1056,2543,599,1764,114,372,236,656,350,1028
353270,201901,628,1716,507,1480,46,137,318,893,364,1030
353280,201901,706,1952,493,1518,88,269,164,463,252,732
353282,201901,1765,5151,1517,4673,180,626,921,2682,1101,3308
353284,201901,366,904,183,533,27,102,75,188,102,290
353286,201901,145,373,85,268,21,76,30,90,51,166
353290,201901,1519,4020,916,2790,96,358,474,1315,570,1673
353300,201901,1664,4642,1233,3754,213,745,534,1447,747,2192
353310,201901,376,952,258,728,26,96,150,394,176,490
353320,201901,582,1551,493,1394,20,62,397,1119,417,1181
353325,201901,583,1797,409,1398,90,310,140,467,230,777
353330,201901,542,1429,331,987,44,140,160,445,204,585
353340,201901,2659,7348,1860,5828,492,1652,678,2074,1170,3726
353350,201901,3095,8515,2086,6341,466,1574,420,1089,886,2663
353360,201901,572,1675,452,1445,56,201,231,715,287,916
353370,201901,540,1664,440,1488,38,135,293,950,331,1085
353380,201901,262,808,209,694,33,116,99,308,132,424
353390,201901,5359,13834,3966,11326,618,1922,1985,5355,2603,7277
353400,201901,383,1126,293,940,58,213,66,165,124,378
353410,201901,519,1428,403,1223,77,252,209,620,286,872
353420,201901,448,1221,271,832,50,140,23,50,73,190
353430,201901,2144,6165,1553,5034,392,1410,568,1696,960,3106
353440,201901,59817,169025,42432,134060,8248,27663,20301,61418,28549,89081
353450,201901,377,997,253,775,38,139,118,324,156,463
353460,201901,3205,8843,2322,7115,204,701,1054,3186,1258,3887
353470,201901,7204,19549,4970,15297,957,3265,1857,5261,2814,8526
353475,201901,1336,3610,955,2809,139,447,455,1236,594,1683
353480,201901,1591,4374,1262,3757,75,263,870,2496,945,2759
353490,201901,940,2580,626,1915,122,404,271,786,393,1190
353500,201901,951,2320,750,2021,190,515,401,1100,591,1615
353510,201901,783,2388,564,1837,148,507,112,319,260,826
353520,201901,1089,2922,705,2207,83,288,325,967,408,1255
353530,201901,2384,6515,1854,5505,253,855,922,2548,1175,3403
353540,201901,1967,5636,1625,5056,328,1061,851,2579,1179,3640
353550,201901,5588,15116,4435,13153,917,2858,2182,6204,3099,9062
353560,201901,1978,5769,1470,4914,496,1788,351,1091,847,2879
353570,201901,522,1425,378,1167,58,178,216,631,274,809
353580,201901,1964,5307,1549,4543,369,1097,696,1971,1065,3068
353590,201901,686,1911,434,1368,109,372,127,392,236,764
353600,201901,1731,4424,1341,3711,168,480,716,1914,884,2394
353610,201901,549,1712,393,1374,92,368,96,303,188,671
353620,201901,2543,7037,1792,5662,382,1330,547,1555,929,2885
353625,201901,492,1240,316,928,32,111,192,549,224,660
353630,201901,1140,3681,892,3088,215,801,257,806,472,1607
353640,201901,1339,3533,1049,3063,117,382,634,1819,751,2201
353650,201901,8820,24440,6351,19281,857,2912,3392,9549,4249,12461
353657,201901,312,881,235,743,30,115,118,329,148,444
353660,201901,1113,2446,764,1952,308,792,212,501,520,1293
353670,201901,3580,10474,2860,9026,653,2276,1368,3982,2021,6258
353680,201901,706,1985,528,1711,102,351,278,874,380,1225
353690,201901,447,1177,177,580,16,57,20,56,36,113
353700,201901,1829,5142,1550,4612,177,582,1040,2973,1217,3555
353710,201901,4003,9157,2204,5956,241,653,1253,3127,1494,3780
353715,201901,440,1166,270,831,16,60,89,261,105,321
353720,201901,1860,5177,1475,4593,186,652,952,2880,1138,3532
353730,201901,4040,11193,2977,9128,458,1522,1400,4038,1858,5560
353740,201901,1845,4975,1233,3825,305,1056,359,1035,664,2091
353750,201901,798,2509,561,2026,143,549,97,372,240,921
353760,201901,11599,28484,9114,24982,1431,4163,5564,14923,6995,19086
353770,201901,725,2188,347,1190,61,207,40,106,101,313
353780,201901,4615,13762,3544,11542,900,3215,1177,3515,2077,6730
353790,201901,2408,7581,1789,6267,536,2160,375,1127,911,3287
353800,201901,16144,44846,12447,38565,2139,7121,6227,19204,8366,26325
353810,201901,1041,2839,694,2158,113,388,279,830,392,1218
353820,201901,1668,4806,1175,3754,252,854,399,1253,651,2107
353830,201901,596,1501,426,1212,67,194,196,531,263,725
353850,201901,1573,4553,1208,3843,326,1007,370,1219,696,2226
353860,201901,2455,7201,1941,6196,485,1699,797,2367,1282,4066
353870,201901,26815,72553,18693,56734,2791,9425,8938,24818,11729,34243
353880,201901,2782,8124,2231,7028,236,862,1292,3912,1528,4774
353890,201901,2366,5298,1533,4115,160,458,990,2548,1150,3006
353900,201901,634,1793,462,1460,92,314,188,572,280,886
353910,201901,1727,5128,1450,4666,214,789,939,2967,1153,3756
353920,201901,2066,5745,1399,4428,289,1053,341,920,630,1973
353930,201901,3977,10802,2641,8432,607,2131,786,2273,1393,4404
353940,201901,1025,3070,693,2368,146,510,204,651,350,1161
353950,201901,2887,8242,2308,7145,446,1531,1225,3485,1671,5016
353960,201901,709,1962,473,1482,98,308,155,460,253,768
353970,201901,679,1704,503,1434,48,156,306,836,354,992
353980,201901,13750,36477,10703,30964,1181,3742,7000,19575,8181,23317
353990,201901,887,2193,533,1527,65,217,274,726,339,943
354000,201901,2434,6071,1325,3933,289,896,219,662,508,1558
354010,201901,347,941,259,791,28,83,163,489,191,572
354020,201901,3332,9790,2618,8198,698,2348,910,2575,1608,4923
354025,201901,722,2005,455,1459,84,305,94,278,178,583
354030,201901,483,1065,239,639,42,106,95,243,137,349
354040,201901,762,1843,478,1356,31,103,316,864,347,967
354050,201901,901,2712,630,2176,160,582,176,606,336,1188
354060,201901,3563,10479,2417,7984,590,2031,701,2168,1291,4199
354070,201901,3124,8909,2202,7059,482,1696,670,1864,1152,3560
354075,201901,2213,6794,1709,5866,251,1009,902,3024,1153,4033
354080,201901,1388,3923,890,2908,170,575,235,717,405,1292
354085,201901,414,886,325,776,2,9,221,491,223,500
354090,201901,1420,4076,1249,3725,105,355,933,2729,1038,3084
354100,201901,16037,46536,11591,38547,2757,9838,4615,15310,7372,25148
354105,201901,1310,3486,930,2757,125,383,505,1448,630,1831
354110,201901,407,1128,305,959,75,244,103,330,178,574
354120,201901,1480,4098,977,3003,199,622,317,869,516,1491
354130,201901,5490,14843,3560,11072,1044,3519,202,401,1246,3920
354140,201901,18599,46188,12174,34599,2435,7463,4688,12315,7123,19778
354150,201901,3107,7704,2296,6353,475,1393,976,2608,1451,4001
354160,201901,3059,9168,2280,7524,693,2432,673,2104,1366,4536
354165,201901,564,1709,428,1430,87,335,198,613,285,948
354170,201901,1470,4291,1187,3689,93,320,728,2145,821,2465
354180,201901,433,1237,310,967,64,216,113,315,177,531
354190,201901,1420,4086,1011,3250,99,348,383,1218,482,1566
354200,201901,872,2254,671,1936,91,272,368,995,459,1267
354210,201901,635,1837,526,1628,51,184,337,964,388,1148
354220,201901,3005,8373,2205,6757,427,1403,996,2880,1423,4283
354230,201901,682,1793,527,1592,47,176,352,1014,399,1190
354240,201901,1472,4256,960,3163,176,628,272,784,448,1412
354250,201901,503,1307,325,1024,99,315,92,302,191,617
354260,201901,7828,21487,6006,18301,1416,4481,2221,6706,3637,11187
354270,201901,1022,3168,809,2754,186,634,290,987,476,1621
354280,201901,733,1925,613,1748,69,251,371,978,440,1229
354290,201901,855,2789,712,2475,129,448,330,1153,459,1601
354300,201901,3536,10730,3068,9878,1002,3306,1015,3168,2017,6474
354310,201901,656,2000,518,1705,108,381,162,476,270,857
354320,201901,880,2262,549,1657,80,295,216,571,296,866
354323,201901,489,1252,325,937,43,115,132,374,175,489
354325,201901,1192,3657,851,2907,150,531,347,1150,497,1681
354330,201901,7550,19939,5164,15042,766,2643,2898,7774,3664,10417
354340,201901,25827,68322,17652,53651,3760,12500,7616,22122,11376,34622
354350,201901,1134,3055,906,2621,123,378,574,1579,697,1957
354360,201901,529,1453,313,1043,63,212,45,150,108,362
354370,201901,978,3013,820,2728,149,533,432,1410,581,1943
354380,201901,775,2087,537,1686,94,350,128,331,222,681
354390,201901,12898,32256,8015,23540,1577,4895,2690,7528,4267,12423
354400,201901,1491,4933,1165,4162,212,817,405,1431,617,2248
354410,201901,5043,14442,3858,12047,932,3161,1632,4864,2564,8025
354420,201901,1416,3874,1032,3131,131,440,605,1754,736,2194
354425,201901,2425,6152,1731,4915,418,1208,651,1892,1069,3100
354430,201901,1474,4080,1158,3549,170,598,613,1756,783,2354
354440,201901,556,1532,339,1064,41,142,152,441,193,583
354450,201901,399,1062,215,701,31,98,65,195,96,293
354460,201901,900,2366,582,1785,91,300,283,824,374,1124
354470,201901,499,1286,318,910,21,69,158,400,179,469
354480,201901,1036,2400,710,1895,63,188,475,1204,538,1392
354490,201901,777,2336,557,1857,120,421,210,639,330,1060
354500,201901,1971,5733,1642,5239,562,1972,394,1230,956,3202
354510,201901,734,2059,589,1739,72,225,316,851,388,1076
354515,201901,285,877,213,731,39,153,78,253,117,406
354520,201901,6308,18167,4152,13193,654,2310,2146,6356,2800,8666
354530,201901,3889,11753,3000,9924,755,2585,1107,3610,1862,6195
354540,201901,1259,3445,917,2810,224,726,294,921,518,1647
354550,201901,530,1429,403,1186,63,188,240,673,303,861
354560,201901,1958,5001,1057,3128,150,464,509,1442,659,1906
354570,201901,1127,2915,479,1412,87,265,83,236,170,501
354580,201901,9067,24239,5851,18044,958,3244,2688,7882,3646,11126
354600,201901,1664,4769,1290,4053,183,641,749,2239,932,2880
354610,201901,387,1035,211,666,31,108,76,232,107,340
354620,201901,442,1279,281,955,44,160,106,315,150,475
354625,201901,302,851,179,608,21,70,49,146,70,216
354630,201901,1766,5426,1439,4781,630,2200,167,536,797,2736
354640,201901,3045,9032,2201,7246,383,1425,676,2050,1059,3475
354650,201901,884,2399,714,2093,75,236,411,1180,486,1416
354660,201901,2724,6897,1731,5220,146,527,1083,3155,1229,3682
354670,201901,1054,3006,719,2277,143,503,277,810,420,1313
354680,201901,4487,12549,3618,11085,877,2757,1819,5668,2696,8425
354690,201901,566,1806,387,1381,94,363,103,349,197,712
354700,201901,894,2398,612,1829,107,357,268,711,375,1068
354710,201901,509,1416,363,1120,56,204,155,417,211,621
354720,201901,318,783,135,406,42,125,30,92,72,217
354730,201901,9101,26374,6793,21919,1005,3528,3673,11497,4678,15025
354740,201901,308,843,124,430,16,65,21,64,37,129
354750,201901,2418,6579,1540,4863,307,1079,579,1612,886,2691
354760,201901,1878,5270,1303,4133,371,1295,340,1004,711,2299
354765,201901,312,852,133,439,22,83,24,69,46,152
354770,201901,2242,5700,1595,4583,314,988,702,1881,1016,2869
354780,201901,51158,133823,38877,109037,5537,17282,22066,57959,27603,75241
354790,201901,939,2719,751,2389,106,370,421,1286,527,1656
354800,201901,2486,6785,1926,5813,486,1541,797,2278,1283,3819
354805,201901,1289,3145,861,2429,118,359,402,999,520,1358
354810,201901,587,1744,350,1242,62,241,90,296,152,537
354820,201901,910,2737,644,2192,126,495,157,455,283,950
354830,201901,460,1153,299,861,76,215,103,289,179,504
354840,201901,945,2408,500,1483,59,173,239,682,298,855
354850,201901,19969,54187,13870,42795,1962,7006,7741,22413,9703,29419
354860,201901,1498,4346,1001,3335,197,704,319,951,516,1655
354870,201901,50496,130827,39465,110490,5235,16032,23015,61408,28250,77440
354880,201901,5595,14253,2574,7562,330,1095,840,1958,1170,3053
354890,201901,15974,41351,12325,35060,1817,5760,7073,19419,8890,25179
354900,201901,418,1128,275,864,41,133,73,216,114,349
354910,201901,4904,13450,2836,9498,622,2229,314,995,936,3224
354920,201901,448,1198,186,635,24,100,36,110,60,210
354925,201901,277,829,150,539,24,93,33,96,57,189
354930,201901,380,933,214,643,21,77,97,260,118,337
354940,201901,1939,6130,1374,4813,466,1758,185,586,651,2344
354950,201901,1446,4025,1144,3552,75,335,765,2236,840,2571
354960,201901,832,2263,639,1980,93,335,325,948,418,1283
354970,201901,3852,11291,2999,9714,427,1465,1726,5477,2153,6942
354980,201901,29008,70996,18930,53195,2337,7758,10353,27081,12690,34839
354990,201901,57392,150654,42296,122802,4669,15208,25192,69508,29861,84716
354995,201901,2416,5996,1813,5140,256,826,1154,3108,1410,3934
355000,201901,1448,3919,1136,3418,200,688,442,1202,642,1890
355010,201901,2900,8474,1917,6213,710,2400,167,564,877,2964
355020,201901,3322,9702,2411,7988,768,2789,611,1921,1379,4710
355030,201901,1266077,3182968,914837,2486107,159355,472850,438433,1098932,597788,1571782
355040,201901,2738,7429,2212,6663,379,1202,1377,4138,1756,5340
355050,201901,957,2421,683,1974,214,619,181,485,395,1104
355060,201901,5238,14897,3862,12261,677,2433,1860,5389,2537,7822
355070,201901,7733,20952,6151,18325,793,2756,3708,10315,4501,13071
355080,201901,818,2422,503,1784,112,428,51,154,163,582
355090,201901,1106,3293,827,2769,214,713,243,832,457,1545
355100,201901,20398,55278,15934,48670,2919,9542,9368,28212,12287,37754
355110,201901,944,2740,713,2348,242,840,130,448,372,1288
355120,201901,622,1679,444,1385,53,180,164,485,217,665
355130,201901,721,1646,324,868,22,58,180,440,202,498
355140,201901,1512,3853,1317,3569,121,407,1018,2648,1139,3055
355150,201901,4030,11123,3234,9708,432,1423,1865,5399,2297,6822
355160,201901,1743,5013,1289,4190,329,1230,309,964,638,2194
355170,201901,8747,23254,6837,19977,1657,5159,3286,9375,4943,14534
355180,201901,2671,7500,1896,6137,440,1631,623,1786,1063,3417
355190,201901,1768,4801,1396,4190,362,1126,680,2142,1042,3268
355200,201901,780,2531,672,2352,216,857,218,689,434,1546
355210,201901,2797,7980,2305,6939,328,1132,1304,3705,1632,4837
355220,201901,42064,115470,32864,97596,8678,27327,12352,33730,21030,61057
355230,201901,1130,2853,590,1742,109,320,162,457,271,777
355240,201901,21414,57457,14752,44266,2345,7655,7219,20827,9564,28482
355250,201901,34105,94080,24987,76489,6449,20916,8876,26041,15325,46957
355255,201901,819,2135,423,1316,81,266,135,406,216,672
355260,201901,1334,3462,944,2784,120,417,568,1589,688,2006
355270,201901,1201,3634,908,3001,242,824,281,896,523,1720
355280,201901,26659,71375,18943,56213,3221,10293,8547,24025,11768,34318
355290,201901,818,2319,597,1885,116,356,249,746,365,1102
355300,201901,1188,3549,940,3058,182,635,318,999,500,1634
355310,201901,1006,2846,751,2396,105,359,399,1287,504,1646
355320,201901,518,1406,377,1132,68,234,139,350,207,584
355330,201901,2108,5851,1608,4930,150,553,1095,3208,1245,3761
355340,201901,3504,7892,2799,6910,365,842,1825,4545,2190,5387
355350,201901,1285,3864,946,3147,200,707,305,999,505,1706
355360,201901,1278,3406,1005,2968,102,323,672,1970,774,2293
355365,201901,356,984,182,639,37,118,28,101,65,219
355370,201901,5714,14735,4281,12571,1063,3070,1798,5690,2861,8760
355380,201901,2851,7863,2118,6390,374,1249,690,1799,1064,3048
355385,201901,1325,3686,1084,3328,134,505,626,1752,760,2257
355390,201901,746,2113,547,1679,122,383,212,603,334,986
355395,201901,2003,5793,1384,4433,199,684,510,1476,709,2160
355400,201901,8639,26344,6951,22814,1953,7087,2163,6454,4116,13541
355410,201901,20715,58019,13626,44435,3308,11846,3118,10181,6426,22027
355420,201901,648,2194,532,1945,148,616,119,414,267,1030
355430,201901,3525,9133,2688,7688,720,2027,1131,3246,1851,5273
355440,201901,833,2341,490,1575,101,338,135,412,236,750
355450,201901,3319,8861,2096,6447,389,1291,788,2210,1177,3501
355460,201901,538,1351,333,992,47,164,158,423,205,587
355465,201901,378,1080,278,877,55,189,100,298,155,487
355470,201901,1136,3019,616,1933,180,598,167,486,347,1084
355475,201901,281,699,254,655,25,66,199,518,224,584
355480,201901,3508,10301,2893,9313,431,1598,1813,5650,2244,7248
355490,201901,930,2529,482,1543,45,151,224,687,269,838
355495,201901,777,2304,568,1905,77,283,198,642,275,925
355500,201901,6479,17410,3761,11799,596,2034,1107,3172,1703,5206
355510,201901,1287,3359,788,2393,115,397,284,768,399,1165
355520,201901,357,808,172,480,23,66,62,153,85,219
355530,201901,425,971,135,405,23,80,50,125,73,205
355535,201901,503,1405,381,1201,75,275,158,449,233,724
355540,201901,9225,24866,7578,22364,1480,4662,4319,12456,5799,17118
355550,201901,635,1928,519,1707,69,239,253,805,322,1044
355560,201901,1104,2939,588,1895,127,443,33,104,160,547
355570,201901,225,652,126,425,23,73,25,73,48,146
355580,201901,1185,2958,776,2285,98,350,391,1077,489,1427
355590,201901,178,451,135,388,14,39,86,235,100,274
355600,201901,1435,3648,952,2803,224,700,377,1065,601,1765
355610,201901,1693,4396,1127,3349,156,454,519,1474,675,1928
355620,201901,4310,12156,3212,9913,458,1667,1653,4669,2111,6336
355630,201901,2167,6169,1496,4836,287,950,686,2182,973,3132
355635,201901,907,2764,686,2323,119,471,259,823,378,1294
355640,201901,2576,7668,1781,6036,424,1492,376,1284,800,2776
355645,201901,4182,12286,3203,10523,420,1533,1852,5989,2272,7522
355650,201901,6288,17450,5084,15232,1412,4416,2197,6111,3609,10527
355660,201901,1258,3444,867,2670,120,478,289,872,409,1350
355670,201901,3226,9213,2159,6668,326,1192,1028,2756,1354,3948
355680,201901,3194,9109,1208,4095,343,1205,121,420,464,1625
355690,201901,741,2276,484,1738,131,493,21,56,152,549
355695,201901,217,652,122,412,15,57,13,24,28,81
355700,201901,6427,19173,5200,16384,1077,3445,2402,7266,3479,10711
355710,201901,7953,19074,4918,13526,880,2616,2035,5081,2915,7697
355715,201901,465,1242,242,771,52,189,45,120,97,309
355720,201901,1393,4194,1088,3595,205,739,512,1542,717,2281
355730,201901,905,2656,709,2253,176,571,248,732,424,1303
410010,201901,1200,3383,912,2778,197,665,212,623,409,1288
410020,201901,968,3043,770,2568,274,869,206,698,480,1567
410030,201901,1385,4054,1184,3702,178,664,609,1875,787,2539
410040,201901,10613,30996,8023,25952,1818,6371,2600,7886,4418,14257
410045,201901,909,2419,605,1849,97,331,186,536,283,867
410050,201901,2446,6210,1515,4513,362,1178,327,864,689,2042
410060,201901,2019,6019,1555,4999,383,1283,428,1349,811,2632
410070,201901,1728,4581,1236,3618,217,686,450,1255,667,1941
410080,201901,1324,3599,949,2908,159,502,389,1222,548,1724
410090,201901,990,2756,887,2578,107,305,490,1502,597,1807
410100,201901,1897,5655,1331,4276,180,691,250,759,430,1450
410105,201901,449,1210,243,759,39,142,51,150,90,292
410110,201901,3020,7993,2075,6060,313,974,813,2274,1126,3248
410115,201901,537,1376,377,1095,61,199,130,361,191,560
410120,201901,2359,7263,2058,6735,664,2329,672,2169,1336,4498
410130,201901,1096,3082,953,2816,258,856,401,1077,659,1933
410140,201901,13834,34194,8331,24225,1703,5328,1763,4641,3466,9969
410150,201901,15912,38480,7551,21582,1398,4311,1548,4178,2946,8489
410160,201901,2796,7981,2287,7083,465,1599,836,2577,1301,4176
410165,201901,701,1976,580,1707,58,191,339,934,397,1125
410170,201901,2433,6558,1570,4632,395,1257,136,421,531,1678
410180,201901,13492,39239,10596,32942,1677,5746,5459,15877,7136,21623
410185,201901,441,1229,318,981,53,174,103,291,156,465
410190,201901,2128,5528,1560,4494,336,989,419,1173,755,2162
410200,201901,4671,11398,2519,7448,449,1539,546,1590,995,3129
410210,201901,2760,7119,1720,5166,308,1066,542,1362,850,2428
410220,201901,503,1357,327,991,44,163,60,178,104,341
410230,201901,1486,4179,1204,3646,189,693,654,1853,843,2546
410240,201901,4238,11863,3149,9716,862,2941,259,753,1121,3694
410250,201901,2482,6182,1786,4966,190,652,801,2128,991,2780
410260,201901,1744,4513,1127,3363,220,677,459,1355,679,2032
410270,201901,445,1173,322,937,37,117,144,401,181,518
410275,201901,644,1889,422,1386,63,217,188,570,251,787
410280,201901,2148,5918,1378,4308,231,783,496,1454,727,2237
410290,201901,2876,8391,2120,6785,485,1566,691,2207,1176,3773
410300,201901,617,1587,490,1372,63,195,226,588,289,783
410302,201901,357,940,182,579,30,97,82,243,112,340
410304,201901,1086,3116,920,2771,125,388,518,1520,643,1908
410305,201901,1615,4067,1123,3319,187,576,601,1741,788,2317
410310,201901,2438,7275,1919,6152,410,1435,693,2189,1103,3624
410315,201901,692,1701,339,1105,111,368,73,229,184,597
410320,201901,1090,3101,700,2233,111,418,111,343,222,761
410322,201901,482,1327,262,828,20,66,119,364,139,430
410330,201901,1474,3748,1029,2877,169,512,288,805,457,1317
410335,201901,806,2295,651,1977,81,264,291,819,372,1083
410337,201901,792,1965,541,1472,53,163,250,635,303,798
410340,201901,474,1302,322,930,34,124,156,379,190,503
410345,201901,2164,5786,1109,3423,260,807,237,675,497,1482
410347,201901,673,1721,478,1366,56,198,137,378,193,576
410350,201901,1307,3477,909,2761,98,332,391,1115,489,1447
410360,201901,3902,9738,3100,8385,221,704,2016,5222,2237,5926
410370,201901,10971,29815,7346,21687,1005,3327,2798,7347,3803,10674
410380,201901,1357,3648,1005,2938,117,399,421,1142,538,1541
410390,201901,2443,6547,1572,4853,393,1314,361,1036,754,2350
410395,201901,841,2535,678,2181,132,462,297,939,429,1401
410400,201901,4883,13565,3660,11243,657,2108,1538,4570,2195,6678
410405,201901,775,1953,602,1697,147,443,250,661,397,1104
410410,201901,1139,3258,1088,3190,178,643,670,2022,848,2665
410420,201901,7457,21987,5728,18411,1119,4001,1765,5138,2884,9139
410425,201901,2776,8180,2007,6603,367,1298,671,2030,1038,3328
410430,201901,12460,32085,8480,24522,1458,4529,2805,7699,4263,12228
410440,201901,2307,7099,1978,6466,343,1255,1009,3240,1352,4495
410442,201901,2178,6901,1837,6117,539,1814,568,1882,1107,3696
410445,201901,2167,6557,1719,5670,370,1370,470,1614,840,2984
410450,201901,1424,3803,1027,3074,201,672,286,771,487,1443
410460,201901,1732,4490,1328,3863,192,601,590,1635,782,2236
410465,201901,2475,7506,1929,6330,393,1322,619,1930,1012,3252
410470,201901,1758,5259,1285,4263,323,1205,263,896,586,2101
410480,201901,32977,80939,17836,53561,3067,10313,3400,8819,6467,19132
410490,201901,10225,29306,7287,23045,1484,5132,2525,7519,4009,12651
410500,201901,1656,4657,1160,3627,272,966,281,757,553,1723
410510,201901,1983,5037,1278,3647,241,651,389,1130,630,1781
410520,201901,2960,9643,2676,9072,808,2776,1075,3715,1883,6491
410530,201901,1426,3778,708,2111,125,383,114,254,239,637
410540,201901,2419,6734,1767,5464,289,945,887,2725,1176,3670
410550,201901,6479,17808,4102,12413,747,2456,1018,2725,1765,5181
410560,201901,1384,3680,1054,3037,219,661,414,1064,633,1725
410570,201901,2437,7044,1838,5915,536,2012,147,514,683,2526
410580,201901,22609,60985,16943,50355,3525,11404,7087,19621,10612,31025
410590,201901,1397,4112,914,2878,171,560,237,664,408,1224
410600,201901,1726,4766,1300,3923,289,830,460,1448,749,2278
410610,201901,718,1957,513,1548,56,194,223,637,279,831
410620,201901,1954,5978,1259,4272,311,1137,204,635,515,1772
410630,201901,2245,6211,1447,4506,306,1026,250,654,556,1680
410640,201901,4397,10794,2832,8090,689,2215,410,1160,1099,3375
410645,201901,1009,3069,840,2828,298,1033,325,1115,623,2148
410650,201901,1931,5559,1371,4381,321,1076,416,1229,737,2305
410655,201901,890,2251,621,1758,37,128,302,802,339,930
410657,201901,623,1706,393,1220,65,241,160,427,225,668
410660,201901,3043,8065,1671,5037,331,1060,337,961,668,2021
410670,201901,1014,2526,587,1680,106,301,268,728,374,1029
410680,201901,2669,8257,1923,6408,485,1564,474,1643,959,3207
410685,201901,548,1442,434,1240,87,282,206,546,293,828
410690,201901,114491,294143,75346,219482,13379,43943,25343,65001,38722,108944
410700,201901,2278,5937,1933,5397,326,974,968,2584,1294,3558
410710,201901,811,2103,532,1588,59,190,272,778,331,968
410712,201901,640,1940,546,1735,141,472,194,577,335,1049
410715,201901,851,2597,514,1789,106,379,155,535,261,914
410720,201901,2990,8029,2172,6395,326,1144,441,1137,767,2281
410725,201901,1081,2757,637,1913,128,405,110,293,238,698
410730,201901,580,1547,421,1254,86,296,95,260,181,556
410740,201901,905,2588,647,2091,102,358,257,810,359,1168
410750,201901,1625,4306,1328,3782,219,678,542,1497,761,2175
410752,201901,344,896,157,485,24,83,62,171,86,254
410753,201901,212,648,152,513,14,51,30,97,44,148
410754,201901,1088,2901,891,2595,62,157,584,1815,646,1972
410755,201901,578,1517,418,1194,58,196,196,485,254,681
410760,201901,3162,8424,2327,6931,689,2266,545,1557,1234,3823
410765,201901,11836,34548,9185,29185,1587,5575,1523,4507,3110,10082
410770,201901,940,2328,652,1835,74,228,308,850,382,1078
410773,201901,1249,3389,1094,3141,123,400,715,1990,838,2390
410775,201901,1382,3655,1203,3379,102,334,682,1856,784,2190
410780,201901,583,1466,353,995,63,180,85,238,148,418
410785,201901,716,2074,576,1807,103,347,210,635,313,982
410790,201901,590,1728,477,1496,125,438,57,130,182,568
410800,201901,3102,7191,2473,6198,89,277,1522,3685,1611,3962
410810,201901,365,1015,280,853,43,147,121,345,164,492
410820,201901,740,2193,393,1244,79,265,73,206,152,471
410830,201901,28861,73461,19786,57912,4623,15220,6520,18090,11143,33310
410832,201901,963,2565,780,2239,103,349,431,1137,534,1486
410840,201901,7127,19100,4295,13438,912,3157,798,2196,1710,5353
410845,201901,1104,2998,889,2646,174,561,327,945,501,1506
410850,201901,2215,6648,1921,6097,352,1196,878,2767,1230,3963
410855,201901,694,1784,462,1338,39,118,210,563,249,681
410860,201901,3728,9785,2903,8255,545,1701,1100,2924,1645,4625
410865,201901,1345,4229,1184,3877,197,702,650,2177,847,2879
410870,201901,1241,3444,1057,3147,46,154,768,2259,814,2413
410880,201901,4019,11422,2905,9252,529,1896,421,1446,950,3342
410890,201901,923,2691,666,2145,161,561,183,578,344,1139
410895,201901,926,3114,768,2744,293,1116,125,428,418,1544
410900,201901,888,2435,577,1801,99,326,123,313,222,639
410910,201901,363,883,199,561,12,37,118,306,130,343
410920,201901,793,1940,538,1529,78,263,239,662,317,925
410930,201901,1392,3833,1028,3139,269,964,242,723,511,1687
410940,201901,20521,58856,14987,48490,3429,12051,4008,12991,7437,25042
410950,201901,1885,5603,1684,5286,71,290,1379,4234,1450,4524
410960,201901,6766,17930,4333,13535,1051,3677,1517,4597,2568,8274
410965,201901,925,2542,693,2092,108,329,362,1077,470,1406
410970,201901,3647,10136,2586,8111,643,2434,358,953,1001,3387
410975,201901,1252,3300,956,2777,160,530,349,994,509,1524
410980,201901,6447,16966,4142,12602,568,1908,1643,4728,2211,6636
410990,201901,1192,3069,763,2330,243,861,160,397,403,1258
411000,201901,500,1381,351,1078,55,197,97,248,152,445
411005,201901,418,1162,263,818,56,182,49,147,105,329
411007,201901,2113,6219,1748,5543,409,1397,561,1788,970,3185
411010,201901,4078,12547,3208,10692,857,3078,293,884,1150,3962
411020,201901,2287,6704,1881,5996,563,1902,538,1656,1101,3558
411030,201901,696,1784,457,1272,48,164,214,535,262,699
411040,201901,797,2073,374,1112,46,146,106,281,152,427
411050,201901,1756,5735,1453,5014,398,1453,206,624,604,2077
411060,201901,1622,4363,1046,3199,196,737,194,532,390,1269
411065,201901,337,934,245,756,35,109,104,321,139,430
411070,201901,6189,16673,4890,14350,892,2888,2116,6019,3008,8907
411080,201901,2085,5735,1657,4951,427,1393,431,1261,858,2654
411090,201901,839,2228,512,1570,47,175,120,342,167,517
411095,201901,1492,3579,1019,2797,124,403,359,931,483,1334
411100,201901,1069,2832,713,2180,84,299,203,641,287,940
411110,201901,599,1583,253,807,33,92,18,43,51,135
411120,201901,1185,3451,931,2916,323,1142,189,470,512,1612
411125,201901,4788,14389,4346,13550,948,3050,2093,6722,3041,9772
411130,201901,674,1886,477,1480,93,296,174,556,267,852
411140,201901,2175,6869,1796,5985,472,1682,606,2014,1078,3696
411150,201901,3560,9539,2479,7301,522,1765,193,418,715,2183
411155,201901,936,2437,543,1659,55,175,249,708,304,883
411160,201901,334,792,212,602,25,77,50,146,75,223
411170,201901,694,2152,510,1714,107,358,172,561,279,919
411180,201901,5151,14181,3961,11989,695,2312,1692,4856,2387,7168
411190,201901,1407,3749,1017,3023,188,580,309,862,497,1442
411200,201901,4808,13321,3296,10359,927,3159,686,2001,1613,5160
411210,201901,2525,5866,1686,4558,398,1240,387,959,785,2199
411220,201901,831,2248,612,1792,133,410,183,530,316,940
411230,201901,788,2188,533,1677,102,344,202,633,304,977
411240,201901,1543,3797,898,2527,87,282,436,1150,523,1432
411250,201901,2005,5542,1499,4615,346,1228,449,1356,795,2584
411260,201901,311,825,207,620,24,71,84,226,108,297
411270,201901,1811,5110,1392,4228,238,740,619,1810,857,2550
411275,201901,1279,3133,907,2490,150,473,385,976,535,1449
411280,201901,1297,3564,838,2659,188,600,113,343,301,943
411290,201901,710,1985,493,1555,59,174,240,764,299,938
411295,201901,1117,2850,835,2301,78,249,415,1090,493,1339
411300,201901,993,2518,618,1755,72,225,229,564,301,789
411310,201901,858,2055,642,1738,43,116,289,777,332,893
411320,201901,5124,13891,3698,11207,799,2551,1289,3574,2088,6125
411325,201901,1465,4263,1229,3835,216,668,662,2126,878,2794
411330,201901,3125,8758,2298,7202,565,1940,647,2075,1212,4015
411340,201901,844,2362,514,1598,60,217,204,594,264,811
411342,201901,935,2305,581,1627,89,255,264,729,353,984
411345,201901,1020,2764,771,2346,92,310,511,1556,603,1866
411350,201901,2368,6715,1590,5087,445,1551,165,503,610,2054
411360,201901,615,1520,427,1229,54,174,138,382,192,556
411370,201901,46718,118226,33465,95529,3017,10312,18967,50659,21984,60971
411373,201901,1297,3454,1062,3077,116,376,532,1578,648,1954
411375,201901,1039,2681,742,2116,123,370,280,741,403,1111
411380,201901,1017,2433,701,1795,49,147,424,991,473,1138
411390,201901,1584,4505,1217,3680,194,647,464,1264,658,1911
411400,201901,2076,5410,1601,4509,227,771,749,1994,976,2765
411410,201901,1992,5740,1474,4570,342,1173,294,867,636,2040
411420,201901,3814,9745,2153,6486,337,1171,385,941,722,2112
411430,201901,3217,9018,2523,7711,544,1843,986,2750,1530,4593
411435,201901,402,1176,263,869,47,149,92,262,139,411
411440,201901,2435,7242,1994,6330,425,1501,699,2206,1124,3707
411450,201901,2508,6806,1883,5743,270,803,983,3025,1253,3828
411460,201901,3617,9744,2047,6480,385,1414,331,945,716,2359
411470,201901,681,1897,497,1504,90,296,150,411,240,707
411480,201901,4188,11766,2942,9303,605,2172,824,2410,1429,4582
411490,201901,1511,4065,1150,3430,172,587,412,1091,584,1678
411500,201901,1348,3672,882,2682,130,464,247,678,377,1142
411510,201901,2131,5741,1700,4950,364,1226,390,1162,754,2388
411520,201901,27497,67936,15326,44356,2127,6926,5201,13510,7328,20436
411530,201901,903,2452,556,1758,123,435,96,282,219,717
411535,201901,458,1359,221,768,19,67,33,87,52,154
411540,201901,2656,6887,1812,5171,270,861,711,1969,981,2830
411545,201901,917,2744,768,2475,73,245,501,1619,574,1864
411550,201901,671,1758,468,1352,83,265,84,242,167,507
411560,201901,1823,4926,1055,3296,161,595,69,162,230,757
411570,201901,6541,15998,4451,12590,973,3054,1206,3385,2179,6439
411573,201901,758,2119,644,1922,75,248,372,1077,447,1325
411575,201901,1725,4909,1309,4045,275,916,345,1027,620,1943
411580,201901,4106,9791,2307,6949,303,1116,340,877,643,1993
411585,201901,640,1889,288,973,83,286,36,100,119,386
411590,201901,365,1054,253,794,28,103,136,389,164,492
411600,201901,286,769,169,560,42,144,57,187,99,331
411605,201901,1463,3510,874,2470,119,408,435,1186,554,1594
411610,201901,2240,5734,1543,4321,130,419,896,2378,1026,2797
411620,201901,2752,7617,2355,6996,398,1304,1336,3887,1734,5191
411630,201901,703,1851,468,1392,87,300,143,369,230,669
411640,201901,525,1457,351,1044,46,141,126,335,172,476
411650,201901,201,588,133,438,27,88,27,91,54,179
411660,201901,887,2287,633,1800,51,143,332,917,383,1060
411670,201901,1166,3018,813,2253,112,322,318,814,430,1136
411680,201901,1504,4146,1184,3529,125,423,620,1844,745,2267
411690,201901,3394,9111,2603,7746,533,1661,811,2526,1344,4187
411695,201901,581,1804,431,1448,62,223,158,533,220,756
411700,201901,1557,4187,1034,3182,253,860,127,338,380,1198
411705,201901,1811,5842,1531,5335,320,1098,825,3053,1145,4151
411710,201901,1762,4619,1239,3654,351,1103,162,474,513,1577
411720,201901,1036,2534,714,1932,109,324,304,762,413,1086
411721,201901,850,2245,634,1837,132,393,139,404,271,797
411722,201901,682,1887,383,1180,60,222,150,409,210,631
411725,201901,1173,3472,783,2630,186,648,163,562,349,1210
411727,201901,1392,4004,908,2952,265,901,119,359,384,1260
411729,201901,666,1638,435,1193,59,202,146,356,205,558
411730,201901,5086,14119,3783,11453,1025,3230,1274,3768,2299,6998
411740,201901,527,1414,269,851,52,167,54,161,106,328
411745,201901,739,2163,472,1521,61,212,87,222,148,434
411750,201901,4729,12782,3384,10034,457,1485,1623,4527,2080,6012
411760,201901,6756,18455,5183,15620,1804,5641,978,3248,2782,8889
411770,201901,2951,8861,2143,7003,565,1972,278,855,843,2827
411780,201901,2823,8218,2408,7372,672,2177,843,2585,1515,4762
411790,201901,2772,6946,1504,4542,362,1232,188,465,550,1697
411800,201901,961,2750,657,2039,115,363,126,378,241,741
411810,201901,1556,4092,1165,3354,189,586,563,1508,752,2094
411820,201901,10068,30685,8308,27271,2497,8597,2999,9708,5496,18305
411830,201901,586,1471,396,1131,83,250,86,266,169,516
411840,201901,11105,30173,7285,22073,1346,4439,1866,5196,3212,9635
411845,201901,422,1245,223,746,39,157,18,51,57,208
411850,201901,7023,18831,5012,15142,1477,4941,706,1919,2183,6860
411860,201901,707,2095,520,1680,109,397,131,380,240,777
411870,201901,637,1979,431,1458,88,328,93,282,181,610
411880,201901,1975,5247,1441,4309,298,957,332,972,630,1929
411885,201901,1009,2664,715,2120,101,354,248,717,349,1071
411890,201901,1103,3049,743,2322,131,470,57,146,188,616
411900,201901,782,2278,468,1550,117,396,51,180,168,576
411910,201901,922,2882,674,2308,183,663,182,595,365,1258
411915,201901,14954,37676,9401,27408,1635,5220,2984,7814,4619,13034
411920,201901,963,3040,810,2688,208,747,241,765,449,1512
411925,201901,487,1301,329,1003,77,261,104,299,181,560
411930,201901,4947,15969,4215,14511,1953,7214,261,1047,2214,8261
411940,201901,3078,9582,2373,7886,624,2159,611,1832,1235,3991
411950,201901,12787,35975,10443,31962,1951,6584,5377,15895,7328,22479
411960,201901,5418,15147,4446,13140,950,3071,1562,4333,2512,7404
411965,201901,413,1172,290,915,48,172,110,323,158,495
411970,201901,978,2404,753,2080,143,373,346,1069,489,1442
411980,201901,1434,3766,1063,3099,264,827,400,1093,664,1920
411990,201901,33354,93413,22753,72343,4757,16694,7529,22768,12286,39462
411995,201901,2754,7242,2081,6162,596,1971,588,1603,1184,3574
412000,201901,2009,4692,1445,3737,60,205,973,2353,1033,2558
412010,201901,610,1929,416,1460,63,252,103,297,166,549
412015,201901,553,1589,458,1413,57,192,260,793,317,985
412020,201901,429,1223,256,839,36,133,100,317,136,450
412030,201901,620,1804,431,1429,77,264,131,432,208,696
412033,201901,814,2245,566,1708,76,227,196,561,272,788
412035,201901,766,2077,492,1581,67,252,239,718,306,970
412040,201901,563,1557,349,1098,68,231,60,166,128,397
412050,201901,1689,4386,1161,3398,210,710,288,830,498,1540
412060,201901,6865,21394,5813,19265,1760,6446,1452,4578,3212,11024
412065,201901,593,1653,430,1327,86,272,132,415,218,687
412070,201901,1105,2879,838,2322,119,347,354,945,473,1292
412080,201901,1825,5378,1145,3830,193,686,118,341,311,1027
412085,201901,280,733,96,312,16,50,11,24,27,74
412090,201901,5464,14588,4325,12480,1185,3474,1706,5064,2891,8538
412100,201901,1673,4696,1251,3934,381,1278,243,834,624,2112
412110,201901,829,2296,608,1817,107,333,195,567,302,900
412120,201901,1783,5490,1403,4692,304,1145,405,1183,709,2328
412125,201901,640,1904,467,1526,103,345,155,479,258,824
412130,201901,666,1768,469,1372,63,200,123,373,186,573
412135,201901,581,1577,261,792,44,135,87,234,131,369
412140,201901,1529,3912,985,2921,225,778,152,395,377,1173
412150,201901,2800,7600,2337,6753,351,1132,1396,3865,1747,4997
412160,201901,992,3146,601,2110,137,526,85,275,222,801
412170,201901,4073,11806,3432,10676,750,2499,1424,4137,2174,6636
412175,201901,1234,3831,1038,3449,263,869,393,1345,656,2214
412180,201901,1671,4693,1211,3819,175,663,506,1427,681,2090
412190,201901,3232,8304,2385,6763,307,958,1081,3071,1388,4029
412200,201901,1708,5265,1223,4063,332,1169,199,629,531,1798
412210,201901,607,1550,341,1027,66,223,90,231,156,454
412215,201901,3538,9646,2851,8325,787,2258,1133,3747,1920,6005
412217,201901,976,2627,820,2371,68,217,545,1526,613,1743
412220,201901,5621,16147,4547,14084,1189,3693,1432,4683,2621,8376
412230,201901,2554,7910,2063,6898,412,1570,559,1596,971,3166
412240,201901,6397,16738,4052,12092,755,2480,1100,3028,1855,5508
412250,201901,1933,5125,1480,4273,380,1109,293,833,673,1942
412260,201901,1203,3335,851,2574,143,439,252,704,395,1143
412265,201901,780,2293,661,2054,129,432,290,863,419,1295
412270,201901,759,2198,501,1610,76,266,194,561,270,827
412280,201901,454,1344,360,1182,85,286,105,323,190,609
412290,201901,962,2487,642,1882,108,339,206,583,314,922
412300,201901,1379,3884,1086,3307,277,878,245,742,522,1620
412310,201901,761,2128,625,1884,56,247,336,962,392,1209
412320,201901,812,2106,554,1618,73,290,202,569,275,859
412330,201901,1417,3927,960,2996,171,568,353,1130,524,1698
412340,201901,1000,2908,621,2007,107,375,120,358,227,733
412350,201901,2639,7130,1719,5283,364,1112,360,1136,724,2248
412360,201901,238,660,147,462,14,49,66,196,80,245
412370,201901,753,2228,516,1725,98,375,37,135,135,510
412380,201901,1487,4170,1028,3189,285,915,160,535,445,1450
412382,201901,507,1302,338,1000,56,186,109,277,165,463
412385,201901,2099,5958,1715,5185,585,1706,497,1636,1082,3342
412390,201901,2360,6028,1894,5281,342,995,818,2267,1160,3262
412395,201901,675,1939,464,1468,56,185,202,613,258,798
412400,201901,864,2367,621,1878,136,427,159,516,295,943
412402,201901,1730,4454,1235,3621,321,1028,145,430,466,1458
412405,201901,3042,8340,1952,6112,468,1713,59,176,527,1889
412410,201901,5186,14145,3736,11524,777,2709,1013,2911,1790,5620
412420,201901,471,1249,287,848,30,105,112,291,142,396
412430,201901,534,1403,351,1051,32,101,161,458,193,559
412440,201901,2661,7568,1782,5811,529,1847,276,922,805,2769
412450,201901,357,1104,236,791,44,144,20,48,64,192
412460,201901,959,2643,770,2326,136,456,314,939,450,1395
412470,201901,1602,5250,1302,4553,349,1271,311,1140,660,2411
412480,201901,893,2498,569,1766,103,339,126,340,229,679
412490,201901,1102,2891,903,2498,105,285,503,1333,608,1618
412500,201901,1782,4683,1345,3835,327,939,322,860,649,1799
412510,201901,1912,5993,1331,4450,316,1115,103,310,419,1425
412520,201901,1294,3452,686,2092,162,494,44,128,206,622
412530,201901,647,1768,470,1397,69,234,118,345,187,579
412535,201901,766,2070,522,1582,116,395,99,264,215,659
412540,201901,1211,3270,840,2494,96,345,266,795,362,1140
412545,201901,671,1775,449,1315,74,235,122,330,196,565
412550,201901,28446,79120,19658,60862,3799,12690,6721,19314,10520,32004
412555,201901,233,630,150,453,21,70,39,86,60,156
412560,201901,4660,13981,3455,11120,636,2231,1012,3216,1648,5447
412570,201901,3786,10150,2234,7003,499,1682,324,1109,823,2791
412575,201901,935,2470,760,2129,82,264,448,1172,530,1436
412580,201901,1305,3520,904,2726,142,478,410,1195,552,1673
412590,201901,397,1072,209,683,44,159,20,61,64,220
412600,201901,1353,3919,1004,3167,168,597,401,1211,569,1808
412610,201901,793,2181,512,1532,58,196,241,637,299,833
412620,201901,1244,3451,915,2845,191,665,273,792,464,1457
412625,201901,8015,21914,5057,15883,798,2801,306,912,1104,3713
412627,201901,1003,2868,656,2140,160,586,172,540,332,1126
412630,201901,2753,8155,1978,6417,391,1278,646,1890,1037,3168
412635,201901,332,892,222,638,37,116,63,155,100,271
412640,201901,1030,2861,576,1812,87,306,131,350,218,656
412650,201901,1506,4309,1190,3638,219,742,412,1092,631,1834
412660,201901,2414,6551,1701,5118,306,1011,511,1373,817,2384
412665,201901,506,1264,295,867,56,164,112,310,168,474
412667,201901,1691,4538,1257,3678,179,585,492,1353,671,1938
412670,201901,758,1908,500,1446,89,302,171,464,260,766
412680,201901,1499,4176,971,3097,133,480,390,1119,523,1599
412690,201901,846,2387,622,1903,110,356,201,579,311,935
412700,201901,2019,5491,1618,4841,260,935,762,2169,1022,3104
412710,201901,5701,17227,4456,14579,984,3544,1279,3890,2263,7434
412720,201901,1199,3578,893,2853,159,534,181,492,340,1026
412730,201901,2005,5583,1147,3719,237,836,202,619,439,1455
412740,201901,1686,4813,1112,3552,210,727,167,549,377,1276
412750,201901,3738,10367,3209,9554,394,1387,2052,5809,2446,7196
412760,201901,2784,7799,2319,6970,369,1222,1290,3718,1659,4940
412770,201901,9610,24972,5076,15758,749,2454,1010,2770,1759,5224
412780,201901,1187,3307,918,2804,200,664,349,1032,549,1696
412785,201901,1881,4871,1342,3899,213,642,711,2013,924,2655
412788,201901,1287,3758,1045,3274,254,807,453,1387,707,2194
412790,201901,1226,3303,662,2100,122,454,195,520,317,974
412795,201901,1297,3473,682,2121,128,424,120,354,248,778
412796,201901,2272,6851,1872,5992,390,1309,621,1860,1011,3169
412800,201901,3254,8244,2204,6249,295,942,918,2326,1213,3268
412810,201901,10224,26396,6174,18055,863,2870,2061,5308,2924,8178
412820,201901,6185,17464,4446,13955,1041,3403,1343,4294,2384,7697
412830,201901,339,978,225,711,39,113,47,149,86,262
412840,201901,1758,4626,1248,3610,171,542,428,1171,599,1713
412850,201901,2795,7569,2047,6221,364,1195,738,2162,1102,3357
412853,201901,1623,4284,1340,3695,160,487,687,1717,847,2204
412855,201901,1167,3166,750,2247,156,526,197,538,353,1064
412860,201901,765,2039,551,1661,75,248,254,739,329,987
412862,201901,701,1688,458,1266,72,216,211,568,283,784
412863,201901,1180,3677,1095,3540,121,400,787,2556,908,2956
412865,201901,706,2024,515,1651,98,326,179,574,277,900
412870,201901,864,2358,658,2021,205,717,137,438,342,1155
412880,201901,827,2315,526,1671,96,321,75,217,171,538
420005,201901,442,1335,237,849,35,130,102,378,137,508
420010,201901,3370,8531,2224,6492,185,600,1567,4555,1752,5155
420020,201901,464,1449,289,1007,48,188,46,135,94,323
420030,201901,75,264,51,214,21,93,11,45,32,138
420040,201901,551,1728,325,1211,54,228,17,44,71,272
420050,201901,635,1561,400,1130,50,161,251,670,301,831
420055,201901,154,464,77,277,14,61,23,76,37,137
420060,201901,112,326,69,217,11,41,17,35,28,76
420070,201901,777,2519,584,2048,121,445,206,697,327,1142
420075,201901,81,220,38,118,7,20,10,19,17,39
420080,201901,344,1029,266,860,84,288,77,242,161,530
420090,201901,397,1298,248,913,62,237,54,198,116,435
420100,201901,1119,3129,966,2897,49,171,779,2313,828,2484
420110,201901,240,799,216,751,44,171,87,277,131,448
420120,201901,403,1187,266,874,53,204,103,295,156,499
420125,201901,308,1016,241,868,61,243,114,389,175,632
420127,201901,274,791,95,342,20,82,20,67,40,149
420130,201901,2076,6106,1544,5078,304,1188,678,2045,982,3233
420140,201901,3201,8892,2283,7260,654,2377,287,876,941,3253
420150,201901,552,1438,338,1071,60,210,160,478,220,688
420160,201901,233,601,110,350,13,46,35,100,48,146
420165,201901,157,464,92,310,22,74,27,85,49,159
420170,201901,246,754,151,528,21,73,25,77,46,150
420180,201901,181,561,104,367,14,52,36,112,50,164
420190,201901,160,532,93,357,33,135,16,58,49,193
420195,201901,1245,3386,918,2852,285,1012,115,300,400,1312
420200,201901,3266,8715,1881,5954,306,1195,659,1796,965,2991
420205,201901,1260,3516,914,2914,148,482,509,1650,657,2132
420207,201901,1505,4119,960,3059,204,748,354,1087,558,1835
420208,201901,368,1048,208,767,37,157,86,315,123,472
420209,201901,144,493,94,335,25,110,31,95,56,205
420210,201901,2287,6209,1496,4906,335,1234,640,2027,975,3261
420213,201901,739,2383,617,2130,145,537,290,985,435,1522
420215,201901,207,634,145,497,43,151,25,71,68,222
420220,201901,219,670,132,468,29,123,54,168,83,291
420230,201901,3940,11243,2987,9464,437,1541,1583,4870,2020,6411
420240,201901,10865,30060,6892,21367,931,3412,3466,9480,4397,12892
420243,201901,375,1099,299,944,51,178,161,483,212,661
420245,201901,1194,3276,839,2636,95,383,464,1372,559,1755
420250,201901,410,1219,356,1117,77,281,177,506,254,787
420253,201901,496,1285,363,1084,29,100,194,560,223,660
420257,201901,179,472,105,334,19,66,53,161,72,227
420260,201901,1007,2842,740,2425,118,440,430,1387,548,1827
420270,201901,422,1149,198,618,22,75,74,222,96,297
420280,201901,1177,3393,812,2675,174,638,224,719,398,1357
420285,201901,93,258,53,176,6,27,8,18,14,45
420287,201901,438,1114,299,889,89,281,94,275,183,556
420290,201901,3661,10663,2774,8683,447,1624,1412,3995,1859,5619
420300,201901,6182,17828,3590,11781,730,2674,944,2755,1674,5429
420310,201901,806,1945,378,1072,68,204,166,425,234,629
420315,201901,793,2420,558,1937,140,534,196,670,336,1204
420320,201901,3819,11243,3000,9759,960,3442,678,2039,1638,5481
420325,201901,236,716,174,602,39,127,59,201,98,328
420330,201901,826,2527,539,1878,127,504,180,559,307,1063
420340,201901,905,2689,659,2182,160,556,59,188,219,744
420350,201901,1284,3504,905,2772,100,340,568,1707,668,2047
420360,201901,2381,6847,1280,4338,260,948,133,445,393,1393
420370,201901,1045,2943,837,2578,103,388,564,1663,667,2051
420380,201901,4514,12378,2943,9324,662,2254,963,2936,1625,5190
420390,201901,1021,2578,670,1829,112,365,299,609,411,974
420395,201901,931,2763,615,2077,106,374,68,211,174,585
420400,201901,869,2591,566,1897,116,433,171,552,287,985
420410,201901,503,1422,374,1154,38,135,233,681,271,816
420415,201901,286,881,213,718,71,260,65,229,136,489
420417,201901,595,1842,488,1606,128,430,174,589,302,1019
420419,201901,149,538,118,453,45,185,9,29,54,214
420420,201901,9916,27075,6759,21244,2215,7648,1624,4720,3839,12368
420425,201901,656,1767,461,1404,42,155,206,609,248,764
420430,201901,2783,7932,1747,5573,456,1577,522,1474,978,3051
420435,201901,253,669,107,372,19,79,44,149,63,228
420440,201901,653,1933,381,1283,122,448,94,272,216,720
420445,201901,294,783,176,532,37,118,56,156,93,274
420450,201901,628,1920,458,1532,88,360,153,455,241,815
420455,201901,1889,4898,1403,4116,187,635,718,2005,905,2640
420460,201901,8192,22626,6116,18795,1034,3625,2917,8553,3951,12178
420470,201901,568,1563,323,1063,64,247,79,227,143,474
420475,201901,50,148,26,91,10,33,3,13,13,46
420480,201901,4688,12341,3062,9507,644,2186,973,2960,1617,5146
420490,201901,354,1073,239,821,58,230,74,246,132,476
420500,201901,1252,3755,886,3025,180,646,330,1109,510,1755
420510,201901,170,493,95,320,16,58,29,92,45,150
420515,201901,51,137,32,95,2,3,17,53,19,56
420517,201901,744,2069,643,1898,51,146,494,1456,545,1602
420519,201901,299,720,193,558,26,82,91,270,117,352
420520,201901,363,970,159,555,21,67,14,49,35,116
420530,201901,783,2330,554,1839,121,459,159,464,280,923
420535,201901,185,528,82,287,22,81,18,69,40,150
420540,201901,25316,61969,16021,45526,2848,9092,5737,13924,8585,23016
420543,201901,217,660,170,547,26,80,83,256,109,336
420545,201901,1036,3171,784,2602,169,602,292,932,461,1534
420550,201901,3245,9318,2126,7229,446,1671,892,3071,1338,4742
420555,201901,282,827,188,631,37,141,86,262,123,403
420560,201901,420,1093,291,888,67,198,149,453,216,651
420570,201901,1977,5752,1505,4830,310,1102,554,1663,864,2765
420580,201901,1608,4242,1169,3572,251,790,538,1655,789,2445
420590,201901,2727,7484,1597,4986,313,1124,382,909,695,2033
420600,201901,919,2804,701,2348,139,519,307,976,446,1495
420610,201901,311,937,183,637,45,160,47,165,92,325
420620,201901,496,1333,363,1106,106,327,127,385,233,712
420630,201901,859,2596,612,1958,127,449,284,810,411,1259
420640,201901,490,1413,234,829,61,220,22,68,83,288
420650,201901,2847,7945,1698,5407,290,1013,638,1774,928,2787
420660,201901,345,988,236,764,59,205,64,201,123,406
420665,201901,507,1360,317,1021,59,206,126,364,185,570
420670,201901,1349,3757,884,2863,145,591,340,974,485,1565
420675,201901,124,370,79,278,28,117,14,34,42,151
420680,201901,325,788,180,580,28,102,89,282,117,384
420690,201901,789,2486,480,1663,78,305,107,306,185,611
420700,201901,2588,7179,1987,6113,292,1027,1017,2986,1309,4013
420710,201901,674,2057,508,1671,80,331,264,771,344,1102
420720,201901,1272,3565,910,2973,230,740,390,1264,620,2004
420730,201901,2589,7068,1997,6120,337,1081,1125,3354,1462,4435
420740,201901,612,1871,377,1347,110,418,39,152,149,570
420750,201901,1690,5101,1125,3765,210,809,419,1281,629,2090
420757,201901,60,167,28,107,4,18,10,35,14,53
420760,201901,339,1023,148,483,37,127,23,72,60,199
420765,201901,359,1149,200,713,27,97,79,283,106,380
420768,201901,1152,3591,996,3295,171,560,664,2189,835,2749
420770,201901,439,1205,203,729,37,148,83,283,120,431
420775,201901,369,1094,234,801,53,209,44,124,97,333
420780,201901,931,2691,549,1862,122,444,108,328,230,772
420785,201901,192,533,137,417,17,56,53,142,70,198
420790,201901,964,3118,720,2579,167,679,341,1146,508,1825
420800,201901,700,1811,327,1042,93,296,68,231,161,527
420810,201901,1404,4703,1152,4152,367,1488,302,934,669,2422
420820,201901,9647,25021,6629,20020,1382,4729,2876,7828,4258,12557
420830,201901,2899,8163,2181,6844,497,1695,844,2591,1341,4286
420840,201901,506,1558,233,867,64,239,46,168,110,407
420845,201901,1856,4970,1087,3572,227,849,369,1180,596,2029
420850,201901,1035,3438,638,2378,154,626,90,286,244,912
420860,201901,258,673,146,467,42,158,30,83,72,241
420870,201901,778,2147,617,1885,178,642,267,758,445,1400
420880,201901,859,2716,677,2331,142,534,225,706,367,1240
420890,201901,7391,20166,4184,13497,701,2516,1227,3365,1928,5881
420895,201901,153,463,88,288,27,95,30,92,57,187
420900,201901,1314,3417,783,2463,116,441,325,902,441,1343
420910,201901,24168,65680,15162,48047,2509,8973,5529,15835,8038,24808
420915,201901,513,1925,368,1485,65,264,163,666,228,930
420917,201901,330,892,176,521,26,85,76,218,102,303
420920,201901,78,224,28,108,4,17,2,9,6,26
420930,201901,16346,43854,11710,35684,2131,7144,5373,15608,7504,22752
420940,201901,2180,5623,1351,4158,328,1128,183,441,511,1569
420945,201901,123,364,95,300,27,105,33,90,60,195
420950,201901,307,919,169,577,28,106,46,133,74,239
420960,201901,908,2366,620,1835,113,385,250,662,363,1047
420970,201901,2370,6995,1597,5397,471,1630,246,870,717,2500
420980,201901,295,922,237,833,110,382,75,293,185,675
420985,201901,289,865,151,540,31,124,51,159,82,283
420990,201901,387,1190,197,733,41,159,34,108,75,267
421000,201901,456,1507,304,1130,78,320,67,205,145,525
421003,201901,443,1055,144,440,18,56,24,60,42,116
421005,201901,53,179,48,172,11,39,22,80,33,119
421010,201901,3297,9226,2359,7552,508,1796,550,1569,1058,3365
421020,201901,355,1108,280,974,32,128,170,579,202,707
421030,201901,713,2269,569,1966,173,659,160,503,333,1162
421040,201901,672,1609,406,1197,38,127,246,707,284,834
421050,201901,1052,3001,671,2145,133,460,230,676,363,1136
421055,201901,168,463,82,259,15,50,30,77,45,127
421060,201901,526,1598,339,1116,64,242,131,391,195,633
421070,201901,497,1539,282,992,62,227,38,132,100,359
421080,201901,453,1352,401,1262,54,180,258,824,312,1004
421085,201901,350,1057,144,541,27,111,20,56,47,167
421090,201901,279,756,161,509,21,70,46,145,67,215
421100,201901,886,2061,379,1144,86,287,59,168,145,455
421105,201901,1353,3808,1038,3262,160,491,588,1898,748,2389
421110,201901,1017,2977,860,2742,44,128,608,2022,652,2150
421120,201901,869,2807,611,2178,85,340,196,636,281,976
421125,201901,252,700,207,627,73,244,70,173,143,417
421130,201901,3711,11363,3131,10224,697,2535,1706,5370,2403,7905
421140,201901,276,773,179,573,35,116,60,167,95,283
421145,201901,446,1279,266,861,54,198,119,356,173,554
421150,201901,518,1421,269,908,50,191,89,294,139,485
421160,201901,551,1471,351,1110,50,174,203,625,253,799
421165,201901,188,585,127,438,30,103,51,180,81,283
421170,201901,1018,2805,811,2472,130,392,514,1592,644,1984
421175,201901,1022,2721,671,2147,134,492,263,763,397,1255
421180,201901,347,937,185,603,43,177,46,138,89,315
421185,201901,302,818,201,611,32,98,109,324,141,422
421187,201901,296,872,187,596,35,114,68,203,103,317
421189,201901,336,1010,261,849,45,147,87,272,132,419
421190,201901,8978,24846,5816,18975,1249,4468,1447,4487,2696,8955
421200,201901,618,1911,509,1682,83,291,271,868,354,1159
421205,201901,187,524,138,444,27,97,71,219,98,316
421210,201901,1034,2797,638,2070,156,513,208,671,364,1184
421220,201901,1276,4069,1017,3479,236,897,239,720,475,1617
421223,201901,364,1056,241,814,60,192,104,353,164,545
421225,201901,863,2688,748,2468,153,547,419,1397,572,1944
421227,201901,956,2552,558,1757,94,315,254,801,348,1116
421230,201901,567,1544,359,1148,98,337,104,325,202,662
421240,201901,303,934,124,471,16,83,16,60,32,143
421250,201901,1451,3860,968,3046,157,550,421,1288,578,1838
421260,201901,165,472,43,160,10,39,8,32,18,71
421265,201901,579,1715,540,1659,17,59,491,1517,508,1576
421270,201901,395,1069,178,655,31,116,65,237,96,353
421280,201901,1482,4455,1124,3781,243,965,489,1528,732,2493
421290,201901,740,2039,398,1243,81,264,84,257,165,521
421300,201901,237,654,136,441,18,63,41,136,59,199
421310,201901,154,481,119,399,21,77,55,184,76,261
421315,201901,192,557,119,391,37,120,22,70,59,190
421320,201901,596,1751,307,1017,50,171,48,108,98,279
421330,201901,605,1806,425,1442,95,361,117,375,212,736
421335,201901,338,1065,278,957,51,196,111,378,162,574
421340,201901,1225,3607,913,3018,213,773,364,1178,577,1951
421350,201901,1121,3180,794,2578,157,605,333,1010,490,1615
421360,201901,2156,6075,1309,4335,276,1083,464,1359,740,2442
421370,201901,469,1582,284,1081,65,258,70,256,135,514
421380,201901,792,2197,678,1997,96,324,403,1154,499,1478
421390,201901,176,475,63,212,11,32,18,52,29,84
421400,201901,239,799,167,626,33,146,78,265,111,411
421410,201901,250,688,109,385,18,66,38,135,56,201
421415,201901,221,688,131,441,37,128,29,83,66,211
421420,201901,497,1447,422,1301,74,254,243,707,317,961
421430,201901,115,389,89,328,12,50,33,104,45,154
421440,201901,582,1554,371,1204,75,245,184,604,259,849
421450,201901,350,1080,221,762,31,133,38,140,69,273
421460,201901,319,932,200,692,44,163,51,154,95,317
421470,201901,235,723,136,488,31,134,47,169,78,303
421480,201901,2547,7003,1658,5327,391,1391,529,1541,920,2932
421490,201901,106,342,69,241,10,41,17,46,27,87
421500,201901,1972,6037,1371,4774,391,1515,291,942,682,2457
421505,201901,281,849,252,800,35,125,150,451,185,576
421507,201901,363,1115,218,765,65,247,66,218,131,465
421510,201901,254,743,147,477,32,106,66,198,98,304
421520,201901,512,1380,318,947,41,146,176,483,217,629
421530,201901,305,971,184,660,41,180,45,130,86,310
421535,201901,387,1075,246,803,34,129,130,393,164,522
421540,201901,197,504,115,369,18,67,41,113,59,180
421545,201901,643,1936,471,1605,95,367,218,713,313,1080
421550,201901,1834,5366,1524,4866,343,1172,738,2297,1081,3469
421555,201901,183,568,66,246,12,55,10,25,22,80
421560,201901,88,283,53,198,13,51,13,48,26,99
421565,201901,845,2289,603,1893,147,511,190,621,337,1132
421567,201901,452,1578,289,1085,127,494,52,172,179,666
421568,201901,346,1027,242,795,34,125,111,349,145,474
421569,201901,182,544,71,254,19,68,24,91,43,159
421570,201901,911,2600,644,2082,182,650,154,471,336,1121
421575,201901,285,869,228,714,47,172,90,227,137,399
421580,201901,2767,8164,1868,6244,389,1528,605,1749,994,3277
421590,201901,131,424,102,347,34,122,26,74,60,196
421600,201901,507,1443,346,1090,86,288,89,240,175,528
421605,201901,711,1915,487,1528,112,349,167,533,279,882
421610,201901,1069,2982,654,2144,130,444,155,518,285,962
421620,201901,3632,10108,2093,7167,539,2028,513,1693,1052,3721
421625,201901,194,538,81,262,19,57,12,35,31,92
421630,201901,2283,6302,1346,4320,238,911,328,915,566,1826
421635,201901,216,609,147,448,17,54,80,225,97,279
421640,201901,640,1794,450,1476,99,343,130,424,229,767
421650,201901,2077,5969,1329,4493,340,1301,299,831,639,2132
421660,201901,7236,21116,5397,17590,924,3412,2146,6463,3070,9875
421670,201901,716,2129,501,1623,104,388,232,725,336,1113
421680,201901,876,2671,675,2256,197,710,265,813,462,1523
421690,201901,1128,3455,803,2721,173,657,251,833,424,1490
421700,201901,443,1386,232,835,45,179,56,183,101,362
421710,201901,207,658,94,319,24,86,25,79,49,165
421715,201901,103,300,74,234,18,57,49,149,67,206
421720,201901,1836,5159,1042,3463,276,1001,268,783,544,1784
421725,201901,199,488,101,316,20,67,40,101,60,168
421730,201901,337,1021,185,591,29,103,75,215,104,318
421740,201901,586,1742,407,1339,123,417,96,294,219,711
421750,201901,820,1996,397,1193,82,260,157,450,239,710
421755,201901,172,497,100,320,15,56,46,132,61,188
421760,201901,819,2331,483,1623,91,341,144,401,235,742
421770,201901,2052,5664,1504,4679,393,1232,544,1854,937,3086
421775,201901,236,630,145,447,22,76,66,183,88,259
421780,201901,735,2326,496,1785,100,395,190,644,290,1039
421790,201901,639,1728,386,1273,88,307,184,583,272,890
421795,201901,214,629,136,425,23,84,51,145,74,229
421800,201901,2260,6549,1690,5460,307,1095,846,2619,1153,3714
421810,201901,592,1654,413,1304,56,219,229,679,285,898
421820,201901,784,2344,407,1397,80,304,83,255,163,559
421825,201901,1262,3655,1142,3468,136,460,802,2372,938,2832
421830,201901,1879,6010,1603,5484,365,1355,644,2111,1009,3466
421835,201901,210,569,119,396,14,71,51,146,65,217
421840,201901,199,630,130,472,34,130,26,83,60,213
421850,201901,347,1041,196,701,42,173,56,143,98,316
421860,201901,268,802,175,594,23,105,60,158,83,263
421870,201901,3242,8516,2258,6628,464,1556,988,2637,1452,4193
421875,201901,204,610,104,371,19,76,23,58,42,134
421880,201901,465,1323,336,1077,99,376,67,210,166,586
421885,201901,181,543,127,436,38,133,26,78,64,211
421890,201901,719,2330,569,2013,117,471,254,827,371,1298
421895,201901,354,985,297,905,36,127,201,615,237,742
421900,201901,908,2366,645,1873,104,348,306,802,410,1150
421910,201901,309,951,214,740,47,190,44,127,91,317
421915,201901,372,1065,207,675,48,155,28,87,76,242
421917,201901,520,1346,316,1061,116,431,69,231,185,662
421920,201901,420,1319,304,1084,136,503,97,348,233,851
421930,201901,2194,5878,1025,3481,284,1060,160,506,444,1566
421935,201901,417,1365,323,1145,64,238,170,577,234,815
421940,201901,295,902,122,423,24,101,33,107,57,208
421950,201901,2882,7311,1423,4514,308,1093,307,865,615,1958
421960,201901,153,399,95,309,20,83,21,58,41,141
421970,201901,1778,4740,991,3127,220,740,279,779,499,1519
421985,201901,253,671,146,454,13,53,52,168,65,221
422000,201901,1547,4300,1294,3872,162,576,821,2439,983,3015
430003,201901,501,1464,340,1156,72,269,129,435,201,704
430005,201901,256,703,159,514,45,149,64,208,109,357
430010,201901,1588,4211,1276,3657,164,513,841,2330,1005,2843
430020,201901,575,1370,443,1191,69,213,260,654,329,867
430030,201901,981,2405,559,1644,165,491,157,436,322,927
430040,201901,9233,23138,5522,16324,1480,4807,432,1393,1912,6200
430045,201901,535,1395,359,1050,35,123,198,545,233,668
430047,201901,240,539,96,285,19,63,24,72,43,135
430050,201901,921,2412,518,1570,117,389,110,318,227,707
430055,201901,254,649,112,345,13,47,57,160,70,207
430057,201901,93,209,29,82,8,30,7,17,15,47
430060,201901,15495,43844,12178,38456,2987,10116,5127,16169,8114,26285
430063,201901,861,2438,678,2040,126,380,374,1110,500,1490
430064,201901,941,2725,716,2216,208,676,229,685,437,1361
430066,201901,107,245,75,194,4,11,55,130,59,141
430070,201901,704,1794,105,349,12,40,12,30,24,70
430080,201901,733,1917,448,1332,89,295,194,514,283,809
430085,201901,850,2004,498,1416,82,244,201,560,283,804
430087,201901,522,1433,423,1291,82,251,240,758,322,1009
430090,201901,550,1453,181,596,18,76,56,179,74,255
430100,201901,545,1386,314,942,62,197,114,307,176,504
430105,201901,956,2625,600,2018,116,435,276,944,392,1379
430107,201901,175,523,117,381,20,70,29,76,49,146
430110,201901,2045,5141,1468,4278,240,737,820,2368,1060,3105
430120,201901,1327,4046,817,2714,161,552,355,1196,516,1748
430130,201901,3356,8168,2543,7016,1016,2820,538,1703,1554,4523
430140,201901,866,2551,592,1974,154,497,231,786,385,1283
430150,201901,528,1406,298,939,61,203,96,289,157,492
430155,201901,249,663,121,379,22,69,29,79,51,148
430160,201901,16958,43230,13586,38154,2768,8163,6276,17954,9044,26117
430163,201901,2366,5989,1667,4881,140,459,1102,3213,1242,3672
430165,201901,340,804,77,246,12,31,10,23,22,54
430170,201901,888,2398,323,1115,67,236,64,206,131,442
430175,201901,650,2033,536,1777,136,439,254,839,390,1278
430180,201901,638,1668,510,1435,72,226,349,941,421,1167
430185,201901,436,1057,261,728,42,117,117,298,159,415
430187,201901,614,1557,432,1282,75,240,213,637,288,877
430190,201901,1380,3849,1108,3390,264,866,484,1405,748,2271
430192,201901,122,361,52,160,9,32,13,36,22,68
430195,201901,386,1158,63,224,10,35,5,18,15,53
430200,201901,1032,3234,864,2907,298,1051,252,862,550,1913
430205,201901,484,1313,396,1132,13,46,329,910,342,956
430210,201901,4707,12044,3247,9116,649,1953,1157,2652,1806,4605
430215,201901,295,791,185,551,36,112,71,206,107,318
430220,201901,648,1609,172,587,35,138,35,100,70,238
430222,201901,177,511,140,437,20,73,58,168,78,241
430223,201901,241,673,200,592,32,98,111,319,143,417
430225,201901,15,35,12,30,1,2,9,15,10,17
430230,201901,1676,4838,1483,4556,163,477,1129,3533,1292,4010
430235,201901,239,713,176,566,42,137,50,139,92,276
430237,201901,517,1281,354,991,19,68,239,634,258,702
430240,201901,1085,2482,646,1788,64,216,380,1011,444,1227
430245,201901,665,2018,508,1694,170,569,224,750,394,1319
430250,201901,938,2501,732,2178,238,771,33,81,271,852
430258,201901,99,277,76,229,4,8,40,124,44,132
430260,201901,604,1651,438,1323,76,240,232,697,308,937
430265,201901,194,576,143,484,29,102,46,153,75,255
430270,201901,2665,6937,2144,6125,310,983,1375,3805,1685,4788
430280,201901,4727,11683,3363,9230,721,2055,1408,3839,2129,5894
430290,201901,2059,5014,1784,4660,62,192,1520,3905,1582,4097
430300,201901,8452,22943,6662,19619,1213,3874,3321,9623,4534,13497
430310,201901,9266,23981,6195,18056,910,3069,2935,7928,3845,10997
430320,201901,914,2489,514,1627,77,207,264,879,341,1086
430330,201901,591,1514,386,1083,76,236,182,454,258,690
430340,201901,667,1537,351,1033,67,212,185,528,252,740
430350,201901,5947,16520,4558,13765,1059,3286,2007,5962,3066,9248
430355,201901,304,774,106,355,25,73,13,43,38,116
430360,201901,731,1847,515,1479,115,364,194,506,309,870
430367,201901,341,855,176,530,45,148,62,187,107,335
430370,201901,478,1329,222,726,46,159,58,167,104,326
430380,201901,674,1710,333,1066,70,259,74,242,144,501
430390,201901,2865,7191,1557,4689,304,1006,125,286,429,1292
430400,201901,1074,2362,821,1994,83,215,583,1362,666,1577
430410,201901,552,1370,369,1063,56,180,212,591,268,771
430420,201901,2616,7358,1991,5957,603,1886,693,1984,1296,3870
430430,201901,647,1695,311,966,75,239,66,198,141,437
430435,201901,1458,3813,1102,3235,250,786,469,1369,719,2155
430440,201901,3515,10179,2645,8439,458,1596,1403,4449,1861,6045
430450,201901,6519,17042,5203,14695,632,2052,3053,8403,3685,10455
430460,201901,27337,72708,19407,59384,4126,14012,8297,24140,12423,38152
430461,201901,392,990,110,347,21,69,29,82,50,151
430462,201901,242,670,146,486,19,66,49,175,68,241
430463,201901,4494,12847,3531,11118,675,2312,1776,5516,2451,7828
430465,201901,461,1255,382,1098,60,187,230,638,290,825
430466,201901,3735,9649,2947,8313,781,2301,1325,3537,2106,5838
430467,201901,475,1210,333,967,53,188,164,443,217,631
430468,201901,1287,3267,1020,2868,132,403,607,1678,739,2081
430469,201901,641,1802,77,268,11,37,10,18,21,55
430470,201901,5263,14163,3639,11219,1167,3854,859,2572,2026,6426
430471,201901,504,1538,426,1374,79,261,200,619,279,880
430480,201901,819,2167,423,1316,64,212,85,225,149,437
430485,201901,156,425,58,194,9,25,11,39,20,64
430490,201901,406,1069,225,673,31,103,104,289,135,392
430495,201901,354,1004,214,715,35,127,76,232,111,359
430500,201901,1006,2679,703,2146,210,700,218,591,428,1291
430510,201901,21951,59013,15578,46156,3224,10616,6231,16986,9455,27602
430511,201901,320,947,122,428,14,50,15,44,29,94
430512,201901,881,2103,689,1802,176,460,228,616,404,1076
430513,201901,771,1968,360,1041,61,181,164,451,225,632
430515,201901,392,1108,277,870,44,127,141,447,185,574
430517,201901,865,2767,740,2507,137,458,378,1338,515,1796
430520,201901,1260,3343,648,2019,124,380,130,380,254,760
430530,201901,1027,2664,375,1175,83,251,86,269,169,520
430535,201901,2927,7880,2070,6252,342,1073,993,2947,1335,4020
430537,201901,308,1114,281,1026,33,112,217,791,250,903
430540,201901,557,1354,331,988,60,175,143,409,203,584
430543,201901,632,1236,382,942,57,128,216,562,273,690
430544,201901,613,1856,441,1449,99,348,206,655,305,1003
430545,201901,1826,5003,1363,4275,277,886,670,2180,947,3066
430550,201901,399,1146,248,807,46,153,70,213,116,366
430558,201901,110,252,48,133,9,25,16,41,25,66
430560,201901,321,717,134,401,11,41,44,122,55,163
430570,201901,782,1861,562,1515,83,258,345,866,428,1124
430580,201901,937,2332,637,1863,144,474,283,781,427,1255
430583,201901,190,473,38,117,3,10,6,16,9,26
430585,201901,219,531,117,317,15,39,56,127,71,166
430587,201901,185,554,130,426,20,66,52,169,72,235
430590,201901,1369,3370,1180,3077,58,180,1017,2606,1075,2786
430593,201901,18,66,12,44,2,8,6,21,8,29
430595,201901,397,940,86,285,7,27,20,54,27,81
430597,201901,335,928,207,632,25,82,74,173,99,255
430600,201901,1732,4593,798,2425,147,475,219,631,366,1106
430605,201901,1069,3038,795,2491,118,443,316,933,434,1376
430607,201901,581,1349,428,1108,34,92,296,776,330,868
430610,201901,5385,13441,3648,10702,1089,3449,610,1912,1699,5361
430613,201901,254,604,73,218,8,27,18,43,26,70
430620,201901,521,1390,408,1166,83,271,194,521,277,792
430630,201901,398,1129,125,411,19,63,24,63,43,126
430632,201901,505,1368,236,731,28,91,103,302,131,393
430635,201901,511,1353,378,1091,60,184,256,731,316,915
430637,201901,445,1148,351,1000,43,142,199,537,242,679
430640,201901,1052,2747,614,1849,99,318,207,575,306,893
430642,201901,334,930,254,749,47,136,135,386,182,522
430645,201901,225,492,79,209,17,49,12,31,29,80
430650,201901,1512,4639,1268,4214,348,1167,586,2008,934,3175
430655,201901,231,553,138,376,13,40,71,175,84,215
430660,201901,4551,12264,3487,10373,799,2555,1574,4619,2373,7174
430670,201901,585,1511,447,1260,42,138,292,830,334,968
430673,201901,561,1314,223,680,44,139,77,230,121,369
430675,201901,194,567,57,196,18,71,15,49,33,120
430676,201901,4168,10813,3233,9305,477,1481,1883,5303,2360,6784
430680,201901,939,2532,569,1769,155,489,146,441,301,930
430690,201901,2968,8333,2398,7260,796,2502,656,1938,1452,4440
430692,201901,210,652,159,565,11,33,116,423,127,456
430693,201901,988,2619,566,1736,109,385,122,340,231,725
430695,201901,483,1217,286,835,32,92,159,441,191,533
430697,201901,374,965,279,811,60,177,142,425,202,602
430700,201901,6440,16406,3485,10831,874,2917,408,1271,1282,4188
430705,201901,376,941,177,551,32,111,67,197,99,308
430710,201901,1633,3680,1131,2935,173,511,625,1590,798,2101
430720,201901,716,1751,378,1154,60,174,164,500,224,674
430730,201901,1054,2884,723,2253,120,354,349,1106,469,1460
430740,201901,553,1531,291,971,48,176,84,288,132,464
430745,201901,440,1242,237,764,40,143,62,181,102,324
430750,201901,1292,3430,919,2773,190,606,481,1393,671,1999
430755,201901,454,1124,289,789,19,65,156,391,175,456
430760,201901,1899,4881,1465,4216,361,1078,621,1748,982,2826
430770,201901,5745,14738,4396,12682,692,2235,2646,7397,3338,9632
430780,201901,2012,5037,1138,3529,226,736,349,1098,575,1834
430781,201901,385,1105,223,727,53,174,48,136,101,310
430783,201901,410,961,235,682,23,83,132,355,155,438
430786,201901,36,123,20,78,4,14,1,8,5,22
430790,201901,4273,11057,2941,8558,443,1459,1599,4343,2042,5802
430800,201901,719,1809,533,1474,47,148,345,938,392,1086
430805,201901,429,1173,254,775,24,81,149,420,173,501
430807,201901,312,731,196,556,15,51,106,283,121,334
430810,201901,802,1970,263,862,35,134,71,219,106,353
430820,201901,1267,3432,683,2259,150,509,149,514,299,1023
430825,201901,272,699,90,252,16,43,22,53,38,96
430830,201901,1595,4771,1328,4261,74,287,913,2911,987,3198
430840,201901,887,2426,697,2078,112,352,442,1305,554,1657
430843,201901,111,269,33,102,4,12,16,41,20,53
430845,201901,371,904,240,685,77,241,64,160,141,401
430850,201901,2192,5939,1622,4821,297,946,755,2232,1052,3178
430860,201901,771,1832,422,1216,66,226,193,488,259,714
430865,201901,503,1320,407,1154,77,224,204,553,281,777
430870,201901,630,1679,273,872,43,152,93,257,136,409
430880,201901,1184,2837,791,2227,177,525,366,990,543,1515
430885,201901,199,489,90,298,8,39,48,145,56,184
430890,201901,976,2634,669,2067,59,271,116,323,175,594
430900,201901,2874,6642,1962,5270,186,600,1188,2987,1374,3587
430905,201901,749,1987,475,1444,92,307,168,492,260,799
430910,201901,1353,3714,912,2799,161,552,384,1067,545,1619
430912,201901,471,1320,317,1026,30,90,203,673,233,763
430915,201901,481,1510,359,1273,89,330,126,452,215,782
430920,201901,21968,57194,16782,48570,2510,8060,9726,27330,12236,35390
430925,201901,135,302,50,143,9,30,19,56,28,86
430930,201901,9277,22322,5669,16693,1293,4072,2028,6204,3321,10276
430940,201901,1092,3071,610,1917,196,655,66,150,262,805
430950,201901,688,1727,432,1244,51,179,252,660,303,839
430955,201901,214,560,60,189,14,42,12,30,26,72
430957,201901,177,617,164,586,30,113,90,315,120,428
430960,201901,1266,3030,771,2162,172,530,346,953,518,1483
430965,201901,1656,4106,1262,3479,78,243,938,2552,1016,2795
430970,201901,369,952,185,573,32,115,87,250,119,365
430975,201901,472,1484,360,1204,91,324,144,470,235,794
430980,201901,388,956,213,649,39,123,86,253,125,376
430990,201901,540,1613,324,1061,44,158,157,510,201,668
430995,201901,558,1468,400,1203,60,187,193,576,253,763
431000,201901,1297,3069,508,1495,88,287,30,74,118,361
431010,201901,2009,5367,1204,3902,210,762,126,351,336,1113
431020,201901,7970,17977,4857,13116,1150,3393,1585,3887,2735,7280
431030,201901,313,869,143,496,26,96,26,85,52,181
431033,201901,2925,7328,1870,5634,501,1553,561,1771,1062,3324
431036,201901,350,779,72,222,12,28,16,48,28,76
431040,201901,903,2394,586,1790,93,337,257,722,350,1059
431041,201901,453,1078,340,911,34,90,204,530,238,620
431043,201901,392,970,209,658,59,197,70,217,129,414
431046,201901,105,285,45,146,4,14,11,34,15,48
431050,201901,1359,3452,981,2848,176,526,520,1510,696,2036
431053,201901,517,1472,317,1035,71,245,102,311,173,556
431055,201901,581,1462,495,1333,37,90,373,996,410,1086
431057,201901,265,774,129,444,16,55,35,109,51,164
431060,201901,4834,13352,3442,10858,994,3367,681,2228,1675,5595
431065,201901,460,1229,311,962,66,205,106,326,172,531
431070,201901,434,1299,245,839,68,260,35,106,103,366
431075,201901,220,675,142,488,26,89,40,139,66,228
431080,201901,576,1618,399,1254,91,312,116,343,207,655
431085,201901,692,1893,493,1439,75,215,261,740,336,955
431087,201901,458,1328,366,1124,26,78,250,783,276,861
431090,201901,387,926,144,465,30,105,34,108,64,213
431100,201901,3042,7061,2194,5907,360,1016,1064,2882,1424,3898
431110,201901,1338,3208,937,2483,238,627,406,1032,644,1659
431112,201901,493,1514,414,1352,84,303,214,666,298,969
431113,201901,330,957,291,877,64,209,157,467,221,676
431115,201901,1041,3032,820,2614,135,478,460,1405,595,1883
431120,201901,2268,6559,1581,5132,539,1954,361,1067,900,3021
431123,201901,380,1080,235,773,50,138,118,414,168,552
431125,201901,1035,3121,771,2540,304,982,224,796,528,1778
431127,201901,254,672,59,191,9,28,8,17,17,45
431130,201901,2935,7960,2106,6434,429,1438,927,2769,1356,4207
431140,201901,4718,11430,2649,7484,369,1141,1095,2748,1464,3889
431142,201901,479,1330,358,1110,55,168,212,659,267,827
431150,201901,990,2738,698,2158,154,498,276,842,430,1340
431160,201901,666,1924,477,1520,93,295,162,529,255,824
431162,201901,475,1179,223,694,26,110,90,247,116,357
431164,201901,197,463,43,137,10,33,5,18,15,51
431170,201901,514,1439,350,1102,102,301,94,298,196,599
431171,201901,629,1575,521,1434,68,181,335,921,403,1102
431173,201901,372,1022,279,868,96,324,83,250,179,574
431175,201901,1011,2537,628,1865,138,407,154,457,292,864
431177,201901,673,1986,506,1700,155,558,232,771,387,1329
431179,201901,303,649,66,199,14,45,15,36,29,81
431180,201901,2134,5595,1301,3953,381,1172,246,755,627,1927
431190,201901,449,1234,235,754,30,91,52,144,82,235
431198,201901,301,941,260,866,104,366,66,235,170,601
431200,201901,376,977,87,274,13,36,2,6,15,42
431205,201901,179,518,79,280,19,69,31,106,50,175
431210,201901,605,1592,487,1416,118,321,240,735,358,1056
431213,201901,239,699,180,593,15,64,91,302,106,366
431215,201901,511,1251,235,707,30,101,96,261,126,362
431217,201901,156,448,103,340,9,32,60,184,69,216
431220,201901,590,1574,341,1078,30,120,176,507,206,627
431225,201901,1475,3668,1113,3049,115,338,727,1977,842,2315
431230,201901,662,1962,482,1507,75,252,274,819,349,1071
431235,201901,141,359,24,75,3,8,2,7,5,15
431237,201901,345,1047,270,901,42,165,147,469,189,634
431238,201901,24,63,19,51,6,14,6,15,12,29
431240,201901,3660,9555,2876,8284,616,1951,1288,3592,1904,5543
431242,201901,295,829,243,729,62,197,114,343,176,540
431244,201901,326,790,151,428,25,96,51,107,76,203
431245,201901,1278,3063,804,2208,107,314,385,1005,492,1319
431247,201901,215,600,104,342,20,71,21,51,41,122
431250,201901,1511,4164,1153,3631,259,796,545,1804,804,2600
431260,201901,212,600,117,410,18,79,43,137,61,216
431261,201901,237,753,190,662,21,81,94,305,115,386
431262,201901,383,1088,170,569,14,47,110,365,124,412
431265,201901,1413,3363,576,1692,80,274,193,476,273,750
431267,201901,236,664,142,431,4,15,97,268,101,283
431270,201901,2513,5929,1354,3915,356,1109,374,1096,730,2205
431275,201901,141,404,72,235,18,60,8,18,26,78
431280,201901,243,671,70,240,8,24,5,14,13,38
431290,201901,289,837,198,633,33,112,59,159,92,271
431295,201901,68,182,23,71,3,13,5,13,8,26
431300,201901,373,937,56,190,5,22,12,34,17,56
431301,201901,219,648,56,199,6,14,4,11,10,25
431303,201901,560,1515,320,982,33,122,122,353,155,475
431306,201901,2070,4992,1238,3558,202,671,478,1200,680,1871
431308,201901,23,73,20,63,13,44,5,12,18,56
431310,201901,520,1514,341,1082,47,170,152,452,199,622
431320,201901,564,1535,258,863,49,164,39,123,88,287
431330,201901,1598,3872,738,2261,201,672,185,511,386,1183
431333,201901,215,599,112,333,16,39,39,113,55,152
431335,201901,39,113,23,78,6,14,4,8,10,22
431337,201901,2470,6783,1724,5472,464,1645,596,1791,1060,3436
431339,201901,392,1023,292,844,66,193,142,410,208,603
431340,201901,18798,47616,13173,37908,2711,8513,5014,13608,7725,22121
431342,201901,451,1027,329,844,20,56,281,714,301,770
431344,201901,384,1002,228,681,11,38,149,432,160,470
431346,201901,256,654,98,325,15,46,31,103,46,149
431349,201901,625,1667,334,1011,66,214,122,344,188,558
431350,201901,3764,10165,2752,8395,444,1495,1330,4008,1774,5503
431360,201901,544,1314,305,865,75,229,104,279,179,508
431365,201901,1677,4318,1409,3926,148,487,1044,2871,1192,3358
431370,201901,3981,10410,2952,8643,757,2399,1258,3755,2015,6154
431380,201901,727,2086,618,1893,40,139,405,1233,445,1372
431390,201901,2345,5908,1363,4080,228,784,518,1364,746,2148
431395,201901,1182,3200,849,2669,217,698,343,1119,560,1817
431400,201901,330,948,173,554,30,94,45,130,75,224
431402,201901,829,1976,587,1562,85,249,369,924,454,1173
431403,201901,178,495,139,424,20,79,83,216,103,295
431405,201901,4238,11434,3365,10076,428,1503,1978,5712,2406,7215
431406,201901,420,1327,344,1157,88,275,168,583,256,858
431407,201901,447,1247,287,897,61,202,131,395,192,597
431410,201901,14578,38601,9368,28890,1744,6128,3844,11046,5588,17174
431413,201901,176,454,58,193,6,18,8,27,14,45
431415,201901,672,1720,410,1273,70,256,168,464,238,720
431417,201901,564,1298,387,1030,68,195,199,508,267,703
431420,201901,1413,3432,1097,2969,198,561,529,1451,727,2012
431430,201901,508,1325,246,787,39,134,63,174,102,308
431440,201901,24568,60743,17769,49709,3666,10941,6205,16979,9871,27920
431442,201901,100,286,48,165,7,25,8,22,15,47
431445,201901,421,1201,134,467,18,57,13,44,31,101
431446,201901,306,859,209,661,53,180,81,242,134,422
431447,201901,598,1664,403,1257,92,300,147,463,239,763
431449,201901,703,1884,434,1282,77,226,178,512,255,738
431450,201901,2040,4469,1672,3947,110,286,1279,2898,1389,3184
431454,201901,42,125,38,117,8,28,15,50,23,78
431455,201901,563,1386,296,823,41,136,145,355,186,491
431460,201901,2794,7168,2054,5800,563,1671,606,1735,1169,3406
431470,201901,1426,4091,1028,3252,198,646,442,1406,640,2052
431475,201901,247,714,31,126,1,4,2,10,3,14
431477,201901,410,1071,254,752,41,121,117,317,158,438
431478,201901,241,613,60,185,18,55,4,11,22,66
431480,201901,2956,7613,2303,6588,408,1235,1300,3684,1708,4919
431490,201901,96805,239874,77919,210735,6969,21778,56572,148206,63541,169984
431500,201901,471,1253,348,1010,68,189,178,503,246,692
431505,201901,343,825,219,632,21,60,135,386,156,446
431507,201901,339,809,146,421,34,112,51,128,85,240
431510,201901,1452,3882,1040,3078,249,776,392,1160,641,1936
431513,201901,233,547,123,349,9,22,84,242,93,264
431514,201901,80,213,41,133,6,18,19,61,25,79
431515,201901,480,1252,326,960,67,206,160,447,227,653
431517,201901,70,200,54,163,13,35,16,47,29,82
431520,201901,423,1049,163,529,32,114,55,158,87,272
431530,201901,3842,8355,2297,6176,641,1769,409,1131,1050,2900
431531,201901,191,528,125,390,14,42,55,174,69,216
431532,201901,540,1311,340,948,76,229,135,372,211,601
431535,201901,242,649,102,330,22,76,14,41,36,117
431540,201901,1687,5550,1576,5372,63,254,1273,4348,1336,4602
431545,201901,346,916,63,206,7,24,15,40,22,64
431550,201901,1852,5034,1503,4337,288,903,698,1934,986,2837
431555,201901,669,1562,415,1122,27,87,258,682,285,769
431560,201901,19759,50891,13053,39931,2849,9349,3815,12391,6664,21740
431570,201901,4606,11363,3597,9937,529,1631,2252,6003,2781,7634
431575,201901,203,586,149,471,22,63,32,97,54,160
431580,201901,518,1402,296,928,48,184,141,404,189,588
431590,201901,669,1818,481,1431,90,265,195,598,285,863
431595,201901,317,908,217,686,45,144,83,246,128,390
431600,201901,1260,3141,921,2642,272,811,326,975,598,1786
431610,201901,1308,3552,898,2710,138,385,445,1397,583,1782
431620,201901,548,1493,234,717,43,139,98,277,141,416
431630,201901,1198,3143,572,1799,132,453,178,491,310,944
431640,201901,5756,15020,5087,14071,622,1818,3625,10057,4247,11875
431642,201901,460,1132,301,831,31,74,158,416,189,490
431643,201901,316,775,137,397,17,47,45,133,62,180
431645,201901,1680,4138,1344,3621,112,340,986,2641,1098,2981
431647,201901,210,539,101,291,12,39,23,55,35,94
431650,201901,158,451,108,355,17,61,38,114,55,175
431660,201901,821,2221,429,1416,76,283,86,258,162,541
431670,201901,1134,2795,747,2105,114,352,395,1058,509,1410
431673,201901,235,612,90,312,16,52,14,43,30,95
431675,201901,524,1276,111,350,10,40,28,71,38,111
431680,201901,6904,18530,5100,15023,1354,4133,1910,5601,3264,9734
431690,201901,19900,51291,13674,40001,3293,10169,4818,14291,8111,24460
431695,201901,148,384,95,285,17,60,42,98,59,158
431697,201901,461,1119,351,941,59,149,190,529,249,678
431700,201901,1388,3710,1176,3317,172,476,675,1893,847,2369
431710,201901,10772,28195,8162,24280,1921,5973,3456,10807,5377,16780
431720,201901,5411,14190,3414,10161,942,2988,551,1492,1493,4480
431725,201901,25,72,17,54,4,13,4,11,8,24
431730,201901,3505,8954,2270,6857,586,1896,689,2184,1275,4080
431740,201901,4765,11960,3201,9215,954,3076,643,1577,1597,4653
431750,201901,6713,18312,5637,16618,1048,3359,2935,8686,3983,12045
431755,201901,299,799,66,236,10,39,10,35,20,74
431760,201901,5313,12385,3428,9318,363,1212,2057,5212,2420,6424
431770,201901,1707,4290,1384,3851,117,367,996,2730,1113,3097
431775,201901,203,542,97,302,23,81,16,39,39,120
431780,201901,1830,4745,1207,3574,235,742,434,1262,669,2004
431790,201901,856,2356,609,1857,118,363,263,770,381,1133
431795,201901,221,577,106,322,23,76,31,90,54,166
431800,201901,6996,18398,4849,14715,1496,5044,634,1993,2130,7037
431805,201901,289,679,84,277,6,23,34,100,40,123
431810,201901,3211,7873,2041,5677,378,1177,843,2180,1221,3357
431820,201901,2083,5975,1702,5321,447,1439,674,2179,1121,3618
431830,201901,8488,19447,6293,16285,1537,4462,2254,5857,3791,10319
431840,201901,2362,6571,1942,5851,348,1084,1140,3427,1488,4511
431842,201901,655,1631,223,696,30,102,67,196,97,298
431843,201901,305,839,238,704,34,107,114,319,148,426
431844,201901,194,522,64,212,17,63,20,58,37,121
431845,201901,509,1359,356,1042,27,84,219,633,246,717
431846,201901,249,709,223,671,18,50,182,550,200,600
431848,201901,153,385,82,250,9,30,12,23,21,53
431849,201901,399,946,63,182,9,21,5,11,14,32
431850,201901,3854,10787,3028,9096,766,2492,915,2683,1681,5175
431860,201901,641,1634,395,1139,77,232,200,548,277,780
431861,201901,109,284,44,138,6,21,15,40,21,61
431862,201901,417,1335,341,1202,75,284,173,606,248,890
431870,201901,15998,43610,13123,38723,2096,7017,7097,20112,9193,27129
431880,201901,3920,10339,2768,8267,505,1710,1179,3374,1684,5084
431890,201901,3876,10191,2438,7317,778,2548,338,1095,1116,3643
431900,201901,952,2502,603,1827,105,363,295,835,400,1198
431910,201901,784,1934,280,818,49,146,76,182,125,328
431912,201901,443,1289,355,1117,76,249,202,634,278,883
431915,201901,928,2498,759,2203,52,164,542,1542,594,1706
431920,201901,1134,2914,966,2659,47,160,816,2200,863,2360
431930,201901,664,1885,473,1528,121,362,234,781,355,1143
431935,201901,75,220,46,158,12,37,9,32,21,69
431936,201901,288,873,167,567,37,128,44,146,81,274
431937,201901,177,455,105,299,27,87,38,89,65,176
431940,201901,2713,6647,1569,4493,238,803,707,1891,945,2694
431950,201901,1705,4727,1416,4250,397,1230,603,1812,1000,3042
431960,201901,2645,6805,1979,5563,576,1674,539,1522,1115,3196
431970,201901,390,1025,151,485,34,97,36,104,70,201
431971,201901,59,154,32,106,4,16,4,9,8,25
431973,201901,445,1456,363,1292,39,136,255,922,294,1058
431975,201901,97,200,17,57,4,13,4,11,8,24
431980,201901,1051,2835,808,2417,185,603,351,1004,536,1607
431990,201901,5454,13680,3580,10783,602,2034,1446,4215,2048,6249
432000,201901,9870,24925,7271,20753,1805,5355,3115,8935,4920,14290
432010,201901,1848,4879,1393,4026,209,673,804,2223,1013,2896
432020,201901,1758,4415,1209,3433,288,870,529,1410,817,2280
432023,201901,492,1218,259,751,45,143,121,316,166,459
432026,201901,990,2887,733,2361,171,547,296,944,467,1491
432030,201901,313,838,195,608,34,113,102,308,136,421
432032,201901,392,1041,271,804,31,109,143,383,174,492
432035,201901,677,1976,600,1847,219,711,206,632,425,1343
432040,201901,1050,2442,364,1155,70,255,114,320,184,575
432045,201901,174,497,103,346,23,78,33,116,56,194
432050,201901,480,1279,364,1064,94,267,131,391,225,658
432055,201901,670,1806,424,1309,133,440,116,330,249,770
432057,201901,239,633,174,483,35,85,74,188,109,273
432060,201901,422,1015,136,428,26,100,51,135,77,235
432065,201901,222,629,156,478,31,89,55,167,86,256
432067,201901,699,2110,600,1874,72,254,388,1167,460,1421
432070,201901,1761,4769,1099,3418,239,821,280,763,519,1584
432080,201901,3778,9755,2950,8322,663,2121,1233,3356,1896,5477
432085,201901,387,1005,251,793,87,272,84,282,171,554
432090,201901,1241,3305,889,2653,195,623,410,1170,605,1793
432100,201901,956,2580,426,1409,91,325,44,113,135,438
432110,201901,2076,5766,1388,4467,358,1325,95,317,453,1642
432120,201901,2617,7493,2120,6599,618,2055,555,1706,1173,3761
432130,201901,2396,6476,2048,5962,694,2118,795,2353,1489,4471
432132,201901,180,532,107,369,21,75,41,121,62,196
432135,201901,904,2286,601,1693,47,158,424,1164,471,1322
432140,201901,1482,4620,1108,3862,187,688,600,2113,787,2801
432143,201901,1282,3504,1000,3056,91,332,634,1921,725,2253
432145,201901,1301,3579,739,2328,122,422,186,517,308,939
432146,201901,107,307,71,237,21,74,14,41,35,115
432147,201901,434,1324,286,998,88,322,58,193,146,515
432149,201901,375,993,217,654,20,58,106,312,126,370
432150,201901,2780,7587,2043,6186,503,1703,628,1834,1131,3537
432160,201901,4584,12940,3509,11105,1011,3445,1136,3517,2147,6962
432162,201901,268,599,34,98,6,14,5,16,11,30
432163,201901,143,374,27,83,0,0,2,5,2,5
432166,201901,504,1496,388,1236,69,232,143,416,212,648
432170,201901,1249,3500,788,2594,177,646,218,682,395,1328
432180,201901,2525,6425,1352,4085,277,904,398,1074,675,1978
432183,201901,331,979,216,703,64,242,57,169,121,411
432185,201901,774,2056,451,1405,33,119,246,727,279,846
432190,201901,1955,4927,1212,3592,275,936,462,1263,737,2199
432195,201901,919,2333,591,1750,171,480,222,686,393,1166
432200,201901,2948,8105,2143,6692,428,1367,1021,3265,1449,4632
432210,201901,321,914,219,710,44,169,97,294,141,463
432215,201901,620,1858,549,1748,51,149,394,1274,445,1423
432218,201901,248,627,122,348,18,50,53,141,71,191
432220,201901,3656,8919,2710,7378,391,1193,1624,4263,2015,5456
432225,201901,88,260,67,214,16,52,30,98,46,150
432230,201901,701,1740,385,1115,54,161,166,449,220,610
432232,201901,484,1227,319,935,65,200,125,363,190,563
432234,201901,296,777,132,402,30,83,23,59,53,142
432235,201901,87,242,31,99,8,24,8,28,16,52
432237,201901,354,905,303,815,19,53,226,581,245,634
432240,201901,13010,35750,10114,31527,858,3073,6363,20581,7221,23654
432250,201901,4015,12753,3428,11611,1069,3706,1235,4325,2304,8031
432252,201901,429,1097,267,768,43,134,114,308,157,442
432253,201901,1015,3165,593,2058,161,606,30,86,191,692
432254,201901,833,2063,161,523,32,114,16,44,48,158
432255,201901,122,306,57,177,5,18,24,66,29,84
432260,201901,4666,12304,3443,10011,963,2868,998,2916,1961,5784
432270,201901,1827,5327,1485,4639,467,1549,253,779,720,2328
432280,201901,1067,2815,592,1840,105,357,227,628,332,985
432285,201901,189,586,22,78,0,0,2,5,2,5
432290,201901,348,1017,189,633,64,218,41,114,105,332
432300,201901,24449,65006,18873,55729,2864,9403,11061,31670,13925,41073
432310,201901,709,2008,522,1655,62,201,331,1056,393,1257
432320,201901,212,505,68,203,9,36,26,66,35,102
432330,201901,222,563,80,257,16,53,16,44,32,97
432335,201901,172,499,54,206,5,19,13,56,18,75
432340,201901,307,736,130,401,21,76,37,93,58,169
432345,201901,576,1411,517,1342,23,81,404,1031,427,1112
432350,201901,319,872,161,541,30,102,50,160,80,262
432360,201901,212,624,39,124,3,14,13,37,16,51
432370,201901,309,782,201,590,16,42,124,351,140,393
432375,201901,488,1249,372,1030,65,160,199,554,264,714
432377,201901,200,641,34,120,6,19,3,6,9,25
432380,201901,1436,4085,921,3073,186,700,416,1316,602,2016
500020,201901,2140,5790,1525,4721,304,1031,748,2267,1052,3298
500025,201901,1178,2708,746,1994,65,191,439,1141,504,1332
500060,201901,6103,17636,4569,15005,664,2263,2678,9196,3342,11459
500070,201901,3763,10058,2693,8249,539,1664,1187,3807,1726,5471
500080,201901,1168,3118,820,2510,156,549,382,1093,538,1642
500085,201901,1938,4871,1310,3871,297,952,637,1805,934,2757
500090,201901,1826,5022,1253,4007,235,773,496,1643,731,2416
500100,201901,3308,8649,2528,7363,340,1097,1382,3886,1722,4983
500110,201901,6630,18085,4332,14342,969,3455,1327,5116,2296,8571
500124,201901,1885,5875,1553,5276,317,1052,857,3078,1174,4130
500150,201901,1151,2673,721,2024,186,559,236,618,422,1177
500190,201901,4178,10264,2975,8510,745,2207,1138,3319,1883,5526
500200,201901,2077,5006,1541,4125,183,530,934,2371,1117,2901
500210,201901,4280,11547,3235,10026,872,2762,1407,4451,2279,7213
500215,201901,1327,3795,932,3037,95,351,481,1562,576,1913
500220,201901,2558,7280,1814,5969,317,1154,688,2227,1005,3381
500230,201901,1994,4894,1502,4169,202,562,941,2563,1143,3125
500240,201901,3403,10590,2362,8351,420,1660,716,2619,1136,4279
500260,201901,2945,6469,1793,4844,234,616,935,2472,1169,3088
500270,201901,124312,301082,72732,210571,14127,44591,24174,66571,38301,111162
500280,201901,1186,3068,832,2514,109,369,505,1479,614,1848
500290,201901,3506,8177,1921,5694,344,1120,706,1973,1050,3093
500295,201901,2819,7097,1673,4932,295,956,638,1674,933,2630
500310,201901,850,1958,611,1651,98,234,325,916,423,1150
500315,201901,3157,9438,2609,8547,282,931,1790,6036,2072,6967
500320,201901,16780,48687,11950,40384,3234,11647,3887,13947,7121,25594
500325,201901,3947,9250,2684,7413,296,884,1573,4352,1869,5236
500330,201901,6437,15124,4132,11573,362,1158,2317,6607,2679,7765
500345,201901,1895,4699,1220,3620,307,939,417,1225,724,2164
500348,201901,2509,6450,1894,5428,251,756,1112,3248,1363,4004
500350,201901,1241,3440,662,2166,84,290,256,849,340,1139
500370,201901,21857,58780,14947,47054,2415,8589,7068,22271,9483,30860
500375,201901,2256,6255,1581,4817,345,1178,527,1530,872,2708
500380,201901,3371,8563,2329,6859,650,2015,814,2445,1464,4460
500390,201901,493,1043,293,782,49,139,151,401,200,540
500400,201901,1086,2963,745,2260,154,519,253,707,407,1226
500410,201901,2283,5990,1671,5020,228,694,960,2942,1188,3636
500430,201901,2394,6268,1636,5102,260,933,640,2099,900,3032
500440,201901,1062,2605,677,1981,110,320,262,813,372,1133
500450,201901,1306,3361,713,2231,146,476,131,376,277,852
500460,201901,3282,9195,2068,6817,423,1563,571,1899,994,3462
500470,201901,2268,6329,1432,4578,453,1579,283,799,736,2378
500480,201901,2152,6436,1850,5989,170,587,1243,4203,1413,4790
500490,201901,932,2269,544,1677,137,500,163,492,300,992
500500,201901,4012,11145,2652,8927,898,3462,593,2050,1491,5512
500510,201901,638,1620,424,1246,23,81,253,715,276,796
500515,201901,1838,4672,1445,4079,124,350,992,2787,1116,3137
500520,201901,2918,9825,2367,8726,697,2672,935,3543,1632,6215
500525,201901,851,2606,695,2359,81,306,425,1470,506,1776
500540,201901,4098,10887,2471,7975,736,2846,227,617,963,3463
500560,201901,4953,14697,4116,13534,335,1207,3087,10296,3422,11503
500568,201901,4019,9076,2450,6762,614,1882,779,2142,1393,4024
500570,201901,6955,16842,4024,11710,895,2864,1057,2862,1952,5726
500580,201901,3004,8207,2290,6993,487,1568,1129,3427,1616,4995
500600,201901,2896,7378,2026,6064,374,1189,883,2680,1257,3869
500620,201901,6962,19187,4769,14929,1038,3383,1844,5728,2882,9111
500625,201901,476,1349,263,867,50,187,103,314,153,501
500627,201901,712,1844,433,1326,68,207,139,423,207,630
500630,201901,5570,13739,3389,10034,794,2540,1044,3164,1838,5704
500635,201901,2639,8793,2085,8009,152,613,1524,6226,1676,6839
500640,201901,1605,3705,1083,2958,40,137,745,1967,785,2104
500660,201901,15272,43219,10873,36178,3872,14241,2442,8300,6314,22541
500690,201901,2106,5990,1486,5017,628,2394,94,234,722,2628
500710,201901,2805,7947,2137,6725,631,2092,604,1819,1235,3911
500720,201901,4727,12358,2976,9406,719,2500,758,2434,1477,4934
500730,201901,869,2312,569,1752,91,255,229,735,320,990
500740,201901,4412,10760,3114,8620,327,973,1790,4993,2117,5966
500750,201901,928,2441,646,1943,101,323,245,669,346,992
500755,201901,821,2296,482,1635,103,366,71,224,174,590
500769,201901,4657,11850,2456,7481,489,1675,347,797,836,2472
500770,201901,1454,4047,911,3033,164,594,298,998,462,1592
500780,201901,1227,3084,782,2318,175,547,215,596,390,1143
500790,201901,7414,19817,5924,17439,1126,3601,3219,9510,4345,13111
500793,201901,1741,4594,1196,3667,387,1217,251,682,638,1899
500795,201901,2369,6414,1972,5881,134,374,1633,5028,1767,5402
500797,201901,670,1801,445,1369,105,332,168,509,273,841
500800,201901,2589,6266,1725,4991,592,1949,268,853,860,2802
500830,201901,16626,42491,11525,33302,1911,6016,5363,14793,7274,20809
500840,201901,1353,3422,771,2276,95,299,309,867,404,1166
510010,201901,1782,4310,1197,3507,169,475,712,2125,881,2600
510020,201901,3453,9047,1812,5643,429,1387,343,956,772,2343
510025,201901,6412,16725,3955,12344,708,2478,1351,4004,2059,6482
510030,201901,2124,4911,1392,3867,344,966,488,1420,832,2386
510035,201901,1196,3086,714,2329,97,313,414,1437,511,1750
510040,201901,2112,4957,1535,4163,141,401,973,2637,1114,3038
510050,201901,1892,4483,1283,3582,218,687,766,2025,984,2712
510060,201901,1329,3431,988,2906,181,604,398,1116,579,1720
510080,201901,1164,3225,771,2518,232,813,223,641,455,1454
510100,201901,621,1499,401,1123,56,171,205,538,261,709
510120,201901,251,465,141,337,9,30,103,241,112,271
510125,201901,2101,5309,1636,4609,217,797,758,1942,975,2739
510130,201901,1412,3626,993,2946,227,747,293,868,520,1615
510140,201901,2756,7579,1921,6481,680,2659,698,2180,1378,4839
510160,201901,1651,4379,1219,3814,205,635,827,2614,1032,3249
510170,201901,4387,12050,3242,10161,784,2558,1337,4239,2121,6797
510180,201901,12777,30855,7815,22852,1936,6077,2265,7505,4201,13582
510185,201901,1561,4297,1054,3558,407,1346,348,1418,755,2764
510190,201901,1985,5752,1346,4638,449,1657,310,1138,759,2795
510250,201901,13707,37166,11264,33740,2242,7001,6345,19700,8587,26701
510260,201901,2041,8402,1658,7690,271,1313,968,4963,1239,6276
510263,201901,2799,8040,1749,5896,358,1315,216,660,574,1975
510267,201901,4513,13171,2791,9359,601,2101,523,1784,1124,3885
510268,201901,1322,3363,915,2649,136,407,495,1379,631,1786
510269,201901,1025,2891,657,2185,155,558,239,765,394,1323
510270,201901,2759,8305,2017,6973,401,1506,784,2689,1185,4195
510279,201901,1663,4553,1150,3632,209,737,567,1707,776,2444
510285,201901,1065,2947,751,2408,218,772,189,575,407,1347
510300,201901,3428,8914,2551,7711,363,1027,1532,4907,1895,5934
510305,201901,1432,4095,885,3023,184,673,250,946,434,1619
510310,201901,914,2392,648,1936,206,649,203,621,409,1270
510320,201901,3516,9247,2533,7527,590,1897,706,2121,1296,4018
510325,201901,4389,13300,3436,11715,978,3401,1362,4824,2340,8225
510330,201901,2787,8525,1894,6913,386,1446,689,2823,1075,4269
510335,201901,4478,13030,3371,11428,433,1605,1957,6933,2390,8538
510336,201901,451,1341,334,1147,65,220,155,564,220,784
510337,201901,1566,4738,1062,3801,428,1655,165,611,593,2266
510340,201901,82071,188293,49582,139599,13938,45850,12515,32815,26453,78665
510343,201901,965,2774,660,2173,130,473,238,742,368,1215
510345,201901,1207,3570,902,2967,172,568,383,1220,555,1788
510350,201901,2725,7363,1775,5754,415,1385,707,2309,1122,3694
510360,201901,1780,3897,1137,3116,62,179,824,2355,886,2534
510370,201901,1607,4915,1175,4123,211,814,616,2216,827,3030
510380,201901,480,1239,257,817,74,266,66,201,140,467
510385,201901,1007,3615,755,3095,83,389,465,2005,548,2394
510390,201901,1005,3069,769,2729,201,691,359,1420,560,2111
510395,201901,711,1638,470,1277,33,97,262,768,295,865
510410,201901,4156,12213,3142,10343,721,2440,1646,5602,2367,8042
510420,201901,2067,4685,1448,3837,133,409,878,2315,1011,2724
510450,201901,485,1222,283,845,73,216,45,154,118,370
510452,201901,628,1798,413,1381,79,265,196,666,275,931
510454,201901,778,2293,592,1955,54,170,370,1293,424,1463
510455,201901,876,2558,625,2001,99,374,227,669,326,1043
510460,201901,1809,4578,1308,3840,134,474,812,2259,946,2733
510480,201901,4480,11285,2925,8251,593,1816,1148,3110,1741,4926
510490,201901,1570,4470,1181,3926,251,866,593,2005,844,2871
510500,201901,1528,4000,923,2955,181,624,321,1025,502,1649
510510,201901,3138,9704,2388,8250,738,2778,608,2257,1346,5035
510515,201901,5216,14092,3378,10576,754,2614,927,2663,1681,5277
510517,201901,1071,3175,819,2726,242,907,160,480,402,1387
510520,201901,1985,4128,1154,3117,72,208,648,1855,720,2063
510523,201901,975,2605,731,2187,140,401,418,1256,558,1657
510525,201901,5679,16256,4241,13338,750,2645,1865,5460,2615,8105
510530,201901,544,1404,403,1200,30,117,269,769,299,886
510550,201901,2477,7547,1815,6340,470,1701,702,2508,1172,4209
510558,201901,1975,5482,1536,4816,163,579,814,2713,977,3292
510560,201901,1515,4470,874,3210,209,846,232,904,441,1750
510562,201901,4972,13629,3578,10974,877,2898,1246,3895,2123,6793
510590,201901,2908,7559,2095,6510,291,919,1326,4222,1617,5141
510600,201901,1479,3495,948,2666,181,494,382,1106,563,1600
510610,201901,2657,6565,1811,5379,174,601,1103,3272,1277,3873
510615,201901,1969,5562,1459,4627,262,825,827,2699,1089,3524
510617,201901,907,2660,667,2264,102,373,395,1404,497,1777
510618,201901,1191,3299,842,2670,172,612,440,1345,612,1957
510619,201901,701,1837,413,1305,71,260,85,247,156,507
510620,201901,1379,3181,657,2062,164,597,47,114,211,711
510621,201901,1330,3716,837,2759,184,649,246,793,430,1442
510622,201901,3822,11162,2695,8620,993,3418,420,1199,1413,4617
510623,201901,2524,6635,1793,5425,419,1499,512,1481,931,2980
510624,201901,1472,3912,658,2263,87,322,126,361,213,683
510625,201901,2431,6066,1364,4132,302,1043,275,826,577,1869
510626,201901,1521,3629,903,2687,273,933,200,603,473,1536
510627,201901,574,1502,337,1037,85,257,76,253,161,510
510628,201901,1512,3494,1025,2853,158,413,619,1836,777,2249
510629,201901,1491,4501,1132,3813,278,1010,368,1252,646,2262
510630,201901,3139,9100,1841,6517,435,1655,298,1156,733,2811
510631,201901,523,1291,380,1089,21,62,281,812,302,874
510637,201901,3153,8009,2311,6679,685,2197,634,1758,1319,3955
510642,201901,4854,14680,3918,13280,1059,3862,1608,5663,2667,9525
510645,201901,826,1828,486,1366,122,348,180,494,302,842
510650,201901,6719,18400,5431,16994,671,1936,3948,13207,4619,15143
510665,201901,1745,4054,1016,2851,168,513,406,1181,574,1694
510670,201901,404,865,227,601,28,88,125,327,153,415
510675,201901,5482,15843,3952,12941,1203,4268,686,2222,1889,6490
510677,201901,2062,5467,1438,4499,208,692,737,2289,945,2981
510680,201901,628,1712,384,1239,93,328,54,166,147,494
510682,201901,1520,4762,1129,4053,373,1456,242,875,615,2331
510685,201901,641,1874,474,1540,71,238,224,710,295,948
510700,201901,3574,9214,2496,7609,406,1298,1541,4761,1947,6059
510704,201901,9224,22846,6070,17309,1240,3879,1716,4712,2956,8591
510706,201901,1768,5394,1259,4575,224,864,677,2624,901,3488
510710,201901,2377,6395,1643,4952,351,1111,572,1638,923,2749
510715,201901,618,1432,447,1182,51,129,203,555,254,684
510718,201901,2351,5315,1314,4051,595,1850,227,981,822,2831
510719,201901,392,848,233,638,37,104,122,316,159,420
510720,201901,921,2300,608,1806,143,459,217,605,360,1064
510724,201901,681,1883,466,1503,89,314,215,668,304,982
510726,201901,1173,2138,592,1407,73,188,302,709,375,897
510729,201901,615,1470,284,860,41,139,66,205,107,344
510730,201901,2855,7149,1940,5702,397,1265,797,2300,1194,3565
510735,201901,978,2979,743,2637,84,324,520,1857,604,2181
510740,201901,897,2279,579,1690,81,225,292,881,373,1106
510757,201901,561,1814,457,1641,165,650,151,511,316,1161
510760,201901,38286,85452,22155,61181,5467,17387,6193,15637,11660,33024
510770,201901,3949,9388,2891,8072,307,796,1941,5677,2248,6473
510774,201901,327,923,223,713,36,122,116,390,152,512
510775,201901,577,1604,393,1304,93,341,83,261,176,602
510776,201901,446,1186,306,904,84,255,93,278,177,533
510777,201901,1594,4392,1173,3821,151,629,756,2389,907,3018
510779,201901,565,1587,445,1387,63,175,259,860,322,1035
510780,201901,3491,9527,2611,8189,670,2129,1027,3590,1697,5719
510785,201901,2007,5360,1148,3764,294,1049,168,611,462,1660
510787,201901,2343,6781,1596,5226,681,2337,93,286,774,2623
510788,201901,679,1634,470,1315,77,207,186,621,263,828
510790,201901,14029,37894,8649,27480,2106,7617,1376,3825,3482,11442
510792,201901,7959,21699,5090,16322,1059,3739,1171,3636,2230,7375
510794,201901,1150,3198,754,2474,247,904,162,462,409,1366
510795,201901,7113,19754,4815,15538,1193,4204,1185,3868,2378,8072
510800,201901,1599,4164,1062,3289,314,992,228,674,542,1666
510805,201901,1581,4405,1050,3390,239,837,344,995,583,1832
510810,201901,634,1370,418,1072,107,296,198,497,305,793
510820,201901,768,1501,420,1064,43,137,202,508,245,645
510830,201901,778,1977,545,1642,75,230,339,1066,414,1296
510835,201901,506,1307,347,1067,56,193,175,523,231,716
510840,201901,45531,102933,32385,86432,6020,15514,17098,49472,23118,64986
510850,201901,1790,4438,1014,3175,336,1185,130,327,466,1512
510860,201901,2413,6644,1557,5186,515,1988,169,550,684,2538
510880,201901,641,1911,487,1612,121,411,214,727,335,1138
510885,201901,552,1406,383,1158,68,228,129,389,197,617
510890,201901,637,1932,491,1688,108,402,231,798,339,1200
510895,201901,1150,3067,771,2404,202,709,286,808,488,1517
520005,201901,2047,5542,1621,5013,385,1095,801,2816,1186,3911
520010,201901,2137,6372,1537,5127,408,1530,388,1130,796,2660
520013,201901,2495,6752,1763,5347,434,1377,442,1446,876,2823
520015,201901,518,1348,394,1176,103,322,129,418,232,740
520017,201901,1046,2827,794,2426,122,393,479,1436,601,1829
520020,201901,350,866,278,766,54,176,161,418,215,594
520025,201901,31370,89696,27516,84323,3142,10363,19551,59698,22693,70061
520030,201901,4971,13514,4031,12134,475,1558,2581,7761,3056,9319
520050,201901,399,938,254,686,18,38,150,430,168,468
520055,201901,1167,3087,848,2464,50,151,495,1387,545,1538
520060,201901,1353,3937,1026,3327,275,966,262,864,537,1830
520080,201901,1792,4753,1357,4150,244,748,627,2109,871,2857
520082,201901,923,2380,758,2093,84,204,430,1247,514,1451
520085,201901,729,2018,555,1736,114,366,223,655,337,1021
520090,201901,802,1633,545,1346,95,189,369,968,464,1157
520110,201901,36436,101323,25821,83943,8761,32074,1836,5517,10597,37591
520120,201901,191,474,106,326,14,52,34,101,48,153
520130,201901,3609,9279,2908,8154,549,1607,1369,3892,1918,5499
520140,201901,35687,100866,26155,84367,9759,34095,2851,9705,12610,43800
520145,201901,515,1239,347,985,71,219,152,388,223,607
520150,201901,565,1370,416,1176,73,206,227,658,300,864
520160,201901,774,1825,564,1506,93,240,281,767,374,1007
520170,201901,4893,10289,3468,8624,197,545,2739,6708,2936,7253
520180,201901,1918,5463,1577,4923,411,1385,673,2062,1084,3447
520215,201901,1890,4588,1364,3761,314,953,559,1468,873,2421
520235,201901,593,1440,373,1099,44,140,145,412,189,552
520250,201901,1396,3681,1024,3109,301,1023,212,667,513,1690
520260,201901,826,1962,496,1387,102,301,196,547,298,848
520280,201901,640,1683,507,1451,134,387,200,616,334,1003
520310,201901,1161,2658,774,2077,191,550,301,838,492,1388
520320,201901,1661,4683,1307,4098,145,493,713,2236,858,2729
520330,201901,3458,9892,2511,8265,475,1838,1107,3550,1582,5388
520340,201901,2183,5034,1450,4003,157,376,922,2647,1079,3023
520350,201901,2731,6901,2005,5729,685,2068,620,1736,1305,3804
520355,201901,1726,4856,1299,4039,313,1076,489,1448,802,2524
520357,201901,765,1953,599,1686,37,102,441,1256,478,1358
520360,201901,677,1829,512,1539,164,505,139,459,303,964
520380,201901,1249,3202,753,2249,73,269,392,1078,465,1347
520390,201901,942,2110,530,1586,178,569,134,427,312,996
520393,201901,517,1243,364,1005,46,158,178,447,224,605
520396,201901,769,2136,650,1919,68,209,410,1186,478,1395
520400,201901,1510,3941,1202,3507,217,669,751,2187,968,2856
520410,201901,1659,3651,1002,2706,120,329,561,1503,681,1832
520420,201901,380,914,289,745,29,87,206,502,235,589
520425,201901,1362,3339,899,2567,228,662,320,926,548,1588
520430,201901,2147,5042,1156,3484,213,760,43,117,256,877
520440,201901,3011,7407,1896,5456,477,1472,500,1403,977,2875
520450,201901,11025,27372,7249,21373,2397,7647,798,2477,3195,10124
520455,201901,630,1766,458,1494,121,416,137,452,258,868
520460,201901,870,2251,738,2069,101,245,548,1584,649,1829
520465,201901,795,2094,639,1864,110,345,399,1118,509,1463
520470,201901,1872,5375,1579,4988,371,1151,831,2802,1202,3953
520480,201901,835,2391,572,1933,162,571,130,469,292,1040
520485,201901,1523,4341,1289,4023,223,688,811,2537,1034,3225
520490,201901,3823,10891,2962,9557,845,2746,1328,4473,2173,7219
520495,201901,1475,3387,1144,2944,59,166,896,2323,955,2489
520500,201901,1370,3689,953,2904,220,742,354,1070,574,1812
520505,201901,725,1748,523,1475,84,246,285,786,369,1032
520510,201901,7066,18289,4802,14848,1131,3925,1251,4133,2382,8058
520520,201901,1100,2873,828,2441,199,590,267,815,466,1405
520530,201901,1913,5833,1435,4990,491,1757,391,1559,882,3316
520540,201901,2803,7546,1739,5374,365,1182,403,1226,768,2408
520545,201901,870,2410,676,2096,139,435,246,774,385,1209
520547,201901,713,2022,562,1736,150,469,248,763,398,1232
520549,201901,11394,32468,9456,29346,1817,5900,5463,16886,7280,22786
520551,201901,4145,11732,3536,10847,448,1637,2425,7235,2873,8872
520552,201901,816,2199,702,2055,117,319,478,1473,595,1792
520570,201901,602,1432,395,1124,106,294,138,416,244,710
520580,201901,2392,5536,1784,4795,143,410,1232,3313,1375,3723
520590,201901,1182,3198,836,2573,239,740,153,465,392,1205
520620,201901,7894,21930,6321,19612,1599,5069,2942,9352,4541,14421
520630,201901,794,2051,501,1546,97,306,128,397,225,703
520640,201901,2414,6067,1834,5073,470,1309,714,2056,1184,3365
520650,201901,880,2162,624,1772,114,319,298,889,412,1208
520660,201901,522,1262,253,777,49,160,54,177,103,337
520670,201901,922,2627,784,2430,77,249,517,1548,594,1797
520680,201901,697,1743,518,1469,94,254,253,738,347,992
520690,201901,353,831,240,674,83,224,72,221,155,445
520710,201901,483,1161,322,895,9,23,213,577,222,600
520725,201901,1559,3792,1115,3062,127,380,707,1878,834,2258
520735,201901,710,1806,499,1451,101,274,179,552,280,826
520740,201901,1880,4516,1476,4003,257,687,847,2388,1104,3075
520750,201901,637,1603,455,1306,90,249,220,656,310,905
520753,201901,1358,3647,1054,3063,197,601,435,1188,632,1789
520760,201901,1148,2515,1031,2365,73,137,865,2059,938,2196
520780,201901,1522,3724,1134,3171,122,346,589,1627,711,1973
520790,201901,3310,7927,2321,6399,242,676,1370,4020,1612,4696
520800,201901,14178,38126,11427,34242,2165,6608,6582,20459,8747,27067
520810,201901,1270,2719,910,2309,180,495,491,1287,671,1782
520815,201901,589,1761,426,1433,102,352,86,309,188,661
520830,201901,1785,3971,1266,3376,57,137,1002,2644,1059,2781
520840,201901,2234,6205,1830,5682,782,2536,528,1761,1310,4297
520850,201901,637,1740,448,1438,164,599,93,301,257,900
520860,201901,5680,15998,4391,13942,1087,3728,1699,5396,2786,9124
520870,201901,87153,210043,60092,169838,15848,48649,18627,51737,34475,100386
520880,201901,5916,17226,4671,15104,1340,4593,1441,4671,2781,9264
520890,201901,3682,9340,2565,7559,563,1775,1089,3195,1652,4970
520910,201901,4289,11085,2738,8348,738,2462,519,1620,1257,4082
520915,201901,612,1718,398,1265,69,253,140,425,209,678
520920,201901,4366,10333,2959,8406,417,1255,1548,4431,1965,5686
520929,201901,726,1783,506,1413,81,203,244,728,325,931
520940,201901,982,2685,794,2415,51,172,598,1787,649,1959
520945,201901,486,1125,385,970,26,61,268,661,294,722
520960,201901,1001,2605,796,2267,110,339,497,1361,607,1700
520970,201901,2335,6747,1905,6016,557,1928,478,1572,1035,3500
520980,201901,772,1946,581,1673,130,403,231,640,361,1043
520990,201901,2913,8310,2412,7605,281,929,1596,5069,1877,5998
520993,201901,1020,2425,682,1896,43,142,475,1292,518,1434
520995,201901,2204,5713,1702,5037,344,1047,704,2109,1048,3156
521000,201901,7867,21320,5494,17128,1323,4328,1552,4840,2875,9168
521010,201901,3645,9612,2746,8076,344,1020,1544,4534,1888,5554
521015,201901,681,1747,526,1495,56,167,336,927,392,1094
521020,201901,2806,7426,1715,5287,524,1712,157,507,681,2219
521030,201901,481,1068,329,859,43,89,166,478,209,567
521040,201901,7278,18004,5448,15185,1358,3958,2195,6247,3553,10205
521056,201901,837,2293,648,2005,198,625,191,638,389,1263
521060,201901,998,2595,748,2179,53,159,369,1094,422,1253
521080,201901,1040,2348,534,1515,67,200,195,475,262,675
521090,201901,3314,8757,2267,6839,648,2077,310,984,958,3061
521100,201901,1746,4105,1252,3411,226,608,698,1932,924,2540
521120,201901,4680,11025,3266,9262,287,755,1592,5160,1879,5915
521130,201901,905,2134,584,1598,33,120,331,906,364,1026
521140,201901,1231,3261,888,2662,158,502,367,1092,525,1594
521150,201901,11356,25769,7350,20212,1501,4687,3177,8897,4678,13584
521160,201901,599,1328,427,1062,60,150,246,583,306,733
521170,201901,1048,2490,746,2025,71,197,502,1327,573,1524
521180,201901,6467,19067,5431,17192,1080,3714,2444,7474,3524,11188
521190,201901,10080,26241,5822,18640,1457,5016,1139,3831,2596,8847
521200,201901,722,1808,499,1426,56,157,280,795,336,952
521205,201901,604,1561,454,1312,24,58,331,940,355,998
521210,201901,691,1790,395,1199,105,344,50,112,155,456
521220,201901,3837,9538,2524,7437,579,1870,695,1877,1274,3747
521225,201901,313,718,243,635,40,108,150,390,190,498
521230,201901,1238,3489,1141,3356,429,1244,583,1804,1012,3048
521250,201901,29356,82096,23425,73612,9243,30211,7073,23775,16316,53986
521260,201901,581,1360,427,1110,60,160,253,648,313,808
521270,201901,1781,4603,1530,4299,99,249,1182,3352,1281,3601
521280,201901,1841,5081,1387,4282,383,1278,494,1547,877,2825
521290,201901,450,1127,321,955,51,169,170,492,221,661
521295,201901,1094,2400,860,2150,69,150,669,1772,738,1922
521300,201901,1855,4736,1486,4227,294,789,893,2612,1187,3401
521305,201901,702,1794,495,1454,66,177,273,804,339,981
521308,201901,4570,12593,3320,10161,470,1467,1773,5357,2243,6824
521310,201901,7831,20668,5294,16216,1280,4257,1823,5379,3103,9636
521340,201901,406,957,293,789,20,56,216,567,236,623
521350,201901,2017,5220,1565,4534,165,549,1051,2932,1216,3481
521370,201901,1171,3044,724,2290,174,626,145,478,319,1104
521375,201901,1355,3446,969,2901,239,712,338,1089,577,1801
521377,201901,1448,3173,1073,2708,74,145,887,2301,961,2446
521380,201901,5721,15580,3852,12092,429,1504,936,3092,1365,4596
521385,201901,593,1483,479,1338,91,260,241,729,332,989
521390,201901,688,1740,489,1443,155,486,165,520,320,1006
521400,201901,2449,5635,1907,5011,177,460,1434,3890,1611,4350
521405,201901,1273,3282,954,2753,191,556,430,1221,621,1777
521410,201901,744,2018,590,1772,113,323,302,979,415,1302
521440,201901,1299,3393,954,2838,282,903,266,783,548,1686
521450,201901,3716,11358,2807,9507,659,2243,828,2955,1487,5198
521460,201901,5598,15233,4133,12623,1511,4821,873,2643,2384,7464
521470,201901,637,1768,391,1241,61,193,111,326,172,519
521480,201901,347,908,195,606,39,130,48,134,87,264
521483,201901,2441,5933,1702,4757,418,1249,618,1682,1036,2931
521486,201901,1648,3967,1253,3410,69,198,956,2572,1025,2770
521487,201901,445,1120,318,930,57,167,146,442,203,609
521490,201901,834,2300,613,1921,42,174,436,1328,478,1502
521500,201901,1781,4624,1313,3868,92,344,913,2612,1005,2956
521520,201901,751,1717,508,1357,88,236,209,574,297,810
521523,201901,10775,35321,9250,32781,3165,11935,2461,9070,5626,21005
521525,201901,1031,2424,764,2042,85,239,537,1419,622,1658
521530,201901,2211,5797,1282,3887,268,874,320,1015,588,1889
521540,201901,844,2175,546,1665,92,337,229,702,321,1039
521550,201901,1238,3195,758,2256,156,493,225,719,381,1212
521560,201901,4004,11109,2838,9518,570,2231,1378,4799,1948,7030
521565,201901,615,1543,492,1367,93,235,283,791,376,1026
521570,201901,3553,9567,2382,7370,501,1739,323,1081,824,2820
521580,201901,493,1223,275,826,35,116,64,160,99,276
521590,201901,595,1502,453,1287,108,345,210,561,318,906
521600,201901,385,1081,237,749,47,128,53,173,100,301
521630,201901,1586,3627,966,2667,204,597,312,830,516,1427
521640,201901,1853,4456,1342,3742,306,911,486,1316,792,2227
521645,201901,554,1485,359,1127,84,253,102,321,186,574
521680,201901,1114,3456,883,2986,270,968,102,384,372,1352
521690,201901,497,1327,434,1218,66,202,261,710,327,912
521710,201901,2895,7590,1934,5925,379,1311,432,1262,811,2573
521720,201901,2043,5003,1447,4107,177,546,819,2276,996,2822
521730,201901,3527,10403,2765,9021,899,3251,516,1431,1415,4682
521740,201901,3804,10264,2902,8940,878,2923,958,3094,1836,6017
521760,201901,13433,39201,10854,35145,3302,11691,3694,12370,6996,24061
521770,201901,2816,7125,1990,5766,624,1941,447,1284,1071,3225
521800,201901,5652,16020,4468,14051,1221,3974,1506,5192,2727,9166
521805,201901,533,1275,387,1068,132,347,159,459,291,806
521810,201901,683,1603,466,1289,76,218,227,638,303,856
521830,201901,5077,14562,4156,13188,377,1395,2824,8824,3201,10219
521839,201901,655,1686,469,1360,95,286,202,548,297,834
521850,201901,4953,12669,3371,10064,697,2303,357,969,1054,3272
521860,201901,1719,4512,1171,3567,193,632,388,1158,581,1790
521870,201901,680,1958,472,1560,114,389,130,409,244,798
521878,201901,590,1590,439,1317,72,250,200,540,272,790
521880,201901,17460,42775,11845,34320,3141,9571,3791,11355,6932,20926
521890,201901,2981,8207,2018,6327,541,1798,280,837,821,2635
521900,201901,1580,3802,955,2870,265,784,203,650,468,1434
521910,201901,1127,2561,770,2127,82,228,460,1329,542,1557
521920,201901,420,1210,311,995,62,212,113,378,175,590
521925,201901,711,1974,534,1680,112,350,207,631,319,981
521930,201901,4501,11542,3185,9572,915,2680,1125,3702,2040,6382
521935,201901,850,2128,600,1690,69,203,348,932,417,1135
521940,201901,1252,2896,826,2317,190,588,331,892,521,1480
521945,201901,505,1435,403,1243,91,283,192,621,283,904
521950,201901,649,1581,490,1373,92,296,293,770,385,1066
521960,201901,700,1924,462,1434,69,228,214,634,283,862
521970,201901,2461,6308,2068,5840,120,330,1665,4780,1785,5110
521971,201901,726,1801,508,1472,135,404,125,357,260,761
521973,201901,1151,3126,912,2765,64,242,616,1816,680,2058
521975,201901,11560,31279,9787,28871,1628,4992,6107,18073,7735,23065
521980,201901,2526,6195,1970,5460,185,490,1456,4063,1641,4553
521990,201901,1102,3078,896,2753,136,421,431,1354,567,1775
522000,201901,2806,7805,2194,7037,242,753,1454,4861,1696,5614
522005,201901,334,835,257,729,53,135,120,355,173,490
522010,201901,3712,9331,2684,7693,745,2269,717,2003,1462,4272
522015,201901,923,2486,663,2067,148,486,254,794,402,1280
522020,201901,5046,12290,3372,9627,804,2383,1451,4259,2255,6642
522026,201901,632,1805,483,1539,87,289,197,617,284,906
522028,201901,465,1256,340,1000,70,203,135,376,205,579
522040,201901,2891,6605,2052,5512,259,765,1371,3609,1630,4374
522045,201901,15989,46413,12002,38969,3005,10373,2984,9472,5989,19845
522050,201901,1016,2737,697,2192,147,499,278,833,425,1332
522060,201901,2435,6834,1947,6065,242,789,1124,3627,1366,4416
522068,201901,1704,4665,1380,4256,166,466,984,3133,1150,3599
522070,201901,580,1535,480,1379,35,130,363,992,398,1122
522100,201901,586,1570,419,1302,59,196,220,680,279,876
522108,201901,884,2438,700,2151,45,202,557,1639,602,1841
522119,201901,1504,3944,1171,3496,189,597,622,1910,811,2507
522130,201901,369,925,268,791,54,166,145,450,199,616
522140,201901,15550,42310,11436,35100,3426,11235,2356,7015,5782,18250
522145,201901,829,2052,593,1712,144,372,286,893,430,1265
522150,201901,914,2270,671,1881,215,584,222,665,437,1249
522155,201901,846,2248,663,1937,142,406,306,900,448,1306
522157,201901,516,1344,444,1244,28,102,345,953,373,1055
522160,201901,5596,15009,3762,11597,1089,3634,301,1014,1390,4648
522170,201901,2532,6688,1855,5619,436,1354,822,2534,1258,3888
522180,201901,427,1069,276,812,63,191,27,97,90,288
522185,201901,15698,40390,11779,35193,5111,16339,2681,8818,7792,25157
522190,201901,697,1705,520,1430,95,258,212,597,307,855
522200,201901,1632,4866,1054,3600,194,696,86,273,280,969
522205,201901,1574,3775,1201,3258,120,357,834,2254,954,2611
522220,201901,1276,3352,974,2889,152,429,518,1580,670,2009
522230,201901,1138,3033,950,2761,204,682,519,1445,723,2127
530010,201901,152603,435606,127896,396743,24433,83468,68403,208731,92836,292199
110001,201902,3572,10479,2529,8501,668,2396,965,3226,1633,5622
110002,201902,11159,30230,8029,24820,2344,7701,2514,7842,4858,15543
110003,201902,611,1830,443,1480,124,445,89,288,213,733
110004,201902,9339,26088,6461,20618,1655,5614,1719,5724,3374,11338
110005,201902,2383,6399,1485,4709,362,1229,424,1452,786,2681
110006,201902,1710,4847,1066,3525,237,878,175,555,412,1433
110007,201902,1014,2910,779,2537,279,940,236,863,515,1803
110008,201902,3044,8829,2254,7604,287,940,1516,5367,1803,6307
110009,201902,3954,11460,2596,8970,719,2560,892,3227,1611,5787
110010,201902,6231,21353,4878,18764,1171,4363,2288,9799,3459,14162
110011,201902,6115,16984,4383,13845,1562,5061,779,2576,2341,7637
110012,201902,13403,35142,8565,26526,2283,7419,1054,3515,3337,10934
110013,201902,4967,15047,3862,12818,1697,5757,575,2160,2272,7917
110014,201902,3580,9783,2504,7760,697,2199,955,2943,1652,5142
110015,201902,4756,12932,2708,8752,746,2635,415,1211,1161,3846
110018,201902,3261,8623,1968,6311,454,1638,525,1614,979,3252
110020,201902,70723,176389,49007,145761,10869,33516,19771,63218,30640,96734
110025,201902,4731,11935,3117,9085,690,2124,1416,4057,2106,6181
110026,201902,441,1259,336,1094,104,365,126,398,230,763
110028,201902,5820,15754,3796,11948,1078,3613,560,1755,1638,5368
110029,201902,1317,3259,765,2333,183,572,312,977,495,1549
110030,201902,11888,28685,7763,22754,1621,5515,2323,7145,3944,12660
110032,201902,2805,8343,1940,6514,650,2192,478,1678,1128,3870
110033,201902,3598,11728,2881,10358,1062,3896,697,2785,1759,6681
110034,201902,3265,8072,2203,6582,676,2164,906,2805,1582,4969
110037,201902,1567,4993,1258,4391,304,1073,587,2055,891,3128
110040,201902,2845,8289,2084,6869,661,2317,522,1664,1183,3981
110045,201902,4776,14288,3776,12509,1052,3765,1404,4705,2456,8470
110050,201902,1658,4894,1226,4045,536,1857,238,794,774,2651
110060,201902,745,2279,525,1808,211,769,61,217,272,986
110070,201902,1692,5440,1327,4615,458,1690,277,884,735,2574
110080,201902,5831,14029,4205,12117,493,1331,2890,8812,3383,10143
110090,201902,549,1510,385,1221,111,394,145,440,256,834
110092,201902,1151,3497,860,2931,149,524,447,1598,596,2122
110094,201902,2764,8367,2137,7239,794,2812,560,2003,1354,4815
110100,201902,1669,5186,1381,4563,340,1184,649,2141,989,3325
110110,201902,1667,4845,1166,3914,385,1339,256,919,641,2258
110120,201902,1225,3747,938,3157,259,903,274,925,533,1828
110130,201902,2514,6584,1581,4866,359,1203,542,1665,901,2868
110140,201902,1993,6257,1437,5096,406,1476,370,1345,776,2821
110143,201902,1290,3557,884,2764,309,977,198,627,507,1604
110145,201902,859,2384,564,1826,139,481,188,629,327,1110
110146,201902,433,1199,300,990,55,177,154,539,209,716
110147,201902,750,1994,473,1430,72,221,187,493,259,714
110148,201902,762,2255,464,1601,118,451,54,189,172,640
110149,201902,2852,8198,2063,6939,799,2709,474,1760,1273,4469
110150,201902,2503,6469,1732,5389,583,2012,505,1656,1088,3668
110155,201902,629,1938,484,1611,125,440,157,500,282,940
110160,201902,1480,4682,1103,3851,369,1285,253,930,622,2215
110170,201902,2147,5697,1335,4091,257,823,675,2024,932,2847
110175,201902,1435,4246,1066,3620,195,689,509,1816,704,2505
110180,201902,1275,3612,880,2798,185,593,404,1290,589,1883
120001,201902,3060,9760,2609,9113,422,1411,1725,6272,2147,7683
120005,201902,1881,7278,1699,6983,167,747,1305,5476,1472,6223
120010,201902,5154,16123,4414,14916,565,1874,3054,10622,3619,12496
120013,201902,2124,7946,1983,7746,494,1841,1178,4910,1672,6751
120017,201902,2115,7179,1900,6833,332,1230,1182,4435,1514,5665
120020,201902,14153,58699,13256,56855,1280,5980,10180,44306,11460,50286
120025,201902,2845,8527,2348,7897,450,1515,1518,5252,1968,6767
120030,201902,6477,25839,6156,25263,422,2241,4901,20188,5323,22429
120032,201902,1615,7452,1552,7307,101,616,1274,5941,1375,6557
120033,201902,3995,15045,3742,14601,142,768,3209,12459,3351,13227
120034,201902,2536,9510,2202,8891,126,736,1763,6990,1889,7726
120035,201902,3457,14487,3299,14186,298,1406,2666,11616,2964,13022
120038,201902,2661,8807,2315,8217,559,2105,1207,4314,1766,6419
120039,201902,1921,8606,1806,8375,142,883,1415,6528,1557,7411
120040,201902,40857,134880,36148,126993,6071,22466,22014,78471,28085,100937
120042,201902,3274,12605,3009,12044,168,895,2400,9583,2568,10478
120043,201902,1364,5622,1242,5409,46,269,1095,4782,1141,5051
120045,201902,5778,15961,5105,15209,146,591,4661,13747,4807,14338
120050,201902,8945,33024,8212,31871,524,2612,6642,25849,7166,28461
120060,201902,8996,36189,8349,35171,427,2480,7131,30009,7558,32489
120070,201902,3014,9989,2651,9488,278,1029,1848,6883,2126,7912
120080,201902,4233,14426,3812,13742,593,2303,2563,9380,3156,11683
130002,201902,3104,12474,2800,12058,124,659,2481,10712,2605,11371
130006,201902,2329,8964,1910,8205,166,792,1428,6114,1594,6906
130008,201902,2524,9040,2277,8661,79,405,1928,7332,2007,7737
130010,201902,3869,11307,3312,10674,60,196,3095,10071,3155,10267
130014,201902,2983,9219,2372,8179,435,1528,1449,5100,1884,6628
130020,201902,2656,10649,2417,10261,161,956,1880,7930,2041,8886
130030,201902,9570,32102,8773,31172,215,903,7946,28484,8161,29387
130040,201902,3636,11107,3083,10362,159,592,2498,8465,2657,9057
130050,201902,7363,27312,6179,25792,219,1032,5544,23388,5763,24420
130060,201902,7214,29449,6258,28156,546,3141,4942,22108,5488,25249
130063,201902,6027,20272,5393,19567,134,646,4983,18129,5117,18775
130068,201902,3380,13025,2968,12308,236,1331,2166,8859,2402,10190
130070,201902,7588,22109,6359,20745,298,967,5394,17945,5692,18912
130080,201902,6704,25792,5972,24887,317,1851,4965,20832,5282,22683
130083,201902,2581,8934,2352,8648,189,821,1968,7178,2157,7999
130090,201902,3406,10808,3046,10337,63,287,2635,9105,2698,9392
130100,201902,7617,23515,6582,22419,74,199,6159,21546,6233,21745
130110,201902,8147,23684,6819,22038,819,2163,5266,18012,6085,20175
130115,201902,5387,17207,4722,16420,106,426,4173,14708,4279,15134
130120,201902,14231,52013,12982,50373,1231,5192,10562,41338,11793,46530
130130,201902,5133,17067,4064,15666,450,1966,3057,11759,3507,13725
130140,201902,6783,24802,6262,24215,221,1180,5556,21534,5777,22714
130150,201902,3619,13781,3403,13520,93,577,3091,12283,3184,12860
130160,201902,4907,18213,4265,17368,323,1537,3529,14536,3852,16073
130165,201902,3126,12159,2959,11920,109,584,2646,10644,2755,11228
130170,201902,11537,34787,9448,32284,668,2693,7786,26690,8454,29383
130180,201902,4391,14042,4151,13773,43,231,4003,13243,4046,13474
130185,201902,17935,44843,14617,41296,813,1536,12676,37352,13489,38888
130190,201902,18664,62427,15355,57500,1840,7046,10882,41950,12722,48996
130195,201902,2376,8803,1925,8215,78,422,1697,7244,1775,7666
130200,201902,2472,7314,2064,6751,125,508,1672,5467,1797,5975
130210,201902,1283,4919,1158,4772,99,595,939,3771,1038,4366
130220,201902,2152,7952,1936,7634,95,500,1634,6425,1729,6925
130230,201902,4232,18320,3771,17642,317,1849,3119,14610,3436,16459
130240,201902,11107,35115,9201,32476,213,1275,8120,28562,8333,29837
130250,201902,25578,78373,22391,74795,1608,5101,18423,63788,20031,68889
130255,201902,4206,14558,3759,13752,191,880,3008,11007,3199,11887
130260,201902,244951,718426,205110,658964,57958,198160,92499,302835,150457,500995
130270,201902,8536,32082,7361,30227,1070,4556,5095,21595,6165,26151
130280,201902,3483,14174,3224,13886,117,563,2969,12959,3086,13522
130290,201902,12880,43947,11413,42151,554,2322,9990,37349,10544,39671
130300,201902,4632,16711,4260,16163,168,895,3674,13857,3842,14752
130310,201902,5743,20443,5095,19533,353,1512,4202,16318,4555,17830
130320,201902,3318,11039,2866,10485,297,1060,2218,8360,2515,9420
130330,201902,4522,14690,3741,13745,210,940,3198,11759,3408,12699
130340,201902,21869,72707,19158,69543,1505,5171,15916,59590,17421,64761
130350,201902,3890,14402,3528,13926,152,886,3068,11996,3220,12882
130353,201902,6549,18985,5445,17582,874,2772,3693,12341,4567,15113
130356,201902,4882,16418,4214,15346,613,2277,2795,10496,3408,12773
130360,201902,3134,9410,2691,8907,62,193,2521,8419,2583,8612
130370,201902,5631,22162,5019,21327,287,1449,4231,17968,4518,19417
130380,201902,7174,30316,6805,29741,430,2457,5753,24851,6183,27308
130390,201902,5914,24922,5229,23710,567,3046,3845,17393,4412,20439
130395,201902,2313,7550,2013,7035,232,864,1476,5140,1708,6004
130400,201902,2625,8596,2283,8135,118,440,2009,7242,2127,7682
130406,201902,10727,39372,9302,37517,1739,7183,6290,26083,8029,33266
130410,201902,4006,14613,3499,13766,1088,4448,1645,6722,2733,11170
130420,201902,13025,47447,11110,45114,1043,5351,8784,35478,9827,40829
130423,201902,4080,13358,3614,12815,174,859,3182,11138,3356,11997
130426,201902,2817,11120,2684,10923,89,483,2484,10113,2573,10596
130430,201902,4137,12294,3639,11601,340,1221,2894,9108,3234,10329
130440,201902,4714,14945,4132,14261,101,408,3826,13277,3927,13685
140002,201902,2057,6186,1800,5845,96,385,1491,4780,1587,5165
140005,201902,3113,8754,2849,8461,138,399,2513,7510,2651,7909
140010,201902,54406,145825,42925,128892,11101,34996,16973,52718,28074,87714
140015,201902,3275,10482,2893,10017,214,766,2456,8632,2670,9398
140017,201902,3722,11207,3284,10633,327,1048,2476,8303,2803,9351
140020,201902,5027,15239,4294,14243,307,1328,3368,11091,3675,12419
140023,201902,2269,7002,1860,6419,235,853,1319,4611,1554,5464
140028,201902,2095,5434,1781,5024,131,430,1381,3829,1512,4259
140030,201902,4721,12818,4212,12205,346,818,3513,10515,3859,11333
140040,201902,2212,9218,2030,8942,123,761,1764,7613,1887,8374
140045,201902,2573,9593,2170,9012,409,1635,1415,6226,1824,7861
140047,201902,5768,17122,4939,15867,770,2645,3301,10706,4071,13351
140050,201902,1368,4112,1168,3815,132,450,832,2766,964,3216
140060,201902,1577,4281,1336,3925,114,332,1043,3108,1157,3440
140070,201902,1771,9501,1709,9337,150,997,1353,7311,1503,8308
150010,201902,44096,111939,40225,106954,978,2786,35867,94742,36845,97528
150013,201902,1898,5058,1574,4695,138,356,1216,3797,1354,4153
150020,201902,14001,43049,13101,41878,1127,2792,11094,36619,12221,39411
150030,201902,8563,32727,7846,31838,368,1747,6939,28286,7307,30033
150034,201902,4212,10868,3519,9964,235,659,2932,8426,3167,9085
150040,201902,15741,41361,13785,39168,1340,2335,11238,34751,12578,37086
150050,201902,6663,24009,6154,23283,138,666,5650,21509,5788,22175
150060,201902,20575,57818,17029,52532,2964,9170,10504,33305,13468,42475
150070,201902,6486,25060,5780,24201,185,990,5231,22146,5416,23136
150080,201902,89533,208635,76195,190758,17825,47569,26706,79244,44531,126813
150085,201902,6731,20726,6178,20038,181,580,5717,18670,5898,19250
150090,201902,9974,37444,9378,36319,657,2870,7617,29539,8274,32409
150095,201902,5545,16846,4907,16010,289,757,4079,13805,4368,14562
150100,201902,3013,10631,2666,10033,195,748,2068,7841,2263,8589
150110,201902,4106,17867,3948,17667,221,1068,3577,16080,3798,17148
150120,201902,7541,24714,7308,24400,312,821,6475,22366,6787,23187
150125,201902,748,2068,566,1817,109,401,325,1026,434,1427
150130,201902,22809,66984,20022,62819,2667,7471,14412,47002,17079,54473
150140,201902,225251,543448,195188,502156,31900,80386,113558,306877,145458,387263
150145,201902,4513,13625,3858,12700,795,2339,2503,8845,3298,11184
150150,201902,14903,39734,13286,37710,828,2444,10819,30872,11647,33316
150157,201902,3273,9256,2721,8537,275,935,1957,6343,2232,7278
150160,201902,2948,9084,2757,8778,655,2052,1548,5131,2203,7183
150170,201902,24291,80680,21127,75404,3941,13374,12735,48406,16676,61780
150172,201902,4408,12575,3585,11411,272,785,2658,8754,2930,9539
150175,201902,1662,5200,1423,4757,245,882,896,3025,1141,3907
150178,201902,10142,28733,8510,26808,337,1042,7327,23467,7664,24509
150180,201902,20711,77118,19286,75348,1012,3983,16852,66967,17864,70950
150190,201902,6822,23247,6422,22723,297,1309,5622,19790,5919,21099
150195,201902,5355,17309,5109,16940,94,470,4720,15525,4814,15995
150200,201902,5540,16578,5085,16084,55,166,4787,15275,4842,15441
150210,201902,25123,90163,23620,88064,1971,7229,19130,73390,21101,80619
150215,201902,6938,20681,6017,19323,1508,4772,3100,10562,4608,15334
150220,201902,11537,34083,10318,32301,1449,4459,6633,21260,8082,25719
150230,201902,12231,35555,10667,33468,1237,3652,7392,24175,8629,27827
150240,201902,31538,89521,26143,80229,8097,25298,7905,25028,16002,50326
150250,201902,4043,16322,3858,16066,546,2269,2967,12614,3513,14883
150260,201902,2541,8753,2346,8434,207,745,1789,6527,1996,7272
150270,201902,8594,25022,6153,21025,2045,7298,1973,7097,4018,14395
150275,201902,6605,21713,6123,20995,259,1015,5265,17977,5524,18992
150276,201902,2256,6214,1941,5837,248,680,1355,4433,1603,5113
150277,201902,5161,13808,4211,12704,367,1044,3241,10357,3608,11401
150280,201902,6452,26938,6266,26587,556,2311,5178,22265,5734,24576
150285,201902,3201,11523,2838,10960,304,1247,1999,7864,2303,9111
150290,201902,10726,29285,9872,28352,372,849,8882,26097,9254,26946
150293,201902,9462,23837,6996,20548,1361,3974,3720,11764,5081,15738
150295,201902,7881,21595,5775,18782,2043,7210,1990,7101,4033,14311
150300,201902,2184,6854,1965,6557,52,244,1748,5817,1800,6061
150304,201902,4026,12380,3363,11281,604,1923,2116,7406,2720,9329
150307,201902,6230,20299,5805,19623,410,1348,4728,16190,5138,17538
150309,201902,6070,18976,4934,16994,1003,3300,2611,9485,3614,12785
150310,201902,7171,28480,6858,28091,237,1327,6079,25100,6316,26427
150320,201902,9367,25587,8526,24441,465,1457,6622,18920,7087,20377
150330,201902,13682,45184,12708,43524,1526,5105,9346,32823,10872,37928
150340,201902,2573,7594,2319,7233,339,993,1628,5184,1967,6177
150345,201902,7693,23154,6995,22239,397,1344,5994,19179,6391,20523
150350,201902,8884,23810,8159,22877,832,1702,6620,19298,7452,21000
150360,201902,23376,66863,18943,61159,2184,6409,13063,44278,15247,50687
150370,201902,9976,32354,8476,30255,980,3284,6202,23319,7182,26603
150375,201902,3279,13683,2976,13223,269,1338,2409,10761,2678,12099
150380,201902,10534,28119,8807,25782,245,850,7623,22420,7868,23270
150390,201902,7741,31962,7052,30811,1156,4708,4886,22456,6042,27164
150400,201902,6198,22906,5946,22424,285,1170,5125,19376,5410,20546
150405,201902,9139,24622,8106,23347,522,1169,6535,19534,7057,20703
150410,201902,1863,6121,1599,5654,214,721,1028,3746,1242,4467
150420,201902,39099,112949,30081,99090,9486,32776,9056,34584,18542,67360
150430,201902,8283,24899,7645,24046,812,2102,6008,19592,6820,21694
150440,201902,5575,18400,5244,17894,551,1741,4046,14106,4597,15847
150442,201902,24325,61764,20407,56557,2359,6364,13702,39002,16061,45366
150445,201902,5999,19152,5390,18204,252,927,4558,15438,4810,16365
150450,201902,4864,21557,4600,21192,364,1795,3912,18134,4276,19929
150460,201902,8334,27665,7727,26870,254,1035,6665,23999,6919,25034
150470,201902,20303,54403,18041,51805,680,1832,16456,47556,17136,49388
150475,201902,4584,15062,4071,14267,194,733,3398,12052,3592,12785
150480,201902,13590,45343,12202,43204,2064,6795,8394,31323,10458,38118
150490,201902,8001,28561,7510,27929,240,1133,6704,25005,6944,26138
150495,201902,5067,18076,4926,17877,117,568,4526,16382,4643,16950
150497,201902,2729,9023,2222,8111,566,2154,1097,4218,1663,6372
150500,201902,3282,8629,2920,8106,284,729,2236,6241,2520,6970
150503,201902,4299,11946,3080,10257,953,3332,1029,3842,1982,7174
150506,201902,9853,31155,8553,29294,1840,5591,5440,20296,7280,25887
150510,201902,9750,36202,8544,33878,1194,4575,5774,23956,6968,28531
150520,201902,7299,27659,6991,27269,188,1038,6442,25075,6630,26113
150530,201902,12243,42021,10733,39846,1593,4870,7692,30312,9285,35182
150540,201902,4896,13770,4217,12767,149,450,3628,10980,3777,11430
150543,201902,7017,19294,5757,17654,817,2584,3964,12729,4781,15313
150548,201902,9854,31355,8946,30134,304,1051,7946,26931,8250,27982
150549,201902,2014,6177,1743,5818,49,205,1521,5084,1570,5289
150550,201902,19338,58329,16555,53741,4051,13441,7468,25849,11519,39290
150553,201902,23294,72565,18621,63977,6219,21868,5674,21473,11893,43341
150555,201902,1799,4950,1419,4338,131,345,993,3115,1124,3460
150560,201902,1801,5640,1612,5263,298,923,911,3096,1209,4019
150563,201902,2433,7726,2106,7127,453,1639,1161,3908,1614,5547
150565,201902,4218,13861,3756,13105,107,520,3111,10920,3218,11440
150570,201902,6100,20402,5838,20008,279,1120,5044,17210,5323,18330
150580,201902,10054,41221,9119,40164,638,3145,7580,34163,8218,37308
150590,201902,7277,26610,6636,25782,207,1137,6014,23283,6221,24420
150600,201902,9120,31424,8520,30658,240,1036,7800,28152,8040,29188
150610,201902,2687,8235,2415,7754,126,496,1960,6204,2086,6700
150611,201902,2989,8912,2698,8475,107,432,2342,7290,2449,7722
150613,201902,12668,35546,9658,30408,1872,6260,4647,14774,6519,21034
150616,201902,3245,9107,2398,7698,605,2059,905,2856,1510,4915
150618,201902,6797,20377,5520,18365,678,2223,3421,11913,4099,14136
150619,201902,5994,17757,5006,16278,224,854,4044,13180,4268,14034
150620,201902,6429,21565,5598,20242,809,2855,3851,14339,4660,17194
150630,201902,6113,17002,5639,16420,407,1137,4726,13970,5133,15107
150635,201902,4466,12873,3853,11849,613,1887,2368,7426,2981,9313
150640,201902,2202,6416,2022,6201,33,105,1890,5875,1923,5980
150650,201902,11320,32376,10027,30196,3094,8766,4463,14559,7557,23325
150655,201902,5729,16776,5229,16032,216,680,4477,13731,4693,14411
150658,201902,4359,12528,3505,11276,620,2090,2090,7037,2710,9127
150660,201902,5660,16572,5100,15784,554,1668,3509,11065,4063,12733
150670,201902,8024,19345,6365,17443,643,1471,5017,14384,5660,15855
150680,201902,64124,196205,49519,172776,12671,43832,22038,85782,34709,129614
150690,201902,2643,7238,2370,6880,129,328,2045,6031,2174,6359
150700,201902,6191,18699,5564,17893,391,1173,4399,14472,4790,15645
150710,201902,3746,12620,3422,12088,233,883,2657,9487,2890,10370
150715,201902,4942,14719,4163,13493,361,1114,3240,10685,3601,11799
150720,201902,6548,24635,6162,23977,445,2002,5072,19771,5517,21773
150730,201902,11251,35603,9889,33522,1098,3892,7475,25827,8573,29719
150740,201902,3783,10947,3355,10222,383,1040,2411,7511,2794,8551
150745,201902,5104,14899,4142,13468,819,2814,2674,8737,3493,11551
150746,201902,1545,4936,1427,4747,87,284,1156,3866,1243,4150
150747,201902,4838,15820,4329,14993,787,2432,2802,10276,3589,12708
150750,201902,3603,11502,3070,10680,226,840,2344,8352,2570,9192
150760,201902,11726,34940,10749,33682,1354,3945,7920,25471,9274,29416
150770,201902,6200,22803,5914,22418,180,550,5435,21202,5615,21752
150775,201902,892,2604,711,2333,137,513,384,1246,521,1759
150780,201902,4495,13628,4073,13117,112,350,3731,12186,3843,12536
150790,201902,5487,16145,4792,15393,226,561,3969,13861,4195,14422
150795,201902,13339,43326,12129,41281,3208,10344,6784,24613,9992,34957
150796,201902,3576,9306,3108,8743,178,490,2638,7503,2816,7993
150797,201902,3863,12264,3356,11504,143,456,2788,9670,2931,10126
150800,201902,12880,41435,11929,40246,1576,4908,9050,31633,10626,36541
150803,201902,6749,22840,6351,22216,394,1413,5379,18923,5773,20336
150805,201902,3341,10676,2856,9909,291,1059,2154,7532,2445,8591
150808,201902,5846,17290,4338,14689,1671,6167,599,2257,2270,8424
150810,201902,20367,56075,15665,50296,2806,8938,8834,30704,11640,39642
150812,201902,5300,15375,4709,14324,463,1526,3451,10282,3914,11808
150815,201902,8908,27704,7660,26122,714,2442,6076,21055,6790,23497
150820,201902,11922,32791,10008,30482,945,2528,7798,24595,8743,27123
150830,201902,11385,43234,10821,42528,394,2058,9438,37655,9832,39713
150835,201902,2129,7360,1899,6945,403,1472,959,3561,1362,5033
150840,201902,7183,21243,5757,18714,1146,3928,2949,9563,4095,13491
160005,201902,1179,3253,1069,3098,32,134,979,2816,1011,2950
160010,201902,2423,6259,2310,6142,19,99,2246,5901,2265,6000
160015,201902,2333,7389,2130,7116,84,292,1933,6485,2017,6777
160020,201902,1982,6761,1769,6467,224,846,1355,5002,1579,5848
160021,201902,1091,4304,1014,4195,77,450,814,3286,891,3736
160023,201902,1205,4412,1071,4186,120,435,754,3104,874,3539
160025,201902,1931,5434,1869,5360,12,37,1840,5283,1852,5320
160027,201902,8705,24542,7903,23548,547,1565,6543,19852,7090,21417
160030,201902,61351,182271,50551,167865,11422,35816,26870,98523,38292,134339
160040,201902,5217,18566,4753,17952,93,517,4368,16523,4461,17040
160050,201902,4373,14097,3550,12890,1439,4955,1238,5522,2677,10477
160053,201902,3564,11712,3299,11374,309,998,2663,9426,2972,10424
160055,201902,753,2483,736,2465,27,98,682,2286,709,2384
160060,201902,22848,63620,19125,59333,1117,3473,15403,49683,16520,53156
160070,201902,2894,11077,2622,10637,197,834,2078,8634,2275,9468
160080,201902,2956,10085,2736,9824,68,345,2451,8852,2519,9197
170025,201902,621,1699,464,1467,97,311,238,762,335,1073
170030,201902,1204,3754,954,3268,162,556,470,1650,632,2206
170035,201902,1460,3834,1056,3165,109,358,608,1828,717,2186
170040,201902,1796,5279,1446,4799,116,437,832,2893,948,3330
170070,201902,1720,4122,1211,3476,108,346,699,2035,807,2381
170100,201902,2436,7089,2016,6365,195,584,1320,4239,1515,4823
170105,201902,726,2160,502,1672,132,412,168,572,300,984
170110,201902,932,2950,721,2538,108,410,337,1191,445,1601
170130,201902,1320,4041,939,3278,172,620,459,1665,631,2285
170190,201902,1384,3994,945,3282,321,1091,184,854,505,1945
170200,201902,1759,4432,1079,3276,260,854,277,838,537,1692
170210,201902,24395,67662,18502,57738,6615,22284,1938,7183,8553,29467
170215,201902,1320,3660,1104,3363,61,254,830,2499,891,2753
170220,201902,5840,18364,4952,16691,1169,3684,2367,8635,3536,12319
170230,201902,1263,3858,952,3220,258,893,199,712,457,1605
170240,201902,2660,7544,2054,6571,165,643,1383,4304,1548,4947
170255,201902,3971,11776,2797,9529,508,1797,1277,4491,1785,6288
170270,201902,1035,2514,664,1993,25,78,427,1266,452,1344
170290,201902,2969,8703,2533,8177,133,394,2041,6853,2174,7247
170300,201902,1897,5381,1557,4862,182,596,1025,3243,1207,3839
170305,201902,714,2055,568,1785,69,248,277,852,346,1100
170307,201902,951,3322,764,2933,112,450,413,1607,525,2057
170310,201902,1615,4184,1112,3340,197,654,505,1532,702,2186
170320,201902,1019,2693,761,2288,68,219,476,1431,544,1650
170330,201902,885,2777,790,2623,53,240,627,2017,680,2257
170360,201902,470,1323,334,1094,46,174,192,589,238,763
170370,201902,1287,3502,934,2907,219,646,363,1227,582,1873
170380,201902,1776,5283,1328,4573,120,483,733,2590,853,3073
170382,201902,542,1667,441,1496,52,208,295,974,347,1182
170384,201902,1517,5680,1255,5148,316,1347,550,2300,866,3647
170386,201902,841,2340,527,1718,81,307,154,457,235,764
170388,201902,625,1813,446,1487,57,217,204,682,261,899
170389,201902,1053,3422,894,3148,48,204,699,2490,747,2694
170390,201902,1634,3882,1210,3358,72,183,954,2733,1026,2916
170410,201902,550,1646,399,1366,23,102,259,859,282,961
170460,201902,375,1001,296,867,46,136,181,538,227,674
170510,201902,871,2657,642,2205,58,266,386,1265,444,1531
170550,201902,6455,17657,4635,14563,1328,4480,934,3120,2262,7600
170555,201902,1337,3770,1056,3324,63,212,564,1842,627,2054
170560,201902,1012,2944,756,2573,84,328,437,1605,521,1933
170600,201902,1357,3791,1094,3392,238,611,616,2091,854,2702
170610,201902,1747,4798,1271,4039,79,315,784,2445,863,2760
170625,201902,433,1197,273,853,28,77,91,280,119,357
170650,201902,1283,3882,1004,3400,177,595,480,1725,657,2320
170700,201902,3373,10005,2521,8424,540,1893,1062,3644,1602,5537
170710,201902,1490,4093,1144,3482,195,662,634,1887,829,2549
170720,201902,1867,4786,1498,4248,67,143,1217,3581,1284,3724
170730,201902,1003,2844,740,2399,163,510,318,1100,481,1610
170740,201902,2028,6972,1733,6388,224,863,1147,4239,1371,5102
170755,201902,866,2502,608,2007,64,231,293,936,357,1167
170765,201902,1242,3252,847,2629,198,631,329,1075,527,1706
170770,201902,1785,5414,1505,4962,191,588,980,3327,1171,3915
170820,201902,3417,10902,2855,9828,486,1751,1463,5160,1949,6911
170825,201902,912,2205,738,1960,86,232,500,1333,586,1565
170830,201902,1375,3783,1149,3419,21,65,950,2832,971,2897
170900,201902,2632,8717,2254,8128,182,738,1761,6422,1943,7160
170930,201902,3673,10346,2864,8891,639,2115,1132,3508,1771,5623
170950,201902,11082,31304,7684,25134,2266,8394,1036,3614,3302,12008
170980,201902,408,1185,333,1058,25,118,225,668,250,786
171050,201902,1554,5063,1357,4693,56,278,1094,3742,1150,4020
171070,201902,1327,3926,1130,3634,222,675,641,2271,863,2946
171090,201902,1050,2605,848,2319,69,177,599,1647,668,1824
171110,201902,568,1590,403,1279,66,228,183,524,249,752
171150,201902,1056,2717,646,1990,76,261,404,1236,480,1497
171180,201902,752,2121,497,1622,90,282,193,655,283,937
171190,201902,1613,5705,1429,5381,231,893,865,3330,1096,4223
171195,201902,815,2702,683,2462,121,466,398,1433,519,1899
171200,201902,521,1537,391,1304,74,260,169,559,243,819
171215,201902,383,1099,296,942,53,188,167,512,220,700
171240,201902,747,2578,622,2327,43,220,389,1453,432,1673
171245,201902,631,1957,489,1653,59,224,272,895,331,1119
171250,201902,1077,2866,784,2406,186,614,364,1121,550,1735
171270,201902,381,1495,322,1345,74,324,131,589,205,913
171280,201902,849,2608,657,2261,101,337,344,1251,445,1588
171320,201902,3976,11344,3094,9798,575,1812,1348,4492,1923,6304
171330,201902,2692,7447,2066,6382,441,1305,985,3161,1426,4466
171360,201902,1427,4240,1168,3867,78,312,878,2907,956,3219
171370,201902,672,1764,522,1556,52,162,363,1097,415,1259
171380,201902,1461,4100,1216,3729,116,379,843,2598,959,2977
171395,201902,931,2748,636,2151,71,273,346,1141,417,1414
171420,201902,1882,5721,1370,4672,248,949,595,2017,843,2966
171430,201902,1015,3033,839,2684,74,269,569,1782,643,2051
171488,201902,2346,7100,1831,6241,300,1095,943,3317,1243,4412
171500,201902,972,2533,745,2173,49,154,557,1622,606,1776
171510,201902,758,2633,672,2458,44,205,465,1696,509,1901
171515,201902,472,1301,346,1088,31,129,209,628,240,757
171525,201902,655,1976,529,1751,40,197,312,949,352,1146
171550,201902,335,1007,236,831,37,151,126,431,163,582
171570,201902,1111,3421,931,3091,163,507,525,1821,688,2328
171575,201902,1813,4884,1140,3635,161,554,468,1461,629,2015
171610,201902,5638,16114,4232,13717,985,3485,1161,4024,2146,7509
171620,201902,2692,7667,2263,7039,135,527,1790,5550,1925,6077
171630,201902,952,2630,769,2365,123,394,496,1566,619,1960
171650,201902,2056,6055,1528,5080,402,1407,484,1723,886,3130
171660,201902,2342,6147,1631,4908,257,752,862,2631,1119,3383
171665,201902,1337,3801,1012,3265,175,643,473,1549,648,2192
171670,201902,1817,4996,1399,4311,203,717,785,2359,988,3076
171700,201902,1193,3489,880,2929,116,378,497,1656,613,2034
171720,201902,801,2135,619,1837,40,154,455,1331,495,1485
171750,201902,1233,3551,875,2886,220,753,129,510,349,1263
171780,201902,1216,3187,891,2718,69,257,616,1840,685,2097
171790,201902,1413,4804,1143,4224,254,931,496,1933,750,2864
171800,201902,729,2072,546,1779,73,281,300,970,373,1251
171820,201902,10730,30781,8078,26125,1926,6501,2767,9533,4693,16034
171830,201902,1455,4950,1223,4504,116,543,795,2862,911,3405
171840,201902,742,1992,581,1738,30,94,404,1202,434,1296
171845,201902,630,1646,463,1404,62,233,260,788,322,1021
171850,201902,858,3002,736,2721,67,327,519,1852,586,2179
171855,201902,1067,3298,913,3016,77,261,582,1897,659,2158
171865,201902,370,1206,304,1092,50,194,151,521,201,715
171870,201902,765,2201,549,1796,62,218,292,987,354,1205
171875,201902,1247,3773,1003,3369,57,247,737,2443,794,2690
171880,201902,1086,3456,968,3296,40,166,786,2714,826,2880
171884,201902,801,2209,583,1869,121,446,210,734,331,1180
171886,201902,1409,4034,987,3301,296,1064,198,691,494,1755
171888,201902,738,2100,504,1648,47,161,296,970,343,1131
171889,201902,428,1360,365,1244,75,277,161,549,236,826
171890,201902,1149,3226,857,2753,178,506,470,1588,648,2094
171900,201902,505,1779,354,1381,88,338,123,512,211,850
172000,201902,563,1743,467,1557,56,230,264,833,320,1063
172010,201902,1043,3696,898,3390,77,375,560,2033,637,2408
172015,201902,353,1270,263,1079,62,227,110,503,172,730
172020,201902,2409,7328,2171,6995,180,681,1630,5312,1810,5993
172025,201902,749,2098,544,1752,45,171,348,1104,393,1275
172030,201902,1246,3723,1073,3462,28,118,875,2809,903,2927
172049,201902,1254,3152,870,2594,228,705,438,1339,666,2044
172065,201902,1488,3744,1176,3368,90,189,986,2966,1076,3155
172080,201902,2285,6974,1869,6203,137,532,1257,4164,1394,4696
172085,201902,482,1346,312,990,56,165,101,311,157,476
172090,201902,3963,10301,3056,9076,129,464,2333,6929,2462,7393
172093,201902,498,1494,363,1250,43,178,189,623,232,801
172097,201902,602,1632,434,1352,66,217,208,666,274,883
172100,201902,47331,120149,32140,95196,6697,21677,10311,31447,17008,53124
172110,201902,1580,5937,1362,5580,155,675,987,4219,1142,4894
172120,201902,4816,14663,3822,13018,596,2058,2053,7250,2649,9308
172125,201902,300,852,216,706,29,102,113,367,142,469
172130,201902,716,1945,588,1730,26,99,429,1216,455,1315
172208,201902,2452,6258,1966,5604,215,562,1335,3882,1550,4444
172210,201902,2739,7343,2086,6486,422,1390,1097,3462,1519,4852
210005,201902,19326,57175,15198,50359,4478,15375,5880,20396,10358,35771
210010,201902,1847,5868,1672,5616,53,239,1452,4910,1505,5149
210015,201902,3364,10117,2987,9602,130,344,2578,8446,2708,8790
210020,201902,7490,17205,6596,16183,94,243,6131,15050,6225,15293
210030,201902,4769,16000,4486,15583,197,948,3904,13465,4101,14413
210040,201902,1890,4718,1704,4498,28,48,1594,4252,1622,4300
210043,201902,6400,17957,5289,16527,611,1831,3864,12502,4475,14333
210047,201902,6627,21584,5627,20153,193,974,4868,17327,5061,18301
210050,201902,2216,7672,1752,6819,206,907,1149,4458,1355,5365
210055,201902,1836,6052,1682,5793,71,277,1396,4782,1467,5059
210060,201902,6935,26269,6175,24842,771,3232,4307,17817,5078,21049
210070,201902,7268,20754,6854,20258,36,125,6567,19524,6603,19649
210080,201902,4041,14014,3897,13845,44,273,3673,13083,3717,13356
210083,201902,5478,16149,4619,15236,68,370,4357,14302,4425,14672
210087,201902,2991,8322,2631,7848,124,316,2227,6832,2351,7148
210090,201902,9505,29782,8934,28806,339,1151,7864,25298,8203,26449
210095,201902,6268,20715,5805,20150,251,1055,4852,17382,5103,18437
210100,201902,6752,20464,6144,19517,253,972,5170,16331,5423,17303
210110,201902,2859,9108,2669,8864,34,190,2486,8230,2520,8420
210120,201902,23165,64326,19594,59691,2349,6071,13159,42552,15508,48623
210125,201902,4157,11790,3728,11240,774,1883,2648,8525,3422,10408
210130,201902,4240,11507,3563,10635,150,385,3039,9131,3189,9516
210135,201902,1439,4410,1266,4125,57,192,1044,3438,1101,3630
210140,201902,17431,48693,13701,43777,2743,8721,7653,25452,10396,34173
210150,201902,4510,11048,4025,10372,114,324,3544,9024,3658,9348
210160,201902,16028,48365,14242,45959,1358,4520,10251,34019,11609,38539
210170,201902,14696,47399,13747,46130,645,2239,12163,40861,12808,43100
210173,201902,2291,8588,2111,8276,57,349,1911,7505,1968,7854
210177,201902,3307,9392,2982,8990,108,206,2697,8406,2805,8612
210180,201902,1441,4009,1301,3821,36,99,1162,3405,1198,3504
210190,201902,4969,14391,4399,13527,107,524,3698,11122,3805,11646
210193,201902,1250,3787,1120,3582,40,142,890,2902,930,3044
210197,201902,1997,6563,1864,6370,170,586,1488,5195,1658,5781
210200,201902,7546,24801,6867,23709,620,2223,5429,18907,6049,21130
210203,201902,6953,21051,6133,19924,562,1823,4906,16208,5468,18031
210207,201902,3399,9444,3008,8954,152,396,2493,7583,2645,7979
210210,201902,8238,26880,7677,26121,128,741,7037,23837,7165,24578
210215,201902,2190,7272,1996,6995,66,329,1767,6172,1833,6501
210220,201902,6081,21255,5771,20761,219,1316,5008,17625,5227,18941
210230,201902,5156,15919,4702,15245,286,762,4062,13399,4348,14161
210232,201902,11468,36672,9521,33790,1504,5412,6151,23205,7655,28617
210235,201902,3499,10519,3079,9943,81,367,2724,8784,2805,9151
210237,201902,2530,8816,2312,8538,26,154,2160,7969,2186,8123
210240,201902,2667,8509,2452,8133,85,354,2119,6952,2204,7306
210250,201902,5511,17110,5056,16542,84,474,4523,14762,4607,15236
210255,201902,2548,7898,2181,7212,253,881,1489,4880,1742,5761
210260,201902,5322,16442,4720,15548,264,1011,3939,12923,4203,13934
210270,201902,4762,13457,4280,12824,96,485,3845,11407,3941,11892
210275,201902,3622,9151,3237,8678,47,113,2988,8099,3035,8212
210280,201902,5453,16030,4410,14388,243,1151,3226,10240,3469,11391
210290,201902,6759,19328,6149,18563,151,483,5558,16796,5709,17279
210300,201902,33647,92000,27939,84318,1844,5654,20880,65596,22724,71250
210310,201902,3007,7919,2672,7436,122,290,2310,6482,2432,6772
210312,201902,2621,6946,2324,6608,46,197,2142,6009,2188,6206
210315,201902,2921,8290,2499,7798,73,200,2244,7174,2317,7374
210317,201902,4125,13134,3776,12729,121,592,3391,11366,3512,11958
210320,201902,18696,58242,17202,56245,463,2277,15171,49289,15634,51566
210325,201902,3412,10143,3011,9602,90,316,2691,8680,2781,8996
210330,201902,24102,71537,20732,66830,5781,17079,10383,37916,16164,54995
210340,201902,9964,30531,9011,29106,796,2586,6861,22706,7657,25292
210350,201902,9413,27477,8326,26120,193,699,7341,23157,7534,23856
210355,201902,4371,15346,3886,14572,131,700,3328,12526,3459,13226
210360,201902,13682,42604,12304,40623,515,2346,10028,32714,10543,35060
210370,201902,10472,23916,8266,21568,253,472,7516,20042,7769,20514
210375,201902,3207,8776,2406,7702,624,1963,1165,4083,1789,6046
210380,201902,5555,14595,4898,13786,247,635,4171,11805,4418,12440
210390,201902,2571,9369,2400,9052,132,633,1978,7397,2110,8030
210400,201902,4452,14063,4041,13548,137,435,3567,12060,3704,12495
210405,201902,7043,19303,5690,17358,1049,3037,3212,10392,4261,13429
210407,201902,1946,6597,1631,5995,106,484,1297,4677,1403,5161
210408,201902,2437,9340,2284,9100,151,767,1833,7331,1984,8098
210409,201902,3691,13009,3397,12612,114,649,2812,10441,2926,11090
210410,201902,3457,10831,2965,10027,227,875,2162,7270,2389,8145
210420,201902,3958,12746,3573,12082,187,591,3032,10359,3219,10950
210430,201902,2265,6670,2059,6414,100,297,1801,5635,1901,5932
210440,201902,4185,11763,3833,11279,71,262,3574,10475,3645,10737
210450,201902,2469,7512,2196,7087,104,392,1817,5838,1921,6230
210455,201902,4151,11087,3184,9860,894,2743,1612,5190,2506,7933
210460,201902,3489,10391,3046,9807,82,349,2663,8529,2745,8878
210462,201902,1552,4996,1366,4681,47,223,1097,3734,1144,3957
210465,201902,2605,7766,2289,7325,76,290,1963,6282,2039,6572
210467,201902,5596,18749,5101,18119,287,1182,4423,15787,4710,16969
210470,201902,2116,5560,1465,4629,87,200,1098,3612,1185,3812
210480,201902,15573,47362,13150,44311,1289,4115,9631,34406,10920,38521
210490,201902,3749,9630,3068,8664,86,257,2660,7505,2746,7762
210500,201902,6020,24305,5657,23656,374,1998,4606,19039,4980,21037
210510,201902,6047,20452,5454,19794,120,581,4889,17947,5009,18528
210515,201902,3715,10973,3251,10456,110,399,2865,9289,2975,9688
210520,201902,2523,7345,2286,7046,90,327,2014,6162,2104,6489
210530,201902,52088,128589,41618,113060,6762,23323,11440,39913,18202,63236
210535,201902,3122,10683,2914,10362,115,455,2457,8821,2572,9276
210540,201902,14218,42289,11975,39218,1438,4454,8502,28984,9940,33438
210542,201902,6294,15564,5174,14316,304,513,4464,12998,4768,13511
210545,201902,2247,7085,2116,6863,48,212,1867,5966,1915,6178
210547,201902,3563,12847,3161,12052,311,1172,2291,8988,2602,10160
210550,201902,6138,18640,4990,16892,359,1348,3780,13085,4139,14433
210560,201902,3448,10765,3135,10244,122,429,2651,8601,2773,9030
210565,201902,1464,5005,1231,4648,71,366,955,3651,1026,4017
210570,201902,10969,30124,9805,28729,295,849,8796,26143,9091,26992
210580,201902,3003,8349,2606,7873,204,401,2115,6699,2319,7100
210590,201902,4266,12946,3743,12241,91,493,3314,10755,3405,11248
210592,201902,2592,7732,2436,7484,36,180,2168,6595,2204,6775
210594,201902,2533,6907,1970,6044,79,211,1504,4752,1583,4963
210596,201902,2352,8622,2191,8288,146,608,1762,6697,1908,7305
210598,201902,1857,5338,1705,5122,30,138,1555,4635,1585,4773
210600,201902,2995,8245,2443,7432,74,197,2017,6241,2091,6438
210610,201902,2558,7535,2243,7156,72,347,1936,6119,2008,6466
210620,201902,2525,7213,2166,6781,49,147,1973,6293,2022,6440
210630,201902,3061,10558,2797,10151,151,777,2288,8154,2439,8931
210632,201902,4271,14118,3817,13458,286,1220,2957,10331,3243,11551
210635,201902,1793,6377,1696,6207,140,490,1386,5191,1526,5681
210637,201902,2298,7903,2071,7560,165,719,1562,5736,1727,6455
210640,201902,4512,16410,4312,16179,53,308,4083,15266,4136,15574
210650,201902,7271,20870,6699,20134,80,337,6210,18663,6290,19000
210660,201902,8315,24340,7386,22882,326,1208,6364,19512,6690,20720
210663,201902,2564,7717,2404,7533,108,279,2108,6783,2216,7062
210667,201902,1877,6188,1749,5998,53,218,1585,5472,1638,5690
210670,201902,4452,15462,4114,14903,137,668,3556,12801,3693,13469
210675,201902,5014,13851,4383,13002,291,742,3608,10978,3899,11720
210680,201902,4116,10671,3489,9891,131,261,3091,8969,3222,9230
210690,201902,7409,23803,6614,22889,267,1193,5799,20141,6066,21334
210700,201902,2712,7467,2211,6818,134,358,1740,5680,1874,6038
210710,201902,5039,15839,4453,14977,128,657,3887,12928,4015,13585
210720,201902,2817,9435,2634,9207,56,314,2382,8266,2438,8580
210725,201902,1346,4603,1188,4356,46,214,825,3157,871,3371
210730,201902,1200,3232,1010,2973,83,211,791,2376,874,2587
210735,201902,4627,13998,3979,13102,281,954,3302,11075,3583,12029
210740,201902,5289,14517,4659,13823,143,520,3824,11234,3967,11754
210745,201902,4512,12557,4208,12153,147,391,3809,11045,3956,11436
210750,201902,22285,56912,19523,53534,1574,4234,13708,39512,15282,43746
210760,201902,5764,15564,5072,14822,21,88,4837,14208,4858,14296
210770,201902,6039,15885,5243,14980,53,230,4915,14005,4968,14235
210780,201902,7049,23306,6328,22065,586,1899,4959,17656,5545,19555
210790,201902,4441,13991,4079,13527,224,680,3224,11330,3448,12010
210800,201902,4967,13322,4277,12414,65,274,3856,11028,3921,11302
210805,201902,3921,14574,3774,14354,105,578,3384,12819,3489,13397
210810,201902,4962,14771,4551,14240,221,489,3909,12623,4130,13112
210820,201902,7050,20364,5987,18662,796,2485,3748,11932,4544,14417
210825,201902,6563,20687,6098,20086,244,836,5328,17762,5572,18598
210830,201902,7637,21999,7177,21431,480,1089,6135,18946,6615,20035
210840,201902,3251,8705,2949,8292,94,288,2575,7149,2669,7437
210845,201902,6312,17355,5793,16778,27,83,5633,16359,5660,16442
210850,201902,5786,20071,5021,18896,301,1473,3908,14664,4209,16137
210860,201902,19404,52423,16486,48686,746,2097,13535,41410,14281,43507
210870,201902,6764,18804,5815,17688,239,733,5069,15452,5308,16185
210880,201902,4386,13560,3980,13101,246,937,3285,10807,3531,11744
210890,201902,4085,12370,3705,11920,230,602,3076,10202,3306,10804
210900,201902,4613,13593,3530,11648,1388,4880,608,2253,1996,7133
210905,201902,1912,5433,1630,5052,52,121,1469,4636,1521,4757
210910,201902,7195,22169,6159,20484,827,2836,4138,13849,4965,16685
210920,201902,3217,10728,2824,10205,86,462,2504,8972,2590,9434
210923,201902,1421,4486,1268,4240,65,253,965,3227,1030,3480
210927,201902,5186,16328,4602,15684,159,573,4015,13901,4174,14474
210930,201902,2450,8661,2232,8269,141,670,1748,6408,1889,7078
210940,201902,3923,11397,3690,11112,116,498,3348,9927,3464,10425
210945,201902,6014,17945,5563,17412,233,720,4832,15303,5065,16023
210950,201902,5089,14883,3971,13239,614,1721,2626,9332,3240,11053
210955,201902,1556,5005,1381,4718,135,435,1006,3520,1141,3955
210960,201902,8753,26793,7734,25266,1343,4031,4959,17128,6302,21159
210970,201902,1253,3981,1030,3602,68,304,781,2649,849,2953
210975,201902,1659,5388,1498,5117,108,388,1174,4025,1282,4413
210980,201902,10344,23585,9103,22310,113,232,8630,21293,8743,21525
210990,201902,16030,46275,12845,42075,1055,3706,9325,31075,10380,34781
211000,201902,14185,43193,12215,40921,605,2447,10029,34311,10634,36758
211003,201902,5339,16743,4560,15782,146,567,3948,13948,4094,14515
211010,201902,6328,22962,5764,22237,70,416,5257,20479,5327,20895
211020,201902,7638,23950,7091,23280,285,1138,6120,20170,6405,21308
211023,201902,1994,6660,1900,6529,101,414,1604,5464,1705,5878
211027,201902,2872,9503,2783,9356,179,647,2414,8062,2593,8709
211030,201902,3874,10935,3484,10467,250,587,2859,8838,3109,9425
211040,201902,4492,16470,4220,16019,135,782,3747,14096,3882,14878
211050,201902,9351,24085,8549,23076,166,435,7903,21340,8069,21775
211060,201902,6739,21258,6255,20601,142,568,5779,19059,5921,19627
211065,201902,2123,6125,1804,5698,84,295,1494,4781,1578,5076
211070,201902,7371,24529,6480,23111,520,1894,5072,18260,5592,20154
211080,201902,1272,3635,1026,3242,40,238,796,2367,836,2605
211085,201902,1951,5822,1713,5490,94,261,1491,4861,1585,5122
211090,201902,3243,9014,2925,8603,45,208,2668,7778,2713,7986
211100,201902,6650,17104,6198,16539,44,146,5691,15247,5735,15393
211102,201902,2917,10465,2706,10145,165,790,2313,8587,2478,9377
211105,201902,2304,7491,1925,6780,181,674,1355,4719,1536,5393
211107,201902,4402,14064,3837,13234,146,611,3144,11073,3290,11684
211110,201902,5878,16565,4577,14552,501,1465,3221,10528,3722,11993
211120,201902,40657,105531,36632,100869,4786,12255,23895,70473,28681,82728
211125,201902,2018,6151,1712,5674,53,212,1429,4740,1482,4952
211130,201902,191304,465682,174688,444791,25548,65783,75390,220777,100938,286560
211140,201902,4921,14976,4352,14193,193,590,3712,12150,3905,12740
211150,201902,9232,25903,7957,24225,324,1030,6720,20550,7044,21580
211153,201902,2527,7512,2050,6917,293,1053,1361,4776,1654,5829
211157,201902,1067,3410,889,3099,39,214,646,2221,685,2435
211160,201902,3818,11468,3085,10330,172,766,2291,7532,2463,8298
211163,201902,1779,5747,1637,5542,15,77,1518,5227,1533,5304
211167,201902,1557,5032,1451,4867,30,152,1338,4450,1368,4602
211170,201902,6301,15725,5975,15353,48,159,5698,14590,5746,14749
211172,201902,2376,6750,2074,6284,86,314,1690,4969,1776,5283
211174,201902,2783,8342,2555,8061,60,306,2314,7243,2374,7549
211176,201902,4204,12347,3298,11023,209,850,2555,8486,2764,9336
211178,201902,4621,10843,4022,10172,40,174,3777,9439,3817,9613
211180,201902,3984,13478,3703,13050,200,817,3166,11147,3366,11964
211190,201902,3028,9131,2621,8500,48,251,2256,7242,2304,7493
211195,201902,1363,3971,1159,3675,63,179,971,3150,1034,3329
211200,201902,2081,6222,1708,5729,188,656,1189,4058,1377,4714
211210,201902,6496,19873,5895,19079,271,984,5096,16472,5367,17456
211220,201902,35194,92087,29446,84988,2883,8146,21713,64190,24596,72336
211223,201902,4809,13398,4218,12552,444,1279,3116,9385,3560,10664
211227,201902,1736,5904,1580,5675,44,219,1383,5017,1427,5236
211230,201902,7066,21725,6346,20594,404,1263,5118,16809,5522,18072
211240,201902,8132,26288,7692,25714,152,793,7033,23287,7185,24080
211245,201902,6628,17140,6241,16744,67,197,6083,16316,6150,16513
211250,201902,13426,40523,12259,39117,470,2005,10484,33052,10954,35057
211260,201902,7662,25359,7043,24519,200,916,6354,22197,6554,23113
211270,201902,10279,33334,8973,31571,380,1793,7381,26045,7761,27838
211280,201902,12919,36695,11614,35057,966,2376,9352,29490,10318,31866
211285,201902,1660,5799,1461,5489,210,837,875,3390,1085,4227
211290,201902,7146,22438,6630,21705,181,824,5708,18545,5889,19369
211300,201902,8026,22936,7295,21955,155,501,6673,20074,6828,20575
211400,201902,11145,33042,9225,30313,1317,4357,5887,20414,7204,24771
220005,201902,1828,4943,1657,4691,39,153,1368,3808,1407,3961
220010,201902,1461,4172,1229,3764,36,153,959,2901,995,3054
220020,201902,3320,9814,2956,9230,252,864,2277,7030,2529,7894
220025,201902,2201,5083,1878,4587,22,64,1583,3764,1605,3828
220027,201902,1244,3234,1075,3011,23,79,894,2464,917,2543
220030,201902,3278,8563,3115,8329,98,286,2727,7174,2825,7460
220040,201902,6879,21136,6165,19781,1219,3698,3708,12239,4927,15937
220045,201902,1436,4494,1213,4102,34,181,987,3266,1021,3447
220050,201902,4549,12889,3889,11929,99,460,3485,10560,3584,11020
220060,201902,2371,5114,2007,4691,25,69,1878,4371,1903,4440
220070,201902,2464,6390,2114,5876,73,168,1762,4905,1835,5073
220080,201902,693,1978,597,1832,28,111,513,1536,541,1647
220090,201902,1775,4348,1472,3926,18,72,1251,3412,1269,3484
220095,201902,642,1676,611,1641,12,22,562,1513,574,1535
220100,201902,1357,3829,1109,3415,49,195,884,2645,933,2840
220105,201902,1996,6339,1742,5801,144,474,1312,4396,1456,4870
220110,201902,3429,9493,3207,9087,45,220,2862,7979,2907,8199
220115,201902,2679,8077,2483,7785,72,300,2236,6898,2308,7198
220117,201902,1357,3324,1043,2872,16,67,883,2382,899,2449
220120,201902,11943,33800,11028,32662,101,400,10343,30614,10444,31014
220130,201902,1076,3037,917,2820,15,107,818,2457,833,2564
220140,201902,1945,4298,1675,3970,143,380,1434,3344,1577,3724
220150,201902,6430,19213,6003,18539,127,637,5135,15522,5262,16159
220155,201902,1100,3226,873,2801,25,101,623,1965,648,2066
220157,201902,1043,2582,866,2304,17,76,700,1799,717,1875
220160,201902,2690,7748,2322,7078,43,229,1922,5715,1965,5944
220170,201902,1488,3993,1263,3662,11,61,1109,3171,1120,3232
220173,201902,2001,5757,1659,5127,40,175,1324,4014,1364,4189
220177,201902,1948,5598,1870,5505,14,46,1827,5388,1841,5434
220180,201902,1130,2857,898,2446,7,37,667,1703,674,1740
220190,201902,6123,16501,5223,15229,398,1291,3915,11363,4313,12654
220191,201902,1385,4440,1272,4238,76,324,946,3071,1022,3395
220192,201902,1828,4994,1442,4305,28,105,1155,3382,1183,3487
220194,201902,1683,4889,1501,4587,64,268,1241,3696,1305,3964
220196,201902,1901,5187,1724,4901,36,166,1465,4059,1501,4225
220198,201902,1283,3545,1067,3266,8,21,990,3067,998,3088
220200,201902,4773,14359,4287,13713,223,815,3523,11274,3746,12089
220202,201902,2174,6151,1868,5629,31,154,1591,4705,1622,4859
220205,201902,2530,7143,2256,6689,36,158,1936,5643,1972,5801
220207,201902,777,2341,648,2115,58,212,429,1396,487,1608
220208,201902,1678,5261,1369,4648,235,866,696,2331,931,3197
220209,201902,1577,4581,1368,4226,28,136,1107,3377,1135,3513
220210,201902,1582,4125,1380,3796,15,71,1138,3043,1153,3114
220211,201902,1548,4052,1433,3892,14,53,1273,3473,1287,3526
220213,201902,1738,4721,1507,4283,26,92,1207,3323,1233,3415
220217,201902,2041,6242,1934,6124,37,130,1808,5776,1845,5906
220220,201902,10124,27032,8481,24452,547,1481,6044,17878,6591,19359
220225,201902,1096,2867,889,2600,9,44,811,2345,820,2389
220230,201902,5731,14339,4948,13267,206,521,4243,11408,4449,11929
220240,201902,2897,8605,2663,8159,95,323,2163,6621,2258,6944
220245,201902,1603,4005,1293,3608,12,67,1170,3284,1182,3351
220250,201902,2846,8253,2505,7804,24,140,2288,7078,2312,7218
220253,201902,1629,4492,1394,4078,79,244,1147,3275,1226,3519
220255,201902,1863,4623,1561,4168,36,176,1297,3299,1333,3475
220260,201902,4202,13202,3711,12346,185,670,2952,9814,3137,10484
220265,201902,1200,3991,1107,3846,54,224,891,3063,945,3287
220270,201902,6411,20252,6020,19543,264,1164,5014,15741,5278,16905
220271,201902,1462,3816,1268,3540,35,122,1113,3099,1148,3221
220272,201902,1705,4918,1524,4579,65,205,1142,3340,1207,3545
220273,201902,1208,3484,997,3094,40,161,758,2293,798,2454
220275,201902,2226,5426,1745,4773,36,131,1506,4112,1542,4243
220277,201902,2104,5450,1820,5006,34,106,1546,4179,1580,4285
220280,201902,1594,3905,1320,3523,27,83,1126,2948,1153,3031
220285,201902,1474,3836,1243,3545,17,78,1106,3112,1123,3190
220290,201902,5944,17707,4809,16106,356,1349,3572,12061,3928,13410
220300,201902,1952,5845,1605,5370,49,292,1326,4333,1375,4625
220310,201902,2919,8067,2304,7372,53,267,1925,6074,1978,6341
220320,201902,2995,8987,2341,7718,119,523,1767,5647,1886,6170
220323,201902,1595,4909,1286,4392,72,291,1048,3519,1120,3810
220325,201902,1271,3770,1083,3447,34,151,901,2811,935,2962
220327,201902,1444,4231,1290,3976,45,201,1052,3170,1097,3371
220330,201902,4172,10372,3444,9460,97,303,2984,8112,3081,8415
220335,201902,1764,5273,1567,5037,25,92,1421,4556,1446,4648
220340,201902,1831,4855,1441,4205,47,151,1007,2816,1054,2967
220342,201902,1171,3507,1041,3304,43,196,823,2578,866,2774
220345,201902,3109,7150,2489,6270,16,49,2304,5787,2320,5836
220350,201902,3356,8747,2674,7675,135,431,1957,5578,2092,6009
220360,201902,1241,3183,986,2779,23,75,795,2221,818,2296
220370,201902,8782,25199,7997,24064,182,791,7037,20899,7219,21690
220375,201902,1539,4515,1382,4316,8,30,1319,4145,1327,4175
220380,201902,1505,3648,1246,3275,21,59,1085,2810,1106,2869
220385,201902,828,2006,660,1704,11,37,563,1426,574,1463
220390,201902,8343,23599,6854,21103,1787,5402,2960,9743,4747,15145
220400,201902,1460,3595,1128,3082,29,98,857,2275,886,2373
220410,201902,1144,3193,943,2859,53,158,756,2259,809,2417
220415,201902,809,2146,683,1941,14,44,528,1478,542,1522
220420,201902,1974,5508,1609,4819,49,149,1250,3686,1299,3835
220430,201902,2513,6780,2397,6613,82,259,2104,5722,2186,5981
220435,201902,1683,4518,1474,4196,55,180,1170,3260,1225,3440
220440,201902,2371,7585,2080,7109,105,432,1709,5764,1814,6196
220450,201902,2356,6372,1944,5841,140,493,1537,4609,1677,5102
220455,201902,1313,4064,1243,3971,23,111,1100,3494,1123,3605
220460,201902,925,2361,864,2291,28,100,746,1934,774,2034
220465,201902,2352,7376,2080,6944,168,598,1559,5263,1727,5861
220470,201902,3418,9722,3071,9160,84,272,2503,7357,2587,7629
220480,201902,2496,6697,1996,5871,143,376,1430,4159,1573,4535
220490,201902,2363,6201,2130,5897,43,192,1883,5128,1926,5320
220500,201902,2507,6727,2307,6416,45,181,1930,5190,1975,5371
220510,201902,2502,7205,2024,6364,89,260,1584,4981,1673,5241
220515,201902,1669,4052,1506,3829,33,71,1316,3333,1349,3404
220520,201902,4962,12992,4479,12286,102,308,3944,10754,4046,11062
220525,201902,1287,3353,1151,3168,16,71,1048,2840,1064,2911
220527,201902,1290,3658,1142,3424,16,55,982,2984,998,3039
220530,201902,1357,3494,1183,3268,25,99,1097,2980,1122,3079
220535,201902,795,2241,729,2155,42,157,593,1726,635,1883
220540,201902,3302,10497,3098,10123,105,398,2669,8663,2774,9061
220545,201902,1356,4279,1265,4117,78,323,1040,3323,1118,3646
220550,201902,8509,26350,7664,24943,578,2070,5759,18545,6337,20615
220551,201902,1418,4171,1246,3870,39,153,998,3043,1037,3196
220552,201902,1571,4612,1287,4079,48,234,1006,3064,1054,3298
220553,201902,1544,4265,1369,4016,53,123,1094,3304,1147,3427
220554,201902,855,2294,623,1904,37,92,428,1298,465,1390
220555,201902,2058,6543,1923,6317,54,255,1557,5226,1611,5481
220556,201902,1253,3699,1074,3339,62,256,755,2234,817,2490
220557,201902,1569,4788,1332,4322,83,304,961,3029,1044,3333
220558,201902,1387,3658,1085,3233,24,111,912,2677,936,2788
220559,201902,1600,4164,1364,3789,5,30,1109,3118,1114,3148
220560,201902,1761,4022,1420,3574,34,74,1268,3189,1302,3263
220570,201902,7132,21715,6506,20799,449,1504,5157,16452,5606,17956
220580,201902,6834,19223,6330,18388,115,415,5680,16320,5795,16735
220585,201902,1892,6199,1682,5809,53,200,1382,4771,1435,4971
220590,201902,1276,3565,1060,3236,92,277,754,2304,846,2581
220595,201902,2444,6780,2247,6516,18,90,2034,5842,2052,5932
220600,201902,1399,3131,1157,2825,114,174,942,2385,1056,2559
220605,201902,1651,4811,1396,4373,21,113,1121,3418,1142,3531
220610,201902,2800,8718,2633,8483,35,154,2430,7835,2465,7989
220620,201902,7865,24718,7322,23984,224,1070,6612,21413,6836,22483
220630,201902,359,1075,285,944,31,102,178,605,209,707
220635,201902,1622,5195,1433,4778,58,248,1083,3529,1141,3777
220640,201902,2620,7224,2244,6672,89,343,1817,5333,1906,5676
220650,201902,2064,5773,1771,5307,50,180,1385,4136,1435,4316
220660,201902,2624,8253,2284,7697,87,438,1866,6112,1953,6550
220665,201902,1283,3951,1099,3648,33,176,900,2924,933,3100
220667,201902,1609,5137,1435,4807,72,289,1142,3809,1214,4098
220669,201902,1678,5176,1611,5062,78,350,1370,4196,1448,4546
220670,201902,2201,5818,1763,5213,34,109,1510,4439,1544,4548
220672,201902,3117,7715,2529,7005,147,415,2168,5977,2315,6392
220675,201902,1207,3348,1107,3158,47,142,889,2510,936,2652
220680,201902,2649,7344,2519,7155,103,262,2275,6475,2378,6737
220690,201902,1489,4030,1313,3762,104,273,1005,2913,1109,3186
220695,201902,864,2447,806,2341,16,58,694,2000,710,2058
220700,201902,9282,23615,7368,20892,364,1101,5641,15861,6005,16962
220710,201902,857,2429,654,2035,28,93,481,1467,509,1560
220720,201902,2089,5033,1878,4735,20,77,1606,3990,1626,4067
220730,201902,1276,3643,1088,3342,21,104,918,2754,939,2858
220735,201902,966,2300,746,1949,21,70,622,1562,643,1632
220740,201902,1378,3839,1110,3484,35,122,943,2978,978,3100
220750,201902,3723,9837,3308,9232,229,564,2847,7991,3076,8555
220755,201902,1214,3091,1013,2778,34,123,804,2120,838,2243
220760,201902,2985,8698,2637,8216,112,360,2273,7178,2385,7538
220770,201902,20708,64122,17758,58921,5968,20472,6271,21632,12239,42104
220775,201902,1099,2911,1019,2811,13,50,983,2701,996,2751
220777,201902,1642,4197,1246,3562,29,86,927,2635,956,2721
220779,201902,1313,3246,1153,3020,25,78,999,2589,1024,2667
220780,201902,5443,14094,4799,13065,202,658,3951,10472,4153,11130
220785,201902,1438,3236,1285,3026,11,17,1234,2906,1245,2923
220790,201902,10086,29017,9073,27582,271,1264,7653,22872,7924,24136
220793,201902,862,2320,708,2049,19,54,578,1681,597,1735
220795,201902,1392,3674,1251,3500,30,129,1091,3007,1121,3136
220800,201902,16551,39663,13949,35953,763,1994,10347,26426,11110,28420
220810,201902,2932,8341,2529,7612,54,213,2107,6217,2161,6430
220820,201902,5128,13364,4394,12351,396,978,3234,9156,3630,10134
220830,201902,7184,19399,6478,18382,257,825,5442,15286,5699,16111
220840,201902,12047,37397,10243,33661,2394,7511,4973,17043,7367,24554
220850,201902,3045,9615,2747,9238,59,328,2439,8130,2498,8458
220855,201902,609,1656,537,1536,11,56,469,1314,480,1370
220860,201902,1015,2548,871,2319,16,70,783,2052,799,2122
220865,201902,2539,6741,1968,5765,62,230,1520,4340,1582,4570
220870,201902,2842,8198,2358,7545,34,172,2143,6810,2177,6982
220880,201902,5168,12487,4535,11707,84,276,4175,10667,4259,10943
220885,201902,1330,4228,1120,3870,56,237,888,3087,944,3324
220887,201902,1480,3311,1245,3004,9,30,1161,2768,1170,2798
220890,201902,1430,4550,1229,4207,71,261,970,3328,1041,3589
220900,201902,1984,4882,1670,4458,35,85,1441,3817,1476,3902
220910,201902,1476,4173,1258,3846,39,137,1057,3214,1096,3351
220915,201902,956,2581,772,2221,11,46,606,1691,617,1737
220920,201902,1364,4516,1166,4242,74,332,938,3400,1012,3732
220930,201902,1593,4552,1394,4244,29,113,1263,3805,1292,3918
220935,201902,1041,2997,840,2582,25,96,556,1616,581,1712
220937,201902,1360,3692,1175,3405,26,109,962,2725,988,2834
220940,201902,1442,4166,1166,3642,39,159,881,2680,920,2839
220945,201902,422,1463,372,1355,20,111,279,984,299,1095
220950,201902,1393,3282,913,2515,13,45,709,1895,722,1940
220955,201902,1563,4088,1338,3698,35,96,1146,3157,1181,3253
220960,201902,823,2094,631,1790,13,55,478,1301,491,1356
220965,201902,1757,4841,1543,4541,21,131,1330,3819,1351,3950
220970,201902,1834,4650,1400,3965,41,116,1127,3176,1168,3292
220975,201902,709,2123,620,2018,22,140,549,1700,571,1840
220980,201902,1163,3314,1036,3132,36,156,871,2592,907,2748
220985,201902,1170,3224,1053,3054,37,144,837,2320,874,2464
220987,201902,1495,4438,1282,4065,56,242,1036,3224,1092,3466
220990,201902,1673,4722,1461,4396,27,148,1197,3515,1224,3663
220995,201902,1160,3456,910,3017,50,199,644,2125,694,2324
220997,201902,2442,7156,2247,6869,54,241,2023,6090,2077,6331
221000,201902,4141,11683,3800,11194,95,473,3263,9407,3358,9880
221005,201902,1458,3932,1328,3714,45,182,1119,3006,1164,3188
221010,201902,1187,2841,965,2557,28,73,834,2169,862,2242
221020,201902,1516,4677,1401,4454,29,129,1056,3314,1085,3443
221030,201902,1580,4137,1356,3844,29,124,1183,3329,1212,3453
221035,201902,1432,3788,1254,3542,24,45,1096,3184,1120,3229
221037,201902,617,1784,518,1613,9,53,343,1013,352,1066
221038,201902,515,1469,410,1264,16,56,283,863,299,919
221039,201902,866,2355,761,2176,19,74,621,1704,640,1778
221040,201902,4061,12332,3632,11576,159,563,2904,9256,3063,9819
221050,201902,3770,10107,3360,9572,58,229,3040,8580,3098,8809
221060,201902,8285,23100,6854,20889,235,733,5514,16907,5749,17640
221062,201902,1159,3836,995,3534,45,220,801,2791,846,3011
221063,201902,1111,3200,949,2965,71,268,696,2098,767,2366
221065,201902,2593,6768,2282,6222,22,105,2006,5365,2028,5470
221070,201902,3305,10513,2757,9401,301,1047,1771,6141,2072,7188
221080,201902,3482,8537,2832,7579,50,206,2341,6161,2391,6367
221090,201902,1388,3668,1138,3236,13,54,975,2701,988,2755
221093,201902,1343,3833,1233,3603,123,362,848,2440,971,2802
221095,201902,898,2367,751,2139,7,20,623,1752,630,1772
221097,201902,817,2153,627,1807,22,72,458,1259,480,1331
221100,201902,102837,281072,88406,257536,12423,37860,55563,158796,67986,196656
221110,201902,9875,29678,9100,28674,204,1054,8096,25107,8300,26161
221120,201902,4457,12850,4042,12142,196,667,3428,10216,3624,10883
221130,201902,4949,13210,3695,10734,840,2360,1700,4983,2540,7343
221135,201902,1576,4339,1416,4120,45,172,1245,3589,1290,3761
221140,201902,1300,3145,1115,2896,10,45,984,2485,994,2530
221150,201902,1089,2715,878,2352,24,113,680,1699,704,1812
221160,201902,780,1939,689,1817,23,42,558,1471,581,1513
221170,201902,983,2896,907,2766,21,68,772,2348,793,2416
230010,201902,3150,8393,2534,7311,96,346,1961,5517,2057,5863
230015,201902,2915,9633,2620,9062,216,885,1815,6189,2031,7074
230020,201902,13006,41271,12304,40146,399,1681,10363,33399,10762,35080
230030,201902,12569,32404,10814,29977,198,636,9524,26331,9722,26967
230040,201902,4418,11607,3703,10426,85,359,3041,8402,3126,8761
230050,201902,2767,8765,2036,6984,372,1244,826,2775,1198,4019
230060,201902,2322,6396,1882,5572,43,189,1519,4391,1562,4580
230070,201902,3823,10520,3129,9146,150,504,2147,6220,2297,6724
230075,201902,9013,29379,8336,28204,369,1877,6802,22382,7171,24259
230080,201902,2949,6321,2263,5452,10,39,2018,4851,2028,4890
230090,201902,4102,10509,3530,9570,159,459,2757,7405,2916,7864
230100,201902,17483,47014,15632,44380,1392,4173,10866,30903,12258,35076
230110,201902,12175,36738,10536,33452,1721,5447,5807,18531,7528,23978
230120,201902,7271,20123,6426,18713,574,1494,4656,13786,5230,15280
230125,201902,3106,8363,2536,7423,82,304,1935,5595,2017,5899
230130,201902,5569,17534,4597,15371,356,1347,3048,9992,3404,11339
230140,201902,3360,10244,2888,9303,116,510,2182,6817,2298,7327
230150,201902,1596,4780,1345,4225,226,636,741,2426,967,3062
230160,201902,6473,17159,5614,15820,156,603,4698,12955,4854,13558
230170,201902,5960,17365,5057,15585,308,999,3688,11146,3996,12145
230180,201902,1609,4523,1375,4064,25,108,1095,3134,1120,3242
230185,201902,4169,12311,3569,11301,282,1003,2621,8278,2903,9281
230190,201902,12822,38015,10951,34489,1708,5479,5913,18674,7621,24153
230195,201902,4982,14981,4544,14157,319,1076,3495,10781,3814,11857
230200,201902,4944,13678,4228,12294,143,482,3260,9260,3403,9742
230205,201902,3906,12142,3526,11513,155,662,2710,8673,2865,9335
230210,201902,10053,25005,8582,22934,435,1401,6597,17356,7032,18757
230220,201902,13327,34433,11901,32307,533,1536,9884,26526,10417,28062
230230,201902,6810,20832,6124,19406,435,1438,4466,14036,4901,15474
230240,201902,12242,33223,10909,31073,345,1193,9054,25448,9399,26641
230250,201902,8943,25902,8633,25410,279,1022,6846,19598,7125,20620
230260,201902,14302,44027,12621,40944,1587,5270,7399,24305,8986,29575
230270,201902,7340,20349,5745,17321,496,1483,3820,11560,4316,13043
230280,201902,20210,54764,16695,48827,582,2369,13109,37003,13691,39372
230290,201902,4710,13319,3999,11935,351,934,2947,8861,3298,9795
230300,201902,4531,12529,4195,12057,70,297,3708,10478,3778,10775
230310,201902,4647,13303,3953,12114,136,581,2838,8465,2974,9046
230320,201902,7588,22091,6585,20193,303,1179,5052,15187,5355,16366
230330,201902,4599,12747,3791,11193,173,551,2813,8157,2986,8708
230340,201902,3554,11290,3042,10239,294,1017,2019,6751,2313,7768
230350,201902,18251,51069,16101,47597,1050,3614,10401,30998,11451,34612
230360,201902,2831,7857,2276,6827,152,477,1530,4561,1682,5038
230365,201902,3032,7652,2549,6894,49,242,2144,5701,2193,5943
230370,201902,53567,155623,46114,144050,8253,26141,24966,80095,33219,106236
230380,201902,6406,17896,5075,15400,161,612,3711,11072,3872,11684
230390,201902,3238,9805,2841,9153,114,472,2192,6984,2306,7456
230393,201902,2995,9206,2482,8182,95,516,1918,6068,2013,6584
230395,201902,5707,15674,4985,14432,390,1090,3428,9978,3818,11068
230400,201902,5753,16147,5093,15070,157,761,3942,11253,4099,12014
230410,201902,14274,42921,11738,38038,1121,3874,7645,24751,8766,28625
230420,201902,26444,75698,22257,67947,2762,8809,12902,39101,15664,47910
230423,201902,4723,14122,4128,12900,99,449,3333,10201,3432,10650
230425,201902,5429,17077,4952,16067,440,1508,3510,11330,3950,12838
230426,201902,2609,7033,1946,5707,41,169,1482,4257,1523,4426
230427,201902,1849,5278,1316,4084,62,212,892,2681,954,2893
230428,201902,9536,26191,8427,24487,1148,3401,5137,14859,6285,18260
230430,201902,4649,13422,3809,11994,166,626,2869,8856,3035,9482
230435,201902,5481,15013,4712,13699,522,1534,3032,8805,3554,10339
230440,201902,389596,1001163,327290,906351,42813,124685,195328,537041,238141,661726
230445,201902,4269,11406,3501,10068,208,566,2412,6818,2620,7384
230450,201902,3581,10529,3118,9799,240,914,2259,6958,2499,7872
230460,201902,2061,5903,1819,5511,77,290,1502,4536,1579,4826
230465,201902,3944,11245,3373,10193,98,442,2489,7216,2587,7658
230470,201902,11041,37124,10023,35167,866,3698,7292,25113,8158,28811
230480,201902,1399,4113,1188,3736,98,386,862,2606,960,2992
230490,201902,2411,6895,2069,6246,195,654,1294,3721,1489,4375
230495,201902,5761,17421,5074,16144,397,1596,3326,10364,3723,11960
230500,201902,8841,29393,8146,28054,340,1422,6506,22321,6846,23743
230510,201902,1620,5099,1208,4147,220,792,535,1826,755,2618
230520,201902,4440,12881,3907,11878,306,954,2750,8290,3056,9244
230523,201902,14131,42545,11731,37380,2790,8837,3176,10725,5966,19562
230526,201902,3895,11231,3296,10157,155,569,2433,7398,2588,7967
230530,201902,5266,16512,4513,15079,368,1352,3173,10564,3541,11916
230533,201902,4110,10486,3544,9506,98,287,2900,7679,2998,7966
230535,201902,5254,14798,4491,13487,240,733,3199,9714,3439,10447
230540,201902,15823,44026,13958,41231,266,1160,11773,34266,12039,35426
230550,201902,19672,53933,16232,47901,1717,5273,9948,29190,11665,34463
230560,201902,7788,19726,6460,17515,79,309,5432,14567,5511,14876
230565,201902,3001,8418,2531,7553,85,365,1922,5633,2007,5998
230570,201902,3506,8909,3037,8302,62,192,2600,7087,2662,7279
230580,201902,10214,27565,8974,25799,337,1099,7527,21482,7864,22581
230590,201902,8787,25629,7338,22902,485,1728,5249,15865,5734,17593
230600,201902,3643,9621,2774,7988,88,271,1853,5412,1941,5683
230610,201902,6494,18325,5773,17154,504,1441,4401,13120,4905,14561
230620,201902,2084,5703,1590,4719,132,425,960,2783,1092,3208
230625,201902,7761,22742,6636,20616,2054,6589,1766,5835,3820,12424
230630,201902,10221,31329,9030,28832,2024,6053,4332,14608,6356,20661
230640,201902,27565,84203,24929,79891,1557,6024,19470,61506,21027,67530
230650,201902,4991,13961,4229,12565,164,694,3320,9588,3484,10282
230655,201902,9214,32069,8769,31264,682,2673,6865,24573,7547,27246
230660,201902,6148,18269,5020,16241,168,896,4061,12835,4229,13731
230670,201902,6103,14868,4500,12218,156,473,3541,9393,3697,9866
230680,201902,2520,7129,2171,6500,165,519,1518,4531,1683,5050
230690,201902,6762,20470,5972,18856,458,1639,3725,11493,4183,13132
230700,201902,9521,25014,8108,22415,349,1095,6093,16382,6442,17477
230710,201902,6795,21492,5907,19656,560,2034,4134,13498,4694,15532
230720,201902,1925,5731,1587,5027,126,375,1053,3270,1179,3645
230725,201902,3758,11669,3329,10816,506,1778,1639,5235,2145,7013
230730,201902,54285,151082,44053,134794,10398,34211,15191,48884,25589,83095
230740,201902,6019,17122,5216,15787,136,575,4181,12528,4317,13103
230750,201902,8336,22669,7013,20468,195,766,5512,15648,5707,16414
230760,201902,11015,29875,9783,27948,637,2099,7267,20255,7904,22354
230763,201902,4384,12567,3768,11397,146,616,2983,8738,3129,9354
230765,201902,40033,112579,33799,102105,6223,19501,15008,45449,21231,64950
230770,201902,25171,64480,21356,59263,2584,7486,13574,37701,16158,45187
230780,201902,5939,21406,5566,20595,831,3121,3308,12552,4139,15673
230790,201902,2910,8573,2595,8045,132,549,1919,5772,2051,6321
230800,201902,7716,25166,6937,23542,800,3027,4195,13940,4995,16967
230810,201902,11697,35430,10437,33321,444,1730,7987,24934,8431,26664
230820,201902,3211,10624,2717,9492,294,1218,1658,5528,1952,6746
230830,201902,7581,21049,6463,19077,157,688,5244,15073,5401,15761
230835,201902,4115,9993,3215,8588,98,298,2570,6761,2668,7059
230837,201902,3057,9599,2648,8835,112,544,2086,6772,2198,7316
230840,201902,8896,26650,7770,24793,589,2008,5788,18520,6377,20528
230850,201902,9236,27417,7990,24906,435,1544,5706,17605,6141,19149
230860,201902,5184,13546,4352,12327,98,354,3722,10436,3820,10790
230870,201902,16546,40886,14201,37187,461,1296,11468,29750,11929,31046
230880,201902,2084,6448,1899,6124,59,321,1485,4649,1544,4970
230890,201902,4381,14403,4064,13777,348,1309,2971,9915,3319,11224
230900,201902,3009,8907,2575,8046,213,740,1688,5137,1901,5877
230910,201902,2894,8087,2399,7249,79,384,1920,5671,1999,6055
230920,201902,4442,12795,3817,11787,151,604,2927,8833,3078,9437
230930,201902,6401,18348,5384,16395,365,1159,3719,11270,4084,12429
230940,201902,7652,20216,6749,18812,199,602,5681,15706,5880,16308
230945,201902,6487,18926,5616,17164,393,1340,3896,11827,4289,13167
230950,201902,6226,15880,5651,15142,139,312,5024,13653,5163,13965
230960,201902,12867,38226,11565,35778,1839,5769,5925,18575,7764,24344
230970,201902,12945,35612,11029,32613,2058,6246,5623,16773,7681,23019
230980,201902,2703,8039,2366,7414,443,1309,1381,4497,1824,5806
230990,201902,1695,4832,1408,4259,72,293,954,2740,1026,3033
231000,201902,2464,6607,2048,5802,74,209,1482,4106,1556,4315
231010,201902,3290,8036,2658,6944,85,291,2205,5575,2290,5866
231020,201902,7734,25076,6996,23514,1223,3843,4080,14260,5303,18103
231025,201902,7301,20825,6432,19404,840,2536,4331,13148,5171,15684
231030,201902,7045,21461,5666,18503,946,3038,2994,9828,3940,12866
231040,201902,3038,8950,2643,8199,95,361,2054,6237,2149,6598
231050,201902,11778,31016,9597,27108,670,1861,7023,19529,7693,21390
231060,201902,2663,7772,2371,7279,81,308,1901,5806,1982,6114
231070,201902,7998,23607,6784,21426,908,2904,4004,12632,4912,15536
231080,201902,3982,11558,3499,10742,144,654,2666,7957,2810,8611
231085,201902,6267,16023,5108,14592,248,710,3905,11194,4153,11904
231090,201902,4261,11392,3245,9360,111,419,2267,6333,2378,6752
231095,201902,2140,6544,1749,5662,139,479,1191,3845,1330,4324
231100,201902,2944,8763,2477,7879,137,497,1876,5889,2013,6386
231110,201902,3457,10558,3221,10099,138,548,2401,7417,2539,7965
231120,201902,2128,6408,1815,5857,96,365,1238,3938,1334,4303
231123,201902,1912,5039,1606,4499,82,230,1167,3230,1249,3460
231126,201902,5545,15530,4479,13443,236,734,3228,9533,3464,10267
231130,201902,20065,53837,16903,49653,1290,4635,11965,34520,13255,39155
231135,201902,4127,11661,3470,10443,153,546,2500,7365,2653,7911
231140,201902,16616,47788,13541,42236,741,3122,9362,28298,10103,31420
231150,201902,5445,15422,4350,13193,779,2362,1949,6035,2728,8397
231160,201902,5928,18441,5328,17288,1036,3165,2891,9716,3927,12881
231170,201902,4348,13040,3591,11502,219,806,2429,7533,2648,8339
231180,201902,13822,40180,11599,35340,2994,9033,4357,13472,7351,22505
231190,201902,3761,10808,3232,9803,114,493,2521,7419,2635,7912
231195,201902,4582,14360,3921,12974,210,869,2910,9399,3120,10268
231200,201902,7727,24788,6780,22772,274,1398,5143,16736,5417,18134
231210,201902,4740,14272,4096,13127,189,713,3080,9647,3269,10360
231220,201902,11929,31957,9479,27238,496,1542,6774,18731,7270,20273
231230,201902,9017,28934,8030,27242,493,1956,5947,20211,6440,22167
231240,201902,11525,34413,10213,31825,1668,5200,5793,18219,7461,23419
231250,201902,2052,5404,1345,3795,106,296,794,2197,900,2493
231260,201902,3210,9306,2807,8658,294,890,1847,5849,2141,6739
231270,201902,6407,16885,5323,15094,134,522,4038,11169,4172,11691
231280,201902,1649,5254,1549,5060,122,409,1138,3703,1260,4112
231290,201902,36799,112108,31636,101516,5576,18095,14569,46461,20145,64556
231300,201902,3981,11208,3155,9509,264,849,2019,5976,2283,6825
231310,201902,7188,19204,5851,16673,550,1554,3861,10842,4411,12396
231320,201902,7583,21323,6045,18476,107,492,4679,14099,4786,14591
231325,201902,2451,6728,2041,6054,280,746,1259,3835,1539,4581
231330,201902,9543,29307,8001,26196,1535,4896,4175,14121,5710,19017
231335,201902,5628,14999,4765,13570,91,429,4134,11541,4225,11970
231340,201902,17371,54656,15595,51550,1299,4410,11350,37873,12649,42283
231350,201902,15556,42683,14130,40688,331,1176,12614,35971,12945,37147
231355,201902,4371,13338,3922,12530,216,800,3033,9598,3249,10398
231360,201902,7464,22915,6499,21187,404,1440,4889,15902,5293,17342
231370,201902,2260,6131,1794,5299,40,128,1375,4019,1415,4147
231375,201902,4344,13747,3960,13079,150,701,3274,10660,3424,11361
231380,201902,5843,16015,5371,15405,218,588,4388,12777,4606,13365
231390,201902,3348,9911,3010,9343,168,648,2177,6542,2345,7190
231395,201902,3934,11914,3317,10908,558,1827,1809,6087,2367,7914
231400,201902,9105,26725,7946,24537,338,1354,6074,18379,6412,19733
231410,201902,14584,46028,13186,43700,751,2890,10316,33712,11067,36602
240010,201902,2466,6726,1921,5703,214,710,1166,3350,1380,4060
240020,201902,11433,33286,9912,30577,807,3001,6480,19616,7287,22617
240030,201902,2724,7016,2517,6701,106,295,2199,5801,2305,6096
240040,201902,817,2341,677,2091,15,69,504,1511,519,1580
240050,201902,3122,8426,2611,7495,56,166,2072,5837,2128,6003
240060,201902,1374,3727,1163,3342,33,108,938,2647,971,2755
240070,201902,2086,6283,1952,6010,207,696,1458,4414,1665,5110
240080,201902,2766,7647,2368,6893,62,256,1835,5230,1897,5486
240090,201902,2245,5607,1818,4874,19,60,1514,3998,1533,4058
240100,201902,9387,23985,7670,20769,323,991,5927,15543,6250,16534
240110,201902,4242,12464,3710,11489,209,803,2712,8197,2921,9000
240120,201902,3509,9600,2604,8554,214,848,1734,5830,1948,6678
240130,201902,3533,7570,2985,6824,43,134,2715,6100,2758,6234
240140,201902,1924,5811,1656,5305,186,662,1096,3428,1282,4090
240145,201902,6312,18164,5281,16312,740,2361,3206,10006,3946,12367
240150,201902,869,2567,790,2410,53,188,614,1814,667,2002
240160,201902,1422,4354,1219,3943,58,265,878,2828,936,3093
240165,201902,916,2559,785,2307,60,187,593,1716,653,1903
240170,201902,2308,6536,1966,5922,217,737,1266,3690,1483,4427
240180,201902,3048,9049,2450,7857,533,1668,1202,4027,1735,5695
240185,201902,1248,4034,1132,3842,59,248,918,3072,977,3320
240190,201902,1005,3021,883,2811,23,100,729,2298,752,2398
240200,201902,10492,27818,8707,24707,1051,3204,4755,13291,5806,16495
240210,201902,2867,7417,2534,6895,32,149,2142,5645,2174,5794
240220,201902,7267,22453,6554,21318,409,1748,5015,16010,5424,17758
240230,201902,5734,14788,4694,13014,231,634,3712,10263,3943,10897
240240,201902,1928,5900,1237,4157,131,433,464,1530,595,1963
240250,201902,2822,7689,2544,7283,145,384,2055,5920,2200,6304
240260,201902,13287,40212,11638,37342,1683,5235,7156,23994,8839,29229
240270,201902,2251,6717,2002,6325,106,302,1544,4990,1650,5292
240280,201902,1665,4313,1410,3915,44,131,1145,3128,1189,3259
240290,201902,1193,3512,991,3077,36,167,690,2001,726,2168
240300,201902,2150,5636,1579,4542,78,234,1011,2840,1089,3074
240310,201902,8649,23268,7009,20358,883,2634,3786,10917,4669,13551
240320,201902,2014,5527,1501,4526,29,140,1122,3238,1151,3378
240325,201902,28990,80200,22782,69169,5273,16758,8018,25057,13291,41815
240330,201902,1655,4568,1300,3881,45,158,913,2611,958,2769
240340,201902,1899,4583,1563,4056,52,138,1269,3219,1321,3357
240350,201902,2030,5392,1895,5235,29,113,1697,4691,1726,4804
240360,201902,7840,22528,7032,21241,1034,3066,4453,13925,5487,16991
240370,201902,1945,5251,1526,4396,85,249,1046,2949,1131,3198
240375,201902,885,2266,747,1994,28,109,596,1509,624,1618
240380,201902,2234,6372,1653,5090,156,474,973,2958,1129,3432
240390,201902,942,2433,679,1901,19,52,452,1194,471,1246
240400,201902,1347,3419,1064,2901,35,136,738,1898,773,2034
240410,201902,548,1721,463,1532,54,225,271,856,325,1081
240420,201902,4571,16450,4049,15266,565,2526,2215,8177,2780,10703
240430,201902,3292,8900,2810,7965,233,740,2024,5552,2257,6292
240440,201902,2510,5699,2123,5144,134,322,1686,4027,1820,4349
240450,201902,4103,11551,3366,10205,331,1149,2054,6019,2385,7168
240460,201902,2872,8383,2662,8049,261,844,2103,6342,2364,7186
240470,201902,3506,10772,2759,9205,371,1264,1527,5101,1898,6365
240480,201902,547,1526,397,1208,33,108,174,509,207,617
240485,201902,2065,6029,1710,5340,159,518,1118,3488,1277,4006
240490,201902,1724,4351,1372,3714,52,122,1106,3006,1158,3128
240500,201902,2155,5801,1894,5420,42,155,1635,4625,1677,4780
240510,201902,1657,4414,1486,4173,82,263,1231,3375,1313,3638
240520,201902,1299,3359,1066,3038,43,153,852,2383,895,2536
240530,201902,1971,6039,1827,5786,113,399,1455,4572,1568,4971
240540,201902,2213,5626,1942,5207,92,226,1640,4389,1732,4615
240550,201902,664,1887,611,1793,28,108,475,1345,503,1453
240560,201902,3240,8626,2774,7994,262,695,2052,5994,2314,6689
240570,201902,2852,7557,1923,5469,265,809,838,2188,1103,2997
240580,201902,7640,22601,6943,21349,539,1705,5593,17197,6132,18902
240590,201902,696,1869,610,1724,11,44,459,1275,470,1319
240600,201902,1753,4799,1286,3830,54,191,848,2428,902,2619
240610,201902,4270,11721,3606,10497,139,487,2738,7818,2877,8305
240615,201902,1087,3037,871,2601,65,244,596,1689,661,1933
240620,201902,1833,5217,1574,4755,90,269,1252,3751,1342,4020
240630,201902,2012,5844,1814,5505,130,320,1272,3997,1402,4317
240640,201902,897,2440,722,2151,32,128,532,1548,564,1676
240650,201902,3862,10810,3405,9996,202,613,2650,7742,2852,8355
240660,201902,2855,7601,2580,7237,57,214,2341,6494,2398,6708
240670,201902,2422,6858,2006,6020,142,454,1302,3811,1444,4265
240680,201902,1608,4360,1289,3801,63,227,948,2698,1011,2925
240690,201902,915,2360,730,2038,15,63,590,1589,605,1652
240700,201902,2324,6801,1937,6096,71,291,1517,4679,1588,4970
240710,201902,15842,41704,13435,37522,2245,6105,7704,21824,9949,27929
240720,201902,5075,13139,4414,12118,516,1522,3001,8077,3517,9599
240725,201902,1072,3108,834,2609,32,113,562,1711,594,1824
240730,201902,2056,5892,1757,5296,81,265,1363,4036,1444,4301
240740,201902,1835,4963,1531,4400,62,250,1131,3076,1193,3326
240750,201902,2224,7448,1871,6698,273,1078,1026,3690,1299,4768
240760,201902,1496,3694,1083,3067,56,144,837,2399,893,2543
240770,201902,3090,8741,2681,8144,144,560,2111,6289,2255,6849
240780,201902,5202,14318,4148,12562,527,1600,2519,7813,3046,9413
240790,201902,843,2440,710,2184,15,57,526,1589,541,1646
240800,201902,42968,108288,34428,95027,4981,14340,16933,46841,21914,61181
240810,201902,80552,216819,70789,200396,12286,35069,41176,116418,53462,151487
240820,201902,5584,17088,4836,15751,768,2570,2843,9403,3611,11973
240830,201902,8586,25283,7847,24117,311,1378,6366,19139,6677,20517
240840,201902,1136,2886,903,2487,51,136,625,1663,676,1799
240850,201902,1231,3453,900,2748,43,144,522,1563,565,1707
240860,201902,1219,3352,921,2796,19,90,688,1987,707,2077
240870,201902,1144,2887,893,2463,84,260,603,1611,687,1871
240880,201902,1271,4001,1154,3783,80,310,925,2977,1005,3287
240890,201902,4491,12364,3428,10320,507,1641,1715,4978,2222,6619
240895,201902,2658,8528,2411,8157,179,632,2009,6787,2188,7419
240910,201902,3142,8843,2724,8038,65,228,2219,6454,2284,6682
240920,201902,797,2356,691,2155,64,193,387,1254,451,1447
240930,201902,3647,8489,3047,7752,181,252,2393,6304,2574,6556
240933,201902,1767,4242,1459,3776,46,176,1254,3183,1300,3359
240940,201902,6123,15229,4876,13105,269,765,3529,9168,3798,9933
240950,201902,927,2840,811,2611,30,127,661,2082,691,2209
240960,201902,692,2125,618,1974,40,149,473,1467,513,1616
240970,201902,1841,4819,1516,4257,52,199,1264,3446,1316,3645
240980,201902,2921,9169,2666,8680,170,690,2039,6464,2209,7154
240990,201902,2522,7328,2310,6893,275,893,1646,4782,1921,5675
241000,201902,939,2514,759,2161,46,112,529,1511,575,1623
241010,201902,2761,8913,2534,8417,188,762,1862,6054,2050,6816
241020,201902,2028,5492,1502,4409,137,410,955,2725,1092,3135
241025,201902,1723,4985,1385,4326,63,249,947,2915,1010,3164
241030,201902,2454,7829,2021,6904,210,760,1330,4519,1540,5279
241040,201902,2257,7203,2027,6810,95,428,1621,5415,1716,5843
241050,201902,1255,3519,1031,3085,34,116,789,2304,823,2420
241060,201902,706,2011,635,1875,40,117,449,1294,489,1411
241070,201902,637,1775,562,1641,23,81,435,1217,458,1298
241080,201902,1112,3189,855,2672,11,45,640,1985,651,2030
241090,201902,2012,5850,1626,5199,58,278,1272,3995,1330,4273
241100,201902,1131,3229,895,2709,49,158,618,1811,667,1969
241105,201902,1026,3112,833,2736,263,870,270,930,533,1800
241110,201902,897,2611,683,2138,35,134,453,1354,488,1488
241120,201902,7375,21336,6355,19499,1066,3163,3536,11258,4602,14421
241140,201902,3208,8594,2607,7400,153,452,1912,5275,2065,5727
241142,201902,752,2041,555,1652,28,102,315,868,343,970
241150,201902,5703,15351,5097,14335,180,654,4145,11374,4325,12028
241160,201902,1315,3674,1105,3311,136,399,742,2205,878,2604
241170,201902,1288,3293,1120,3020,38,143,934,2401,972,2544
241180,201902,976,2560,709,2035,76,221,412,1148,488,1369
241190,201902,1073,2882,896,2528,25,94,657,1768,682,1862
241200,201902,18317,48892,15937,45295,2794,8102,8942,25571,11736,33673
241210,201902,1339,3738,1007,3072,108,357,600,1786,708,2143
241220,201902,8530,25963,7524,24209,1971,6325,3352,11329,5323,17654
241230,201902,2887,7810,2573,7305,114,403,2128,5908,2242,6311
241240,201902,1157,3322,699,2251,42,148,339,1097,381,1245
241250,201902,5407,16045,4477,14277,184,861,3318,10146,3502,11007
241255,201902,1968,6502,1736,5992,131,560,1247,4183,1378,4743
241260,201902,4802,12780,3782,11041,100,444,2957,8409,3057,8853
241270,201902,1780,5194,1485,4620,137,484,1029,3147,1166,3631
241280,201902,2111,5422,1835,4926,66,191,1547,4098,1613,4289
241290,201902,3394,8443,2609,7135,80,298,2040,5396,2120,5694
241300,201902,1435,3931,1154,3422,40,153,781,2245,821,2398
241310,201902,1996,5204,1710,4795,22,94,1448,4054,1470,4148
241320,201902,978,3190,815,2855,96,390,497,1721,593,2111
241330,201902,1754,4557,1378,4087,28,119,1176,3483,1204,3602
241335,201902,3042,8675,2751,8149,90,325,2320,6787,2410,7112
241340,201902,1644,4778,1283,4011,277,888,535,1647,812,2535
241350,201902,1959,5765,1742,5372,111,387,1325,4011,1436,4398
241355,201902,1277,3519,1065,3117,23,86,822,2373,845,2459
241360,201902,2064,5398,1605,4483,61,182,1145,3073,1206,3255
241370,201902,1338,3741,1057,3177,68,236,701,2015,769,2251
241380,201902,638,1784,502,1516,77,233,273,833,350,1066
241390,201902,2682,8131,2442,7743,197,610,1877,5982,2074,6592
241400,201902,3485,9796,3153,9309,189,627,2564,7495,2753,8122
241410,201902,2297,6919,1892,6107,348,1163,1024,3301,1372,4464
241415,201902,1613,4798,1330,4245,77,299,952,2953,1029,3252
241420,201902,2146,7123,1841,6553,472,1830,788,2784,1260,4614
241430,201902,559,1609,392,1210,26,90,236,700,262,790
241440,201902,7158,23000,6438,21691,425,1687,5025,16673,5450,18360
241445,201902,1070,2784,980,2671,22,61,896,2488,918,2549
241450,201902,2711,6858,2363,6301,269,639,1729,4655,1998,5294
241460,201902,3588,9915,3021,8706,166,540,2150,6023,2316,6563
241470,201902,1426,3757,1134,3327,29,114,930,2705,959,2819
241475,201902,1197,3428,948,2948,30,151,687,2026,717,2177
241480,201902,2726,8682,2322,7830,824,2741,662,2567,1486,5308
241490,201902,657,1609,527,1420,25,74,352,915,377,989
241500,201902,811,2340,700,2195,13,58,614,1929,627,1987
250010,201902,2577,7776,2161,6912,76,304,1579,4930,1655,5234
250020,201902,1589,4360,1141,3470,56,159,816,2451,872,2610
250030,201902,6710,18741,6045,17709,467,1439,4639,13372,5106,14811
250040,201902,4030,12583,3495,11581,229,923,2492,8091,2721,9014
250050,201902,3440,9538,3158,9127,145,514,2580,7369,2725,7883
250053,201902,1160,3377,1056,3209,78,255,772,2365,850,2620
250057,201902,643,2339,606,2282,4,26,549,2097,553,2123
250060,201902,5246,14217,4807,13671,411,1099,3774,10910,4185,12009
250070,201902,3896,11188,3429,10348,57,269,2727,8000,2784,8269
250073,201902,724,1996,596,1792,7,28,491,1420,498,1448
250077,201902,2187,5980,1641,5064,84,291,1185,3624,1269,3915
250080,201902,4455,11759,3973,11105,94,351,3429,9444,3523,9795
250090,201902,3031,7711,2682,7235,63,207,2307,6102,2370,6309
250100,201902,3689,11469,3417,10960,154,623,2760,8613,2914,9236
250110,201902,4765,13526,4336,12899,351,1272,3343,9677,3694,10949
250115,201902,537,1564,462,1441,10,56,347,1042,357,1098
250120,201902,1833,5384,1521,4866,43,192,1207,3828,1250,4020
250130,201902,5399,15257,4620,14108,85,461,3819,11447,3904,11908
250135,201902,1150,3171,1033,2989,14,56,933,2696,947,2752
250140,201902,2097,6443,1993,6292,96,453,1739,5382,1835,5835
250150,201902,4754,15136,4309,14330,175,802,3450,11229,3625,12031
250153,201902,1438,3726,1201,3378,26,93,985,2726,1011,2819
250157,201902,1709,5193,1534,4839,84,295,1195,3720,1279,4015
250160,201902,3839,9769,3107,8772,31,124,2792,7837,2823,7961
250170,201902,1738,4540,1565,4280,38,136,1354,3647,1392,3783
250180,201902,18147,46272,15939,43355,876,2707,12264,32680,13140,35387
250190,201902,4012,11043,3431,10122,389,1100,2298,6744,2687,7844
250200,201902,1837,5086,1579,4685,52,186,1346,3969,1398,4155
250205,201902,804,2599,712,2444,21,113,591,2002,612,2115
250210,201902,1563,4744,1417,4504,56,283,1117,3456,1173,3739
250215,201902,1555,4410,1285,3961,64,213,800,2450,864,2663
250220,201902,672,1923,552,1740,28,121,380,1137,408,1258
250230,201902,1602,3727,1173,3070,25,78,936,2373,961,2451
250240,201902,2176,6680,1967,6307,45,198,1675,5292,1720,5490
250250,201902,4446,12490,3879,11667,92,312,3277,9827,3369,10139
250260,201902,1715,4764,1437,4299,44,143,1144,3392,1188,3535
250270,201902,1199,3671,1080,3528,79,258,798,2710,877,2968
250280,201902,3224,9221,2812,8583,93,309,2246,6834,2339,7143
250290,201902,1591,4218,1361,3902,26,73,1097,3164,1123,3237
250300,201902,5401,14721,4988,14242,207,909,4161,11437,4368,12346
250310,201902,1154,3227,977,2925,39,126,751,2206,790,2332
250320,201902,10392,25226,9195,23783,391,1164,7887,20121,8278,21285
250330,201902,2291,6614,1947,6149,130,449,1547,4841,1677,5290
250340,201902,1095,2849,964,2670,7,23,857,2341,864,2364
250350,201902,3984,11198,3634,10657,146,380,2978,8960,3124,9340
250355,201902,1979,6069,1774,5789,32,178,1605,5197,1637,5375
250360,201902,1773,5019,1611,4778,41,153,1324,3894,1365,4047
250370,201902,12153,32776,10370,30107,371,1432,8545,24312,8916,25744
250375,201902,1137,2979,940,2733,7,22,872,2553,879,2575
250380,201902,1596,4211,1469,4043,42,169,1235,3276,1277,3445
250390,201902,1761,4619,1481,4159,136,374,1085,3041,1221,3415
250400,201902,69019,171305,50062,142093,13840,41373,15458,45946,29298,87319
250403,201902,1633,4754,1492,4572,91,438,1167,3413,1258,3851
250407,201902,1208,3105,1005,2811,68,158,741,2101,809,2259
250410,201902,591,1635,518,1513,4,19,432,1237,436,1256
250415,201902,1856,5303,1637,4948,48,199,1360,4065,1408,4264
250420,201902,1210,3481,1092,3322,13,56,1023,3110,1036,3166
250430,201902,6125,15354,5299,14196,162,514,4411,11602,4573,12116
250435,201902,1502,4222,1251,3797,24,101,955,2845,979,2946
250440,201902,4480,12069,3884,11329,78,276,3382,9825,3460,10101
250450,201902,1794,4891,1517,4511,33,126,1268,3755,1301,3881
250460,201902,7193,19624,6483,18620,361,1081,5316,15235,5677,16316
250470,201902,1538,3967,1276,3584,58,184,985,2697,1043,2881
250480,201902,3986,10980,3482,10375,20,96,3137,9452,3157,9548
250485,201902,721,1654,535,1395,34,73,387,976,421,1049
250490,201902,4792,12080,4315,11502,203,666,3714,9727,3917,10393
250500,201902,1915,5359,1709,5010,74,242,1399,4094,1473,4336
250510,201902,5371,13618,4666,12708,87,280,4120,11222,4207,11502
250520,201902,1757,4885,1533,4562,140,442,1074,3179,1214,3621
250523,201902,2195,5413,1979,5146,88,365,1663,4172,1751,4537
250527,201902,1661,4326,1514,4153,28,77,1341,3702,1369,3779
250530,201902,611,1666,529,1553,11,36,465,1355,476,1391
250535,201902,1329,3957,1223,3753,35,153,995,2963,1030,3116
250540,201902,2874,6787,2389,6234,64,151,2085,5495,2149,5646
250550,201902,785,2526,691,2348,16,82,545,1798,561,1880
250560,201902,1629,4592,1465,4362,47,174,1230,3576,1277,3750
250570,201902,2600,7849,2253,7223,80,314,1784,5599,1864,5913
250580,201902,1035,2714,950,2591,57,185,769,2071,826,2256
250590,201902,818,2324,727,2190,18,88,607,1817,625,1905
250600,201902,8156,21146,6861,19464,336,985,5655,16011,5991,16996
250610,201902,2953,8341,2686,7957,112,433,2224,6488,2336,6921
250620,201902,693,1914,589,1717,13,59,457,1299,470,1358
250625,201902,2526,7390,2276,6991,50,263,1896,5654,1946,5917
250630,201902,9403,26821,7924,24109,874,2793,5208,15397,6082,18190
250640,201902,3282,9444,3029,9095,85,404,2576,7526,2661,7930
250650,201902,903,2234,753,2029,30,85,635,1671,665,1756
250660,201902,1597,4041,1375,3733,46,129,1146,3049,1192,3178
250670,201902,2319,7264,2150,6981,52,242,1867,5931,1919,6173
250680,201902,5827,13601,5183,12861,103,386,4693,11366,4796,11752
250690,201902,6670,15474,5848,14421,120,297,5206,12688,5326,12985
250700,201902,4289,12152,3775,11371,330,993,2809,8384,3139,9377
250710,201902,4399,12741,3815,11943,285,994,2815,8790,3100,9784
250720,201902,2726,7258,2469,6890,40,182,2191,6030,2231,6212
250730,201902,3996,10773,3528,10146,126,461,2928,8173,3054,8634
250740,201902,1938,4968,1592,4504,103,311,1245,3478,1348,3789
250750,201902,96781,248691,84545,231355,7701,22861,60329,161952,68030,184813
250760,201902,2336,6095,2036,5622,114,337,1583,4250,1697,4587
250770,201902,3818,11854,3475,11383,333,1125,2522,8277,2855,9402
250780,201902,1701,4679,1426,4166,84,285,1057,3008,1141,3293
250790,201902,2403,7269,2098,6824,237,896,1351,4312,1588,5208
250800,201902,2439,6537,2121,6041,90,210,1763,5047,1853,5257
250810,201902,1244,3382,1024,3059,26,74,876,2639,902,2713
250820,201902,1831,5479,1750,5384,49,217,1585,4841,1634,5058
250830,201902,5629,17017,4773,15319,318,1209,3314,10368,3632,11577
250840,201902,787,2518,670,2272,23,99,483,1643,506,1742
250850,201902,1820,5509,1641,5203,44,228,1359,4192,1403,4420
250855,201902,949,2790,828,2589,70,242,606,1876,676,2118
250860,201902,2927,9070,2482,8276,412,1450,1413,4714,1825,6164
250870,201902,1044,2871,892,2611,32,116,728,2105,760,2221
250880,201902,1535,4054,1262,3651,139,406,881,2555,1020,2961
250890,201902,9622,26500,8808,25364,463,1984,7098,19448,7561,21432
250900,201902,2739,7963,2368,7279,73,285,1974,5940,2047,6225
250905,201902,2281,6573,2099,6303,46,192,1878,5613,1924,5805
250910,201902,5766,14623,4765,13442,104,399,4021,11357,4125,11756
250915,201902,1912,4709,1443,4204,14,34,1310,3866,1324,3900
250920,201902,3424,8891,3013,8251,323,819,2175,5903,2498,6722
250930,201902,2130,5834,1948,5583,63,247,1676,4701,1739,4948
250933,201902,1120,3426,996,3197,24,130,752,2346,776,2476
250937,201902,712,1960,603,1777,28,102,436,1297,464,1399
250939,201902,1683,4654,1499,4376,54,185,1204,3460,1258,3645
250940,201902,3811,10439,3399,9865,57,246,2931,8426,2988,8672
250950,201902,1672,4274,1349,3872,25,107,1154,3275,1179,3382
250960,201902,1060,3171,953,3002,30,147,773,2341,803,2488
250970,201902,8205,21757,7121,19990,329,1081,5625,15479,5954,16560
250980,201902,2463,6651,2217,6259,46,175,1860,5122,1906,5297
250990,201902,1904,6027,1655,5553,81,361,1220,4037,1301,4398
251000,201902,2067,5819,1700,5220,34,141,1415,4311,1449,4452
251010,201902,2606,7411,2364,7026,30,131,2136,6324,2166,6455
251020,201902,1687,4527,1534,4319,33,135,1356,3746,1389,3881
251030,201902,981,2654,836,2388,32,95,593,1652,625,1747
251040,201902,1838,5341,1571,4881,48,231,1246,3812,1294,4043
251050,201902,1079,2958,894,2610,47,161,657,1852,704,2013
251060,201902,1021,2221,767,1904,11,48,637,1543,648,1591
251065,201902,436,1205,350,1065,13,36,253,742,266,778
251070,201902,736,1995,636,1859,8,29,541,1564,549,1593
251080,201902,18327,47908,15189,43247,2012,6043,9707,27689,11719,33732
251090,201902,2663,7777,2285,7087,53,196,1849,5696,1902,5892
251100,201902,804,2527,716,2373,26,107,552,1762,578,1869
251110,201902,1678,4607,1463,4213,50,142,1138,3246,1188,3388
251120,201902,6961,20395,5957,19080,265,1107,4685,14853,4950,15960
251130,201902,3825,8975,3439,8540,178,466,2999,7411,3177,7877
251140,201902,4155,11873,3788,11345,98,384,3142,9312,3240,9696
251150,201902,2653,7786,2387,7364,110,481,1915,5730,2025,6211
251160,201902,2038,6147,1798,5797,133,466,1427,4579,1560,5045
251170,201902,1516,4237,1368,4066,40,170,1206,3551,1246,3721
251180,201902,2510,6982,2108,6423,178,572,1418,4265,1596,4837
251190,201902,4313,11437,4033,11112,54,248,3683,9966,3737,10214
251200,201902,4041,12343,3698,11912,91,378,3220,10418,3311,10796
251203,201902,923,3047,872,2934,33,152,668,2182,701,2334
251207,201902,1039,2961,825,2587,19,90,584,1779,603,1869
251210,201902,7325,19260,6014,17569,267,734,4655,13732,4922,14466
251220,201902,1153,2870,897,2510,45,116,710,2005,755,2121
251230,201902,4551,12605,3989,11699,126,515,3226,9177,3352,9692
251240,201902,3576,9945,2988,9026,165,553,2242,6621,2407,7174
251250,201902,9714,26770,8671,25065,756,2323,6409,17943,7165,20266
251260,201902,468,1403,429,1329,14,72,329,982,343,1054
251270,201902,4044,12776,3666,12285,104,443,3105,10528,3209,10971
251272,201902,1319,3652,1204,3488,36,156,1038,2918,1074,3074
251274,201902,874,2501,725,2244,49,183,496,1468,545,1651
251275,201902,1221,3417,1049,3144,45,208,785,2239,830,2447
251276,201902,1315,3537,1155,3330,32,161,953,2650,985,2811
251278,201902,554,1585,496,1488,39,100,369,1118,408,1218
251280,201902,2198,6185,1973,5819,48,200,1630,4704,1678,4904
251290,201902,5643,14002,5236,13479,191,702,4504,11126,4695,11828
251300,201902,793,2408,739,2330,11,47,626,1966,637,2013
251310,201902,2770,8004,2426,7445,60,291,1935,5787,1995,6078
251315,201902,1673,5314,1543,5086,68,253,1183,3826,1251,4079
251320,201902,1640,4352,1144,3490,33,114,836,2531,869,2645
251330,201902,2000,4731,1649,4311,23,84,1521,3987,1544,4071
251335,201902,1000,3101,912,2972,28,117,777,2482,805,2599
251340,201902,3596,8997,2880,8021,120,388,2153,5888,2273,6276
251350,201902,1063,3154,950,2970,30,143,793,2410,823,2553
251360,201902,1804,5155,1496,4732,21,95,1302,4124,1323,4219
251365,201902,693,1990,557,1697,11,36,429,1303,440,1339
251370,201902,21857,60966,19554,57741,2324,7112,13022,38675,15346,45787
251380,201902,1176,3416,1048,3197,23,127,883,2587,906,2714
251385,201902,709,1865,558,1593,18,56,418,1146,436,1202
251390,201902,6226,18787,5461,17500,673,2325,3309,10502,3982,12827
251392,201902,946,2643,789,2394,24,121,620,1833,644,1954
251394,201902,589,1771,485,1580,25,102,361,1151,386,1253
251396,201902,694,1880,590,1713,25,69,405,1164,430,1233
251398,201902,912,2387,662,1929,17,75,500,1412,517,1487
251400,201902,1158,2964,952,2675,31,112,738,2002,769,2114
251410,201902,1545,3687,1296,3335,22,106,1115,2769,1137,2875
251420,201902,1882,5106,1553,4727,45,181,1211,3639,1256,3820
251430,201902,1533,4788,1371,4520,39,188,1190,3881,1229,4069
251440,201902,1099,3127,899,2746,28,94,710,2166,738,2260
251445,201902,1481,4290,1378,4138,54,230,1138,3288,1192,3518
251450,201902,4247,12850,3890,12326,94,413,3265,10229,3359,10642
251455,201902,904,2728,817,2574,27,100,624,1941,651,2041
251460,201902,887,2578,786,2414,28,104,650,1994,678,2098
251465,201902,428,1279,366,1145,7,33,285,877,292,910
251470,201902,1154,3237,864,2626,70,223,534,1560,604,1783
251480,201902,938,2527,788,2270,21,94,603,1671,624,1765
251490,201902,1864,5073,1495,4559,59,203,1091,3310,1150,3513
251500,201902,1881,5488,1738,5270,58,247,1509,4503,1567,4750
251510,201902,2625,8111,2207,7250,154,579,1460,4700,1614,5279
251520,201902,936,2482,716,2057,69,178,476,1357,545,1535
251530,201902,13946,34201,11568,31216,127,701,10212,26997,10339,27698
251540,201902,2769,8313,2558,7916,103,402,2074,6300,2177,6702
251550,201902,3642,8815,2908,7880,89,249,2445,6615,2534,6864
251560,201902,576,1739,512,1639,78,267,334,1019,412,1286
251570,201902,888,2586,739,2280,19,93,569,1685,588,1778
251580,201902,1891,4587,1686,4291,71,230,1439,3539,1510,3769
251590,201902,1570,4095,1352,3836,60,205,1088,2974,1148,3179
251593,201902,890,2690,833,2593,94,312,530,1603,624,1915
251597,201902,2074,5844,1893,5600,27,101,1663,4855,1690,4956
251600,201902,6285,17258,5603,16218,171,549,4703,13407,4874,13956
251610,201902,3249,9316,2794,8484,303,888,1906,5851,2209,6739
251615,201902,1208,3067,977,2688,21,69,777,2085,798,2154
251620,201902,17775,42209,14207,37920,223,742,11894,32234,12117,32976
251630,201902,4632,11126,3743,9903,200,592,2904,7583,3104,8175
251640,201902,2052,5891,1863,5547,46,221,1594,4624,1640,4845
251650,201902,4052,10770,3554,10155,135,463,3063,8705,3198,9168
251660,201902,3415,10282,2996,9538,83,403,2496,7771,2579,8174
251670,201902,4093,11642,3604,10975,51,264,3210,9676,3261,9940
251675,201902,646,1905,584,1827,84,291,385,1192,469,1483
251680,201902,2562,6949,2137,6377,49,182,1717,5105,1766,5287
251690,201902,3171,9042,2696,8176,83,266,2020,6006,2103,6272
251700,201902,1884,5745,1708,5516,50,238,1447,4566,1497,4804
251710,201902,791,2094,543,1571,51,183,309,875,360,1058
251720,201902,1330,3777,1099,3369,31,136,836,2469,867,2605
251740,201902,627,1774,504,1537,36,139,362,1061,398,1200
260005,201902,29256,62389,23982,55660,1774,4257,18213,41353,19987,45610
260010,201902,9843,26050,8133,23427,490,1512,4960,14439,5450,15951
260020,201902,6781,16190,5775,14726,128,557,4807,12027,4935,12584
260030,201902,6380,16991,5449,15567,195,682,4353,12318,4548,13000
260040,201902,7782,21256,6451,19156,551,1668,4297,12938,4848,14606
260050,201902,13117,35233,11371,33271,271,913,10148,29988,10419,30901
260060,201902,3884,10089,3348,9211,199,552,2615,7157,2814,7709
260070,201902,10256,26551,8824,24441,479,1623,6828,18491,7307,20114
260080,201902,6467,15049,5634,13872,153,500,4668,11208,4821,11708
260090,201902,4889,12701,4381,12032,666,1808,2942,8174,3608,9982
260100,201902,3126,8449,2622,7694,91,366,2122,6109,2213,6475
260105,201902,5146,13874,4571,13064,162,604,3761,10546,3923,11150
260110,201902,22406,60843,20121,57609,1104,3542,16549,46672,17653,50214
260120,201902,14055,38607,11852,35221,1553,4675,7323,22164,8876,26839
260130,201902,2958,7912,2662,7444,214,643,1972,5396,2186,6039
260140,201902,13140,30304,11249,27959,605,1693,9308,22792,9913,24485
260150,201902,3515,8438,3009,7812,127,411,2554,6520,2681,6931
260160,201902,6571,17452,5576,16178,113,454,4881,14262,4994,14716
260170,201902,18202,45855,15625,42201,1511,3972,11623,31341,13134,35313
260180,201902,3279,9196,2899,8678,104,369,2425,7132,2529,7501
260190,201902,18402,37789,15500,34386,187,529,13589,29503,13776,30032
260200,201902,10973,26876,9551,25085,458,1139,8110,21370,8568,22509
260210,201902,11812,33929,10036,31043,359,1465,7989,24474,8348,25939
260220,201902,10193,25171,9435,24214,195,675,8248,20822,8443,21497
260230,201902,10353,26322,9037,24499,243,778,7487,19970,7730,20748
260240,201902,2736,8194,2395,7588,172,594,1819,5734,1991,6328
260250,201902,2180,5839,1893,5421,111,311,1438,4077,1549,4388
260260,201902,12727,33752,11185,31351,492,1697,8752,24058,9244,25755
260270,201902,3896,10033,3424,9427,154,655,2740,7313,2894,7968
260280,201902,12892,39374,11598,37559,548,2292,9774,31263,10322,33555
260290,201902,38326,101209,33365,93738,4025,11683,21792,60668,25817,72351
260300,201902,9512,25968,8277,24226,247,1055,6846,19865,7093,20920
260310,201902,4674,12503,4196,11868,337,923,3214,9204,3551,10127
260320,201902,7290,21521,6478,20122,277,855,5308,16548,5585,17403
260330,201902,2500,7727,2233,7174,66,247,1819,5716,1885,5963
260340,201902,2029,5480,1756,5057,36,174,1479,4133,1515,4307
260345,201902,24177,65264,20496,59762,3523,11091,10079,28687,13602,39778
260350,201902,5081,12558,4512,11857,103,314,3968,10338,4071,10652
260360,201902,2493,6602,2266,6193,48,214,1571,4207,1619,4421
260370,201902,5431,15819,4685,14538,225,819,3586,11043,3811,11862
260380,201902,4866,14742,4190,13621,196,724,3106,9933,3302,10657
260390,201902,4277,13061,3647,11809,232,808,2507,7975,2739,8783
260392,201902,3447,11014,3069,10534,130,741,2461,8442,2591,9183
260400,201902,16208,39495,14198,36831,646,1969,11028,27577,11674,29546
260410,201902,67565,169094,52885,148381,10325,30476,23733,68266,34058,98742
260415,201902,4255,11854,3624,10725,91,406,2819,8093,2910,8499
260420,201902,12759,27069,10803,24869,176,488,9740,22170,9916,22658
260430,201902,2815,8728,2424,7988,125,484,1695,5537,1820,6021
260440,201902,3607,9760,3155,8989,111,401,2523,7011,2634,7412
260450,201902,5605,14450,5082,13797,296,696,4180,11516,4476,12212
260460,201902,5117,15747,4429,14434,523,1937,2587,8214,3110,10151
260470,201902,4956,13035,4214,12176,119,291,3771,11082,3890,11373
260480,201902,4051,10855,3402,9933,275,994,2295,6711,2570,7705
260490,201902,5249,12412,4627,11451,67,263,4120,9955,4187,10218
260500,201902,6031,15589,5146,14287,485,1264,3548,9988,4033,11252
260510,201902,9423,23455,7960,21409,160,573,6964,18472,7124,19045
260515,201902,4258,12002,3318,10174,159,537,2196,6574,2355,7111
260520,201902,17436,41128,15391,38431,969,2503,12316,30358,13285,32861
260530,201902,9613,27941,8293,25856,192,890,7017,21583,7209,22473
260540,201902,7031,15566,6259,14573,388,842,5343,12432,5731,13274
260545,201902,41,133,17,79,3,11,4,18,7,29
260550,201902,2827,8230,2395,7447,154,661,1559,4712,1713,5373
260560,201902,5930,15336,5082,14117,138,600,4274,11558,4412,12158
260570,201902,7440,21031,6625,19877,470,1504,5141,15417,5611,16921
260580,201902,4388,10625,3909,9970,33,143,3558,9005,3591,9148
260590,201902,6688,15837,5643,14646,250,663,4653,12175,4903,12838
260600,201902,29938,79483,24616,71192,1390,4442,18167,51746,19557,56188
260610,201902,6948,18779,6340,17965,421,1336,4727,13240,5148,14576
260620,201902,15346,41836,13606,39264,1568,4946,9259,26230,10827,31176
260630,201902,2329,6399,1933,5750,43,185,1559,4535,1602,4720
260640,201902,20410,48002,17449,44539,934,2558,13804,34860,14738,37418
260650,201902,5663,15743,4717,14468,174,744,3961,12012,4135,12756
260660,201902,7246,19349,6237,17990,173,739,5262,14851,5435,15590
260670,201902,2192,5753,1806,5176,84,223,1343,3811,1427,4034
260680,201902,25564,63126,21534,57113,1905,5360,14202,36923,16107,42283
260690,201902,3622,9368,2958,8364,120,429,2358,6567,2478,6996
260700,201902,5951,17446,5661,17117,20,54,5490,16745,5510,16799
260710,201902,1313,3522,1195,3377,46,155,897,2545,943,2700
260720,201902,21075,56505,18568,52878,2606,7669,11960,33729,14566,41398
260730,201902,7247,21655,6446,20484,325,1220,5288,16531,5613,17751
260740,201902,1326,3732,1112,3384,16,85,880,2695,896,2780
260750,201902,6811,19316,5891,18096,122,419,5252,16345,5374,16764
260760,201902,5542,13393,4814,12483,226,657,3875,10084,4101,10741
260765,201902,7635,22911,6715,21593,560,2358,4590,14293,5150,16651
260770,201902,3778,9866,3240,8949,94,324,2584,7041,2678,7365
260775,201902,5190,14090,4639,13252,244,936,3526,9716,3770,10652
260780,201902,3603,10914,3217,10268,316,1202,2026,6265,2342,7467
260790,201902,114038,262086,95500,237434,15204,37038,58050,144170,73254,181208
260795,201902,3022,8109,2618,7542,130,437,1973,5684,2103,6121
260800,201902,5391,12611,4876,11895,164,509,4267,10071,4431,10580
260805,201902,3560,10411,3003,9420,180,680,2164,6653,2344,7333
260810,201902,6537,17932,5822,16564,565,1592,4138,11558,4703,13150
260820,201902,4370,10582,3848,9890,173,600,3106,7762,3279,8362
260825,201902,2865,8734,2482,8040,124,475,1842,5919,1966,6394
260830,201902,4282,12587,3564,11277,471,1367,2290,7440,2761,8807
260840,201902,4034,10895,3597,10253,189,553,2996,8513,3185,9066
260845,201902,4112,11175,3706,10450,261,734,2736,7646,2997,8380
260850,201902,4785,13831,4099,12473,407,1333,2568,7599,2975,8932
260860,201902,3401,9796,2918,8943,93,351,2358,7074,2451,7425
260870,201902,4448,10804,3852,10059,101,406,3393,8662,3494,9068
260875,201902,6664,17331,5582,15673,646,1824,3719,10433,4365,12257
260880,201902,9642,27325,8444,25217,446,1318,6708,20106,7154,21424
260890,201902,13178,34761,11657,32507,885,2746,8279,22562,9164,25308
260900,201902,5186,15088,4360,13800,329,1213,2923,9128,3252,10341
260910,201902,3144,8700,2741,8066,109,377,2151,6257,2260,6634
260915,201902,5130,15134,4526,14418,63,294,4090,13065,4153,13359
260920,201902,3304,8611,2843,8074,102,320,2416,6855,2518,7175
260930,201902,3482,11338,3091,10633,162,678,2366,8009,2528,8687
260940,201902,14490,35421,12622,32708,871,2474,9437,23916,10308,26390
260950,201902,6451,17976,5228,15716,500,1722,3065,8765,3565,10487
260960,201902,64706,151136,52337,134568,6857,18564,31399,79459,38256,98023
260970,201902,5189,14119,4650,13396,164,443,3623,10477,3787,10920
260980,201902,4399,13143,3978,12600,69,286,3599,11462,3668,11748
260990,201902,17603,50002,15012,46517,854,3116,11594,35516,12448,38632
261000,201902,16023,38998,13543,35654,506,1886,10587,27191,11093,29077
261010,201902,2427,6375,2126,5976,74,205,1851,5192,1925,5397
261020,201902,6037,16768,5196,15246,260,919,4123,11658,4383,12577
261030,201902,4053,11531,3512,10625,155,545,2792,8263,2947,8808
261040,201902,5147,15396,4211,13526,207,824,3061,9655,3268,10479
261050,201902,7609,20475,6877,19253,585,1392,4859,13742,5444,15134
261060,201902,13525,34951,11932,32901,445,1461,9714,26497,10159,27958
261070,201902,59074,131856,49121,118525,3251,7707,36399,86470,39650,94177
261080,201902,6145,15622,5666,14979,171,453,5154,13625,5325,14078
261090,201902,18059,44454,16144,41967,390,1337,13804,35277,14194,36614
261100,201902,8051,23107,7027,21575,593,1976,5050,15521,5643,17497
261110,201902,58849,169073,49951,153828,9389,30384,26177,80884,35566,111268
261120,201902,3788,9493,3242,8766,84,270,2814,7579,2898,7849
261130,201902,7441,18096,6597,17028,116,372,5856,14994,5972,15366
261140,201902,3488,8304,3120,7808,189,539,2508,6137,2697,6676
261150,201902,5214,14031,4614,13098,97,396,3953,11050,4050,11446
261153,201902,1927,5705,1662,5249,80,319,1144,3589,1224,3908
261160,201902,204511,487435,168472,437265,42551,113563,67475,178655,110026,292218
261170,201902,5839,15031,5226,14116,368,968,4109,11035,4477,12003
261180,201902,9729,24964,8590,23470,520,1582,6170,16688,6690,18270
261190,201902,4658,13980,4189,13171,274,1105,3110,9466,3384,10571
261200,201902,3344,7802,2975,7314,160,403,2460,5946,2620,6349
261210,201902,1920,4687,1628,4280,60,178,1379,3587,1439,3765
261220,201902,13603,39490,11343,35142,1488,4972,6374,19497,7862,24469
261230,201902,4221,12137,3516,11168,74,316,2895,9265,2969,9581
261240,201902,5076,13241,4483,12317,263,761,3650,9927,3913,10688
261245,201902,3496,10080,2992,9204,97,459,2362,6997,2459,7456
261247,201902,2919,8786,2451,7932,145,545,1697,5438,1842,5983
261250,201902,20770,48724,17953,45410,1945,4593,13200,34216,15145,38809
261255,201902,3976,11910,3377,10747,155,689,2498,7652,2653,8341
261260,201902,12930,34855,11152,32584,400,1629,9373,27046,9773,28675
261270,201902,3960,10497,3516,9901,213,754,2863,7852,3076,8606
261280,201902,2538,7233,2247,6721,81,336,1756,5104,1837,5440
261290,201902,2941,7817,2507,7301,85,341,2020,5907,2105,6248
261300,201902,11709,33736,9987,30727,606,2308,7153,21511,7759,23819
261310,201902,8394,22159,7183,20409,824,2560,4939,13678,5763,16238
261320,201902,5935,16926,5178,15614,86,397,4330,12818,4416,13215
261330,201902,5968,14936,5413,14189,169,602,4691,12053,4860,12655
261340,201902,4147,12210,3609,11468,193,784,2823,8869,3016,9653
261350,201902,8568,25446,7696,23977,130,654,6238,19036,6368,19690
261360,201902,8273,20435,7010,18642,258,815,5554,14303,5812,15118
261370,201902,21293,55391,18120,50992,2557,7239,11096,31468,13653,38707
261380,201902,3930,12260,3537,11558,464,1689,2320,7446,2784,9135
261390,201902,15762,46018,13468,42264,1266,4319,8781,27455,10047,31774
261400,201902,4568,14732,3986,13530,176,830,2938,9682,3114,10512
261410,201902,9345,24110,7805,21647,520,1449,6106,16738,6626,18187
261420,201902,7096,22184,6475,21389,872,3315,4370,14309,5242,17624
261430,201902,3410,9692,2849,8833,85,350,2340,7132,2425,7482
261440,201902,1435,4363,1237,3983,46,223,869,2702,915,2925
261450,201902,14794,40421,13242,37919,260,1060,10990,31186,11250,32246
261460,201902,7312,20324,6544,19197,215,768,5498,16012,5713,16780
261470,201902,4210,10584,3733,9966,43,199,3163,8448,3206,8647
261480,201902,4830,15184,4203,14123,238,977,3188,10502,3426,11479
261485,201902,4968,14264,4279,13176,411,1461,2913,8759,3324,10220
261500,201902,5520,14725,4876,13831,491,1259,3312,9767,3803,11026
261510,201902,1818,5541,1577,5112,67,250,1159,3801,1226,4051
261520,201902,2381,7333,2212,6994,92,337,1539,4903,1631,5240
261530,201902,11120,33834,9226,30215,1228,4649,4338,13847,5566,18496
261540,201902,7665,22496,6906,21335,1088,3252,3965,12764,5053,16016
261550,201902,3575,9614,3135,8905,228,739,2229,6194,2457,6933
261560,201902,7630,23079,6661,21625,388,1503,4929,15950,5317,17453
261570,201902,3408,9377,2780,8352,210,762,1914,5630,2124,6392
261580,201902,6573,17521,5808,16507,127,585,5207,14585,5334,15170
261590,201902,2694,6999,2143,6191,84,262,1589,4558,1673,4820
261600,201902,5067,13170,4249,11939,427,1117,2818,8192,3245,9309
261610,201902,2362,6505,1969,5865,102,384,1441,4254,1543,4638
261618,201902,2567,6538,2253,6087,82,240,1786,4765,1868,5005
261620,201902,3969,11605,3679,11171,842,2331,2227,7116,3069,9447
261630,201902,6418,18103,5481,16363,442,1652,3573,10101,4015,11753
261640,201902,36236,83074,31355,76964,1705,3579,24306,60913,26011,64492
261650,201902,4101,10396,3595,9750,152,550,2668,7142,2820,7692
270010,201902,4244,14679,3744,13786,178,1006,2904,10386,3082,11392
270020,201902,3844,9892,3400,9306,195,613,2806,7523,3001,8136
270030,201902,33504,93229,28928,85983,4247,12433,18691,56000,22938,68433
270040,201902,11218,30354,9685,28518,438,1752,7916,23005,8354,24757
270050,201902,5477,12700,4651,11776,180,447,4113,10445,4293,10892
270060,201902,2026,5311,1733,4962,130,348,1371,3969,1501,4317
270070,201902,4575,13158,4017,12362,152,640,3369,10157,3521,10797
270080,201902,1428,3973,1177,3542,51,172,886,2557,937,2729
270090,201902,1877,5781,1662,5361,75,338,1313,4091,1388,4429
270100,201902,5526,15164,4832,14122,224,894,3879,11031,4103,11925
270110,201902,3275,7968,2612,7183,127,334,2059,5864,2186,6198
270120,201902,2982,8071,2591,7567,74,294,2235,6467,2309,6761
270130,201902,5176,13759,4515,12982,189,609,3784,10943,3973,11552
270135,201902,2019,4933,1715,4582,54,170,1537,4074,1591,4244
270140,201902,9725,22683,7999,20322,367,1358,6461,15531,6828,16889
270150,201902,2716,8171,2537,7914,8,35,2431,7570,2439,7605
270160,201902,5642,16182,4974,15384,73,442,4571,13964,4644,14406
270170,201902,3469,10245,2958,9541,235,1046,2165,6704,2400,7750
270180,201902,2242,6951,2041,6683,46,226,1796,5788,1842,6014
270190,201902,1659,4997,1493,4784,55,255,1281,4045,1336,4300
270200,201902,2441,7425,2095,6956,120,476,1548,5028,1668,5504
270210,201902,5608,13651,4878,12824,146,512,4400,11407,4546,11919
270220,201902,1438,3952,1180,3583,229,726,652,1970,881,2696
270230,201902,9158,26408,7654,24041,748,2740,5209,16031,5957,18771
270235,201902,5877,18259,5124,17017,169,745,4141,13609,4310,14354
270240,201902,10433,28722,8550,26315,966,3278,6115,18762,7081,22040
270250,201902,2841,7357,2510,6904,228,603,1919,5311,2147,5914
270255,201902,4605,13273,3520,11259,167,688,2551,7980,2718,8668
270260,201902,5600,16766,5118,15979,116,583,4408,13372,4524,13955
270270,201902,1045,2785,897,2589,119,346,623,1785,742,2131
270280,201902,3857,9460,3089,8483,455,796,2156,6347,2611,7143
270290,201902,7724,24713,6956,23431,260,1183,5872,19522,6132,20705
270300,201902,4093,11091,3231,10144,185,593,2447,7812,2632,8405
270310,201902,7085,19908,6114,18483,146,758,5169,15192,5315,15950
270320,201902,5635,16534,4940,15232,565,1833,3422,10269,3987,12102
270330,201902,3795,12652,3414,12056,265,1105,2635,9229,2900,10334
270340,201902,1630,4583,1391,4261,61,196,1135,3452,1196,3648
270350,201902,1847,4543,1545,4176,183,536,1054,2886,1237,3422
270360,201902,2413,6349,2164,6063,64,188,1970,5529,2034,5717
270370,201902,1408,4392,1275,4136,46,199,1026,3283,1072,3482
270375,201902,3062,7317,2619,6809,20,62,2440,6337,2460,6399
270380,201902,5548,16319,4728,15212,441,1455,3295,10856,3736,12311
270390,201902,1207,3095,983,2820,26,135,805,2269,831,2404
270400,201902,6134,16697,5224,15271,236,772,4044,11566,4280,12338
270410,201902,4553,13500,3970,12533,204,768,3199,9964,3403,10732
270420,201902,5518,16593,5023,15875,185,817,4225,13076,4410,13893
270430,201902,136916,338727,109707,303646,22939,66333,50116,141037,73055,207370
270440,201902,4784,13143,4106,12300,106,491,3479,10268,3585,10759
270450,201902,6743,18728,6044,17885,276,1040,5041,14803,5317,15843
270460,201902,3719,8414,3247,7865,66,216,3005,7170,3071,7386
270470,201902,10856,31330,9544,29395,885,2893,6993,21614,7878,24507
270480,201902,2816,7750,2437,7178,140,544,1938,5514,2078,6058
270490,201902,962,2768,848,2627,48,180,669,2037,717,2217
270500,201902,4840,15102,4362,14399,229,960,3506,11408,3735,12368
270510,201902,5568,15385,4793,14325,426,1629,3485,9948,3911,11577
270520,201902,3930,11498,3136,10106,717,2370,1190,4045,1907,6415
270530,201902,1185,3548,1041,3318,62,184,761,2462,823,2646
270540,201902,2123,6367,1873,6040,62,301,1614,5096,1676,5397
270550,201902,6651,17745,5461,16425,530,1402,4140,12868,4670,14270
270560,201902,3075,8345,2722,7860,171,535,2122,6027,2293,6562
270570,201902,4028,11455,3428,10522,102,425,2809,8470,2911,8895
270580,201902,2284,6561,2082,6268,106,332,1785,5336,1891,5668
270590,201902,1613,4808,1488,4639,15,74,1406,4360,1421,4434
270600,201902,2738,8578,2474,8158,66,333,2161,7004,2227,7337
270610,201902,3691,9745,3139,9024,91,349,2774,7871,2865,8220
270620,201902,1237,3862,1140,3686,49,208,958,3009,1007,3217
270630,201902,16154,41892,14164,39066,763,2519,11567,31331,12330,33850
270640,201902,5422,15730,4721,14644,195,823,3777,11358,3972,12181
270642,201902,2434,7984,2174,7551,142,696,1683,5637,1825,6333
270644,201902,3502,8843,2883,8045,246,661,2172,6166,2418,6827
270650,201902,3177,9535,2839,9034,436,1574,1895,5827,2331,7401
270660,201902,2108,5253,1706,4690,75,295,1292,3464,1367,3759
270670,201902,15720,38091,13300,35152,567,1770,11041,28671,11608,30441
270680,201902,5220,13147,4683,12544,139,220,4349,11835,4488,12055
270690,201902,9057,22854,7558,20991,1007,2631,5358,15018,6365,17649
270700,201902,546,1645,476,1523,33,137,345,1088,378,1225
270710,201902,5635,17103,5132,16374,255,1130,4229,13163,4484,14293
270720,201902,3361,10238,2995,9623,75,440,2616,8191,2691,8631
270730,201902,7870,18335,7049,17427,308,749,5620,15021,5928,15770
270740,201902,2350,6275,2090,5952,104,365,1719,4787,1823,5152
270750,201902,5454,14920,4816,14075,159,643,4122,11933,4281,12576
270760,201902,3349,9493,2915,8898,66,332,2465,7418,2531,7750
270770,201902,21302,52160,16739,46589,3108,7966,9487,28220,12595,36186
270780,201902,1757,5189,1645,5033,93,320,1368,4144,1461,4464
270790,201902,1537,4517,1326,4206,107,358,891,2819,998,3177
270800,201902,10631,29694,9551,28180,385,1580,8134,23394,8519,24974
270810,201902,3239,9413,2555,8234,186,767,1752,5522,1938,6289
270820,201902,1680,5081,1417,4641,66,278,1108,3539,1174,3817
270830,201902,5304,12970,4337,11771,194,680,3452,9244,3646,9924
270840,201902,8166,24415,7345,23265,200,1080,6399,19708,6599,20788
270850,201902,8766,21737,7911,20663,558,1771,6598,16774,7156,18545
270860,201902,12283,29739,10139,27177,472,1562,8282,21725,8754,23287
270870,201902,2058,5982,1773,5488,217,715,1221,3809,1438,4524
270880,201902,8087,24398,7269,23190,253,1090,5989,18770,6242,19860
270890,201902,2629,7298,2285,6827,182,635,1615,4743,1797,5378
270895,201902,2892,9448,2683,9169,84,466,2364,7895,2448,8361
270900,201902,1783,4667,1358,3998,53,189,1054,3047,1107,3236
270910,201902,3802,11271,3272,10377,121,489,2555,7975,2676,8464
270915,201902,9112,27291,7540,24600,792,3053,4975,15800,5767,18853
270920,201902,5353,16761,4890,15979,237,1112,3963,12474,4200,13586
270930,201902,17144,41091,13513,36797,1903,4754,9184,25854,11087,30608
270940,201902,6138,17296,5390,16361,255,1174,4222,12402,4477,13576
280010,201902,687,1895,559,1625,20,84,382,999,402,1083
280020,201902,4665,12296,4015,11281,543,1444,2635,7479,3178,8923
280030,201902,72102,173514,56831,151973,13690,36920,23259,65053,36949,101973
280040,201902,3042,8606,2663,8039,295,921,1770,5297,2065,6218
280050,201902,3878,11181,3350,10305,532,1706,1986,6083,2518,7789
280060,201902,5336,14605,4320,13045,773,2428,2165,6776,2938,9204
280067,201902,6934,17663,5862,16020,385,1130,4199,11204,4584,12334
280070,201902,1899,5800,1781,5598,80,292,1491,4608,1571,4900
280100,201902,3769,10485,3201,9554,345,1083,2212,6581,2557,7664
280110,201902,1337,3735,1183,3489,21,108,1018,2921,1039,3029
280120,201902,7492,22186,6777,21013,714,2048,5071,15988,5785,18036
280130,201902,8819,21537,7742,19970,583,1589,5980,15360,6563,16949
280140,201902,5482,13506,4844,12646,240,670,4063,10519,4303,11189
280150,201902,3887,10094,3421,9476,209,590,2786,7651,2995,8241
280160,201902,1219,3573,1009,3210,131,438,624,1939,755,2377
280170,201902,5172,13742,4598,12969,245,680,3698,10412,3943,11092
280190,201902,1187,2736,1023,2508,55,151,817,1952,872,2103
280200,201902,1322,3498,1069,3091,109,400,727,2030,836,2430
280210,201902,15533,40456,13582,37677,1836,5397,8260,22889,10096,28286
280220,201902,1717,4662,1493,4372,36,189,1224,3558,1260,3747
280230,201902,3814,9926,3384,9305,257,669,2470,6748,2727,7417
280240,201902,3403,9120,3056,8602,68,337,2582,7064,2650,7401
280250,201902,797,2064,655,1849,77,239,387,1043,464,1282
280260,201902,2124,5237,1907,4964,41,112,1753,4574,1794,4686
280270,201902,2285,6540,2029,6138,126,466,1686,4960,1812,5426
280280,201902,3950,12411,3562,11854,487,1497,2430,8427,2917,9924
280290,201902,17062,46703,14892,43552,1526,4858,9920,29173,11446,34031
280300,201902,11029,27985,9569,26393,267,901,7530,21909,7797,22810
280310,201902,1322,3511,1108,3153,33,119,823,2262,856,2381
280320,201902,8505,23645,7380,21909,878,2656,4829,14170,5707,16826
280330,201902,4765,11954,4030,10878,261,731,3006,8037,3267,8768
280340,201902,5481,11418,4660,10522,235,456,4027,9181,4262,9637
280350,201902,24302,59354,21182,55048,1420,3953,16056,41121,17476,45074
280360,201902,5783,16558,5081,15347,881,2694,2832,8596,3713,11290
280370,201902,2200,5425,1808,4727,69,193,1449,3714,1518,3907
280380,201902,966,2729,840,2555,97,335,534,1606,631,1941
280390,201902,3525,9066,2914,8057,140,424,2272,6184,2412,6608
280400,201902,3915,10294,3374,9492,481,1273,2100,6102,2581,7375
280410,201902,2108,6051,1703,5337,181,613,1034,3169,1215,3782
280420,201902,4300,11658,3911,11136,99,357,3509,9936,3608,10293
280430,201902,2020,5083,1766,4738,80,315,1409,3660,1489,3975
280440,201902,4354,11863,3804,11021,205,700,3095,8742,3300,9442
280445,201902,2299,5911,2032,5435,59,197,1508,3837,1567,4034
280450,201902,10286,23685,9078,22091,389,765,7624,18683,8013,19448
280460,201902,6683,16369,6057,15484,475,1130,4921,12536,5396,13666
280470,201902,1748,4985,1502,4536,68,267,1103,3239,1171,3506
280480,201902,39008,97675,34248,91043,2907,8456,24582,64113,27489,72569
280490,201902,3750,10807,3226,9928,103,479,2450,7263,2553,7742
280500,201902,959,2338,815,2139,40,132,670,1742,710,1874
280510,201902,2550,6736,2200,6226,93,360,1667,4622,1760,4982
280520,201902,1613,4141,1421,3888,77,213,1142,3090,1219,3303
280530,201902,2684,6569,2305,6093,316,729,1621,4388,1937,5117
280540,201902,8949,24265,8168,23137,237,927,7129,19783,7366,20710
280550,201902,6699,15898,5449,14107,254,825,4317,10812,4571,11637
280560,201902,7041,20127,6607,19478,156,591,5747,16707,5903,17298
280570,201902,6345,15996,5161,14460,231,866,3772,10413,4003,11279
280580,201902,5436,15073,4685,13900,570,1596,3219,9697,3789,11293
280590,201902,2969,6974,2494,6399,139,547,1871,4529,2010,5076
280600,201902,3392,9391,3018,8831,188,625,2167,6310,2355,6935
280610,201902,2523,6334,2282,5993,172,432,1825,4755,1997,5187
280620,201902,5337,13596,4549,12516,420,1008,3245,9233,3665,10241
280630,201902,3768,10991,3417,10473,182,663,2738,8355,2920,9018
280640,201902,2446,6654,2203,6383,63,188,1969,5729,2032,5917
280650,201902,1235,3235,970,2836,73,239,701,1989,774,2228
280660,201902,3188,7508,2815,7063,88,247,2483,6162,2571,6409
280670,201902,19347,44334,16806,41064,1041,2724,13225,32094,14266,34818
280680,201902,2731,6779,2336,6181,194,422,1684,4450,1878,4872
280690,201902,946,2423,791,2202,36,112,590,1593,626,1705
280700,201902,1102,2854,949,2616,20,81,744,2013,764,2094
280710,201902,15041,34000,12809,31447,479,975,11061,27563,11540,28538
280720,201902,2672,6071,2156,5465,111,337,1455,3832,1566,4169
280730,201902,1062,2741,951,2566,70,225,721,1892,791,2117
280740,201902,14033,34831,11970,31677,981,2696,8307,21592,9288,24288
280750,201902,3511,10076,3104,9353,177,637,2234,6601,2411,7238
280760,201902,6123,17076,5409,15952,577,1672,3635,10974,4212,12646
290010,201902,3124,6657,2104,5049,9,31,1723,3946,1732,3977
290020,201902,5382,14448,4938,13844,375,762,4128,11901,4503,12663
290030,201902,4227,10347,3535,9559,180,452,2953,8046,3133,8498
290035,201902,5201,11569,4195,10266,323,551,3323,8479,3646,9030
290040,201902,4257,10460,3613,9676,133,385,2831,7829,2964,8214
290050,201902,2096,6720,1746,5979,136,560,1188,3962,1324,4522
290060,201902,1296,3206,967,2654,89,316,649,1699,738,2015
290070,201902,34691,79657,29938,73603,2194,5621,21997,53726,24191,59347
290080,201902,5361,16034,4557,14826,508,1769,3097,10159,3605,11928
290090,201902,2199,4239,1582,3576,34,88,1423,3183,1457,3271
290100,201902,9757,26190,8080,23665,1088,3019,4769,14388,5857,17407
290110,201902,5082,13838,4580,12955,417,1203,3232,9075,3649,10278
290115,201902,4177,12224,3556,11175,231,821,2658,8263,2889,9084
290120,201902,6645,16475,5508,15030,137,490,4761,12772,4898,13262
290130,201902,4566,11285,3644,10128,123,460,2921,8004,3044,8464
290135,201902,4276,10194,3488,8911,226,592,2628,6530,2854,7122
290140,201902,4642,12502,3700,11247,117,443,3145,9485,3262,9928
290150,201902,2445,6585,2138,6192,167,532,1605,4598,1772,5130
290160,201902,3108,7525,2815,7146,288,653,2175,5559,2463,6212
290170,201902,3212,8529,2857,8117,109,359,2548,7240,2657,7599
290180,201902,2957,8082,2441,7279,88,315,1959,5775,2047,6090
290190,201902,4119,11967,3639,11310,160,660,2956,9039,3116,9699
290195,201902,2306,5884,1843,5217,39,174,1509,4233,1548,4407
290200,201902,4009,11330,3328,10214,231,775,2537,7727,2768,8502
290205,201902,3411,8850,3011,8266,152,578,2361,6250,2513,6828
290210,201902,13118,37142,11675,35002,976,2619,8899,27428,9875,30047
290220,201902,2753,7121,2477,6776,179,525,1976,5343,2155,5868
290225,201902,3478,7341,2768,6579,29,99,2512,5866,2541,5965
290230,201902,2444,6633,2223,6374,43,160,1969,5624,2012,5784
290240,201902,3615,9251,2967,8418,118,384,2442,6886,2560,7270
290250,201902,4052,11830,3514,11066,146,483,2862,9234,3008,9717
290260,201902,5376,13541,4425,12174,212,746,3564,9563,3776,10309
290265,201902,3602,10568,2926,9274,152,572,2164,6762,2316,7334
290270,201902,11283,38656,10671,37593,611,2702,8515,29561,9126,32263
290280,201902,6039,18199,5233,16641,355,1319,3758,11762,4113,13081
290290,201902,10051,29682,8264,26337,816,2840,5565,17552,6381,20392
290300,201902,4233,11643,3153,9611,174,596,2225,6775,2399,7371
290310,201902,1494,3893,1255,3578,85,327,940,2598,1025,2925
290320,201902,23791,64184,19449,57505,4501,13309,9303,28694,13804,42003
290323,201902,3734,10207,3279,9531,79,277,2663,7670,2742,7947
290327,201902,4235,12271,3623,11115,281,846,2559,7822,2840,8668
290330,201902,2079,4495,1666,4039,45,104,1469,3555,1514,3659
290340,201902,5629,14879,4460,13401,518,1643,3185,9668,3703,11311
290350,201902,4619,13045,3847,11727,307,1002,2736,8334,3043,9336
290360,201902,5003,13356,4380,12530,131,403,3771,10774,3902,11177
290370,201902,5323,13046,3974,11305,198,499,2969,8603,3167,9102
290380,201902,5570,15016,4762,13896,118,366,4149,12189,4267,12555
290390,201902,14029,40245,11995,37216,1253,3913,8205,25823,9458,29736
290395,201902,2738,8207,2294,7436,65,313,1794,5745,1859,6058
290400,201902,3586,9889,2911,8789,99,409,2207,6505,2306,6914
290405,201902,4626,13651,3889,12362,261,902,2757,8871,3018,9773
290410,201902,5671,15793,4467,13805,119,568,3418,10206,3537,10774
290420,201902,2975,8451,2443,7598,102,364,1898,5873,2000,6237
290430,201902,3068,8681,2540,7838,289,925,1652,5082,1941,6007
290440,201902,2736,7032,2016,5889,47,155,1459,4314,1506,4469
290450,201902,3262,8757,2658,7874,153,525,2034,5951,2187,6476
290460,201902,11558,32655,9983,29704,2203,6654,4624,13742,6827,20396
290470,201902,4385,11240,3260,9648,352,1164,1865,5562,2217,6726
290475,201902,6392,18723,5429,16981,108,559,4409,13451,4517,14010
290480,201902,1729,4517,1473,4135,122,379,976,2604,1098,2983
290485,201902,4473,13318,3970,12567,120,636,3371,10425,3491,11061
290490,201902,9013,21623,8062,20331,521,1245,6317,16058,6838,17303
290500,201902,3920,11949,3045,10053,517,1786,1406,4529,1923,6315
290510,201902,3348,8646,2835,7971,85,305,2431,6729,2516,7034
290515,201902,3759,10134,3181,9410,66,201,2797,8451,2863,8652
290520,201902,11060,32309,8606,27519,463,1735,5497,17248,5960,18983
290530,201902,4964,14234,4257,13071,151,545,3531,10826,3682,11371
290540,201902,3561,9519,3197,9075,74,270,2915,8218,2989,8488
290550,201902,4343,11317,3807,10688,23,88,3525,10001,3548,10089
290560,201902,6553,17223,5083,15025,468,1671,3355,9606,3823,11277
290570,201902,42746,107961,38722,102827,2742,7608,30904,81539,33646,89147
290580,201902,7813,23461,6855,22062,648,2078,5025,16510,5673,18588
290590,201902,6964,21714,5983,19962,160,680,4858,16190,5018,16870
290600,201902,18234,51704,16431,48899,695,2278,13193,39161,13888,41439
290610,201902,2480,7958,1989,6946,105,443,1378,4727,1483,5170
290620,201902,6597,18473,5710,16997,213,644,4762,14095,4975,14739
290630,201902,8972,22130,7211,19836,607,1668,5566,15375,6173,17043
290640,201902,2744,7230,2088,6233,84,265,1544,4601,1628,4866
290650,201902,12295,32247,11115,30791,2877,7541,6201,18305,9078,25846
290660,201902,3662,9467,3083,8632,59,157,2331,6781,2390,6938
290670,201902,6593,18788,5695,17322,442,1308,4352,13385,4794,14693
290680,201902,10457,29571,8992,27411,228,1178,7332,21775,7560,22953
290682,201902,4557,12169,4022,11407,142,362,3397,9677,3539,10039
290685,201902,3573,8049,2385,6399,185,469,1527,4340,1712,4809
290687,201902,6628,18305,5341,16181,731,2173,3340,10413,4071,12586
290689,201902,2770,7952,2271,7081,132,451,1676,5229,1808,5680
290690,201902,5631,14772,4586,13308,437,1287,3199,9224,3636,10511
290700,201902,2628,7282,2345,6904,88,307,1934,5703,2022,6010
290710,201902,8536,24142,7242,22354,190,782,6124,18780,6314,19562
290720,201902,18836,51573,17285,49279,928,3011,13981,39406,14909,42417
290730,201902,7119,17464,6077,16235,265,640,4758,12740,5023,13380
290740,201902,1057,2912,803,2469,39,154,611,1874,650,2028
290750,201902,10722,27858,9317,25426,847,2465,6564,17412,7411,19877
290755,201902,2096,5925,1691,5181,95,310,1203,3684,1298,3994
290760,201902,3839,11250,3057,9750,268,794,1938,6400,2206,7194
290770,201902,2596,8485,2367,8201,56,284,1979,6918,2035,7202
290780,201902,8277,20707,7136,19166,323,741,5671,15420,5994,16161
290790,201902,4569,12622,3993,11849,141,459,3388,10124,3529,10583
290800,201902,7274,15161,5240,12811,349,805,3877,9619,4226,10424
290810,201902,5586,15060,4491,13388,115,431,3349,10016,3464,10447
290820,201902,5040,13570,4496,12744,232,715,3315,9475,3547,10190
290830,201902,4584,10574,4098,9938,58,178,3543,8448,3601,8626
290840,201902,16498,45086,14479,41952,1770,4428,9574,29076,11344,33504
290850,201902,6330,16008,5739,15352,337,785,4801,13121,5138,13906
290860,201902,5822,17461,5089,16581,225,814,4291,14187,4516,15001
290870,201902,4823,13353,3702,11317,119,418,2648,8012,2767,8430
290880,201902,1399,3552,1099,3146,76,209,764,2237,840,2446
290890,201902,8591,18284,7738,17289,181,452,7177,15923,7358,16375
290900,201902,2316,6179,1772,5257,106,311,1143,3332,1249,3643
290910,201902,5050,12484,3917,10763,50,202,3225,8728,3275,8930
290920,201902,5121,12687,4705,12190,58,127,4421,11486,4479,11613
290930,201902,7878,22225,6408,19657,206,939,5086,15122,5292,16061
290940,201902,3662,10380,3058,9517,166,615,2429,7568,2595,8183
290950,201902,1468,3763,1226,3413,61,168,890,2487,951,2655
290960,201902,5355,14487,4812,13805,138,440,4080,11674,4218,12114
290970,201902,3514,10241,2891,9175,154,527,2192,6924,2346,7451
290980,201902,11396,28349,9603,25541,919,2631,5785,14995,6704,17626
290990,201902,9205,25214,8091,23387,344,1332,6608,18492,6952,19824
291000,201902,3360,9023,2680,8169,209,584,2076,6461,2285,7045
291005,201902,14896,36810,13233,34676,822,2207,10816,28176,11638,30383
291010,201902,3005,9142,2430,7942,140,506,1609,5152,1749,5658
291020,201902,1269,3202,1015,2718,28,95,722,1833,750,1928
291030,201902,2388,5985,1660,4679,92,266,1081,2947,1173,3213
291040,201902,5239,14894,4513,13862,195,820,3576,10828,3771,11648
291050,201902,7257,19888,6285,18475,847,2731,4210,12187,5057,14918
291060,201902,5745,18670,4994,17592,401,1742,3675,12789,4076,14531
291070,201902,15629,42794,13182,39005,516,1858,10639,31188,11155,33046
291072,201902,23478,62403,17238,51067,3503,10792,6970,20885,10473,31677
291075,201902,5122,13410,4550,12483,125,387,3719,9990,3844,10377
291077,201902,1578,4159,1242,3558,51,150,871,2491,922,2641
291080,201902,84518,228492,69377,205989,25377,77102,13934,44520,39311,121622
291085,201902,5709,14521,4766,13129,182,565,4009,10949,4191,11514
291090,201902,1938,3753,1433,3193,32,93,1207,2640,1239,2733
291100,201902,3131,6971,2156,5794,121,391,1641,4316,1762,4707
291110,201902,5823,17830,5003,16402,376,1534,3702,11670,4078,13204
291120,201902,7759,19269,6654,17814,390,1132,4996,13340,5386,14472
291125,201902,2155,3821,1574,3176,127,186,1188,2497,1315,2683
291130,201902,3126,9192,2388,7742,88,416,1710,5355,1798,5771
291140,201902,4694,13025,3511,10794,414,1125,2252,6995,2666,8120
291150,201902,2223,5118,1860,4702,18,51,1732,4364,1750,4415
291160,201902,4984,14106,4222,12989,374,1261,2858,8683,3232,9944
291165,201902,2159,5991,1679,5086,37,151,1245,3648,1282,3799
291170,201902,20497,52501,17328,47268,1009,3013,11379,30722,12388,33735
291180,201902,5780,14067,4502,12244,434,1154,3295,9028,3729,10182
291185,201902,3177,8736,2765,8044,81,268,2148,6193,2229,6461
291190,201902,7624,19069,6340,17340,360,1064,4945,13497,5305,14561
291200,201902,2876,8046,2137,6640,91,301,1316,4027,1407,4328
291210,201902,6860,15217,5291,13371,171,545,3956,9978,4127,10523
291220,201902,3985,11590,3599,10992,232,832,2787,8421,3019,9253
291230,201902,4442,9750,3432,8636,76,169,3048,7765,3124,7934
291240,201902,4203,10969,3666,10065,64,221,3146,8510,3210,8731
291250,201902,3418,10148,2691,8830,176,586,1757,5793,1933,6379
291260,201902,1384,3271,1187,3019,32,99,978,2505,1010,2604
291270,201902,4982,13841,4049,12384,681,2041,2557,7974,3238,10015
291280,201902,2427,6356,1836,5420,170,579,1092,3107,1262,3686
291290,201902,5859,15705,4667,13840,428,1341,3138,9260,3566,10601
291300,201902,3937,10695,2961,9065,141,463,2182,6630,2323,7093
291310,201902,5036,13722,4341,12410,127,448,3614,10122,3741,10570
291320,201902,5964,17260,4694,14783,1103,3246,2272,7520,3375,10766
291330,201902,1812,4623,1528,4146,75,205,1127,2977,1202,3182
291340,201902,4135,10878,3474,9776,82,297,2697,7440,2779,7737
291345,201902,2983,9167,2735,8782,125,434,2239,7211,2364,7645
291350,201902,6768,17243,5268,15307,93,289,4477,13216,4570,13505
291360,201902,34598,83516,27908,75086,3431,9507,17101,46972,20532,56479
291370,201902,7847,21713,7068,20580,490,1594,5349,15397,5839,16991
291380,201902,3300,9491,2965,8978,104,455,2460,7300,2564,7755
291390,201902,12787,28738,10161,25782,432,1162,8289,20961,8721,22123
291400,201902,13615,36206,11477,32978,1645,4292,6879,21129,8524,25421
291410,201902,2883,7624,2201,6482,56,250,1630,4671,1686,4921
291420,201902,1904,4788,1531,4324,46,199,1304,3634,1350,3833
291430,201902,2935,8270,2539,7644,98,431,2024,5921,2122,6352
291440,201902,6355,18500,5468,17020,308,1058,4335,13505,4643,14563
291450,201902,8665,22508,7282,20887,133,264,6369,18838,6502,19102
291460,201902,15007,40869,13223,38184,754,2414,9878,28355,10632,30769
291465,201902,8822,22734,7096,20713,222,975,5937,17159,6159,18134
291470,201902,15309,36457,13068,33912,633,1593,9806,26129,10439,27722
291480,201902,39711,90205,29381,76111,3794,10380,15417,39915,19211,50295
291490,201902,5288,13747,4645,12947,177,579,4117,11427,4294,12006
291500,201902,5032,12404,4202,11277,61,265,3800,10128,3861,10393
291510,201902,3835,10251,2994,9112,90,434,2391,7234,2481,7668
291520,201902,4387,10280,3399,8973,162,458,2578,6783,2740,7241
291530,201902,2211,5275,1613,4472,290,727,953,2867,1243,3594
291535,201902,3092,9466,2870,9091,171,524,2230,7174,2401,7698
291540,201902,2265,5148,1607,4363,56,221,1337,3513,1393,3734
291550,201902,5416,12735,4258,11207,403,955,2856,7642,3259,8597
291560,201902,19265,44228,13498,37121,1007,2625,8999,25821,10006,28446
291570,201902,2325,5586,1865,5014,72,168,1534,4235,1606,4403
291580,201902,6148,16452,4850,14680,286,985,3536,10513,3822,11498
291590,201902,1866,5094,1674,4828,129,404,1353,3851,1482,4255
291600,201902,5104,12806,3831,10798,489,1515,2352,6416,2841,7931
291610,201902,5589,15361,5211,14942,80,308,4833,13826,4913,14134
291620,201902,3200,7101,2314,6114,117,318,1760,4745,1877,5063
291630,201902,3242,7495,2415,6418,187,596,1844,4802,2031,5398
291640,201902,15246,39135,11680,33819,1883,5325,4971,15212,6854,20537
291650,201902,8940,23516,7904,22228,454,1038,6677,19078,7131,20116
291660,201902,2050,5043,1508,4193,130,434,1010,2659,1140,3093
291670,201902,2048,5400,1736,4970,105,268,1348,3912,1453,4180
291680,201902,4040,10263,3291,9123,295,871,2383,6511,2678,7382
291685,201902,4664,11337,3723,10126,252,533,2823,7994,3075,8527
291690,201902,4217,9488,2903,7604,179,442,2245,5826,2424,6268
291700,201902,8508,25023,7592,23413,432,1527,6169,18752,6601,20279
291710,201902,5169,12735,3875,10900,289,916,2724,7502,3013,8418
291720,201902,4334,13515,3645,12113,421,1523,2383,7715,2804,9238
291730,201902,6320,16685,5457,15542,247,814,4503,12760,4750,13574
291733,201902,2897,7520,2447,6910,63,224,1817,5344,1880,5568
291735,201902,2973,7699,2421,6813,78,224,1933,5409,2011,5633
291740,201902,3820,9949,2935,8428,98,301,2221,6281,2319,6582
291750,201902,19463,47419,15812,41962,1627,4377,10478,27896,12105,32273
291760,201902,10202,30359,8124,26862,2592,9692,2115,7008,4707,16700
291770,201902,6962,19377,5817,17294,465,1484,4172,12126,4637,13610
291780,201902,5013,13574,4531,12873,106,396,3937,11039,4043,11435
291790,201902,2629,7560,2424,7286,254,679,1811,5555,2065,6234
291800,201902,28720,74179,22095,64072,3378,9465,11806,35312,15184,44777
291810,201902,10468,25606,8785,23505,237,759,7611,20182,7848,20941
291820,201902,3768,10134,3300,9477,108,362,2613,7522,2721,7884
291830,201902,4194,10327,3577,9465,212,533,2877,7650,3089,8183
291835,201902,6303,18994,4923,16285,728,2479,2861,9688,3589,12167
291840,201902,46320,128410,40238,119631,4743,14654,27667,82693,32410,97347
291845,201902,2396,6498,1966,5971,101,325,1610,4931,1711,5256
291850,201902,3997,11485,3297,10309,280,814,2360,7591,2640,8405
291855,201902,2135,4379,1691,3862,53,139,1496,3398,1549,3537
291860,201902,2252,5938,1562,4611,36,122,1064,3023,1100,3145
291870,201902,1311,3318,881,2567,53,163,588,1657,641,1820
291875,201902,2662,8074,2347,7451,98,378,1795,5540,1893,5918
291880,201902,5516,16099,4772,14785,299,950,3478,10778,3777,11728
291890,201902,1547,3302,1006,2660,157,387,650,1708,807,2095
291900,201902,1182,3005,914,2572,21,81,729,1993,750,2074
291905,201902,2652,6665,2070,5726,86,295,1557,4181,1643,4476
291910,201902,2819,7311,2397,6801,73,252,2063,5843,2136,6095
291915,201902,7230,20904,5986,18771,218,837,4548,14242,4766,15079
291920,201902,25086,68134,21813,63579,2626,8195,14535,41746,17161,49941
291930,201902,2419,6809,2081,6280,253,821,1358,4044,1611,4865
291940,201902,3780,9936,2537,7792,232,698,1470,4450,1702,5148
291950,201902,8974,27485,7716,25037,455,1690,5180,16700,5635,18390
291955,201902,14276,36760,12890,34966,1228,3388,9989,27374,11217,30762
291960,201902,3124,8408,2537,7580,146,456,1934,5890,2080,6346
291970,201902,4234,11306,3654,10520,191,677,2733,7842,2924,8519
291980,201902,10096,28719,7987,25389,675,2081,5386,17366,6061,19447
291990,201902,2124,5673,1862,5378,21,101,1768,5093,1789,5194
291992,201902,4185,10203,3141,8768,269,672,2434,6900,2703,7572
291995,201902,2155,5850,1738,5234,58,279,1373,4022,1431,4301
292000,201902,2574,6286,2076,5657,128,469,1560,4173,1688,4642
292010,201902,5992,13988,4917,12484,215,642,4048,10086,4263,10728
292020,201902,4511,13333,3792,12058,244,885,2757,8525,3001,9410
292030,201902,1712,5433,1638,5306,76,301,1048,3283,1124,3584
292040,201902,4248,11176,3424,9973,248,676,2648,7887,2896,8563
292045,201902,3967,10566,2953,9051,51,133,2587,8083,2638,8216
292050,201902,6459,18462,5184,16080,314,1104,3263,9984,3577,11088
292060,201902,11979,27734,11118,26676,602,1403,9567,22682,10169,24085
292070,201902,5700,15119,5019,14281,278,853,4318,12210,4596,13063
292080,201902,3198,8105,2640,7399,94,293,2315,6489,2409,6782
292090,201902,4533,9921,3282,8446,248,640,2515,6570,2763,7210
292100,201902,10265,26020,8772,24083,1130,3262,5606,15304,6736,18566
292105,201902,3339,8743,2955,8178,83,274,2419,6627,2502,6901
292110,201902,6066,15304,4339,12439,1011,2948,1978,5679,2989,8627
292120,201902,6811,17822,5564,15676,412,1209,4119,11412,4531,12621
292130,201902,3352,8175,2736,7423,140,417,2109,5672,2249,6089
292140,201902,5102,12144,4235,10893,279,658,3384,8722,3663,9380
292145,201902,2306,6860,1946,6204,75,258,1459,4672,1534,4930
292150,201902,13272,37226,11831,34989,284,1231,9840,28634,10124,29865
292160,201902,2865,7270,2237,6456,66,210,1848,5425,1914,5635
292170,201902,8117,22055,6795,19837,481,1530,4884,14075,5365,15605
292180,201902,2798,7688,2042,6351,246,736,1231,3801,1477,4537
292190,201902,2878,7702,2464,7091,164,476,1825,5306,1989,5782
292200,201902,7744,20354,5912,17640,1021,3126,3198,9727,4219,12853
292205,201902,3866,10759,3338,9979,63,303,2919,8620,2982,8923
292210,201902,6214,14992,5097,13543,91,405,4531,11848,4622,12253
292220,201902,2055,5129,1817,4772,71,211,1414,3628,1485,3839
292225,201902,3175,9341,2819,8808,72,301,2377,7318,2449,7619
292230,201902,8365,20212,7490,19071,178,635,6374,15890,6552,16525
292240,201902,4806,13982,4141,12740,354,1070,2784,8580,3138,9650
292250,201902,5176,14314,4670,13517,577,1572,3122,9196,3699,10768
292260,201902,3289,8840,2946,8401,121,332,2550,7329,2671,7661
292265,201902,3330,9336,2819,8538,78,377,2198,6498,2276,6875
292270,201902,4224,9946,3384,8937,193,543,2726,7211,2919,7754
292273,201902,2607,5739,2092,5108,58,105,1597,4089,1655,4194
292275,201902,1642,4322,1314,3861,58,142,998,2990,1056,3132
292280,201902,2582,6199,2101,5653,101,236,1741,4827,1842,5063
292285,201902,2517,6199,1990,5460,92,231,1567,4346,1659,4577
292290,201902,7048,19465,5783,17601,182,700,4724,14326,4906,15026
292300,201902,9996,26076,7920,23387,871,2790,5260,15544,6131,18334
292303,201902,2856,8289,2520,7761,72,190,2151,6672,2223,6862
292305,201902,2477,6624,2294,6366,44,217,2034,5519,2078,5736
292310,201902,6607,17156,5679,16017,187,623,4840,13559,5027,14182
292320,201902,6176,16917,5008,14744,281,906,3709,10650,3990,11556
292330,201902,2747,6118,2146,5441,109,258,1658,4306,1767,4564
292335,201902,4710,12299,4210,11583,281,709,3491,9695,3772,10404
292340,201902,5755,16096,4866,14404,228,746,3658,10642,3886,11388
292350,201902,2517,6775,2067,6173,86,327,1695,5060,1781,5387
292360,201902,4878,13118,4111,11787,321,1034,2846,7940,3167,8974
292370,201902,10970,25103,9522,23164,138,488,8760,20867,8898,21355
292380,201902,6793,19213,6088,17965,417,1254,4618,13525,5035,14779
292390,201902,4348,8584,3170,7210,100,228,2775,6301,2875,6529
292400,201902,21606,63155,18981,58832,1843,6076,13188,40747,15031,46823
292405,201902,4306,10652,3559,9569,154,399,2880,7718,3034,8117
292410,201902,2128,5167,1838,4804,55,167,1616,4213,1671,4380
292420,201902,3619,11037,3307,10529,156,712,2756,8582,2912,9294
292430,201902,4732,14394,3663,12486,309,1130,2410,8230,2719,9360
292440,201902,8432,27012,7784,26012,124,630,7009,23377,7133,24007
292450,201902,3787,11190,3093,9806,120,449,2394,7570,2514,8019
292460,201902,4799,13477,3967,12050,371,1075,2810,8561,3181,9636
292465,201902,2560,6792,2125,6203,91,229,1473,4557,1564,4786
292467,201902,1783,5144,1607,4910,221,627,1109,3504,1330,4131
292470,201902,2963,7564,2317,6541,70,164,1813,5126,1883,5290
292480,201902,6421,15341,5153,13801,78,293,4608,12161,4686,12454
292490,201902,2096,5577,1748,5062,105,303,1329,3891,1434,4194
292500,201902,6415,17970,5258,15859,574,1782,3446,10322,4020,12104
292510,201902,12403,33937,9947,30225,543,1987,7266,22015,7809,24002
292520,201902,6698,17004,5943,15903,616,1687,4374,11682,4990,13369
292525,201902,5727,13741,4739,12600,116,320,4146,11079,4262,11399
292530,201902,26193,71148,20711,61916,5638,17077,7407,22956,13045,40033
292540,201902,4065,8016,3225,7105,117,220,2837,6262,2954,6482
292550,201902,7793,21472,6096,19335,416,1451,4504,14651,4920,16102
292560,201902,4260,10910,3651,10061,90,321,3013,8257,3103,8578
292570,201902,3820,9974,3262,9079,64,226,2856,7821,2920,8047
292575,201902,6885,20226,6374,19544,263,873,5299,16253,5562,17126
292580,201902,7428,19093,6296,17421,165,542,5271,14468,5436,15010
292590,201902,7403,19677,6433,18121,275,873,5434,14989,5709,15862
292593,201902,2818,6979,2357,6218,79,193,1944,5108,2023,5301
292595,201902,5360,14241,4650,13378,176,604,3889,11040,4065,11644
292600,201902,10934,29882,9453,27671,413,1138,7450,21895,7863,23033
292610,201902,4257,11210,3578,10040,225,552,2573,7363,2798,7915
292620,201902,6357,17719,5386,16583,79,199,5063,15770,5142,15969
292630,201902,8577,21154,7005,18650,559,1490,4808,12825,5367,14315
292640,201902,8106,24303,7112,22679,222,972,5121,16322,5343,17294
292650,201902,4582,11245,4135,10664,142,415,3718,9444,3860,9859
292660,201902,11012,30332,9473,28079,475,1558,7402,21855,7877,23413
292665,201902,2171,6502,1940,6213,76,243,1656,5391,1732,5634
292670,201902,3555,9646,2730,8109,125,426,1876,5484,2001,5910
292680,201902,3941,10696,3172,9268,187,561,2306,6571,2493,7132
292690,201902,2597,6883,1843,5634,176,510,1132,3619,1308,4129
292700,201902,9775,26894,8495,24941,817,2328,5777,17410,6594,19738
292710,201902,2429,7694,2247,7449,51,197,2015,6723,2066,6920
292720,201902,9212,22195,7744,20550,281,739,6248,16763,6529,17502
292730,201902,4373,10466,4113,10149,198,343,3591,8985,3789,9328
292740,201902,317731,792812,283097,741581,44856,119028,171946,447708,216802,566736
292750,201902,6219,16692,5394,15485,288,860,4083,11822,4371,12682
292760,201902,3818,11173,3367,10384,252,835,2454,7530,2706,8365
292770,201902,5907,16108,4793,14483,758,2407,2910,9084,3668,11491
292780,201902,1986,4151,1481,3498,45,147,1181,2654,1226,2801
292790,201902,4100,8781,3184,7789,143,389,2727,6642,2870,7031
292800,201902,10896,27594,9443,25381,364,1022,7820,20781,8184,21803
292805,201902,3421,8514,2690,7525,172,455,2026,5693,2198,6148
292810,201902,10473,28205,8306,24856,248,991,6210,18168,6458,19159
292820,201902,7423,20505,5403,17262,510,1768,3675,11538,4185,13306
292830,201902,2867,6748,2449,6229,78,253,2130,5369,2208,5622
292840,201902,8791,23185,7653,21649,179,666,6614,18274,6793,18940
292850,201902,2513,6804,2099,6159,140,464,1462,4171,1602,4635
292860,201902,16466,37829,14750,35701,704,1727,12224,29352,12928,31079
292870,201902,17049,43861,14863,40777,1069,3251,9878,26748,10947,29999
292880,201902,11155,30534,9666,28345,339,1424,7558,21390,7897,22814
292890,201902,6425,18513,5708,17406,260,1008,4781,14424,5041,15432
292895,201902,2982,6525,2172,5303,95,238,1707,4121,1802,4359
292900,201902,2638,7283,2435,6962,59,255,1973,5469,2032,5724
292905,201902,4266,11502,3364,10140,191,677,2411,7173,2602,7850
292910,201902,4910,13593,4479,12930,259,847,3375,9633,3634,10480
292920,201902,9754,27021,9180,26223,286,1100,7966,22315,8252,23415
292925,201902,5340,15266,4621,14022,243,761,3418,10204,3661,10965
292930,201902,6444,19450,5564,17730,504,1873,3462,10688,3966,12561
292935,201902,2308,6039,1801,5468,40,210,1592,4826,1632,5036
292937,201902,3084,7408,2696,6945,67,195,2407,6200,2474,6395
292940,201902,2991,7676,2418,6797,180,416,1740,5039,1920,5455
292950,201902,9710,25132,8536,23349,476,1278,6436,17407,6912,18685
292960,201902,5230,12697,4453,11625,116,344,3584,9153,3700,9497
292970,201902,3816,11214,3342,10497,116,519,2765,8670,2881,9189
292975,201902,4459,9757,3953,9183,179,345,3525,8281,3704,8626
292980,201902,3302,8076,2639,7070,105,332,2102,5535,2207,5867
292990,201902,11292,31122,9555,28060,693,2212,7066,20547,7759,22759
293000,201902,2526,6148,2210,5708,38,146,1758,4561,1796,4707
293010,201902,18033,46768,14666,41401,1972,5784,8969,25191,10941,30975
293015,201902,7858,24725,6287,21606,464,1951,4265,14557,4729,16508
293020,201902,9718,28688,8818,27416,144,676,7822,24564,7966,25240
293030,201902,5350,14479,4091,12523,119,406,2792,8788,2911,9194
293040,201902,3908,11035,3402,10339,92,351,2953,8937,3045,9288
293050,201902,21580,53984,19199,50595,1268,3479,14212,37194,15480,40673
293060,201902,3491,9233,2852,8138,202,624,2070,5777,2272,6401
293070,201902,24656,61148,20946,56208,2710,7462,13722,37264,16432,44726
293075,201902,3303,10677,2934,10072,204,842,2313,7911,2517,8753
293076,201902,3577,8940,3189,8453,94,253,2724,7279,2818,7532
293077,201902,6007,16943,4856,15177,458,1488,3154,10163,3612,11651
293080,201902,4834,14310,4192,13230,124,556,3336,10297,3460,10853
293090,201902,3170,9339,2457,8159,251,880,1587,5272,1838,6152
293100,201902,5710,15505,4612,13543,277,848,3564,10367,3841,11215
293105,201902,3633,11563,3192,10684,211,750,2331,7708,2542,8458
293110,201902,2464,6117,2089,5605,70,285,1739,4507,1809,4792
293120,201902,4315,11909,3852,11169,119,314,3203,9305,3322,9619
293130,201902,3776,10489,3343,9927,90,376,2871,8428,2961,8804
293135,201902,28773,69505,21383,59294,3800,11563,9539,26602,13339,38165
293140,201902,2327,5388,2020,5003,79,207,1678,4121,1757,4328
293150,201902,5382,16370,4465,14638,421,1452,3031,9950,3452,11402
293160,201902,3861,9516,3295,8864,251,462,2700,7612,2951,8074
293170,201902,4410,9953,3835,9197,102,279,3251,7682,3353,7961
293180,201902,4557,12551,3742,11162,121,524,2998,8686,3119,9210
293190,201902,13978,38603,12224,36094,222,974,10648,31198,10870,32172
293200,201902,7961,20116,6609,18054,228,878,5249,14021,5477,14899
293210,201902,5220,13834,4413,12555,309,860,3363,9577,3672,10437
293220,201902,4910,13182,3702,11082,851,2577,1482,4603,2333,7180
293230,201902,3860,10140,2903,8743,255,849,1955,5961,2210,6810
293240,201902,4392,11713,3565,10357,91,254,2726,8126,2817,8380
293245,201902,3865,10499,3492,9974,174,531,2956,8352,3130,8883
293250,201902,5539,13534,4726,12428,243,657,3830,10058,4073,10715
293260,201902,4390,12243,3627,11056,108,355,2575,7809,2683,8164
293270,201902,6878,15837,5556,14409,471,813,4304,11870,4775,12683
293280,201902,4791,12658,4114,11725,257,647,3178,9115,3435,9762
293290,201902,13357,40843,11965,38619,2292,7353,6879,22911,9171,30264
293300,201902,5886,14239,5019,13005,319,770,3665,9624,3984,10394
293305,201902,3993,9998,3530,9389,47,141,3143,8314,3190,8455
293310,201902,2113,5482,1739,4853,71,215,1336,3665,1407,3880
293315,201902,4108,10026,3355,8879,168,425,2708,7140,2876,7565
293317,201902,2489,6206,2191,5766,145,315,1701,4514,1846,4829
293320,201902,10735,27710,9902,26732,387,1097,8655,23315,9042,24412
293325,201902,1694,4366,1350,3876,186,545,869,2512,1055,3057
293330,201902,43956,135192,37698,124015,8466,28172,16696,56444,25162,84616
293340,201902,2344,6571,1908,5830,120,425,1294,3902,1414,4327
293345,201902,3290,9245,2689,8356,306,721,1885,6265,2191,6986
293350,201902,6723,19105,5932,18222,62,242,5466,17064,5528,17306
293360,201902,15132,39147,12964,36356,454,1689,11245,31048,11699,32737
310010,201902,839,2014,579,1639,61,208,266,700,327,908
310020,201902,2297,6580,1683,5447,363,1303,287,868,650,2171
310030,201902,2016,5884,1574,5089,236,844,968,3024,1204,3868
310040,201902,942,2478,767,2188,39,151,533,1444,572,1595
310050,201902,1555,4834,1366,4518,187,760,805,2563,992,3323
310060,201902,3252,9299,2838,8766,136,582,2323,7059,2459,7641
310070,201902,359,811,244,637,7,18,185,477,192,495
310080,201902,807,2200,542,1655,76,263,217,614,293,877
310090,201902,4474,12318,3670,10974,304,1005,2635,7716,2939,8721
310100,201902,3250,9296,2757,8468,110,484,2201,6534,2311,7018
310110,201902,4746,12785,3746,11021,785,2530,1652,4653,2437,7183
310120,201902,633,1580,397,1182,65,236,209,547,274,783
310130,201902,368,1013,313,926,41,156,202,550,243,706
310140,201902,225,705,164,589,33,138,50,151,83,289
310150,201902,4767,13328,3633,11189,623,2138,1498,4437,2121,6575
310160,201902,7019,18563,5208,15551,1185,3907,1642,4827,2827,8734
310163,201902,981,2904,782,2539,230,839,223,645,453,1484
310170,201902,8904,23384,7257,20805,705,2080,5102,14617,5807,16697
310180,201902,1697,4370,1292,3703,109,393,887,2430,996,2823
310190,201902,2846,8730,2297,7661,551,2047,324,1011,875,3058
310200,201902,1735,5301,1291,4397,241,915,518,1727,759,2642
310205,201902,1056,2938,782,2498,170,610,284,886,454,1496
310210,201902,2664,7070,2180,6274,100,284,1669,4759,1769,5043
310220,201902,1105,3049,877,2656,94,321,604,1771,698,2092
310230,201902,2261,6492,1849,5691,226,819,1104,3168,1330,3987
310240,201902,889,2860,762,2634,56,243,535,1816,591,2059
310250,201902,1011,2755,827,2461,36,146,591,1719,627,1865
310260,201902,2732,7387,1704,5570,504,1883,339,822,843,2705
310270,201902,2658,6760,2082,5961,111,426,1689,4766,1800,5192
310280,201902,2330,5582,1813,4841,301,873,994,2502,1295,3375
310285,201902,1863,6161,1611,5727,158,674,989,3487,1147,4161
310290,201902,1141,3069,955,2737,207,680,502,1302,709,1982
310300,201902,1442,4434,1271,4134,194,795,669,1969,863,2764
310310,201902,308,795,207,612,31,96,114,335,145,431
310320,201902,505,1315,320,994,29,114,156,464,185,578
310330,201902,486,1164,293,806,40,129,130,324,170,453
310340,201902,7604,21263,6095,18665,977,2900,3033,9589,4010,12489
310350,201902,12183,30184,8268,23789,1914,5863,2943,8222,4857,14085
310360,201902,487,1173,373,1027,12,42,276,744,288,786
310370,201902,1275,4073,1060,3654,217,807,335,1185,552,1992
310375,201902,831,2205,559,1781,101,341,227,723,328,1064
310380,201902,387,908,206,592,36,97,79,214,115,311
310390,201902,441,1338,353,1172,92,327,91,242,183,569
310400,201902,9364,23387,6594,19121,943,3129,3515,9894,4458,13023
310410,201902,774,2273,477,1710,102,378,136,449,238,827
310420,201902,3971,10432,2572,7634,445,1500,828,2205,1273,3705
310430,201902,1443,4024,938,3067,196,706,299,901,495,1607
310440,201902,566,1459,393,1155,25,109,232,664,257,773
310445,201902,1314,3884,1001,3273,49,186,712,2282,761,2468
310450,201902,4669,12030,3514,10180,206,752,2606,7322,2812,8074
310460,201902,1585,4307,1091,3374,219,719,316,956,535,1675
310470,201902,3844,8448,3049,7412,308,815,2276,5486,2584,6301
310480,201902,984,2671,747,2239,109,370,465,1347,574,1717
310490,201902,2865,8115,2237,7003,320,1203,1114,3214,1434,4417
310500,201902,1416,4076,1028,3360,201,724,476,1534,677,2258
310510,201902,1873,5072,1200,3789,245,844,389,1240,634,2084
310520,201902,1283,3254,921,2641,127,353,528,1491,655,1844
310530,201902,763,1994,436,1331,63,225,110,264,173,489
310540,201902,3237,9391,2674,8396,647,2126,1121,3394,1768,5520
310550,201902,1244,3253,853,2566,77,291,507,1433,584,1724
310560,201902,13828,37378,10151,30928,2049,7029,3645,10047,5694,17076
310570,201902,1113,2995,883,2658,83,317,585,1697,668,2014
310590,201902,4078,11140,3297,9727,264,896,1905,5333,2169,6229
310600,201902,1410,4245,1150,3720,181,652,558,1685,739,2337
310610,201902,490,1326,310,1024,54,201,162,491,216,692
310620,201902,160117,422463,117650,345535,22138,73837,49312,129769,71450,203606
310630,201902,4441,12449,3643,10931,268,947,2431,7065,2699,8012
310640,201902,976,3007,814,2677,194,717,286,887,480,1604
310650,201902,2410,7131,1785,5931,212,786,1005,3219,1217,4005
310660,201902,1263,3459,1066,3210,44,152,880,2612,924,2764
310665,201902,1332,3517,1055,3114,44,172,861,2504,905,2676
310670,201902,50173,134457,42148,120291,5184,16950,26679,72210,31863,89160
310680,201902,675,1676,573,1532,25,77,456,1184,481,1261
310690,201902,1705,4658,1255,3899,134,484,698,2073,832,2557
310700,201902,489,1110,370,969,40,129,256,634,296,763
310710,201902,5271,15478,3744,13249,894,3708,471,1546,1365,5254
310720,201902,907,2285,722,2039,47,157,517,1400,564,1557
310730,201902,9308,26126,8026,24017,497,1867,5708,16702,6205,18569
310740,201902,5332,15186,3585,11454,670,2309,1060,3156,1730,5465
310750,201902,1211,2991,867,2497,136,453,373,978,509,1431
310760,201902,549,1479,401,1244,30,102,195,623,225,725
310770,201902,1076,3009,718,2437,102,404,348,1126,450,1530
310780,201902,4014,10167,3301,9052,129,394,2437,6577,2566,6971
310790,201902,1776,5671,1557,5217,422,1517,484,1604,906,3121
310800,201902,2228,6746,1607,5480,414,1659,98,302,512,1961
310810,201902,1124,2936,898,2522,51,177,614,1656,665,1833
310820,201902,1142,3041,693,2214,153,516,148,466,301,982
310825,201902,2455,7869,2009,7093,86,485,1581,5356,1667,5841
310830,201902,1530,4517,1053,3512,222,820,421,1331,643,2151
310840,201902,1866,5175,1315,4200,348,1238,324,902,672,2140
310850,201902,1520,4214,1282,3887,66,318,995,2867,1061,3185
310855,201902,3235,8771,2514,7599,212,752,1732,5089,1944,5841
310860,201902,6852,20115,5476,17359,530,1785,3367,10712,3897,12497
310870,201902,1041,2519,787,2149,86,242,559,1530,645,1772
310880,201902,1018,3084,797,2632,89,309,473,1520,562,1829
310890,201902,2243,6390,1430,4833,304,1121,175,495,479,1616
310900,201902,4138,11678,3066,9623,481,1656,1388,4011,1869,5667
310910,201902,1765,4570,1155,3497,132,472,182,480,314,952
310920,201902,1834,4946,1404,4261,255,796,722,2187,977,2983
310925,201902,948,2713,789,2428,102,347,513,1519,615,1866
310930,201902,5733,15537,4153,12959,779,2520,2056,6584,2835,9104
310940,201902,6227,15809,5032,14030,272,995,3649,9840,3921,10835
310945,201902,1210,3229,994,2907,109,377,589,1672,698,2049
310950,201902,1823,5520,1234,4184,246,921,417,1285,663,2206
310960,201902,714,1867,425,1329,60,200,146,470,206,670
310970,201902,1154,3490,804,2722,201,750,166,496,367,1246
310980,201902,333,798,223,627,25,74,140,378,165,452
310990,201902,1201,3527,930,2990,206,690,398,1238,604,1928
311000,201902,3984,11414,2967,9677,777,2705,1113,3477,1890,6182
311010,201902,752,2355,606,2026,244,877,168,539,412,1416
311020,201902,972,2587,658,2009,72,244,307,912,379,1156
311030,201902,1502,3940,1012,3059,242,827,393,1074,635,1901
311040,201902,323,1030,256,865,71,245,72,226,143,471
311050,201902,2434,6395,1855,5517,411,1367,815,2306,1226,3673
311060,201902,2814,7576,1948,5814,309,1099,765,2049,1074,3148
311070,201902,2007,5347,1462,4444,202,754,704,2008,906,2762
311080,201902,992,2429,820,2137,55,219,595,1432,650,1651
311090,201902,2015,6595,1585,5806,380,1560,465,1668,845,3228
311100,201902,2006,5874,1239,4331,291,1144,182,579,473,1723
311110,201902,3627,7715,2039,5443,439,1257,734,1979,1173,3236
311115,201902,1275,3130,1038,2796,64,206,827,2172,891,2378
311120,201902,6393,17208,4773,14192,813,2755,1677,4448,2490,7203
311130,201902,1839,4961,1420,4363,136,558,768,2248,904,2806
311140,201902,1385,3453,1023,2933,84,276,637,1817,721,2093
311150,201902,1518,4886,1213,4298,190,765,637,2176,827,2941
311160,201902,3612,10741,2523,8703,685,2637,712,2407,1397,5044
311170,201902,849,2297,674,2043,44,138,424,1321,468,1459
311180,201902,1306,3019,835,2330,185,548,345,964,530,1512
311190,201902,1003,2793,735,2253,113,403,307,862,420,1265
311200,201902,1767,4855,1234,3843,296,1011,343,947,639,1958
311205,201902,868,2692,711,2371,55,245,412,1324,467,1569
311210,201902,997,3006,877,2851,122,390,634,2109,756,2499
311220,201902,733,2109,608,1885,74,261,332,954,406,1215
311230,201902,7507,23013,5639,19271,1054,3788,2015,7108,3069,10896
311240,201902,963,2639,740,2323,184,633,357,1098,541,1731
311250,201902,871,2528,682,2191,162,538,296,919,458,1457
311260,201902,2374,5965,1515,4484,294,915,544,1524,838,2439
311265,201902,1233,3298,939,2811,62,220,653,1884,715,2104
311270,201902,2989,9108,2609,8481,204,920,1907,5875,2111,6795
311280,201902,1152,3096,539,1765,97,348,85,253,182,601
311290,201902,1869,5831,1728,5520,175,595,1177,3723,1352,4318
311300,201902,4554,13181,3804,11920,225,981,2941,8971,3166,9952
311310,201902,557,1610,472,1450,61,199,244,711,305,910
311320,201902,3085,9693,2625,8651,444,1657,1180,3601,1624,5258
311330,201902,4761,13075,3926,11698,451,1503,2182,6554,2633,8057
311340,201902,9951,28994,7897,25217,2377,8176,1980,6153,4357,14329
311350,201902,2186,5668,1551,4494,160,567,825,2130,985,2697
311360,201902,1088,2735,680,2085,215,741,188,541,403,1282
311370,201902,4346,11075,3226,9207,171,690,2018,5465,2189,6155
311380,201902,379,1173,302,1020,78,276,107,371,185,647
311390,201902,1678,5307,1345,4860,571,2373,352,1104,923,3477
311400,201902,1378,3971,997,3227,144,533,415,1205,559,1738
311410,201902,1595,4837,1325,4461,230,870,700,2384,930,3254
311420,201902,1531,4615,1044,3576,190,703,178,483,368,1186
311430,201902,3400,9348,2230,6972,431,1380,656,2072,1087,3452
311440,201902,2422,7088,1704,5814,373,1462,555,1858,928,3320
311450,201902,1711,5308,1266,4458,331,1306,299,895,630,2201
311455,201902,942,2226,651,1784,177,498,239,666,416,1164
311460,201902,478,1542,327,1234,72,349,92,310,164,659
311470,201902,432,1387,309,1085,74,311,59,188,133,499
311480,201902,1148,3217,991,2994,43,118,815,2498,858,2616
311490,201902,222,673,172,567,48,183,75,216,123,399
311500,201902,406,1065,299,890,30,99,181,530,211,629
311510,201902,2859,7782,1902,6021,343,1234,680,1988,1023,3222
311520,201902,570,1701,518,1594,106,372,279,824,385,1196
311530,201902,8501,20368,5337,15161,1319,4148,1348,3780,2667,7928
311535,201902,726,2009,493,1561,84,298,147,427,231,725
311540,201902,509,1613,443,1496,94,326,259,878,353,1204
311545,201902,1998,5745,1735,5385,93,374,1336,4063,1429,4437
311547,201902,1468,3823,1283,3535,41,132,931,2601,972,2733
311550,201902,2665,7665,2117,6624,329,1170,852,2549,1181,3719
311560,201902,278,627,192,508,29,84,105,248,134,332
311570,201902,1816,4308,1313,3600,58,171,1023,2865,1081,3036
311580,201902,2125,4015,1377,3151,156,315,898,2114,1054,2429
311590,201902,468,1331,376,1193,61,221,200,620,261,841
311600,201902,1673,3879,1404,3545,54,161,1201,2969,1255,3130
311610,201902,2340,7894,1954,7029,314,1185,972,3479,1286,4664
311615,201902,2934,8786,2427,7934,163,622,1817,5838,1980,6460
311620,201902,403,1115,346,1038,22,79,273,808,295,887
311630,201902,1337,3724,1076,3215,88,278,721,2076,809,2354
311640,201902,545,1591,427,1370,83,313,200,587,283,900
311650,201902,1884,4994,1582,4517,131,458,1077,2938,1208,3396
311660,201902,2688,7829,1962,6474,380,1356,459,1320,839,2676
311670,201902,1535,4067,1139,3393,181,606,504,1525,685,2131
311680,201902,2064,6067,1583,5221,287,964,924,3051,1211,4015
311690,201902,561,1236,432,1073,52,127,306,798,358,925
311700,201902,2232,5437,1746,4755,32,131,1456,3853,1488,3984
311710,201902,1488,4385,1017,3463,261,964,344,1163,605,2127
311720,201902,406,1254,326,1099,33,145,178,575,211,720
311730,201902,4090,10430,2582,7720,811,2676,408,1209,1219,3885
311740,201902,810,2338,700,2198,36,99,619,1977,655,2076
311750,201902,3847,11860,3110,10611,488,1811,1595,5218,2083,7029
311760,201902,603,1770,502,1586,90,363,216,567,306,930
311770,201902,1938,5778,1515,4979,284,1003,607,1893,891,2896
311780,201902,1250,3727,855,2894,173,668,233,681,406,1349
311783,201902,2162,6192,1784,5509,53,240,1431,4295,1484,4535
311787,201902,690,2028,496,1588,77,278,183,508,260,786
311790,201902,1418,3775,930,2935,223,779,310,941,533,1720
311800,201902,4685,14447,3819,12554,734,2661,658,1974,1392,4635
311810,201902,950,2974,747,2591,59,246,455,1560,514,1806
311820,201902,762,1961,566,1631,84,272,309,837,393,1109
311830,201902,8036,23748,5587,18378,1576,5544,646,2025,2222,7569
311840,201902,3146,8471,2680,7798,284,910,1930,5539,2214,6449
311850,201902,308,864,252,767,17,54,162,486,179,540
311860,201902,54851,142973,42244,121510,6698,20499,23213,64687,29911,85186
311870,201902,1949,5265,1258,4005,204,734,457,1300,661,2034
311880,201902,6143,16418,5213,15115,340,931,3968,11628,4308,12559
311890,201902,1534,3909,1199,3419,106,353,799,2188,905,2541
311900,201902,705,1873,538,1636,64,228,353,1038,417,1266
311910,201902,4129,10786,3111,9447,586,1774,1615,5028,2201,6802
311920,201902,1966,5581,1579,4966,150,463,942,3004,1092,3467
311930,201902,3169,7967,2423,6890,882,2694,720,1925,1602,4619
311940,201902,13753,37548,10238,30840,1522,5049,4679,13254,6201,18303
311950,201902,2121,6029,1592,5107,94,422,1072,3345,1166,3767
311960,201902,551,1379,449,1220,30,137,292,667,322,804
311970,201902,437,1434,295,1077,58,237,67,217,125,454
311980,201902,417,1177,219,759,30,115,59,201,89,316
311990,201902,530,1305,353,1057,77,267,154,434,231,701
311995,201902,965,2730,517,1698,22,74,56,126,78,200
312000,201902,578,1558,476,1407,33,116,332,982,365,1098
312010,201902,875,2494,671,2144,67,246,396,1224,463,1470
312015,201902,1308,3972,1168,3723,69,306,891,2736,960,3042
312020,201902,1133,3571,920,3164,235,844,316,1054,551,1898
312030,201902,2015,5049,1775,4769,30,137,1630,4328,1660,4465
312040,201902,778,2523,594,2097,66,250,254,871,320,1121
312050,201902,1228,3989,959,3426,220,921,255,799,475,1720
312060,201902,833,2133,555,1765,138,452,249,786,387,1238
312070,201902,866,2555,615,2055,70,268,313,1007,383,1275
312080,201902,2717,6833,2033,5804,139,459,1285,3483,1424,3942
312083,201902,865,2343,655,2009,70,240,411,1210,481,1450
312087,201902,2296,6277,1909,5680,72,262,1475,4381,1547,4643
312090,201902,9224,25324,7074,21764,1296,4334,3231,9812,4527,14146
312100,201902,1568,4742,1152,3974,136,597,534,1752,670,2349
312110,201902,989,3162,832,2841,223,863,247,753,470,1616
312120,201902,706,2015,507,1669,152,585,157,426,309,1011
312125,201902,1562,4243,1315,3866,129,408,930,2650,1059,3058
312130,201902,901,2270,659,1860,61,188,273,730,334,918
312140,201902,743,2234,614,1961,134,461,249,727,383,1188
312150,201902,446,1278,380,1132,11,54,277,759,288,813
312160,201902,7774,22652,5981,19387,906,3340,2641,8100,3547,11440
312170,201902,851,2349,664,2008,41,147,452,1323,493,1470
312180,201902,1339,3736,1065,3191,156,495,548,1575,704,2070
312190,201902,555,1658,393,1327,82,291,80,263,162,554
312200,201902,4682,12709,3709,11143,743,2321,1927,5757,2670,8078
312210,201902,1347,3185,966,2619,52,188,672,1761,724,1949
312220,201902,1841,5767,1581,5274,126,466,974,3241,1100,3707
312230,201902,11545,31197,7634,23920,2115,7258,1271,3558,3386,10816
312235,201902,1775,4820,1441,4301,106,372,1016,2968,1122,3340
312240,201902,666,2172,499,1822,105,404,150,539,255,943
312245,201902,2505,6727,2081,6071,76,271,1680,4862,1756,5133
312247,201902,893,2287,628,1886,128,409,305,915,433,1324
312250,201902,949,2497,612,1840,104,319,239,711,343,1030
312260,201902,896,2568,725,2289,53,215,509,1549,562,1764
312270,201902,694,1948,532,1626,31,136,290,803,321,939
312280,201902,417,1237,319,1056,100,337,38,117,138,454
312290,201902,713,2206,580,1941,126,468,185,592,311,1060
312300,201902,898,2698,622,2067,169,610,112,300,281,910
312310,201902,746,2502,636,2288,101,411,282,986,383,1397
312320,201902,1737,4636,1274,3825,372,1188,233,644,605,1832
312330,201902,852,2544,688,2221,69,233,460,1444,529,1677
312340,201902,247,664,179,552,43,153,67,186,110,339
312350,201902,271,576,208,509,24,69,140,325,164,394
312352,201902,1623,4848,1421,4495,111,372,879,2929,990,3301
312360,201902,2475,7409,1817,6030,392,1404,462,1468,854,2872
312370,201902,1701,4750,1422,4257,249,861,714,2021,963,2882
312380,201902,2175,5038,1808,4571,16,40,1619,4079,1635,4119
312385,201902,1272,3598,991,3072,150,538,481,1396,631,1934
312390,201902,1863,5565,1400,4690,226,837,483,1475,709,2312
312400,201902,2780,8382,2238,7336,739,2546,653,2185,1392,4731
312410,201902,11323,32510,9295,28961,1813,5902,4659,14330,6472,20232
312420,201902,3594,10257,3049,9303,574,1871,1594,4754,2168,6625
312430,201902,7955,21319,6357,18496,569,1842,4208,12012,4777,13854
312440,201902,899,2917,691,2422,354,1303,69,205,423,1508
312450,201902,1155,3506,876,2981,248,895,292,1017,540,1912
312460,201902,423,1121,288,908,40,154,159,506,199,660
312470,201902,485,1216,312,918,57,207,113,275,170,482
312480,201902,1146,2919,793,2414,113,366,407,1192,520,1558
312490,201902,2038,5066,1550,4325,222,626,796,2153,1018,2779
312500,201902,858,2197,688,1948,51,184,452,1249,503,1433
312510,201902,3554,9750,2669,8061,678,2006,835,2519,1513,4525
312520,201902,154,487,137,455,38,122,64,212,102,334
312530,201902,560,1456,482,1359,20,69,423,1191,443,1260
312540,201902,1467,4319,967,3219,174,631,459,1495,633,2126
312550,201902,750,2059,551,1630,41,134,355,971,396,1105
312560,201902,1940,5062,1583,4536,69,250,1244,3547,1313,3797
312570,201902,2124,5576,1651,4947,513,1614,608,1853,1121,3467
312580,201902,583,1709,438,1391,61,218,193,574,254,792
312590,201902,1614,4869,1313,4283,129,543,742,2255,871,2798
312595,201902,1609,5069,1436,4761,312,979,827,2883,1139,3862
312600,201902,962,2386,523,1688,79,297,189,610,268,907
312610,201902,6335,16551,4021,12181,626,2105,1282,3641,1908,5746
312620,201902,2451,6374,1786,5461,59,270,1403,4347,1462,4617
312630,201902,267,848,203,724,40,170,78,268,118,438
312640,201902,571,1563,377,1234,53,180,125,425,178,605
312650,201902,2079,5488,1408,4184,87,287,947,2667,1034,2954
312660,201902,1338,3315,1008,2786,94,328,673,1762,767,2090
312670,201902,4926,13504,4033,12080,248,1057,2811,8025,3059,9082
312675,201902,1208,3376,981,3008,62,260,761,2268,823,2528
312680,201902,1364,3919,1141,3590,70,312,896,2727,966,3039
312690,201902,2403,5660,1898,5017,104,313,1523,3928,1627,4241
312695,201902,941,2761,803,2520,60,181,607,1926,667,2107
312700,201902,2048,5517,1483,4487,159,553,823,2386,982,2939
312705,201902,1310,3386,1092,3041,21,85,930,2544,951,2629
312707,201902,1378,4149,1072,3568,74,371,656,2052,730,2423
312710,201902,6257,14484,3660,10445,1053,3274,941,2753,1994,6027
312720,201902,1029,2920,761,2467,91,332,424,1319,515,1651
312730,201902,1611,3910,1184,3331,96,311,707,1917,803,2228
312733,201902,1444,3833,1091,3184,37,134,721,2015,758,2149
312735,201902,643,1771,545,1583,69,239,364,957,433,1196
312737,201902,818,1941,547,1534,83,271,293,745,376,1016
312738,201902,577,1564,408,1257,64,237,188,527,252,764
312740,201902,420,1066,239,756,63,213,56,142,119,355
312750,201902,1325,4261,1065,3746,181,712,428,1420,609,2132
312760,201902,1812,5514,1316,4495,255,931,432,1420,687,2351
312770,201902,42683,104535,26672,77404,6165,18909,8142,23318,14307,42227
312780,201902,2411,7531,2043,6899,220,849,1324,4444,1544,5293
312790,201902,259,648,161,514,10,48,53,142,63,190
312800,201902,4787,14083,3742,12017,816,2856,1482,4623,2298,7479
312810,201902,1670,4566,1092,3572,268,987,339,980,607,1967
312820,201902,1771,4890,1457,4298,60,227,1046,2994,1106,3221
312825,201902,1332,3209,1142,2954,27,93,962,2452,989,2545
312830,201902,2252,6555,1456,4995,345,1318,345,1163,690,2481
312840,201902,1158,3427,904,2940,135,538,390,1177,525,1715
312850,201902,849,2163,600,1774,48,194,323,865,371,1059
312860,201902,1299,3339,856,2635,237,775,221,660,458,1435
312870,201902,6285,17502,3798,12450,625,2253,909,2812,1534,5065
312880,201902,1384,3585,1098,3128,50,181,606,1729,656,1910
312890,201902,2022,5384,1388,4234,158,505,600,1850,758,2355
312900,201902,1170,3142,939,2838,83,275,555,1761,638,2036
312910,201902,1608,3023,833,1998,143,314,315,718,458,1032
312920,201902,1009,2801,694,2252,157,589,275,812,432,1401
312930,201902,2108,5553,1696,4931,369,1118,728,2093,1097,3211
312940,201902,894,2556,708,2256,96,352,339,1050,435,1402
312950,201902,3067,7815,2003,6041,522,1693,659,1920,1181,3613
312960,201902,1878,5013,1572,4564,103,297,1177,3495,1280,3792
312965,201902,1639,4876,1401,4437,137,443,895,2814,1032,3257
312970,201902,1093,3196,847,2778,177,687,391,1164,568,1851
312980,201902,21840,62776,17957,55663,3018,10474,9461,27801,12479,38275
312990,201902,439,1176,270,883,59,225,113,353,172,578
313000,201902,419,1251,330,1095,40,172,177,551,217,723
313005,201902,2545,7435,2175,6812,142,485,1593,4873,1735,5358
313010,201902,4599,13274,3757,11836,677,2399,2181,6641,2858,9040
313020,201902,900,2779,598,2088,103,389,99,294,202,683
313030,201902,1177,2885,784,2264,92,338,463,1256,555,1594
313040,201902,766,2433,623,2109,58,245,344,1093,402,1338
313050,201902,1713,4970,1212,4216,218,902,352,1091,570,1993
313055,201902,1798,5083,1627,4817,46,147,1377,4056,1423,4203
313060,201902,928,2400,629,1907,213,719,131,340,344,1059
313065,201902,1639,5147,1454,4833,82,360,1076,3467,1158,3827
313070,201902,947,2519,712,2089,75,238,417,1200,492,1438
313080,201902,364,1022,265,833,71,253,81,205,152,458
313090,201902,4651,13076,3988,11911,617,2033,2358,6884,2975,8917
313100,201902,1398,3705,1066,3212,56,210,761,2256,817,2466
313110,201902,1486,4033,1049,3235,95,362,577,1643,672,2005
313115,201902,2441,7396,2055,6649,312,1117,1028,3111,1340,4228
313120,201902,3650,8806,2715,7563,296,914,1662,4597,1958,5511
313130,201902,27659,75087,21626,63549,2904,9645,11475,31804,14379,41449
313140,201902,562,1296,351,978,26,87,233,629,259,716
313150,201902,1352,3922,992,3213,276,943,270,833,546,1776
313160,201902,962,2520,739,2137,50,180,520,1442,570,1622
313170,201902,11146,33258,7903,26902,1459,5292,2887,9304,4346,14596
313180,201902,2196,5970,1539,4632,203,671,805,2345,1008,3016
313190,201902,4216,12402,3080,10055,578,1995,1047,3171,1625,5166
313200,201902,1059,3057,919,2808,26,110,768,2260,794,2370
313210,201902,3744,11214,3071,9974,413,1450,1773,5597,2186,7047
313220,201902,1725,4634,1156,3558,189,660,414,1119,603,1779
313230,201902,2937,8305,2473,7741,90,314,2037,6433,2127,6747
313240,201902,8713,22265,5446,16896,1029,3635,2230,6408,3259,10043
313250,201902,5726,17271,4573,15082,611,2142,2385,7748,2996,9890
313260,201902,601,1606,421,1262,49,177,203,569,252,746
313270,201902,5468,15039,4391,13324,672,2141,2652,8078,3324,10219
313280,201902,420,1213,282,923,41,137,109,353,150,490
313290,201902,822,2669,641,2380,226,901,188,686,414,1587
313300,201902,1551,4475,1135,3677,324,1113,207,593,531,1706
313310,201902,1032,3147,827,2703,144,543,210,573,354,1116
313320,201902,2113,5672,1473,4636,300,1063,637,1997,937,3060
313330,201902,3934,10896,3040,9490,216,925,1967,5934,2183,6859
313340,201902,1287,2989,916,2458,110,298,623,1669,733,1967
313350,201902,2128,6105,1448,4680,222,819,557,1640,779,2459
313360,201902,1273,3272,872,2609,153,537,446,1253,599,1790
313370,201902,1291,3829,1138,3535,144,529,658,1911,802,2440
313375,201902,1669,4412,1053,3318,206,743,239,708,445,1451
313380,201902,5608,14646,3967,11580,822,2612,1669,4428,2491,7040
313390,201902,865,2841,765,2673,58,277,499,1655,557,1932
313400,201902,3586,9279,2849,8287,198,624,2174,6186,2372,6810
313410,201902,1251,3353,962,2862,72,245,691,2017,763,2262
313420,201902,14813,33739,7470,21252,1638,5111,992,2898,2630,8009
313430,201902,851,2521,643,2110,108,419,267,804,375,1223
313440,201902,5782,12793,3789,10166,312,900,2455,6570,2767,7470
313450,201902,611,1752,445,1422,96,342,144,399,240,741
313460,201902,2100,6274,1689,5619,348,1341,779,2451,1127,3792
313470,201902,2976,7593,2369,6735,229,639,1598,4577,1827,5216
313480,201902,879,2578,502,1720,88,323,119,367,207,690
313490,201902,1632,3847,776,2486,261,968,66,209,327,1177
313500,201902,412,1249,324,1040,41,141,123,362,164,503
313505,201902,9487,25780,8090,23917,303,1112,6672,19601,6975,20713
313507,201902,1457,3831,1204,3454,35,140,970,2738,1005,2878
313510,201902,12282,34630,10105,30613,1305,4255,5191,15314,6496,19569
313520,201902,13292,39001,10876,34733,774,2899,7771,24344,8545,27243
313530,201902,523,1513,411,1303,21,79,206,616,227,695
313535,201902,2322,6484,2022,5923,143,403,1438,4170,1581,4573
313540,201902,787,2441,600,1968,116,375,230,725,346,1100
313545,201902,1177,3992,1003,3632,170,643,543,1902,713,2545
313550,201902,1715,5309,1445,4699,361,1303,662,2039,1023,3342
313560,201902,2539,5173,1886,4377,69,152,1605,3699,1674,3851
313570,201902,951,2918,772,2581,190,685,306,989,496,1674
313580,201902,5418,14696,4133,12535,566,1835,2277,7044,2843,8879
313590,201902,938,2711,717,2386,234,847,274,929,508,1776
313600,201902,3711,10357,3106,9390,110,434,2548,7570,2658,8004
313610,201902,978,2553,785,2201,106,300,476,1290,582,1590
313620,201902,5459,14804,4318,12829,713,2330,2254,6467,2967,8797
313630,201902,8084,20485,5595,16654,709,2432,3037,8908,3746,11340
313640,201902,964,2361,609,1876,171,571,205,617,376,1188
313650,201902,1765,5399,1459,4888,101,398,962,3242,1063,3640
313652,201902,767,2548,700,2393,122,467,423,1394,545,1861
313655,201902,1080,2947,871,2654,55,197,663,2002,718,2199
313657,201902,1243,3369,963,2902,46,188,700,2014,746,2202
313660,201902,840,2436,683,2137,99,383,372,1064,471,1447
313665,201902,4468,12360,3470,10593,520,1797,1940,5655,2460,7452
313670,201902,44128,112599,28516,85502,5017,16489,11487,32670,16504,49159
313680,201902,990,2702,831,2456,64,212,537,1530,601,1742
313690,201902,813,2672,647,2333,146,555,206,713,352,1268
313695,201902,1687,4793,1301,4159,91,326,891,2830,982,3156
313700,201902,3028,9977,2653,9486,255,965,2027,7247,2282,8212
313710,201902,1331,3262,955,2715,89,265,642,1823,731,2088
313720,201902,5215,14709,3792,11843,595,2093,1611,4648,2206,6741
313730,201902,1271,3023,973,2625,78,198,646,1705,724,1903
313740,201902,1660,5933,1343,5125,345,1490,210,680,555,2170
313750,201902,1868,5250,1454,4428,315,1055,574,1633,889,2688
313753,201902,2128,5156,1422,4028,153,475,820,2225,973,2700
313760,201902,4940,13977,3679,11501,838,2787,1401,4180,2239,6967
313770,201902,3637,10464,2909,9332,221,789,2035,6566,2256,7355
313780,201902,3990,10933,2930,9112,299,1082,793,2501,1092,3583
313790,201902,472,1501,416,1393,57,212,226,719,283,931
313800,201902,1320,3161,996,2671,137,417,540,1362,677,1779
313810,201902,1568,4157,1245,3690,76,286,905,2640,981,2926
313820,201902,14073,34264,9340,25799,1546,4671,3391,9013,4937,13684
313830,201902,346,995,265,841,56,193,112,327,168,520
313835,201902,900,2743,730,2411,81,316,358,1116,439,1432
313840,201902,6362,17093,4567,13978,1186,3865,975,3051,2161,6916
313850,201902,928,2339,745,2072,121,417,391,968,512,1385
313860,201902,2549,7124,1881,5784,309,1059,721,2059,1030,3118
313862,201902,1514,3388,770,2229,69,215,394,1079,463,1294
313865,201902,2248,6249,1934,5747,131,407,1472,4301,1603,4708
313867,201902,1098,3507,923,3168,264,967,453,1526,717,2493
313868,201902,1657,5166,1399,4672,75,347,1053,3401,1128,3748
313870,201902,765,2126,568,1777,115,386,191,535,306,921
313880,201902,1437,3890,1050,3238,183,634,462,1277,645,1911
313890,201902,1952,4497,1432,3826,90,281,980,2600,1070,2881
313900,201902,3644,11186,2733,9350,761,2863,656,2121,1417,4984
313910,201902,586,1794,429,1491,104,387,85,290,189,677
313920,201902,2846,9171,2392,8230,514,1754,1164,4052,1678,5806
313925,201902,1565,4116,1258,3546,223,604,753,2125,976,2729
313930,201902,4832,14784,3934,13171,346,1325,2571,8480,2917,9805
313940,201902,8005,24013,5748,19987,1121,4560,1359,5150,2480,9710
313950,201902,4775,11072,3459,9364,482,1672,2091,5481,2573,7153
313960,201902,5278,13404,3598,10531,791,2576,1190,3211,1981,5787
313970,201902,1315,3763,1160,3493,33,125,741,2216,774,2341
313980,201902,1309,3507,847,2747,128,482,303,930,431,1412
313990,201902,1726,5762,1277,4695,351,1432,371,1210,722,2642
314000,201902,9288,25150,7854,22672,513,1916,5368,15220,5881,17136
314010,201902,1334,3361,1075,3000,39,141,821,2219,860,2360
314015,201902,2038,5724,1563,4970,217,828,812,2488,1029,3316
314020,201902,488,1355,293,971,58,240,51,174,109,414
314030,201902,754,2252,600,1951,75,254,300,957,375,1211
314040,201902,641,1751,515,1509,100,321,252,701,352,1022
314050,201902,1641,4507,1192,3656,169,614,592,1675,761,2289
314053,201902,1755,5317,1419,4664,247,785,747,2571,994,3356
314055,201902,2283,6281,1956,5793,55,214,1587,4712,1642,4926
314060,201902,1200,3272,913,2810,45,168,623,1894,668,2062
314070,201902,4387,12392,3443,10656,761,2421,1420,4289,2181,6710
314080,201902,2119,5745,1349,4288,209,800,471,1296,680,2096
314085,201902,2015,6099,1672,5557,326,1143,834,2794,1160,3937
314090,201902,3976,11562,3380,10613,240,960,2233,6956,2473,7916
314100,201902,3105,7444,2437,6531,74,196,1899,5109,1973,5305
314110,201902,4162,12309,3446,10898,465,1673,1838,5440,2303,7113
314120,201902,759,1754,324,988,79,287,60,179,139,466
314130,201902,682,1853,384,1247,39,154,189,596,228,750
314140,201902,4555,13327,3504,11231,572,1941,1593,4985,2165,6926
314150,201902,1457,3750,1087,3111,95,300,720,1967,815,2267
314160,201902,2204,6001,1590,4894,252,829,643,2015,895,2844
314170,201902,987,2816,794,2430,75,260,475,1362,550,1622
314180,201902,5275,15188,4342,13654,414,1468,2538,7951,2952,9419
314190,201902,598,1571,428,1314,93,331,181,494,274,825
314200,201902,2827,8193,2330,7324,139,561,1651,5004,1790,5565
314210,201902,1926,5172,1542,4478,145,448,844,2399,989,2847
314220,201902,1254,3576,890,2923,220,835,291,874,511,1709
314225,201902,1109,3227,947,2975,79,252,690,2170,769,2422
314230,201902,762,2043,630,1879,86,281,380,1174,466,1455
314240,201902,1036,2843,810,2521,191,636,315,988,506,1624
314250,201902,509,1439,322,1054,47,169,122,365,169,534
314260,201902,920,2739,744,2459,171,641,359,1113,530,1754
314270,201902,3136,9108,2574,8220,98,379,1904,6006,2002,6385
314280,201902,3207,7558,2046,5724,298,919,920,2430,1218,3349
314290,201902,4385,11611,3663,10360,373,1058,2455,6854,2828,7912
314300,201902,1656,4943,1150,3810,267,971,347,1110,614,2081
314310,201902,4372,11845,3063,9560,950,3163,581,1709,1531,4872
314315,201902,883,3179,762,2912,62,303,525,1931,587,2234
314320,201902,2677,7396,1745,5676,364,1246,632,2043,996,3289
314330,201902,46013,130484,34828,111112,10201,33959,7804,25855,18005,59814
314340,201902,2231,5649,1227,3779,274,991,271,663,545,1654
314345,201902,1361,4177,1134,3765,159,557,669,2177,828,2734
314350,201902,887,2506,595,1971,127,473,156,478,283,951
314360,201902,558,1637,346,1181,60,229,99,310,159,539
314370,201902,684,1907,537,1671,34,140,385,1148,419,1288
314380,201902,1091,3141,751,2475,182,688,140,454,322,1142
314390,201902,11776,31362,7634,23507,1653,5436,2126,5863,3779,11299
314400,201902,3963,11897,3091,10303,838,2911,1115,3829,1953,6740
314410,201902,2681,7603,1833,5969,282,1046,653,2217,935,3263
314420,201902,778,1932,593,1683,17,88,442,1189,459,1277
314430,201902,6779,17687,4863,14297,857,2654,1986,5617,2843,8271
314435,201902,1493,4230,1220,3768,46,191,906,2739,952,2930
314437,201902,931,2440,651,1971,52,194,325,963,377,1157
314440,201902,575,1677,418,1370,111,397,91,258,202,655
314450,201902,1301,3598,1082,3254,112,399,659,1896,771,2295
314460,201902,3303,10273,2374,8228,610,2259,422,1419,1032,3678
314465,201902,2186,6461,1894,5884,56,254,1453,4338,1509,4592
314467,201902,807,2269,697,2078,24,79,560,1639,584,1718
314470,201902,2181,6435,1747,5512,322,1133,765,2244,1087,3377
314480,201902,5829,17429,4199,13874,767,2764,1228,3689,1995,6453
314490,201902,946,2651,704,2144,79,275,416,1223,495,1498
314500,201902,1583,4054,1148,3364,216,654,473,1365,689,2019
314505,201902,1927,4884,1599,4426,100,310,1176,3182,1276,3492
314510,201902,1777,4750,1223,3897,261,907,529,1647,790,2554
314520,201902,4081,12920,2875,10193,564,2190,347,1088,911,3278
314530,201902,5416,18014,4868,16936,445,1805,3409,11650,3854,13455
314535,201902,2554,6791,2088,6096,128,494,1570,4497,1698,4991
314537,201902,1091,3184,843,2757,60,229,589,1885,649,2114
314540,201902,416,1098,287,855,26,102,145,403,171,505
314545,201902,1713,4399,1519,4146,45,124,1269,3591,1314,3715
314550,201902,639,1599,477,1364,37,145,252,642,289,787
314560,201902,3865,12094,2948,10083,502,1832,928,2991,1430,4823
314570,201902,291,821,225,701,29,107,104,323,133,430
314580,201902,435,1337,334,1138,88,306,77,277,165,583
314585,201902,652,2096,499,1738,66,286,242,782,308,1068
314587,201902,1964,5540,1497,4788,212,608,824,2706,1036,3314
314590,201902,3378,9637,2372,7659,382,1381,890,2688,1272,4069
314600,201902,1801,5120,1065,3652,227,847,112,342,339,1189
314610,201902,8390,22260,5898,18559,1193,4355,2392,7311,3585,11666
314620,201902,2063,5068,1608,4468,59,211,1305,3530,1364,3741
314625,201902,1483,4330,1265,4018,62,333,1018,3123,1080,3456
314630,201902,5057,13455,4167,12198,117,476,3451,10095,3568,10571
314640,201902,626,1562,441,1252,77,246,214,555,291,801
314650,201902,863,2127,543,1614,48,171,261,693,309,864
314655,201902,1538,4360,1110,3570,215,697,503,1590,718,2287
314660,201902,325,780,207,551,8,14,123,310,131,324
314670,201902,1644,3836,1152,3135,39,143,714,1922,753,2065
314675,201902,1714,4698,1465,4272,101,382,1111,3128,1212,3510
314690,201902,2039,5956,1566,5202,487,1738,424,1431,911,3169
314700,201902,9669,28193,6182,21072,1312,4952,1549,5123,2861,10075
314710,201902,7354,21036,5263,16684,1167,4053,1249,3521,2416,7574
314720,201902,2057,6251,1450,4997,331,1249,350,1181,681,2430
314730,201902,2018,5745,1463,4641,375,1239,354,1098,729,2337
314740,201902,2723,7822,2152,6807,287,1019,1113,3442,1400,4461
314750,201902,318,890,249,754,22,82,132,365,154,447
314760,201902,1815,5660,1198,4204,182,733,298,868,480,1601
314770,201902,1062,3185,535,1772,50,172,136,399,186,571
314780,201902,347,846,228,670,47,159,116,306,163,465
314790,201902,9422,26112,6496,20777,1708,6202,1780,5273,3488,11475
314795,201902,1412,3867,1203,3517,42,181,937,2624,979,2805
314800,201902,10556,27336,6154,19038,1242,4184,1202,3345,2444,7529
314810,201902,8295,22935,6084,19039,1719,5677,1788,5659,3507,11336
314820,201902,953,2480,738,2135,64,252,468,1286,532,1538
314830,201902,1443,4520,1215,4056,271,978,557,1838,828,2816
314840,201902,874,2861,677,2534,65,344,459,1634,524,1978
314850,201902,1870,4713,1533,4235,47,173,1317,3623,1364,3796
314860,201902,3085,9549,2579,8546,370,1397,1569,5022,1939,6419
314870,201902,6069,16254,4690,14346,356,1204,3378,10369,3734,11573
314875,201902,1714,5256,1527,5003,113,327,1238,4107,1351,4434
314880,201902,879,2157,689,1892,31,84,469,1343,500,1427
314890,201902,401,1174,292,933,48,172,110,317,158,489
314900,201902,618,1694,473,1436,107,345,182,546,289,891
314910,201902,1621,4772,1219,4116,258,1012,584,1847,842,2859
314915,201902,2193,6655,1864,6076,134,502,1253,3984,1387,4486
314920,201902,457,1186,292,933,11,42,197,626,208,668
314930,201902,5038,14937,3838,12645,786,2814,1366,4279,2152,7093
314940,201902,400,1062,338,952,38,101,202,533,240,634
314950,201902,440,1162,277,893,28,121,119,336,147,457
314960,201902,787,2028,617,1712,45,144,429,1118,474,1262
314970,201902,743,2190,596,1921,102,363,293,900,395,1263
314980,201902,1262,3401,918,2871,255,900,280,850,535,1750
314990,201902,2266,6677,1527,4955,334,1196,319,904,653,2100
314995,201902,1597,4600,1275,4014,78,331,809,2424,887,2755
315000,201902,1076,2882,773,2396,74,249,494,1474,568,1723
315010,201902,380,1086,277,891,48,190,121,352,169,542
315015,201902,2136,6271,1899,5893,197,701,1253,3843,1450,4544
315020,201902,756,2299,565,1884,68,272,251,756,319,1028
315030,201902,569,1595,374,1212,98,331,76,230,174,561
315040,201902,807,2393,692,2120,94,310,436,1336,530,1646
315050,201902,1102,2934,838,2542,70,272,456,1353,526,1625
315053,201902,1131,3028,875,2568,66,214,509,1444,575,1658
315057,201902,1589,5126,1376,4701,169,587,873,3026,1042,3613
315060,201902,572,1796,410,1454,81,300,94,329,175,629
315070,201902,554,1495,393,1202,105,358,102,276,207,634
315080,201902,2542,7806,2000,6680,383,1305,986,3245,1369,4550
315090,201902,775,2434,580,2038,105,395,196,651,301,1046
315100,201902,1110,3481,712,2513,142,576,277,869,419,1445
315110,201902,1549,4055,1181,3443,140,419,575,1693,715,2112
315120,201902,11526,27620,8260,22687,1130,3031,4228,12094,5358,15125
315130,201902,1282,3790,1033,3308,161,605,394,1181,555,1786
315140,201902,2765,7869,2112,6671,422,1498,1020,2994,1442,4492
315150,201902,4120,10377,2897,8341,446,1438,1298,3624,1744,5062
315160,201902,1543,3928,998,3025,214,655,418,1243,632,1898
315170,201902,1383,4442,936,3349,239,882,168,600,407,1482
315180,201902,16177,40677,8390,25634,1246,4383,2308,6192,3554,10575
315190,201902,2038,4712,1610,4139,215,570,1174,2996,1389,3566
315200,201902,3591,10654,2616,8854,792,2882,613,2034,1405,4916
315210,201902,7852,21099,5587,16235,706,2270,2579,6796,3285,9066
315213,201902,1115,3017,961,2799,29,90,763,2209,792,2299
315217,201902,2482,7808,1982,6925,104,509,1331,4496,1435,5005
315220,201902,7823,21914,6291,19264,1632,5278,2317,7062,3949,12340
315230,201902,3074,7346,2602,6771,100,234,2087,5628,2187,5862
315240,201902,2300,7080,1989,6510,507,1780,1007,3217,1514,4997
315250,201902,10458,29546,7692,24381,1332,4610,3253,9952,4585,14562
315260,201902,965,2798,516,1742,88,286,38,113,126,399
315270,201902,773,2319,529,1835,78,309,154,447,232,756
315280,201902,2776,7065,1603,4849,377,1228,247,733,624,1961
315290,201902,1174,2994,702,2239,205,710,189,609,394,1319
315300,201902,688,1676,441,1326,146,485,140,425,286,910
315310,201902,1285,3725,957,3091,85,301,532,1618,617,1919
315320,201902,685,2013,476,1607,61,259,211,653,272,912
315330,201902,738,2600,414,1683,76,335,115,415,191,750
315340,201902,3092,7769,2293,6618,135,454,1504,4304,1639,4758
315350,201902,1488,4149,1127,3539,175,609,582,1792,757,2401
315360,201902,1633,5041,1190,4051,193,701,453,1458,646,2159
315370,201902,435,1298,346,1106,65,204,144,452,209,656
315380,201902,174,541,129,433,38,132,18,39,56,171
315390,201902,1155,3425,875,2872,172,630,332,1006,504,1636
315400,201902,3976,11311,3128,9741,460,1510,1571,4723,2031,6233
315410,201902,2262,5293,1764,4577,445,1251,421,1095,866,2346
315415,201902,1185,3378,948,3005,219,826,399,1245,618,2071
315420,201902,1116,3266,725,2503,148,523,94,313,242,836
315430,201902,3515,8800,2463,7164,482,1663,980,2633,1462,4296
315440,201902,967,2644,781,2325,91,331,427,1175,518,1506
315445,201902,2001,4917,1436,4087,119,381,997,2801,1116,3182
315450,201902,2167,6292,1800,5702,248,754,1129,3623,1377,4377
315460,201902,31836,93053,26380,83078,5823,20026,11632,34651,17455,54677
315470,201902,445,1276,358,1124,40,145,198,590,238,735
315480,201902,1270,3736,873,2878,179,613,265,849,444,1462
315490,201902,2951,7387,1995,5926,264,823,739,2172,1003,2995
315500,201902,488,1361,292,918,33,132,126,339,159,471
315510,201902,1241,3435,1065,3162,27,133,907,2617,934,2750
315520,201902,1060,2972,827,2575,56,214,592,1790,648,2004
315530,201902,609,1831,472,1557,170,602,175,550,345,1152
315540,201902,1310,3641,894,2840,112,435,375,1137,487,1572
315550,201902,1808,4884,1216,3849,277,999,337,1003,614,2002
315560,201902,6161,19430,5324,17877,349,1200,3526,11938,3875,13138
315570,201902,1830,5279,1538,4759,102,428,895,2639,997,3067
315580,201902,2251,5767,1712,4897,355,1141,585,1633,940,2774
315590,201902,891,2407,711,2120,98,348,342,954,440,1302
315600,201902,2358,7779,1734,6545,269,1025,936,3639,1205,4664
315610,201902,886,2297,681,1906,131,438,294,700,425,1138
315620,201902,302,985,276,947,45,159,166,591,211,750
315630,201902,855,2414,686,2124,158,542,238,665,396,1207
315640,201902,324,864,269,790,31,111,166,460,197,571
315645,201902,943,2483,629,1953,154,522,160,462,314,984
315650,201902,1692,4383,1355,3894,47,191,1095,3038,1142,3229
315660,201902,2444,6026,1826,4959,116,336,1280,3339,1396,3675
315670,201902,13146,37540,10200,32145,2202,7287,4363,13317,6565,20604
315680,201902,2983,9152,2195,7597,381,1458,965,3211,1346,4669
315690,201902,2461,6568,1617,5031,375,1204,485,1670,860,2874
315700,201902,7445,21446,5668,17859,988,3298,2495,7562,3483,10860
315710,201902,1826,4696,1318,3900,64,278,896,2507,960,2785
315720,201902,4206,12177,3556,10986,202,916,2486,7334,2688,8250
315725,201902,1822,5218,1420,4430,162,507,935,2964,1097,3471
315727,201902,526,1418,391,1183,61,207,158,450,219,657
315730,201902,621,1923,548,1778,64,236,248,768,312,1004
315733,201902,1388,3622,955,2841,149,539,358,997,507,1536
315737,201902,1088,3220,866,2790,45,193,603,1878,648,2071
315740,201902,918,2636,719,2226,119,428,386,1092,505,1520
315750,201902,1223,3351,988,2958,85,271,631,1897,716,2168
315760,201902,1201,2885,1102,2766,47,120,956,2390,1003,2510
315765,201902,1839,4995,1513,4573,37,119,1313,3966,1350,4085
315770,201902,982,3022,830,2812,318,1171,250,789,568,1960
315780,201902,27139,77548,22840,69758,1960,7297,14457,42110,16417,49407
315790,201902,3525,11070,3022,10123,215,747,2004,6867,2219,7614
315800,201902,1180,4413,846,3463,158,720,191,722,349,1442
315810,201902,1307,3270,1099,2958,55,202,865,2195,920,2397
315820,201902,2494,7177,2047,6479,221,783,1374,4279,1595,5062
315830,201902,1026,3031,755,2528,63,262,341,1075,404,1337
315840,201902,794,1992,500,1443,54,182,232,613,286,795
315850,201902,1092,3347,890,2994,173,641,448,1413,621,2054
315860,201902,483,1471,337,1192,76,307,91,300,167,607
315870,201902,461,1215,363,1072,34,117,243,672,277,789
315880,201902,1090,2850,734,2242,61,236,216,605,277,841
315890,201902,1541,4622,1226,4149,332,1211,562,1843,894,3054
315895,201902,5830,16246,4497,13595,515,1775,2260,6368,2775,8143
315900,201902,829,2181,719,2029,53,170,538,1457,591,1627
315910,201902,506,1509,421,1362,71,260,266,825,337,1085
315920,201902,1566,4123,829,2571,143,477,234,672,377,1149
315930,201902,1046,2459,694,1927,133,374,298,823,431,1197
315935,201902,773,2403,632,2129,122,429,209,723,331,1152
315940,201902,596,1741,484,1542,58,195,249,773,307,968
315950,201902,1153,3255,980,2971,105,306,746,2285,851,2591
315960,201902,3875,11152,2244,7816,733,2959,153,336,886,3295
315970,201902,640,1729,488,1524,62,204,326,1025,388,1229
315980,201902,4099,9130,2211,6002,408,1181,746,1863,1154,3044
315990,201902,3523,9086,2746,7787,299,898,1613,4496,1912,5394
316000,201902,518,1414,400,1243,66,258,169,487,235,745
316010,201902,782,2110,592,1796,37,133,381,1065,418,1198
316020,201902,954,2962,773,2605,81,347,473,1473,554,1820
316030,201902,2833,7931,2073,6587,240,800,1300,4190,1540,4990
316040,201902,2519,7558,1821,6174,306,1122,450,1419,756,2541
316045,201902,2019,5424,1824,5168,103,238,1502,4372,1605,4610
316050,201902,364,1084,272,915,42,161,148,475,190,636
316060,201902,663,1817,501,1565,35,149,340,983,375,1132
316070,201902,5300,15299,4374,13492,814,2640,1982,5900,2796,8540
316080,201902,719,2284,568,1971,149,564,73,236,222,800
316090,201902,412,1260,288,987,37,152,124,384,161,536
316095,201902,1269,4008,1033,3446,236,823,402,1308,638,2131
316100,201902,2464,7533,1751,5906,327,1193,554,1696,881,2889
316105,201902,845,2296,648,1994,64,212,427,1340,491,1552
316110,201902,12495,37847,10528,34448,1066,3846,6942,22574,8008,26420
316120,201902,1060,3182,671,2200,120,428,177,464,297,892
316130,201902,1182,2695,725,1971,58,191,406,1068,464,1259
316140,201902,1075,2935,715,2289,120,410,339,1072,459,1482
316150,201902,1746,4041,1439,3625,237,731,593,1365,830,2096
316160,201902,1023,2877,828,2536,67,237,525,1548,592,1785
316165,201902,894,2278,667,1916,99,336,349,952,448,1288
316170,201902,1067,2805,793,2389,77,282,493,1413,570,1695
316180,201902,1221,3584,801,2698,173,666,129,349,302,1015
316190,201902,2578,7491,1515,4923,243,793,529,1498,772,2291
316200,201902,3219,9534,2306,7769,517,1955,536,1689,1053,3644
316210,201902,4204,12593,3003,9854,963,3389,375,1184,1338,4573
316220,201902,599,1826,394,1346,81,312,48,189,129,501
316225,201902,1419,3372,1081,2802,42,164,798,1933,840,2097
316230,201902,409,1108,311,953,39,120,163,513,202,633
316240,201902,5651,16686,5016,15636,424,1398,3826,11777,4250,13175
316245,201902,2904,9876,2630,9425,159,901,1975,6736,2134,7637
316250,201902,9255,23441,6549,19009,1609,5069,1981,5654,3590,10723
316255,201902,2786,7961,2422,7391,197,663,1738,5332,1935,5995
316257,201902,1218,3034,869,2472,142,411,439,1234,581,1645
316260,201902,1798,4795,1356,4078,85,274,741,2307,826,2581
316265,201902,1144,3145,890,2704,47,179,617,1820,664,1999
316270,201902,3486,11164,2975,10013,557,1982,1363,4390,1920,6372
316280,201902,2911,8822,2504,8049,375,1334,1351,4213,1726,5547
316290,201902,3228,9277,2518,7887,361,1301,973,3019,1334,4320
316292,201902,4629,12715,3798,11392,449,1525,2607,7628,3056,9153
316294,201902,769,2327,564,1971,113,458,108,355,221,813
316295,201902,2728,7865,2255,7017,125,510,1591,4718,1716,5228
316300,201902,939,2955,800,2701,55,219,540,1823,595,2042
316310,201902,936,2380,543,1709,93,338,115,305,208,643
316320,201902,583,1666,449,1424,49,192,203,608,252,800
316330,201902,1036,2888,769,2372,60,227,530,1562,590,1789
316340,201902,1010,2906,746,2394,76,312,388,1173,464,1485
316350,201902,1172,3511,1003,3229,118,403,659,2104,777,2507
316360,201902,647,1714,512,1496,58,198,362,1030,420,1228
316370,201902,4686,13089,3550,10946,724,2570,1161,3184,1885,5754
316380,201902,1611,3980,1261,3494,46,116,914,2546,960,2662
316390,201902,848,2301,608,1872,210,733,141,398,351,1131
316400,201902,1177,3420,785,2641,128,474,279,855,407,1329
316410,201902,1073,3232,900,2952,66,252,696,2230,762,2482
316420,201902,1741,5107,1525,4840,57,257,1248,3862,1305,4119
316430,201902,831,2292,519,1698,120,428,123,383,243,811
316440,201902,689,2208,537,1947,128,523,85,295,213,818
316443,201902,540,1572,412,1322,111,388,99,313,210,701
316447,201902,1798,4990,1576,4638,55,208,1278,3705,1333,3913
316450,201902,2197,6824,1683,5756,210,777,1006,3377,1216,4154
316460,201902,928,2467,752,2194,197,620,382,1059,579,1679
316470,201902,6055,17815,4462,14536,837,3111,1577,4742,2414,7853
316480,201902,206,584,172,526,34,112,82,236,116,348
316490,201902,289,778,212,640,24,83,90,234,114,317
316500,201902,1178,3877,772,2838,161,641,134,461,295,1102
316510,201902,702,2374,553,2078,118,479,235,891,353,1370
316520,201902,1032,2763,805,2372,130,463,378,1027,508,1490
316530,201902,1020,2848,752,2355,120,480,332,904,452,1384
316540,201902,746,2076,609,1869,112,404,280,798,392,1202
316550,201902,1309,4019,1137,3674,80,319,842,2663,922,2982
316553,201902,3411,10452,2337,7864,511,1850,604,1834,1115,3684
316555,201902,2489,8364,2273,8048,145,597,1747,6278,1892,6875
316556,201902,573,1405,402,1118,21,59,230,582,251,641
316557,201902,922,3061,797,2834,309,1150,230,804,539,1954
316560,201902,261,798,201,714,55,226,57,181,112,407
316570,201902,1097,3382,958,3111,252,819,355,1166,607,1985
316580,201902,395,920,249,666,47,145,108,264,155,409
316590,201902,1299,3475,937,2771,156,466,510,1442,666,1908
316600,201902,954,3027,821,2742,138,501,428,1384,566,1885
316610,201902,584,1872,488,1721,61,286,302,1004,363,1290
316620,201902,2006,5665,1734,5296,88,311,1268,3912,1356,4223
316630,201902,1517,4585,1206,3992,329,1091,471,1704,800,2795
316640,201902,142,387,113,345,22,69,54,145,76,214
316650,201902,1004,3291,806,2978,71,280,501,1900,572,2180
316660,201902,193,491,87,267,10,34,10,35,20,69
316670,201902,1813,4753,1357,4008,352,1114,437,1248,789,2362
316680,201902,2079,5455,1605,4652,136,441,1160,3282,1296,3723
316690,201902,1063,3238,875,2877,162,576,402,1306,564,1882
316695,201902,980,2918,816,2625,39,171,559,1771,598,1942
316700,201902,358,878,298,812,12,52,229,589,241,641
316710,201902,2776,9445,2118,8031,535,2140,778,2965,1313,5105
316720,201902,19573,55718,14437,45643,2901,9880,5596,16884,8497,26764
316730,201902,392,1130,313,966,57,199,139,375,196,574
316740,201902,687,2095,608,1966,58,257,411,1314,469,1571
316750,201902,384,1192,293,998,64,236,113,360,177,596
316760,201902,3597,11618,2945,10262,1230,4587,772,2600,2002,7187
316770,201902,1507,3712,1211,3305,35,121,1024,2817,1059,2938
316780,201902,547,1690,427,1463,142,569,72,213,214,782
316790,201902,700,1900,476,1471,117,378,137,389,254,767
316800,201902,5862,17099,4746,15068,430,1598,2656,8174,3086,9772
316805,201902,984,2187,819,2010,21,41,711,1796,732,1837
316810,201902,604,1705,420,1339,87,331,201,613,288,944
316820,201902,320,792,161,495,16,55,52,160,68,215
316830,201902,668,1931,542,1716,85,333,333,998,418,1331
316840,201902,2635,7312,2199,6542,303,1061,1318,3716,1621,4777
316850,201902,1980,5306,1428,4312,199,673,641,1881,840,2554
316860,201902,16772,45684,12814,39694,2388,8406,5807,17583,8195,25989
316870,201902,6700,19229,5023,15950,921,3267,2014,5913,2935,9180
316880,201902,777,2131,640,1939,136,459,291,869,427,1328
316890,201902,1119,2559,681,1962,130,450,371,944,501,1394
316900,201902,2213,6176,1713,5182,358,1204,568,1539,926,2743
316905,201902,507,1544,393,1317,90,327,157,529,247,856
316910,201902,846,2291,555,1797,146,538,54,162,200,700
316920,201902,1546,4026,1023,3173,187,609,419,1315,606,1924
316930,201902,7578,23102,5507,19100,1065,4002,1240,4156,2305,8158
316935,201902,3772,10613,2725,8689,583,1964,936,2901,1519,4865
316940,201902,6439,19585,4931,16312,879,3239,1712,5262,2591,8501
316950,201902,1749,4270,1348,3701,52,183,1059,2846,1111,3029
316960,201902,4852,11461,3585,9666,460,1360,2295,6024,2755,7384
316970,201902,3332,9895,2907,9045,644,2100,1092,3213,1736,5313
316980,201902,709,2157,512,1757,163,634,67,238,230,872
316990,201902,10136,28763,7235,22620,1992,6595,862,2458,2854,9053
317000,201902,2559,7919,2290,7513,155,510,1662,5497,1817,6007
317005,201902,2536,7454,2046,6441,363,1174,1029,3166,1392,4340
317010,201902,21790,52503,13357,39611,3268,10588,3962,12232,7230,22820
317020,201902,59264,143585,33495,98062,6345,20258,9245,24928,15590,45186
317030,201902,640,1790,514,1606,30,124,386,1178,416,1302
317040,201902,10206,26928,7319,21892,1785,5581,2633,8058,4418,13639
317043,201902,802,1912,596,1626,90,244,376,1056,466,1300
317047,201902,1158,2841,784,2232,115,300,447,1292,562,1592
317050,201902,1177,3726,807,2831,112,409,311,981,423,1390
317052,201902,2330,6835,1904,6114,263,905,1201,3816,1464,4721
317057,201902,1619,4118,1149,3300,56,210,713,1987,769,2197
317060,201902,423,1139,252,777,42,145,88,242,130,387
317065,201902,1216,3572,990,3144,58,221,637,1895,695,2116
317070,201902,7518,21139,5072,16337,1122,4081,1116,3419,2238,7500
317075,201902,852,2366,583,1860,113,389,159,471,272,860
317080,201902,5815,14228,4278,11693,1359,3949,1199,3040,2558,6989
317090,201902,4294,13419,3908,12775,378,1205,2803,9160,3181,10365
317100,201902,2349,5744,1585,4570,434,1368,565,1570,999,2938
317103,201902,1757,5544,1543,5151,163,779,1024,3187,1187,3966
317107,201902,1298,3637,1020,3074,54,236,625,1672,679,1908
317110,201902,673,1499,326,979,40,149,108,332,148,481
317115,201902,1089,3164,919,2844,58,171,650,2014,708,2185
317120,201902,11906,34378,9367,30066,1393,5071,4914,15209,6307,20280
317130,201902,9646,23419,6009,17408,1164,3715,1926,5483,3090,9198
317140,201902,637,1833,515,1631,45,153,325,1045,370,1198
317150,201902,998,2494,783,2217,36,138,613,1679,649,1817
317160,201902,3528,8698,2388,6954,223,682,1381,4055,1604,4737
317170,201902,1881,4862,1313,3831,226,770,472,1184,698,1954
317180,201902,1707,5602,1285,4532,280,1028,338,1128,618,2156
317190,201902,1214,3375,903,2870,117,392,525,1669,642,2061
317200,201902,4835,13077,3588,10858,963,3158,738,2074,1701,5232
317210,201902,1128,2867,886,2530,43,158,633,1827,676,1985
317220,201902,274,881,239,807,64,221,85,293,149,514
320010,201902,4418,13188,3603,11596,410,1461,2275,7144,2685,8605
320013,201902,1568,4712,1133,3738,189,600,517,1748,706,2348
320016,201902,2963,7824,2368,6948,116,340,1884,5492,2000,5832
320020,201902,3804,10426,2870,8777,721,2357,977,3100,1698,5457
320030,201902,1480,4433,1029,3479,223,829,343,1093,566,1922
320035,201902,1679,4808,1407,4346,383,1277,598,1803,981,3080
320040,201902,3507,10438,2881,9255,446,1559,1515,4772,1961,6331
320050,201902,1737,4070,1496,3711,246,708,861,2069,1107,2777
320060,201902,10411,30152,7813,24973,1345,4707,3336,10177,4681,14884
320070,201902,1367,4006,993,3242,207,731,332,1057,539,1788
320080,201902,5308,14085,3816,11177,820,2503,1368,3892,2188,6395
320090,201902,7013,19275,5001,15268,1146,3773,2091,5988,3237,9761
320100,201902,2535,7451,2007,6466,434,1498,945,2969,1379,4467
320110,201902,1313,3468,1015,2953,215,656,415,1191,630,1847
320115,201902,1739,5833,1517,5447,668,2482,465,1743,1133,4225
320120,201902,16652,44340,11523,35128,2062,6865,4520,13159,6582,20024
320130,201902,36539,107315,30869,97002,4976,17121,17148,52490,22124,69611
320140,201902,2812,8270,2102,6799,398,1476,828,2622,1226,4098
320150,201902,12413,33411,8796,26254,2517,7967,1457,4096,3974,12063
320160,201902,5240,15493,4005,13071,678,2354,1874,6050,2552,8404
320170,201902,1428,4308,1062,3547,304,1035,381,1281,685,2316
320180,201902,692,2276,555,1994,193,737,125,435,318,1172
320190,201902,2732,9012,2097,7521,505,1917,495,1736,1000,3653
320200,201902,1050,2980,765,2449,202,742,246,771,448,1513
320210,201902,4348,11450,3402,9792,580,1836,1808,4969,2388,6805
320220,201902,2583,7235,1952,6137,367,1241,949,2917,1316,4158
320225,201902,1304,4190,903,3184,338,1286,131,447,469,1733
320230,201902,4482,12981,3416,11189,822,2935,1396,4510,2218,7445
320240,201902,13331,35841,10209,30661,2275,7233,4211,12560,6486,19793
320245,201902,2838,8848,2317,7768,951,3271,541,1801,1492,5072
320250,201902,1863,5372,1248,3919,312,1121,318,884,630,2005
320255,201902,1670,5505,1478,5164,530,1880,621,2292,1151,4172
320260,201902,1004,3009,715,2308,200,717,183,496,383,1213
320265,201902,2319,7360,1953,6643,921,3276,406,1370,1327,4646
320270,201902,2152,6336,1623,5240,344,1204,722,2326,1066,3530
320280,201902,5695,16061,4645,14192,1143,3701,1719,5230,2862,8931
320290,201902,1234,3825,836,2851,241,890,197,633,438,1523
320300,201902,3427,10907,2810,9568,900,3281,567,1857,1467,5138
320305,201902,4618,13651,3688,11758,831,2822,1669,5157,2500,7979
320310,201902,1815,5205,1260,3997,252,846,537,1657,789,2503
320313,201902,2187,5777,1390,4169,325,1050,290,831,615,1881
320316,201902,1450,4241,1201,3760,204,652,676,2116,880,2768
320320,201902,19824,53802,14189,44061,3489,11349,5275,16434,8764,27783
320330,201902,2816,7990,2227,6909,538,1635,1028,3311,1566,4946
320332,201902,5285,15635,4327,13927,1057,3658,2128,6748,3185,10406
320334,201902,1825,5445,1290,4278,293,1137,281,767,574,1904
320335,201902,1598,4720,1024,3416,264,938,211,653,475,1591
320340,201902,4672,12284,3898,11072,573,1708,2172,6250,2745,7958
320350,201902,4978,12701,3471,9946,484,1500,1749,4778,2233,6278
320360,201902,1427,3718,1055,3003,146,400,509,1414,655,1814
320370,201902,2346,7646,1873,6538,563,2037,635,2168,1198,4205
320380,201902,2216,6241,1860,5637,283,925,1093,3239,1376,4164
320390,201902,7160,20101,5380,16408,1166,3742,2124,6200,3290,9942
320400,201902,3176,9309,2542,7977,687,2276,1006,3067,1693,5343
320405,201902,4283,11725,3280,10008,540,1770,1622,4897,2162,6667
320410,201902,4617,12513,3529,10755,574,1724,1814,5806,2388,7530
320420,201902,2688,7483,2116,6530,611,2082,581,1767,1192,3849
320425,201902,1930,4732,1496,4022,113,349,1002,2574,1115,2923
320430,201902,2747,7092,2147,5947,327,980,1289,3408,1616,4388
320435,201902,2218,7142,1742,6159,626,2317,498,1796,1124,4113
320440,201902,1253,3635,929,2989,145,499,418,1309,563,1808
320450,201902,1536,4608,1222,4010,300,1088,530,1644,830,2732
320455,201902,3743,11710,2576,8918,731,2669,739,2459,1470,5128
320460,201902,2078,6420,1471,5049,377,1351,360,1170,737,2521
320465,201902,1202,3520,915,2939,119,420,520,1658,639,2078
320470,201902,3594,10155,2489,7848,640,2197,564,1659,1204,3856
320480,201902,1607,4654,1354,4175,235,813,719,2140,954,2953
320490,201902,18418,50145,13753,41831,2561,8696,5569,16691,8130,25387
320495,201902,1367,3848,937,3011,214,777,319,966,533,1743
320500,201902,46402,128419,38037,113715,6223,19977,21099,60925,27322,80902
320501,201902,4384,13020,3179,10796,896,3381,986,3280,1882,6661
320503,201902,1981,6218,1453,5070,458,1721,454,1460,912,3181
320506,201902,2600,7918,1808,6111,542,1979,164,537,706,2516
320510,201902,9398,26392,7638,23178,1087,3637,4362,12829,5449,16466
320515,201902,1695,4717,1311,3938,392,1251,405,1184,797,2435
320517,201902,1990,6274,1611,5439,560,2039,386,1282,946,3321
320520,201902,32343,87966,24364,74300,4638,15461,10097,29909,14735,45370
320530,201902,28570,78885,22614,68200,2675,9544,13497,38298,16172,47842
330010,201902,19472,54223,16060,48388,2813,8938,9229,27322,12042,36260
330015,201902,1444,3704,1124,3178,182,582,608,1634,790,2216
330020,201902,19241,49603,16839,46189,2305,7198,12026,32111,14331,39309
330022,201902,1918,5226,1457,4438,246,786,861,2574,1107,3360
330023,201902,4324,10659,2960,8662,608,1880,1357,3902,1965,5782
330025,201902,4659,11686,3151,9154,1000,3094,960,2772,1960,5866
330030,201902,9988,28033,7573,23755,958,3507,4393,13014,5351,16521
330040,201902,12763,34745,10468,30725,1262,4210,6797,19167,8059,23377
330045,201902,80537,196109,67318,178779,6865,17680,50997,134621,57862,152301
330050,201902,2312,6264,1726,5274,386,1247,775,2264,1161,3511
330060,201902,4779,13122,3982,11781,875,2845,1718,4756,2593,7601
330070,201902,21387,57039,17695,51373,3271,10146,9634,27690,12905,37836
330080,201902,8384,22196,7312,20601,996,2927,4803,13342,5799,16269
330090,201902,3409,7246,2215,5647,192,527,1417,3555,1609,4082
330093,201902,2386,6182,1770,5226,176,545,1246,3688,1422,4233
330095,201902,1152,3436,912,2966,86,354,510,1524,596,1878
330100,201902,65354,179861,55629,165133,3980,14162,41111,120000,45091,134162
330110,201902,1934,5762,1714,5422,301,1070,883,2689,1184,3759
330115,201902,2038,5291,1547,4554,243,776,899,2571,1142,3347
330120,201902,3356,7798,2488,6637,211,631,1768,4581,1979,5212
330130,201902,3522,10047,2937,9153,467,1553,1777,5520,2244,7073
330140,201902,3323,9056,2722,8144,414,1403,1652,4772,2066,6175
330150,201902,2032,5614,1575,4854,334,1102,687,2055,1021,3157
330160,201902,1307,3669,1034,3214,186,653,538,1573,724,2226
330170,201902,93174,247891,78630,227646,11523,33231,51276,149947,62799,183178
330180,201902,2097,5373,1645,4668,123,417,1125,3093,1248,3510
330185,201902,9117,24454,7572,21976,774,2642,5479,15380,6253,18022
330187,201902,3793,10006,3052,8867,436,1397,1872,5416,2308,6813
330190,201902,29832,75767,26027,70456,2239,6489,20270,54143,22509,60632
330200,201902,14027,37988,11788,35138,2501,7073,7213,22213,9714,29286
330205,201902,2053,5244,1582,4447,106,356,1087,2955,1193,3311
330210,201902,3280,8576,2367,6872,407,1272,940,2526,1347,3798
330220,201902,10623,27661,7661,22495,1823,5873,2332,6242,4155,12115
330225,201902,3318,8943,2658,7953,241,882,1835,5344,2076,6226
330227,201902,16283,41587,14110,38808,858,2674,11717,31726,12575,34400
330230,201902,1626,3799,1180,3229,73,220,835,2258,908,2478
330240,201902,20766,56083,16779,49513,2922,9358,9624,27577,12546,36935
330245,201902,1628,4137,933,2911,223,724,270,859,493,1583
330250,201902,33753,91193,28652,83384,6462,19120,14916,43953,21378,63073
330260,201902,4183,11199,3281,9876,493,1622,1910,5520,2403,7142
330270,201902,24946,52474,15207,38440,2814,7701,6387,15823,9201,23524
330280,201902,2309,6215,1731,5197,205,678,971,2798,1176,3476
330285,201902,20648,51867,16641,46040,1753,5508,11569,31033,13322,36541
330290,201902,3415,8929,2764,7965,402,1265,1673,4676,2075,5941
330300,201902,5268,13097,3757,10794,421,1349,2331,6554,2752,7903
330310,201902,2187,5750,1675,4882,102,290,1102,3228,1204,3518
330320,201902,14628,36836,11759,33114,1558,4490,8279,23369,9837,27859
330330,201902,30743,72950,24778,64618,2916,8354,17160,43654,20076,52008
330340,201902,13506,34941,9976,29219,1897,6140,4746,13288,6643,19428
330350,201902,103451,259094,87327,238695,7738,22306,67271,183086,75009,205392
330360,201902,7385,18451,6395,17265,324,934,5367,14399,5691,15333
330370,201902,4558,13388,3366,11259,800,2818,1312,4512,2112,7330
330380,201902,4969,14093,3800,11976,826,2895,1646,4966,2472,7861
330385,201902,3841,11652,3197,10656,817,2977,1425,4784,2242,7761
330390,201902,23177,67302,18358,58197,3176,11176,9373,28363,12549,39539
330395,201902,3123,8098,2612,7407,228,711,1763,4892,1991,5603
330400,201902,2932,8205,2576,7587,195,721,1862,5174,2057,5895
330410,201902,2801,7828,2077,6523,436,1458,888,2644,1324,4102
330411,201902,2658,7338,2134,6361,176,613,1474,4213,1650,4826
330412,201902,1422,4308,1173,3861,166,608,649,2003,815,2611
330414,201902,22553,58881,18479,53204,2090,6049,12777,36637,14867,42686
330415,201902,3548,9993,2763,8651,388,1220,1530,4875,1918,6095
330420,201902,9622,24462,6438,19152,955,3117,2759,7768,3714,10885
330430,201902,8595,21982,7430,20258,576,1888,5490,14413,6066,16301
330440,201902,2090,5912,1579,5068,360,1298,741,2261,1101,3559
330450,201902,1292,3870,1047,3406,157,555,523,1657,680,2212
330452,201902,14619,38536,11594,33794,2014,6373,6599,18706,8613,25079
330455,201902,528427,1300368,403920,1114750,66173,193240,239197,649896,305370,843136
330460,201902,1161,3331,894,2912,188,656,433,1372,621,2028
330470,201902,4552,11869,3404,10073,973,2977,1255,3759,2228,6736
330475,201902,8656,23253,6971,20987,1344,4461,4151,12251,5495,16712
330480,201902,5794,15729,4972,14462,543,1774,3238,9131,3781,10905
330490,201902,112931,269676,94497,243993,10801,29714,66821,169804,77622,199518
330500,201902,6071,16229,5148,14919,665,2128,3606,10292,4271,12420
330510,201902,36954,98069,29204,86925,6944,21388,15256,45274,22200,66662
330513,201902,1250,3331,987,2939,235,752,455,1335,690,2087
330515,201902,2452,6840,2019,6141,544,1760,912,2687,1456,4447
330520,201902,10515,29222,8722,26229,1358,4535,4903,14237,6261,18772
330530,201902,1644,4160,1204,3417,265,814,519,1410,784,2224
330540,201902,2830,7767,2196,6635,643,1964,798,2408,1441,4372
330550,201902,7844,22763,6420,20574,2214,7572,1974,6224,4188,13796
330555,201902,13400,31784,11186,28977,1288,3685,7979,20725,9267,24410
330560,201902,4231,11627,3459,10298,509,1578,2051,5919,2560,7497
330570,201902,2825,7949,2322,7075,400,1324,1389,4182,1789,5506
330575,201902,5302,14206,4593,12967,368,1175,3490,9504,3858,10679
330580,201902,13649,38469,10506,32537,2306,7731,4591,13633,6897,21364
330590,201902,1482,4168,1286,3919,184,561,880,2727,1064,3288
330600,201902,11197,30870,8856,26895,1303,4176,4946,14861,6249,19037
330610,201902,8996,24944,7455,22489,752,2667,4922,14430,5674,17097
330615,201902,2020,5679,1552,5018,324,1138,921,2982,1245,4120
330620,201902,3708,11254,3010,9981,862,3119,1047,3220,1909,6339
330630,201902,23965,62683,18869,54362,1855,6315,12741,35219,14596,41534
350010,201902,1874,5085,924,2922,239,784,104,255,343,1039
350020,201902,677,1789,358,1142,48,162,129,368,177,530
350030,201902,3704,10749,2718,8854,717,2476,900,2832,1617,5308
350040,201902,642,1925,388,1365,65,259,119,350,184,609
350050,201902,904,2420,640,1940,139,501,206,483,345,984
350055,201902,788,2106,659,1923,46,160,510,1465,556,1625
350060,201902,105,282,77,234,15,46,39,114,54,160
350070,201902,3611,9632,2225,7008,437,1450,715,2066,1152,3516
350075,201902,598,1848,442,1525,189,687,52,165,241,852
350080,201902,608,1648,368,1161,43,155,165,473,208,628
350090,201902,625,1516,362,1035,80,239,116,307,196,546
350100,201902,2068,5630,1355,4300,167,627,686,2044,853,2671
350110,201902,448,1194,315,959,21,74,175,530,196,604
350115,201902,1288,3836,1044,3300,190,666,518,1486,708,2152
350120,201902,661,1619,354,1013,52,162,166,447,218,609
350130,201902,3035,8375,2427,7210,392,1257,1245,3504,1637,4761
350140,201902,684,2040,464,1591,44,199,244,765,288,964
350150,201902,511,1590,421,1413,98,335,106,330,204,665
350160,201902,10545,26605,6920,20146,859,2980,4098,11182,4957,14162
350170,201902,1763,5295,1351,4343,279,931,483,1466,762,2397
350180,201902,1101,2787,543,1676,121,391,153,443,274,834
350190,201902,2778,8000,1947,6283,410,1521,743,1977,1153,3498
350200,201902,409,1151,327,1001,24,80,226,659,250,739
350210,201902,5234,12374,3478,9695,640,1872,1906,5140,2546,7012
350220,201902,2764,7651,1870,5908,441,1464,641,1847,1082,3311
350230,201902,925,2569,770,2320,153,495,391,1146,544,1641
350240,201902,672,2019,446,1471,77,259,146,464,223,723
350250,201902,2319,7158,1759,6135,621,2371,315,1145,936,3516
350260,201902,798,1975,511,1454,61,180,298,819,359,999
350270,201902,4539,12740,3616,10918,619,2025,1798,5081,2417,7106
350275,201902,2279,6463,1817,5636,314,1088,973,2841,1287,3929
350280,201902,18671,42420,11007,30032,2037,5905,3952,10467,5989,16372
350290,201902,2996,8415,2009,6370,390,1377,771,2284,1161,3661
350300,201902,658,1828,465,1418,88,292,196,551,284,843
350310,201902,783,2360,586,1919,95,389,233,658,328,1047
350315,201902,545,1482,374,1166,42,155,161,447,203,602
350320,201902,12421,33444,9496,28224,2396,7651,2871,8261,5267,15912
350330,201902,13463,34132,9617,26495,1321,3936,5577,14489,6898,18425
350335,201902,350,1004,265,845,20,76,161,496,181,572
350340,201902,1094,2920,637,2051,118,404,220,715,338,1119
350350,201902,743,2000,583,1813,89,320,305,914,394,1234
350360,201902,963,3005,786,2599,243,802,235,795,478,1597
350370,201902,578,1516,389,1151,121,335,87,255,208,590
350380,201902,4381,11994,2906,9101,771,2465,745,2396,1516,4861
350390,201902,9239,25816,7422,22591,1915,6048,2935,8776,4850,14824
350395,201902,415,1077,197,648,22,66,61,189,83,255
350400,201902,7598,19639,5341,15790,1407,4537,1538,4318,2945,8855
350410,201902,8928,25854,6470,20931,1539,5558,2115,6315,3654,11873
350420,201902,643,1818,473,1504,90,323,105,305,195,628
350430,201902,661,1843,546,1646,64,231,337,930,401,1161
350440,201902,1698,4534,1367,4005,153,543,847,2388,1000,2931
350450,201902,6326,18242,4976,15763,1147,3908,1906,5744,3053,9652
350460,201902,1621,4178,800,2511,141,480,151,407,292,887
350470,201902,260,659,194,539,8,33,125,318,133,351
350480,201902,846,2292,545,1699,113,388,85,227,198,615
350490,201902,1764,4853,1292,4013,306,970,409,1179,715,2149
350500,201902,657,1791,512,1532,89,292,243,688,332,980
350510,201902,1062,2866,757,2280,94,302,401,1158,495,1460
350520,201902,1886,6058,1450,5137,268,1081,606,1973,874,3054
350530,201902,2539,6561,1840,5191,263,823,1018,2689,1281,3512
350535,201902,1427,4065,1239,3786,164,575,807,2392,971,2967
350540,201902,1692,4442,1233,3700,208,657,643,1915,851,2572
350550,201902,8954,22133,5968,17220,679,2276,3099,8380,3778,10656
350560,201902,3713,10776,2961,9342,268,918,1818,5545,2086,6463
350570,201902,21478,62354,17334,54034,3790,12908,7976,23657,11766,36565
350580,201902,1810,5060,974,3170,231,805,144,383,375,1188
350590,201902,4346,12246,3174,9610,546,1917,1711,4716,2257,6633
350600,201902,36724,88120,23020,63298,3276,9950,11000,27703,14276,37653
350610,201902,6387,18044,4646,14541,949,3144,1995,6059,2944,9203
350620,201902,416,1044,254,797,33,119,136,401,169,520
350630,201902,1462,3924,1062,3190,75,294,651,1834,726,2128
350635,201902,7543,19569,5711,16620,1045,3425,3136,8616,4181,12041
350640,201902,913,2516,488,1525,62,204,168,453,230,657
350650,201902,7550,20893,5021,15657,1032,3464,1574,4577,2606,8041
350660,201902,4379,11936,3416,10289,651,1964,1693,5163,2344,7127
350670,201902,1742,4803,1442,4364,177,571,911,2755,1088,3326
350680,201902,1094,3000,710,2260,147,500,301,915,448,1415
350690,201902,1133,3177,851,2650,156,510,434,1304,590,1814
350700,201902,4853,12451,3102,9694,579,2020,1230,3582,1809,5602
350710,201902,2598,7373,2191,6659,324,1117,1243,3604,1567,4721
350715,201902,858,2480,703,2179,77,293,328,915,405,1208
350720,201902,165,402,118,325,26,80,50,124,76,204
350730,201902,516,1519,405,1300,39,159,263,789,302,948
350740,201902,1554,4383,1028,3249,185,602,288,836,473,1438
350745,201902,538,1485,331,1055,34,125,145,425,179,550
350750,201902,9142,25046,7006,21113,1328,4537,2903,7773,4231,12310
350760,201902,13054,33971,9150,27129,2347,7541,2698,7208,5045,14749
350770,201902,875,2209,560,1653,60,185,334,960,394,1145
350775,201902,668,1688,472,1367,54,164,205,575,259,739
350780,201902,1921,5010,1363,4133,286,953,431,1469,717,2422
350790,201902,1638,4512,1023,3335,198,714,217,595,415,1309
350800,201902,3130,9456,2711,8706,430,1494,1474,4623,1904,6117
350810,201902,2408,6168,1902,5451,299,900,1040,3033,1339,3933
350820,201902,815,1990,466,1337,51,163,233,615,284,778
350830,201902,837,2394,462,1536,63,228,132,384,195,612
350840,201902,2750,8441,2027,7009,507,1893,751,2438,1258,4331
350850,201902,6511,18996,4952,15971,1261,4331,1711,5349,2972,9680
350860,201902,3220,9104,2856,8567,146,567,2144,6298,2290,6865
350870,201902,2664,7708,1953,6528,324,1211,1000,3217,1324,4428
350880,201902,1184,3555,953,3053,230,756,310,967,540,1723
350890,201902,569,1520,358,1082,49,163,125,329,174,492
350900,201902,6238,17836,4002,12845,1168,4039,774,2316,1942,6355
350910,201902,833,2209,718,2011,109,352,475,1283,584,1635
350920,201902,11500,29852,9843,27023,557,1837,7722,20346,8279,22183
350925,201902,4309,12231,3106,9924,628,2132,1332,3890,1960,6022
350930,201902,1429,3692,954,2795,123,388,513,1441,636,1829
350940,201902,1977,5597,1583,4876,205,684,986,2965,1191,3649
350945,201902,847,2446,639,2031,117,418,276,797,393,1215
350950,201902,79113,212602,61471,177800,9027,28704,35761,98428,44788,127132
350960,201902,5556,15867,4326,13524,680,2378,2395,7090,3075,9468
350970,201902,3428,10438,2558,8580,858,3158,374,1096,1232,4254
350980,201902,590,1693,464,1451,147,488,172,533,319,1021
350990,201902,1687,5035,1269,4323,325,1258,431,1376,756,2634
350995,201902,752,2438,679,2282,47,208,458,1456,505,1664
351000,201902,2602,6910,1833,5515,370,1209,575,1669,945,2878
351010,201902,303,757,186,539,17,52,95,263,112,315
351015,201902,708,2191,579,1939,84,338,280,847,364,1185
351020,201902,8944,25065,6783,21376,1362,4503,3443,10612,4805,15115
351030,201902,2444,7537,1980,6578,327,1212,1008,3239,1335,4451
351040,201902,4501,11789,3829,10714,237,833,3019,8127,3256,8960
351050,201902,16551,41255,11074,32443,2427,7567,4299,12419,6726,19986
351060,201902,44551,115970,34217,97931,4487,13998,21488,59519,25975,73517
351070,201902,1306,3434,767,2452,235,806,107,325,342,1131
351080,201902,2545,6658,1860,5781,342,1235,1027,2971,1369,4206
351090,201902,325,982,225,786,43,153,54,195,97,348
351100,201902,2296,6402,1485,4725,365,1245,405,1303,770,2548
351110,201902,5673,14926,3712,11286,736,2440,1431,4033,2167,6473
351120,201902,739,1963,502,1539,84,274,217,623,301,897
351130,201902,1031,2699,465,1508,97,333,77,223,174,556
351140,201902,1771,5233,1266,4234,331,1221,369,1076,700,2297
351150,201902,1903,5708,1188,4056,250,913,363,1101,613,2014
351160,201902,1085,3543,860,3018,197,726,268,835,465,1561
351170,201902,1348,3917,1167,3549,131,442,740,2158,871,2600
351190,201902,840,2439,590,1873,113,344,236,703,349,1047
351200,201902,1580,3941,1202,3362,76,239,803,2148,879,2387
351210,201902,1518,3816,875,2502,89,298,481,1258,570,1556
351220,201902,3034,8934,2621,8223,351,1147,1674,5198,2025,6345
351230,201902,1752,4997,1290,4165,272,1018,520,1480,792,2498
351240,201902,1958,5193,1282,3765,257,803,557,1507,814,2310
351250,201902,1082,2870,591,1852,75,251,221,688,296,939
351260,201902,935,2490,688,2037,165,477,232,700,397,1177
351270,201902,377,1103,311,989,54,213,164,448,218,661
351280,201902,3899,10746,3004,9005,524,1729,1424,4052,1948,5781
351290,201902,1010,2656,686,2067,123,379,322,950,445,1329
351300,201902,14653,41598,10082,32586,2101,7254,3818,12151,5919,19405
351310,201902,3057,8044,2333,6841,232,833,1530,4200,1762,5033
351320,201902,862,2630,642,2100,109,385,235,716,344,1101
351330,201902,606,1867,525,1716,47,133,394,1317,441,1450
351340,201902,6132,18186,4908,16010,1282,4319,1966,6450,3248,10769
351350,201902,11335,29897,9547,26883,1047,3159,6933,18996,7980,22155
351360,201902,3764,10428,3109,9359,810,2635,1064,2946,1874,5581
351370,201902,2095,6086,1416,4627,363,1222,456,1339,819,2561
351380,201902,44159,111592,31918,89402,5073,15072,16817,45295,21890,60367
351385,201902,276,709,157,478,32,86,53,163,85,249
351390,201902,1330,3377,835,2614,128,474,477,1394,605,1868
351400,201902,912,2628,729,2240,163,493,378,1142,541,1635
351410,201902,2297,6591,1704,5432,338,1102,718,2252,1056,3354
351420,201902,351,848,181,534,37,97,74,212,111,309
351430,201902,763,2310,694,2185,63,217,523,1609,586,1826
351440,201902,3255,8745,2122,6371,414,1353,548,1375,962,2728
351450,201902,1699,4511,1123,3448,242,809,233,633,475,1442
351460,201902,760,2077,602,1804,169,490,297,899,466,1389
351470,201902,1172,3100,896,2613,90,310,558,1524,648,1834
351480,201902,2532,7722,2059,6885,341,1264,943,3011,1284,4275
351490,201902,1823,5445,1577,4968,89,356,1180,3543,1269,3899
351492,201902,339,952,277,816,16,57,178,507,194,564
351495,201902,200,559,144,441,18,58,75,217,93,275
351500,201902,34533,88704,25581,72812,4780,14416,13422,36490,18202,50906
351510,201902,11715,30443,8576,24768,1245,4030,5096,14044,6341,18074
351512,201902,482,1359,319,979,48,150,105,291,153,441
351515,201902,3085,7179,1848,5137,361,1140,487,1353,848,2493
351518,201902,2268,5916,1460,4458,207,730,776,2146,983,2876
351519,201902,734,2051,415,1348,63,207,69,202,132,409
351520,201902,1128,2892,437,1388,59,201,168,469,227,670
351530,201902,343,974,195,633,37,124,63,163,100,287
351535,201902,2032,4989,1447,4001,202,633,797,2069,999,2702
351540,201902,2064,5308,1347,4079,406,1389,285,715,691,2104
351550,201902,5928,15457,4018,11711,476,1629,2192,5880,2668,7509
351560,201902,399,1187,324,1038,78,292,95,285,173,577
351565,201902,182,562,143,488,36,129,42,139,78,268
351570,201902,18363,50991,13785,41189,1752,5709,8324,23819,10076,29528
351580,201902,267,701,154,478,15,45,58,186,73,231
351590,201902,494,1135,261,713,32,109,144,349,176,458
351600,201902,1482,3951,1129,3307,131,428,666,1802,797,2230
351610,201902,734,1769,476,1313,24,80,247,621,271,701
351620,201902,20109,56412,14930,46690,2642,9388,6154,17215,8796,26603
351630,201902,25381,70400,20708,62022,3658,11507,12272,35747,15930,47254
351640,201902,15450,42581,12023,36000,1443,4866,7698,22076,9141,26942
351650,201902,415,1135,183,608,22,76,41,124,63,200
351660,201902,750,2229,461,1523,83,300,87,257,170,557
351670,201902,5185,14446,3674,11081,745,2295,1702,4801,2447,7096
351680,201902,399,1192,253,818,49,138,64,194,113,332
351685,201902,424,1277,341,1128,79,264,117,366,196,630
351690,201902,1028,2656,598,1764,111,361,230,601,341,962
351700,201902,1173,3052,864,2468,129,364,477,1310,606,1674
351710,201902,738,2037,490,1554,49,185,221,620,270,805
351720,201902,1440,3855,922,2869,163,551,358,1049,521,1600
351730,201902,908,2503,752,2220,86,314,453,1256,539,1570
351740,201902,3579,9231,2785,7709,518,1515,1280,3274,1798,4789
351750,201902,1243,3457,758,2540,158,571,245,814,403,1385
351760,201902,3281,9479,2316,7443,497,1773,793,2330,1290,4103
351770,201902,1793,5420,1452,4755,344,1148,646,2109,990,3257
351780,201902,1389,3610,715,2204,126,457,206,591,332,1048
351790,201902,1228,3057,983,2717,165,437,593,1668,758,2105
351800,201902,525,1240,264,750,34,105,87,210,121,315
351810,201902,975,2647,794,2343,56,163,571,1621,627,1784
351820,201902,2399,6959,1649,5435,427,1517,308,971,735,2488
351830,201902,4151,11583,3188,9839,380,1375,1856,5458,2236,6833
351840,201902,7680,22427,5834,18941,1005,3568,2672,8191,3677,11759
351850,201902,1762,4713,1088,3437,216,770,308,864,524,1634
351860,201902,2732,8179,2158,7039,398,1367,1145,3730,1543,5097
351870,201902,22243,59222,17088,50567,5456,16573,5945,18354,11401,34927
351880,201902,110677,304433,83235,254431,23271,76841,27856,80828,51127,157669
351885,201902,835,2402,658,2052,100,331,350,1054,450,1385
351890,201902,644,1855,484,1567,110,355,67,179,177,534
351900,201902,1014,2836,784,2468,154,489,368,1158,522,1647
351905,201902,378,1072,253,813,25,87,89,245,114,332
351907,201902,21387,57336,16561,48589,1770,5701,10921,31020,12691,36721
351910,201902,1210,3243,840,2478,101,329,455,1219,556,1548
351920,201902,862,2313,621,1840,75,272,306,832,381,1104
351925,201902,899,2555,699,2174,110,366,322,945,432,1311
351930,201902,3052,8912,2790,8392,363,1218,2097,6157,2460,7375
351940,201902,1072,2823,769,2286,102,341,405,1157,507,1498
351950,201902,1446,3475,1069,2909,63,191,701,1856,764,2047
351960,201902,5024,13252,3735,10967,844,2688,1588,4361,2432,7049
351970,201902,5977,18910,5005,17139,891,3452,2677,8787,3568,12239
351980,201902,1037,2516,663,1885,87,291,380,1003,467,1294
351990,201902,1374,3366,957,2710,94,337,406,1038,500,1375
352000,201902,2396,7159,2046,6418,250,934,1284,3710,1534,4644
352010,201902,2026,5767,1624,5028,424,1412,300,965,724,2377
352020,201902,1455,4086,1142,3551,195,646,546,1614,741,2260
352030,201902,5314,14585,4208,12791,883,2914,2150,6375,3033,9289
352040,201902,2442,6779,1526,4873,277,941,412,1156,689,2097
352042,201902,3141,7861,1867,5612,376,1208,743,2237,1119,3445
352044,201902,2011,5592,1151,3879,207,741,231,710,438,1451
352050,201902,11736,32283,7538,23703,1899,6721,1190,3244,3089,9965
352060,201902,711,1991,515,1607,74,261,240,699,314,960
352070,201902,770,1618,532,1302,76,213,291,668,367,881
352080,201902,459,1211,279,832,36,119,102,263,138,382
352090,201902,1402,4296,1125,3675,172,633,429,1251,601,1884
352100,201902,2959,8524,2466,7603,601,1987,1116,3264,1717,5251
352110,201902,548,1706,424,1428,92,333,166,521,258,854
352115,201902,509,1500,421,1355,72,263,228,721,300,984
352120,201902,858,2643,670,2227,82,313,369,1135,451,1448
352130,201902,1849,5302,1184,3624,230,718,448,1283,678,2001
352140,201902,1250,3429,825,2576,133,454,386,1161,519,1615
352150,201902,805,2226,606,1865,131,420,313,954,444,1374
352160,201902,972,2455,710,2046,96,332,362,980,458,1312
352170,201902,2932,8169,2317,6913,425,1403,1183,3248,1608,4651
352180,201902,2569,7158,2046,6162,503,1696,652,1719,1155,3415
352190,201902,1136,3117,851,2660,142,470,373,1183,515,1653
352200,201902,369,1140,256,892,33,130,85,280,118,410
352210,201902,17844,43883,13923,38427,1379,4172,10042,27342,11421,31514
352215,201902,524,1427,459,1345,50,154,316,908,366,1062
352220,201902,16115,42538,10928,32817,2860,8937,3498,10174,6358,19111
352230,201902,12218,37275,9327,31638,2348,8770,3142,10041,5490,18811
352240,201902,10812,28693,8056,23942,1821,6156,3230,8709,5051,14865
352250,201902,21540,62530,17486,55213,3747,12442,9221,28681,12968,41123
352260,201902,4804,12609,3311,9597,518,1785,1811,4735,2329,6520
352265,201902,900,2620,792,2436,56,208,570,1696,626,1904
352270,201902,1455,4517,1084,3692,237,890,350,1093,587,1983
352280,201902,2318,6105,1779,5297,194,716,982,2697,1176,3413
352290,201902,1074,3270,886,2867,161,573,430,1258,591,1831
352300,201902,949,2633,652,2010,100,358,308,841,408,1199
352310,201902,43452,117875,32169,97847,8352,25766,13625,41775,21977,67541
352320,201902,6011,16598,4620,13763,767,2534,2275,6089,3042,8623
352330,201902,2082,5833,1593,5120,319,1190,750,2286,1069,3476
352340,201902,4885,13527,3562,11110,718,2484,1518,4393,2236,6877
352350,201902,2011,5978,1591,5023,197,751,841,2382,1038,3133
352360,201902,1165,3192,994,2902,106,382,726,2012,832,2394
352370,201902,1025,3040,884,2774,35,150,673,2056,708,2206
352380,201902,800,2312,620,1960,145,491,205,618,350,1109
352390,201902,15642,39230,10539,30424,1714,5457,5641,15369,7355,20826
352400,201902,3459,9668,2896,8649,468,1726,1770,4888,2238,6614
352410,201902,2992,8073,2277,6837,246,879,1360,3901,1606,4780
352420,201902,871,2171,602,1751,120,366,205,565,325,931
352430,201902,7064,18619,5071,15090,1370,4481,2003,5590,3373,10071
352440,201902,16649,47027,12738,39327,2912,9434,5196,15447,8108,24881
352450,201902,808,2125,399,1330,54,189,113,354,167,543
352460,201902,2859,8181,1943,6405,418,1520,647,2033,1065,3553
352470,201902,3427,8714,2474,7135,305,1015,1384,3708,1689,4723
352480,201902,3375,8388,2252,6344,372,1180,1074,2769,1446,3949
352490,201902,704,2175,553,1854,113,426,242,760,355,1186
352500,201902,9787,26032,6836,20452,3207,10437,823,1560,4030,11997
352510,201902,3347,9388,2476,7830,580,2007,959,2858,1539,4865
352520,201902,2452,6973,1897,5961,445,1546,885,2544,1330,4090
352530,201902,8857,24585,5676,17901,1285,4579,1008,2422,2293,7001
352540,201902,523,1565,390,1264,78,263,96,283,174,546
352550,201902,954,2826,669,2243,133,495,191,596,324,1091
352560,201902,558,1585,402,1252,64,210,160,451,224,661
352570,201902,1936,5773,1256,4328,320,1173,179,550,499,1723
352580,201902,707,1970,572,1725,102,352,280,800,382,1152
352585,201902,233,693,176,572,20,84,94,283,114,367
352590,201902,13211,35712,9246,27851,2754,8912,3607,10060,6361,18972
352600,201902,1898,5344,1436,4420,247,816,728,2106,975,2922
352610,201902,2920,8428,2181,7097,490,1733,797,2477,1287,4210
352620,201902,5514,14819,4310,12952,1359,4142,1530,4680,2889,8822
352630,201902,819,2055,616,1754,99,332,282,728,381,1060
352640,201902,2883,7692,2104,6331,205,676,1293,3753,1498,4429
352650,201902,566,1661,400,1275,61,226,144,424,205,650
352660,201902,990,3065,800,2676,174,599,335,1103,509,1702
352670,201902,8191,23140,5252,17042,1487,5147,668,2127,2155,7274
352680,201902,3195,9775,2249,7501,401,1542,1004,3051,1405,4593
352690,201902,27708,71533,20457,58370,1986,6498,12979,35205,14965,41703
352700,201902,552,1434,410,1227,168,551,89,222,257,773
352710,201902,4915,13074,3498,10441,903,2962,1396,3884,2299,6846
352720,201902,7754,22400,6045,18931,2830,9044,831,2290,3661,11334
352725,201902,525,1339,272,813,19,62,121,337,140,399
352730,201902,2710,7852,2303,6889,380,1281,1315,3589,1695,4870
352740,201902,2183,5303,1619,4448,216,652,906,2392,1122,3044
352750,201902,406,1012,210,638,42,130,72,189,114,319
352760,201902,1471,4266,1141,3561,159,520,574,1738,733,2258
352770,201902,911,2499,592,1857,119,383,215,635,334,1018
352780,201902,651,1938,456,1540,95,351,143,467,238,818
352790,201902,516,1393,342,1039,34,109,127,331,161,440
352800,201902,1229,3927,892,3107,223,820,159,498,382,1318
352810,201902,1077,2600,652,1808,93,283,361,931,454,1214
352820,201902,501,1313,322,999,73,230,73,234,146,464
352830,201902,588,1522,255,796,40,135,47,118,87,253
352840,201902,3748,11276,3117,10090,1082,3772,966,2990,2048,6762
352850,201902,9933,25430,6642,20017,1890,6104,1953,5571,3843,11675
352860,201902,1011,2843,720,2285,146,502,229,693,375,1195
352870,201902,880,2270,608,1677,45,151,391,1032,436,1183
352880,201902,1805,4434,1248,3417,184,534,701,1761,885,2295
352885,201902,275,804,203,665,31,112,116,367,147,479
352890,201902,715,1742,438,1156,47,129,236,541,283,670
352900,201902,17319,46278,11624,34983,2066,6767,5095,14270,7161,21037
352910,201902,462,1235,218,692,22,68,55,163,77,231
352920,201902,2543,6773,1830,5458,160,547,1164,3304,1324,3851
352930,201902,5596,15660,4113,12673,769,2532,1786,5144,2555,7676
352940,201902,21755,62579,16251,50668,4162,14209,5155,15093,9317,29302
352950,201902,483,1283,274,869,63,208,29,82,92,290
352960,201902,685,1906,348,1142,56,196,65,200,121,396
352965,201902,263,704,151,496,41,132,30,83,71,215
352970,201902,2937,7133,2238,6015,239,665,1492,3971,1731,4636
352980,201902,1357,3811,1058,3322,255,841,477,1460,732,2301
352990,201902,3977,11376,3255,10188,629,2199,1706,5144,2335,7343
353000,201902,457,1263,221,715,35,123,50,140,85,263
353010,201902,2492,6423,1632,4836,404,1295,533,1453,937,2748
353020,201902,3595,9448,2080,6276,306,1019,734,2029,1040,3048
353030,201902,4073,10843,2778,8405,699,2249,622,1849,1321,4098
353040,201902,587,1423,430,1172,59,180,242,610,301,790
353050,201902,4978,14898,3662,12137,804,2875,1549,4894,2353,7769
353060,201902,45541,120250,37406,107032,3112,10757,27011,74201,30123,84958
353070,201902,9124,26566,6435,20962,1426,4966,2137,6589,3563,11555
353080,201902,4057,11685,2799,9161,616,2237,918,2693,1534,4930
353090,201902,514,1633,417,1424,44,176,230,746,274,922
353100,201902,299,826,122,402,23,80,33,93,56,173
353110,201902,7210,20417,5875,18405,1016,3359,3395,10793,4411,14152
353120,201902,454,1145,295,849,41,131,121,309,162,440
353130,201902,2311,5800,1546,4568,450,1459,486,1348,936,2807
353140,201902,2335,6039,1725,4891,166,541,1060,2807,1226,3348
353150,201902,1480,3845,1059,3136,231,721,431,1195,662,1916
353160,201902,554,1484,393,1214,81,278,155,425,236,703
353170,201902,500,1442,399,1294,78,300,189,566,267,866
353180,201902,9551,24289,7473,20863,954,3003,5136,13892,6090,16895
353190,201902,3277,9070,2600,7710,290,968,1601,4420,1891,5388
353200,201902,2017,5448,909,2993,125,444,203,607,328,1051
353205,201902,326,1046,277,924,62,228,128,411,190,639
353210,201902,961,2311,606,1704,29,100,385,1049,414,1149
353215,201902,394,1140,308,960,45,153,137,380,182,533
353220,201902,757,2066,458,1438,106,319,80,245,186,564
353230,201902,786,2288,642,2061,178,640,256,726,434,1366
353240,201902,2184,6169,1760,5382,248,871,1030,3019,1278,3890
353250,201902,1259,2869,741,2008,108,301,368,965,476,1266
353260,201902,1064,2565,601,1770,119,387,234,653,353,1040
353270,201902,644,1768,523,1533,46,139,332,939,378,1078
353280,201902,711,1962,490,1517,88,266,158,449,246,715
353282,201902,1774,5152,1519,4660,181,614,909,2642,1090,3256
353284,201902,363,886,181,519,28,105,73,172,101,277
353286,201902,148,374,87,272,22,77,30,88,52,165
353290,201902,1536,4060,934,2839,97,351,476,1324,573,1675
353300,201902,1689,4696,1247,3783,214,748,542,1459,756,2207
353310,201902,383,972,264,744,26,96,154,404,180,500
353320,201902,601,1585,510,1426,20,62,414,1152,434,1214
353325,201902,592,1815,411,1399,91,316,141,463,232,779
353330,201902,550,1456,339,1013,44,138,163,457,207,595
353340,201902,2694,7458,1876,5890,492,1645,693,2124,1185,3769
353350,201902,3134,8612,2112,6410,473,1590,436,1128,909,2718
353360,201902,578,1691,453,1451,53,190,233,723,286,913
353370,201902,565,1724,463,1544,41,139,307,984,348,1123
353380,201902,265,814,213,702,37,132,99,305,136,437
353390,201902,5465,14070,4040,11509,621,1938,2041,5474,2662,7412
353400,201902,389,1143,297,953,57,211,68,167,125,378
353410,201902,529,1462,409,1245,78,259,216,643,294,902
353420,201902,448,1219,269,823,50,140,23,50,73,190
353430,201902,2173,6244,1574,5100,389,1397,581,1737,970,3134
353440,201902,60891,171717,43164,135970,8311,27870,20758,62466,29069,90336
353450,201902,380,1005,256,783,40,144,116,320,156,464
353460,201902,3246,8968,2333,7142,203,712,1047,3127,1250,3839
353470,201902,7311,19795,5041,15476,973,3321,1904,5362,2877,8683
353475,201902,1385,3761,975,2873,140,450,459,1247,599,1697
353480,201902,1640,4462,1271,3772,85,294,824,2350,909,2644
353490,201902,963,2646,637,1949,120,394,273,783,393,1177
353500,201902,968,2355,761,2043,188,511,407,1112,595,1623
353510,201902,799,2435,580,1882,148,498,117,333,265,831
353520,201902,1092,2923,703,2202,86,301,319,948,405,1249
353530,201902,2417,6607,1876,5579,252,857,938,2579,1190,3436
353540,201902,2001,5709,1653,5118,327,1056,874,2634,1201,3690
353550,201902,5710,15337,4547,13359,887,2745,2302,6483,3189,9228
353560,201902,1994,5793,1478,4929,496,1788,359,1126,855,2914
353570,201902,534,1451,388,1188,59,177,223,652,282,829
353580,201902,2005,5400,1580,4615,387,1143,704,1988,1091,3131
353590,201902,699,1945,442,1390,108,369,132,405,240,774
353600,201902,1753,4470,1352,3744,171,475,718,1939,889,2414
353610,201902,554,1722,394,1372,91,361,98,311,189,672
353620,201902,2577,7126,1811,5726,380,1341,550,1555,930,2896
353625,201902,489,1229,313,917,32,111,190,540,222,651
353630,201902,1161,3762,911,3159,217,816,257,802,474,1618
353640,201902,1360,3585,1067,3114,122,394,643,1843,765,2237
353650,201902,8891,24611,6413,19450,840,2855,3465,9747,4305,12602
353657,201902,340,945,240,758,32,122,117,324,149,446
353660,201902,1117,2459,766,1963,310,798,211,501,521,1299
353670,201902,3666,10675,2923,9182,657,2290,1408,4070,2065,6360
353680,201902,710,1985,532,1711,101,346,282,876,383,1222
353690,201902,460,1217,178,588,14,53,19,52,33,105
353700,201902,1878,5256,1586,4696,168,550,1083,3082,1251,3632
353710,201902,4038,9232,2228,5993,245,671,1286,3193,1531,3864
353715,201902,469,1235,270,846,16,63,72,205,88,268
353720,201902,1869,5204,1479,4615,185,655,943,2863,1128,3518
353730,201902,4152,11488,3061,9362,475,1572,1451,4166,1926,5738
353740,201902,1899,5101,1278,3942,316,1070,372,1085,688,2155
353750,201902,803,2519,566,2040,143,542,93,360,236,902
353760,201902,11758,28815,9226,25223,1480,4263,5615,15035,7095,19298
353770,201902,727,2192,349,1190,61,203,41,111,102,314
353780,201902,4693,13944,3600,11673,887,3163,1249,3716,2136,6879
353790,201902,2425,7616,1799,6283,537,2148,375,1120,912,3268
353800,201902,16374,45358,12594,38897,2155,7169,6312,19386,8467,26555
353810,201902,1077,2949,706,2204,111,374,282,849,393,1223
353820,201902,1701,4883,1185,3771,258,872,400,1252,658,2124
353830,201902,629,1571,438,1247,68,195,186,495,254,690
353850,201902,1577,4562,1206,3831,322,990,376,1236,698,2226
353860,201902,2502,7314,1975,6283,492,1709,814,2407,1306,4116
353870,201902,27301,73673,18961,57432,2803,9501,9121,25249,11924,34750
353880,201902,2824,8211,2256,7073,234,860,1312,3948,1546,4808
353890,201902,2371,5323,1535,4125,160,455,993,2552,1153,3007
353900,201902,646,1820,465,1464,90,310,190,568,280,878
353910,201902,1773,5231,1486,4745,213,766,982,3090,1195,3856
353920,201902,2073,5755,1407,4440,296,1077,335,887,631,1964
353930,201902,4022,10891,2668,8483,612,2160,805,2293,1417,4453
353940,201902,1048,3133,703,2402,150,522,211,673,361,1195
353950,201902,2916,8301,2326,7182,446,1523,1242,3537,1688,5060
353960,201902,722,2000,485,1516,100,317,161,475,261,792
353970,201902,704,1756,513,1468,51,153,299,824,350,977
353980,201902,14006,37172,10865,31434,1171,3736,7114,19864,8285,23600
353990,201902,890,2202,533,1529,66,215,271,726,337,941
354000,201902,2466,6155,1341,3975,294,915,217,651,511,1566
354010,201902,347,941,259,791,28,83,163,489,191,572
354020,201902,3374,9916,2651,8290,709,2393,922,2593,1631,4986
354025,201902,722,2002,454,1453,85,312,89,255,174,567
354030,201902,494,1087,240,645,42,104,98,256,140,360
354040,201902,766,1847,479,1355,32,107,314,852,346,959
354050,201902,916,2744,638,2199,165,606,180,621,345,1227
354060,201902,3597,10569,2437,8033,592,2034,710,2191,1302,4225
354070,201902,3176,9027,2231,7135,485,1700,692,1926,1177,3626
354075,201902,2306,7042,1764,6019,247,991,933,3111,1180,4102
354080,201902,1405,3981,902,2945,175,590,234,716,409,1306
354085,201902,415,889,324,772,2,9,222,492,224,501
354090,201902,1439,4141,1270,3795,106,354,945,2775,1051,3129
354100,201902,17144,49404,12029,39985,2763,9836,4621,15221,7384,25057
354105,201902,1511,3881,999,2937,133,408,443,1252,576,1660
354110,201902,447,1230,316,999,65,224,105,326,170,550
354120,201902,1503,4152,988,3025,198,619,322,882,520,1501
354130,201902,5564,15025,3593,11159,1039,3493,215,439,1254,3932
354140,201902,18870,46906,12319,35000,2438,7459,4767,12538,7205,19997
354150,201902,3126,7739,2306,6369,486,1417,974,2608,1460,4025
354160,201902,3071,9206,2277,7525,692,2428,671,2083,1363,4511
354165,201902,571,1740,436,1466,90,345,200,617,290,962
354170,201902,1490,4352,1200,3737,92,312,734,2178,826,2490
354180,201902,440,1254,312,970,64,212,116,323,180,535
354190,201902,1444,4155,1021,3289,96,341,390,1249,486,1590
354200,201902,881,2267,678,1945,90,269,377,1013,467,1282
354210,201902,644,1862,532,1646,50,181,346,994,396,1175
354220,201902,3050,8492,2231,6830,432,1424,1017,2946,1449,4370
354230,201902,685,1799,529,1595,50,185,352,1013,402,1198
354240,201902,1494,4309,976,3203,179,631,276,792,455,1423
354250,201902,509,1320,329,1033,101,318,93,305,194,623
354260,201902,7933,21733,6053,18424,1410,4448,2262,6818,3672,11266
354270,201902,1030,3198,815,2778,187,644,288,981,475,1625
354280,201902,738,1929,618,1756,74,266,375,980,449,1246
354290,201902,865,2829,721,2507,127,441,341,1203,468,1644
354300,201902,3520,10719,3049,9856,1007,3319,985,3097,1992,6416
354310,201902,658,2009,520,1714,115,409,157,461,272,870
354320,201902,886,2271,553,1658,79,291,219,573,298,864
354323,201902,492,1245,324,925,41,109,130,356,171,465
354325,201902,1203,3687,856,2924,153,538,353,1169,506,1707
354330,201902,7757,20434,5244,15257,774,2673,2955,7923,3729,10596
354340,201902,26504,69924,18123,54831,3791,12574,7916,22859,11707,35433
354350,201902,1164,3123,925,2670,119,363,596,1637,715,2000
354360,201902,540,1485,319,1061,65,219,46,150,111,369
354370,201902,993,3052,826,2750,149,532,442,1441,591,1973
354380,201902,771,2067,534,1668,97,358,123,310,220,668
354390,201902,13093,32761,8145,23895,1602,4965,2746,7691,4348,12656
354400,201902,1526,5014,1187,4221,218,834,424,1482,642,2316
354410,201902,5162,14763,3925,12238,958,3213,1641,4883,2599,8096
354420,201902,1438,3918,1046,3158,135,456,614,1759,749,2215
354425,201902,2478,6281,1761,4999,422,1215,667,1935,1089,3150
354430,201902,1492,4125,1163,3564,164,564,615,1760,779,2324
354440,201902,563,1553,347,1086,39,138,162,461,201,599
354450,201902,406,1075,220,716,33,104,63,185,96,289
354460,201902,911,2391,588,1806,92,308,288,837,380,1145
354470,201902,503,1288,319,904,21,66,157,390,178,456
354480,201902,1057,2456,718,1923,65,190,478,1218,543,1408
354490,201902,788,2368,568,1892,123,428,217,667,340,1095
354500,201902,1984,5769,1651,5263,559,1969,384,1188,943,3157
354510,201902,740,2075,594,1752,72,225,319,858,391,1083
354515,201902,289,888,216,740,39,152,77,251,116,403
354520,201902,6416,18449,4212,13365,657,2329,2184,6454,2841,8783
354530,201902,3959,11914,3047,10026,763,2607,1132,3657,1895,6264
354540,201902,1270,3474,922,2830,225,722,298,943,523,1665
354550,201902,531,1428,406,1189,64,191,241,672,305,863
354560,201902,1967,4991,1066,3139,149,460,520,1456,669,1916
354570,201902,1137,2945,477,1409,87,260,82,241,169,501
354580,201902,9142,24416,5892,18162,965,3267,2711,7946,3676,11213
354600,201902,1686,4836,1305,4100,179,638,768,2298,947,2936
354610,201902,395,1063,217,686,34,119,76,227,110,346
354620,201902,442,1281,285,966,40,144,107,316,147,460
354625,201902,308,858,175,598,21,75,49,143,70,218
354630,201902,1796,5520,1467,4865,626,2187,187,592,813,2779
354640,201902,3090,9144,2231,7320,396,1474,683,2047,1079,3521
354650,201902,895,2419,721,2108,69,215,428,1226,497,1441
354660,201902,2798,7078,1766,5333,141,509,1107,3235,1248,3744
354670,201902,1056,3008,718,2276,145,505,272,798,417,1303
354680,201902,4567,12751,3672,11233,899,2843,1840,5720,2739,8563
354690,201902,566,1806,386,1380,92,356,103,349,195,705
354700,201902,908,2441,625,1863,108,356,276,738,384,1094
354710,201902,507,1402,360,1107,55,203,154,410,209,613
354720,201902,317,780,133,400,42,125,29,90,71,215
354730,201902,9230,26704,6880,22158,1024,3595,3716,11596,4740,15191
354740,201902,316,861,123,421,17,69,21,60,38,129
354750,201902,2458,6676,1554,4895,304,1061,589,1634,893,2695
354760,201902,1898,5318,1313,4159,366,1272,342,1007,708,2279
354765,201902,322,876,132,437,22,83,25,70,47,153
354770,201902,2272,5767,1616,4639,317,997,706,1884,1023,2881
354780,201902,52063,136129,39456,110537,5513,17178,22532,59059,28045,76237
354790,201902,956,2761,764,2427,107,376,430,1310,537,1686
354800,201902,2525,6875,1957,5888,498,1565,802,2291,1300,3856
354805,201902,1308,3180,871,2451,124,371,411,1029,535,1400
354810,201902,595,1765,354,1251,63,246,91,293,154,539
354820,201902,920,2767,655,2216,127,495,158,449,285,944
354830,201902,465,1167,301,867,72,204,106,298,178,502
354840,201902,953,2433,502,1486,59,170,240,687,299,857
354850,201902,20463,55400,14159,43504,1972,7012,7948,22880,9920,29892
354860,201902,1533,4440,1013,3378,197,706,325,965,522,1671
354870,201902,51397,132957,40071,112018,5234,16025,23496,62529,28730,78554
354880,201902,5669,14475,2591,7619,330,1090,847,2002,1177,3092
354890,201902,16235,41950,12498,35486,1832,5819,7170,19643,9002,25462
354900,201902,424,1142,276,870,42,137,73,213,115,350
354910,201902,4997,13679,2883,9630,635,2266,325,1013,960,3279
354920,201902,451,1202,187,634,23,94,37,111,60,205
354925,201902,282,838,150,534,24,93,31,91,55,184
354930,201902,404,984,217,654,20,75,90,235,110,310
354940,201902,1968,6217,1391,4863,472,1777,195,622,667,2399
354950,201902,1459,4053,1156,3581,72,326,778,2265,850,2591
354960,201902,844,2290,647,2001,87,311,335,972,422,1283
354970,201902,3900,11422,3040,9827,422,1448,1765,5583,2187,7031
354980,201902,29417,71827,19118,53638,2341,7764,10514,27409,12855,35173
354990,201902,58430,153068,42989,124504,4678,15254,25727,70689,30405,85943
354995,201902,2465,6094,1846,5223,255,814,1186,3194,1441,4008
355000,201902,1463,3951,1147,3443,192,664,457,1244,649,1908
355010,201902,3231,9295,2023,6575,694,2349,171,568,865,2917
355020,201902,3356,9810,2431,8073,767,2795,621,1953,1388,4748
355030,201902,1285290,3229613,925520,2512473,160216,475096,444101,1110767,604317,1585863
355040,201902,2764,7493,2233,6720,382,1210,1391,4175,1773,5385
355050,201902,961,2412,687,1967,210,615,192,502,402,1117
355060,201902,5514,15692,4001,12679,706,2541,1886,5428,2592,7969
355070,201902,7799,21049,6202,18390,795,2756,3749,10371,4544,13127
355080,201902,832,2448,506,1787,112,428,53,156,165,584
355090,201902,1122,3332,839,2799,217,730,244,829,461,1559
355100,201902,20609,55785,16094,49079,2934,9576,9466,28456,12400,38032
355110,201902,950,2761,718,2366,236,816,132,455,368,1271
355120,201902,652,1779,450,1437,56,198,145,432,201,630
355130,201902,746,1707,332,891,23,61,188,462,211,523
355140,201902,1554,3915,1353,3620,121,410,1055,2701,1176,3111
355150,201902,4099,11284,3279,9815,430,1412,1901,5472,2331,6884
355160,201902,1774,5102,1309,4258,334,1245,307,950,641,2195
355170,201902,8925,23697,6973,20340,1673,5186,3359,9576,5032,14762
355180,201902,2684,7516,1903,6139,444,1644,628,1786,1072,3430
355190,201902,1804,4874,1411,4235,354,1099,692,2177,1046,3276
355200,201902,787,2551,678,2373,218,861,218,683,436,1544
355210,201902,2840,8100,2320,6991,337,1166,1286,3646,1623,4812
355220,201902,42700,116971,33308,98644,8765,27541,12561,34211,21326,61752
355230,201902,1144,2884,600,1780,109,317,170,483,279,800
355240,201902,21694,58241,14951,44886,2362,7701,7285,21024,9647,28725
355250,201902,34670,95590,25237,77162,6513,21071,8949,26197,15462,47268
355255,201902,820,2140,428,1330,81,263,136,411,217,674
355260,201902,1365,3548,972,2864,120,415,584,1633,704,2048
355270,201902,1213,3667,919,3032,241,810,280,892,521,1702
355280,201902,27132,72492,19168,56758,3225,10226,8688,24398,11913,34624
355290,201902,841,2388,610,1925,115,357,258,767,373,1124
355300,201902,1203,3572,958,3089,184,634,322,997,506,1631
355310,201902,1015,2847,757,2398,105,349,406,1303,511,1652
355320,201902,524,1426,381,1146,68,235,144,362,212,597
355330,201902,2184,6014,1670,5058,153,557,1139,3273,1292,3830
355340,201902,3557,7973,2835,6973,371,855,1837,4562,2208,5417
355350,201902,1306,3920,955,3181,203,721,310,1017,513,1738
355360,201902,1278,3397,1004,2958,103,328,670,1956,773,2284
355365,201902,356,980,179,628,37,118,28,101,65,219
355370,201902,5792,14877,4336,12672,1058,3032,1834,5759,2892,8791
355380,201902,2895,7981,2148,6490,373,1241,713,1879,1086,3120
355385,201902,1347,3752,1103,3388,139,520,632,1752,771,2272
355390,201902,768,2161,550,1681,121,382,212,601,333,983
355395,201902,2035,5872,1404,4495,199,686,522,1510,721,2196
355400,201902,8792,26761,7048,23087,1979,7162,2212,6564,4191,13726
355410,201902,21220,59375,13820,44986,3337,11938,3186,10312,6523,22250
355420,201902,665,2232,545,1979,149,620,125,422,274,1042
355430,201902,3595,9328,2725,7807,704,1992,1169,3350,1873,5342
355440,201902,836,2350,493,1585,100,333,141,431,241,764
355450,201902,3369,8962,2100,6453,391,1293,792,2227,1183,3520
355460,201902,543,1358,337,998,46,155,162,439,208,594
355465,201902,380,1079,279,874,55,189,105,309,160,498
355470,201902,1147,3037,622,1941,180,597,173,492,353,1089
355475,201902,282,702,256,662,21,56,202,525,223,581
355480,201902,3547,10350,2919,9345,437,1616,1827,5661,2264,7277
355490,201902,938,2553,484,1544,42,141,227,691,269,832
355495,201902,791,2341,579,1935,78,293,202,647,280,940
355500,201902,6557,17594,3794,11874,589,2016,1127,3226,1716,5242
355510,201902,1286,3349,786,2380,116,400,282,758,398,1158
355520,201902,383,850,171,482,29,81,45,109,74,190
355530,201902,428,971,135,402,23,85,49,120,72,205
355535,201902,508,1421,386,1219,78,287,159,454,237,741
355540,201902,9332,25098,7650,22534,1479,4665,4384,12596,5863,17261
355550,201902,635,1929,519,1708,70,241,251,799,321,1040
355560,201902,1122,2981,593,1910,124,439,36,112,160,551
355570,201902,231,680,124,421,23,76,24,68,47,144
355580,201902,1203,2990,784,2293,106,364,392,1083,498,1447
355590,201902,179,452,137,390,15,41,86,234,101,275
355600,201902,1447,3680,960,2826,222,695,382,1083,604,1778
355610,201902,1706,4418,1138,3373,157,456,520,1475,677,1931
355620,201902,4391,12378,3269,10065,466,1700,1691,4748,2157,6448
355630,201902,2213,6279,1526,4917,291,958,706,2237,997,3195
355635,201902,922,2795,699,2349,124,478,254,809,378,1287
355640,201902,2589,7707,1787,6048,428,1509,377,1278,805,2787
355645,201902,4244,12419,3235,10604,412,1492,1881,6070,2293,7562
355650,201902,6366,17639,5148,15393,1428,4449,2194,6090,3622,10539
355660,201902,1272,3463,869,2667,117,454,290,885,407,1339
355670,201902,3262,9315,2167,6704,325,1191,1033,2775,1358,3966
355680,201902,3224,9191,1224,4143,346,1210,123,433,469,1643
355690,201902,746,2297,487,1757,124,460,12,20,136,480
355695,201902,223,668,125,422,14,52,14,27,28,79
355700,201902,6551,19510,5292,16639,1091,3486,2461,7403,3552,10889
355710,201902,8097,19424,4972,13672,881,2606,2060,5129,2941,7735
355715,201902,471,1254,246,782,51,190,41,109,92,299
355720,201902,1407,4221,1096,3607,207,751,525,1574,732,2325
355730,201902,914,2677,717,2268,173,565,253,743,426,1308
410010,201902,1215,3410,914,2776,198,665,206,603,404,1268
410020,201902,977,3050,774,2566,277,867,206,693,483,1560
410030,201902,1397,4064,1190,3706,179,659,612,1879,791,2538
410040,201902,10798,31459,8134,26230,1818,6388,2637,7956,4455,14344
410045,201902,919,2431,609,1849,97,326,193,550,290,876
410050,201902,2457,6243,1526,4551,362,1178,335,886,697,2064
410060,201902,2033,6072,1569,5056,388,1296,434,1375,822,2671
410070,201902,1756,4653,1255,3675,217,692,461,1282,678,1974
410080,201902,1338,3630,955,2915,162,502,391,1227,553,1729
410090,201902,1008,2795,897,2602,106,299,499,1529,605,1828
410100,201902,1911,5686,1333,4269,182,692,256,775,438,1467
410105,201902,454,1223,243,761,41,148,50,145,91,293
410110,201902,3058,8087,2097,6124,320,992,835,2333,1155,3325
410115,201902,542,1398,378,1110,62,202,131,374,193,576
410120,201902,2369,7275,2063,6735,652,2293,693,2220,1345,4513
410130,201902,1107,3104,961,2832,256,843,407,1094,663,1937
410140,201902,13995,34587,8417,24459,1710,5351,1804,4754,3514,10105
410150,201902,16091,38897,7591,21670,1407,4327,1563,4212,2970,8539
410160,201902,2836,8107,2317,7182,474,1627,846,2611,1320,4238
410165,201902,701,1984,581,1714,56,184,343,948,399,1132
410170,201902,2495,6708,1596,4693,402,1274,142,430,544,1704
410180,201902,13640,39608,10708,33238,1688,5774,5512,15979,7200,21753
410185,201902,442,1227,319,979,54,177,100,279,154,456
410190,201902,2164,5609,1583,4543,343,1011,422,1172,765,2183
410200,201902,4724,11501,2537,7484,450,1548,549,1597,999,3145
410210,201902,2795,7246,1747,5276,321,1124,553,1401,874,2525
410220,201902,502,1354,325,987,45,164,56,169,101,333
410230,201902,1530,4307,1226,3715,190,683,660,1887,850,2570
410240,201902,4331,12085,3184,9808,865,2945,249,722,1114,3667
410250,201902,2496,6211,1796,4980,189,643,809,2151,998,2794
410260,201902,1767,4572,1141,3391,220,677,468,1376,688,2053
410270,201902,454,1203,328,962,37,117,147,418,184,535
410275,201902,654,1913,427,1391,60,206,197,591,257,797
410280,201902,2184,6016,1405,4384,239,812,517,1511,756,2323
410290,201902,2895,8448,2120,6789,480,1553,682,2185,1162,3738
410300,201902,626,1600,496,1379,60,188,231,592,291,780
410302,201902,360,948,183,584,32,100,82,249,114,349
410304,201902,1087,3103,921,2760,121,371,523,1529,644,1900
410305,201902,1630,4094,1133,3342,190,578,614,1770,804,2348
410310,201902,2481,7376,1954,6239,417,1463,714,2248,1131,3711
410315,201902,700,1723,342,1112,114,378,75,234,189,612
410320,201902,1087,3095,696,2222,111,418,110,345,221,763
410322,201902,495,1370,259,825,21,73,111,340,132,413
410330,201902,1483,3764,1031,2874,165,499,290,806,455,1305
410335,201902,813,2301,653,1972,85,275,290,809,375,1084
410337,201902,801,1993,548,1492,55,163,246,628,301,791
410340,201902,481,1321,324,939,34,124,163,396,197,520
410345,201902,2198,5875,1112,3433,256,799,239,675,495,1474
410347,201902,685,1760,484,1385,56,202,136,381,192,583
410350,201902,1317,3512,913,2774,96,325,386,1105,482,1430
410360,201902,3952,9860,3115,8428,224,712,2021,5226,2245,5938
410370,201902,11274,30725,7496,22155,1024,3384,2856,7499,3880,10883
410380,201902,1353,3637,1002,2929,115,391,419,1140,534,1531
410390,201902,2478,6632,1586,4893,400,1345,365,1048,765,2393
410395,201902,846,2550,684,2197,135,471,299,945,434,1416
410400,201902,5051,14052,3758,11522,652,2107,1598,4730,2250,6837
410405,201902,787,1968,606,1702,153,469,240,618,393,1087
410410,201902,1156,3281,1103,3211,177,641,681,2035,858,2676
410420,201902,7655,22459,5883,18791,1123,3987,1853,5345,2976,9332
410425,201902,2833,8317,2047,6702,368,1296,687,2057,1055,3353
410430,201902,12604,32410,8537,24659,1466,4564,2821,7717,4287,12281
410440,201902,2344,7193,1992,6512,343,1248,1008,3236,1351,4484
410442,201902,2187,6931,1843,6141,537,1794,567,1890,1104,3684
410445,201902,2191,6606,1734,5705,375,1390,478,1638,853,3028
410450,201902,1443,3861,1045,3128,204,687,295,805,499,1492
410460,201902,1752,4558,1356,3939,194,603,611,1707,805,2310
410465,201902,2512,7595,1949,6383,409,1377,622,1947,1031,3324
410470,201902,1806,5361,1312,4329,331,1229,271,907,602,2136
410480,201902,33593,82316,18132,54327,3087,10357,3526,9113,6613,19470
410490,201902,10357,29615,7348,23189,1493,5136,2555,7579,4048,12715
410500,201902,1684,4723,1168,3652,263,944,293,779,556,1723
410510,201902,1982,5033,1271,3631,239,646,386,1125,625,1771
410520,201902,2968,9657,2680,9079,818,2803,1062,3662,1880,6465
410530,201902,1448,3849,717,2151,120,368,117,260,237,628
410540,201902,2476,6880,1787,5524,303,989,881,2688,1184,3677
410550,201902,6604,18111,4168,12561,754,2476,1060,2809,1814,5285
410560,201902,1415,3764,1073,3085,227,686,415,1056,642,1742
410570,201902,2446,7043,1841,5906,535,1994,144,492,679,2486
410580,201902,22931,61750,17109,50765,3567,11460,7157,19763,10724,31223
410590,201902,1407,4148,926,2912,175,572,238,664,413,1236
410600,201902,1765,4860,1327,3993,291,831,464,1452,755,2283
410610,201902,730,1994,520,1575,55,193,227,657,282,850
410620,201902,2020,6185,1303,4407,309,1123,221,683,530,1806
410630,201902,2296,6335,1475,4575,313,1046,248,636,561,1682
410640,201902,4453,10909,2862,8148,693,2235,404,1145,1097,3380
410645,201902,1016,3085,846,2842,296,1026,328,1123,624,2149
410650,201902,1955,5627,1380,4412,326,1100,413,1206,739,2306
410655,201902,892,2245,620,1746,36,126,307,813,343,939
410657,201902,621,1699,390,1208,64,236,157,421,221,657
410660,201902,3107,8246,1695,5090,321,1025,345,988,666,2013
410670,201902,1028,2559,588,1684,112,316,258,704,370,1020
410680,201902,2669,8252,1918,6381,475,1534,472,1625,947,3159
410685,201902,564,1481,442,1260,89,291,207,544,296,835
410690,201902,116509,298842,76520,222347,13481,44201,25864,66056,39345,110257
410700,201902,2312,6015,1959,5459,321,966,991,2629,1312,3595
410710,201902,807,2093,528,1578,59,190,270,773,329,963
410712,201902,645,1953,548,1736,142,479,195,576,337,1055
410715,201902,861,2607,516,1784,104,367,155,529,259,896
410720,201902,3038,8146,2225,6492,334,1156,454,1182,788,2338
410725,201902,1096,2788,643,1924,124,392,115,302,239,694
410730,201902,585,1567,424,1272,85,295,95,259,180,554
410740,201902,902,2574,642,2070,104,361,255,800,359,1161
410750,201902,1643,4336,1341,3803,222,688,547,1499,769,2187
410752,201902,352,920,163,500,23,82,67,183,90,265
410753,201902,222,690,158,542,16,56,30,105,46,161
410754,201902,1105,2931,906,2624,62,158,598,1845,660,2003
410755,201902,578,1517,415,1188,59,198,193,478,252,676
410760,201902,3197,8484,2324,6920,667,2186,544,1551,1211,3737
410765,201902,12102,35224,9355,29649,1600,5567,1575,4638,3175,10205
410770,201902,955,2363,658,1856,70,214,316,877,386,1091
410773,201902,1266,3427,1104,3164,120,391,718,1988,838,2379
410775,201902,1408,3708,1228,3431,90,290,708,1933,798,2223
410780,201902,588,1480,359,1009,60,170,91,257,151,427
410785,201902,724,2095,580,1819,105,353,213,646,318,999
410790,201902,607,1778,489,1538,132,463,56,131,188,594
410800,201902,3145,7275,2505,6255,84,265,1537,3712,1621,3977
410810,201902,367,1021,281,854,43,145,122,348,165,493
410820,201902,756,2234,404,1265,85,282,76,208,161,490
410830,201902,29465,74875,20108,58750,4681,15420,6580,18174,11261,33594
410832,201902,980,2609,795,2279,102,342,441,1168,543,1510
410840,201902,7206,19249,4314,13475,929,3204,824,2242,1753,5446
410845,201902,1116,3017,890,2638,178,572,332,953,510,1525
410850,201902,2239,6709,1931,6128,351,1203,888,2783,1239,3986
410855,201902,699,1798,460,1337,37,110,211,574,248,684
410860,201902,3793,9914,2953,8353,541,1679,1137,3003,1678,4682
410865,201902,1348,4229,1184,3871,188,667,657,2204,845,2871
410870,201902,1262,3490,1066,3158,52,167,762,2232,814,2399
410880,201902,4097,11610,2949,9373,539,1937,440,1512,979,3449
410890,201902,935,2713,671,2156,163,572,184,574,347,1146
410895,201902,941,3154,782,2781,297,1127,127,437,424,1564
410900,201902,902,2473,588,1834,101,338,124,308,225,646
410910,201902,366,893,202,568,12,37,120,308,132,345
410920,201902,826,2024,557,1586,81,267,255,708,336,975
410930,201902,1416,3886,1046,3184,273,976,245,721,518,1697
410940,201902,20861,59636,15186,48958,3449,12109,4087,13149,7536,25258
410950,201902,1905,5660,1699,5330,70,278,1390,4268,1460,4546
410960,201902,6858,18138,4392,13683,1055,3655,1542,4687,2597,8342
410965,201902,947,2612,711,2158,113,350,373,1116,486,1466
410970,201902,3695,10244,2611,8154,646,2443,360,940,1006,3383
410975,201902,1264,3312,959,2780,154,517,354,1001,508,1518
410980,201902,6497,17059,4131,12577,576,1946,1626,4673,2202,6619
410990,201902,1208,3085,773,2333,244,856,165,411,409,1267
411000,201902,503,1400,352,1088,60,214,96,250,156,464
411005,201902,419,1168,262,818,55,182,51,150,106,332
411007,201902,2145,6277,1763,5559,405,1367,573,1818,978,3185
411010,201902,4114,12637,3230,10736,867,3109,300,891,1167,4000
411020,201902,2294,6718,1883,6000,559,1885,542,1670,1101,3555
411030,201902,704,1790,465,1280,45,150,225,556,270,706
411040,201902,848,2214,399,1181,47,149,122,320,169,469
411050,201902,1777,5801,1465,5045,402,1462,213,642,615,2104
411060,201902,1664,4479,1075,3292,205,767,189,524,394,1291
411065,201902,345,953,250,770,38,117,106,330,144,447
411070,201902,6269,16843,4955,14483,881,2824,2179,6175,3060,8999
411080,201902,2116,5822,1681,5022,421,1375,441,1277,862,2652
411090,201902,841,2219,517,1569,45,169,127,364,172,533
411095,201902,1518,3643,1036,2851,125,408,362,935,487,1343
411100,201902,1076,2849,719,2198,85,311,202,637,287,948
411110,201902,605,1597,257,814,33,91,21,51,54,142
411120,201902,1201,3499,942,2945,321,1135,190,476,511,1611
411125,201902,4933,14794,4397,13716,960,3067,2084,6700,3044,9767
411130,201902,673,1878,476,1473,93,296,173,549,266,845
411140,201902,2191,6917,1813,6041,483,1723,586,1948,1069,3671
411150,201902,3617,9661,2500,7328,533,1794,206,442,739,2236
411155,201902,943,2461,544,1669,52,166,250,712,302,878
411160,201902,337,789,213,597,26,79,47,134,73,213
411170,201902,696,2162,513,1722,108,356,176,576,284,932
411180,201902,5209,14310,3988,12056,692,2312,1717,4916,2409,7228
411190,201902,1435,3817,1043,3090,189,583,325,900,514,1483
411200,201902,4863,13439,3312,10406,933,3171,689,2009,1622,5180
411210,201902,2588,5992,1723,4642,384,1196,421,1053,805,2249
411220,201902,844,2285,622,1816,131,401,185,532,316,933
411230,201902,798,2203,542,1694,101,339,209,648,310,987
411240,201902,1559,3825,914,2553,89,287,440,1135,529,1422
411250,201902,2028,5582,1509,4628,352,1239,449,1351,801,2590
411260,201902,317,846,208,628,24,72,83,222,107,294
411270,201902,1864,5224,1432,4317,244,761,650,1868,894,2629
411275,201902,1304,3168,923,2516,146,457,398,1004,544,1461
411280,201902,1311,3604,850,2694,199,637,116,351,315,988
411290,201902,717,1992,492,1549,58,169,244,782,302,951
411295,201902,1141,2911,848,2334,78,239,423,1117,501,1356
411300,201902,1002,2540,623,1760,72,223,230,562,302,785
411310,201902,860,2062,643,1743,46,123,283,758,329,881
411320,201902,5158,13953,3722,11246,795,2517,1328,3675,2123,6192
411325,201902,1461,4248,1225,3820,216,668,659,2114,875,2782
411330,201902,3144,8780,2303,7203,571,1946,640,2053,1211,3999
411340,201902,842,2382,508,1607,63,225,191,570,254,795
411342,201902,961,2369,585,1623,89,251,265,729,354,980
411345,201902,1042,2811,783,2380,88,298,519,1578,607,1876
411350,201902,2407,6806,1615,5154,458,1589,168,507,626,2096
411360,201902,630,1550,439,1252,52,163,149,414,201,577
411370,201902,47439,119920,33950,96713,3013,10277,19329,51504,22342,61781
411373,201902,1311,3478,1070,3088,114,376,544,1595,658,1971
411375,201902,1046,2699,748,2127,121,364,284,746,405,1110
411380,201902,1028,2442,709,1812,49,144,431,1010,480,1154
411390,201902,1594,4507,1222,3673,194,636,468,1255,662,1891
411400,201902,2113,5492,1618,4548,224,758,762,2028,986,2786
411410,201902,2050,5901,1520,4700,358,1222,307,893,665,2115
411420,201902,3830,9768,2147,6473,338,1175,381,921,719,2096
411430,201902,3232,9031,2525,7687,552,1861,979,2727,1531,4588
411435,201902,406,1184,266,876,47,147,93,267,140,414
411440,201902,2461,7298,2013,6367,429,1505,710,2221,1139,3726
411450,201902,2537,6856,1916,5799,284,850,995,3034,1279,3884
411460,201902,3664,9858,2085,6582,402,1453,336,967,738,2420
411470,201902,691,1916,505,1521,89,290,155,422,244,712
411480,201902,4261,11944,2996,9455,618,2208,836,2454,1454,4662
411490,201902,1545,4125,1177,3478,177,593,425,1116,602,1709
411500,201902,1352,3683,875,2667,131,467,241,663,372,1130
411510,201902,2160,5797,1727,5002,364,1221,397,1171,761,2392
411520,201902,28084,69371,15585,45058,2141,6977,5338,13822,7479,20799
411530,201902,903,2452,557,1762,125,443,92,268,217,711
411535,201902,462,1363,225,776,20,70,35,91,55,161
411540,201902,2706,7019,1837,5248,269,866,729,2020,998,2886
411545,201902,924,2758,772,2485,77,256,500,1621,577,1877
411550,201902,679,1776,476,1367,87,269,85,250,172,519
411560,201902,1848,5008,1066,3334,165,606,71,172,236,778
411570,201902,6623,16158,4481,12661,986,3099,1201,3353,2187,6452
411573,201902,765,2135,647,1929,74,245,367,1058,441,1303
411575,201902,1751,4973,1330,4098,283,934,343,1023,626,1957
411580,201902,4175,9976,2350,7072,313,1134,354,929,667,2063
411585,201902,678,2007,291,977,78,271,44,120,122,391
411590,201902,374,1079,256,801,27,101,139,392,166,493
411600,201902,288,776,170,566,42,145,56,184,98,329
411605,201902,1490,3557,891,2505,121,421,447,1210,568,1631
411610,201902,2258,5785,1561,4372,126,410,922,2449,1048,2859
411620,201902,2784,7685,2378,7044,400,1316,1331,3852,1731,5168
411630,201902,720,1897,474,1410,81,285,148,380,229,665
411640,201902,527,1462,352,1047,46,143,124,324,170,467
411650,201902,205,596,135,443,26,84,31,101,57,185
411660,201902,896,2299,638,1809,47,133,331,907,378,1040
411670,201902,1176,3047,819,2277,108,308,326,843,434,1151
411680,201902,1521,4179,1192,3543,124,418,626,1859,750,2277
411690,201902,3436,9203,2620,7796,547,1691,803,2502,1350,4193
411695,201902,614,1919,437,1467,60,212,163,549,223,761
411700,201902,1568,4205,1037,3179,253,860,133,352,386,1212
411705,201902,1835,5883,1547,5358,319,1087,831,3067,1150,4154
411710,201902,1785,4662,1252,3673,348,1096,163,465,511,1561
411720,201902,1051,2562,724,1951,115,342,309,769,424,1111
411721,201902,869,2273,643,1850,129,383,142,416,271,799
411722,201902,709,1968,395,1212,62,222,155,417,217,639
411725,201902,1177,3486,787,2644,187,649,162,563,349,1212
411727,201902,1395,4005,910,2956,258,875,126,385,384,1260
411729,201902,680,1672,437,1200,59,199,148,359,207,558
411730,201902,5130,14215,3800,11483,1017,3189,1304,3846,2321,7035
411740,201902,531,1416,267,840,52,168,53,153,105,321
411745,201902,746,2177,471,1512,59,193,90,233,149,426
411750,201902,4817,13034,3438,10214,474,1535,1638,4592,2112,6127
411760,201902,6834,18655,5243,15784,1820,5673,986,3283,2806,8956
411770,201902,2982,8937,2147,7007,566,1975,274,839,840,2814
411780,201902,2846,8275,2422,7404,672,2171,842,2574,1514,4745
411790,201902,2793,6997,1508,4545,360,1222,188,461,548,1683
411800,201902,970,2779,661,2054,118,374,127,379,245,753
411810,201902,1573,4118,1172,3348,189,585,576,1523,765,2108
411820,201902,10201,30998,8403,27508,2507,8636,3039,9747,5546,18383
411830,201902,589,1481,398,1139,82,250,87,272,169,522
411840,201902,11283,30635,7381,22316,1350,4451,1910,5297,3260,9748
411845,201902,429,1267,225,751,38,152,20,57,58,209
411850,201902,7123,19100,5059,15309,1470,4917,715,1950,2185,6867
411860,201902,709,2097,516,1669,107,386,127,367,234,753
411870,201902,640,1988,433,1467,89,332,92,281,181,613
411880,201902,1997,5285,1451,4328,290,921,352,1032,642,1953
411885,201902,1018,2682,721,2133,101,354,251,721,352,1075
411890,201902,1120,3099,758,2365,133,471,59,153,192,624
411900,201902,784,2289,470,1561,113,381,53,189,166,570
411910,201902,934,2917,683,2335,183,663,185,603,368,1266
411915,201902,15144,38115,9522,27689,1644,5262,3086,8035,4730,13297
411920,201902,992,3097,828,2731,210,756,254,800,464,1556
411925,201902,487,1295,326,989,73,244,107,308,180,552
411930,201902,4987,16044,4247,14570,1956,7213,250,1001,2206,8214
411940,201902,3113,9654,2392,7922,619,2136,637,1897,1256,4033
411950,201902,12923,36246,10549,32170,1950,6549,5429,15987,7379,22536
411960,201902,5459,15288,4464,13216,933,3019,1581,4396,2514,7415
411965,201902,425,1200,300,939,46,159,118,345,164,504
411970,201902,991,2423,768,2103,145,378,348,1068,493,1446
411980,201902,1448,3809,1068,3119,267,840,397,1084,664,1924
411990,201902,33842,94478,22924,72798,4798,16806,7603,22971,12401,39777
411995,201902,2796,7342,2107,6231,609,1996,593,1625,1202,3621
412000,201902,2011,4694,1444,3730,58,195,973,2346,1031,2541
412010,201902,611,1917,418,1452,59,227,106,304,165,531
412015,201902,559,1603,463,1425,58,191,264,806,322,997
412020,201902,431,1226,259,843,36,133,101,316,137,449
412030,201902,622,1811,432,1430,76,270,130,422,206,692
412033,201902,827,2279,571,1714,77,223,195,559,272,782
412035,201902,772,2091,495,1590,65,245,244,732,309,977
412040,201902,565,1562,348,1095,69,236,59,163,128,399
412050,201902,1700,4407,1161,3400,216,728,283,813,499,1541
412060,201902,6939,21554,5865,19375,1778,6486,1459,4585,3237,11071
412065,201902,599,1678,434,1344,86,275,132,416,218,691
412070,201902,1122,2921,849,2352,119,344,361,958,480,1302
412080,201902,1853,5454,1157,3860,192,687,133,379,325,1066
412085,201902,281,729,93,300,14,46,12,27,26,73
412090,201902,5526,14717,4352,12537,1200,3518,1701,5031,2901,8549
412100,201902,1690,4747,1258,3955,379,1269,244,837,623,2106
412110,201902,838,2305,609,1810,105,326,197,567,302,893
412120,201902,1814,5569,1422,4744,305,1163,404,1175,709,2338
412125,201902,651,1923,471,1529,100,331,158,488,258,819
412130,201902,680,1807,474,1390,65,204,119,359,184,563
412135,201902,580,1573,261,795,44,130,84,232,128,362
412140,201902,1532,3908,987,2916,220,757,154,393,374,1150
412150,201902,2816,7624,2345,6763,355,1148,1393,3834,1748,4982
412160,201902,997,3147,600,2095,136,521,89,281,225,802
412170,201902,4129,11940,3480,10798,759,2532,1433,4149,2192,6681
412175,201902,1239,3835,1039,3448,262,869,397,1354,659,2223
412180,201902,1676,4710,1216,3830,175,662,512,1444,687,2106
412190,201902,3281,8403,2412,6818,321,988,1079,3064,1400,4052
412200,201902,1733,5331,1242,4117,338,1198,207,642,545,1840
412210,201902,611,1557,336,1012,62,216,91,242,153,458
412215,201902,3542,9645,2850,8318,787,2257,1131,3743,1918,6000
412217,201902,985,2651,825,2391,67,218,545,1518,612,1736
412220,201902,5637,16166,4552,14081,1197,3719,1434,4680,2631,8399
412230,201902,2572,7941,2074,6910,412,1567,564,1593,976,3160
412240,201902,6497,16989,4096,12220,753,2496,1135,3123,1888,5619
412250,201902,1956,5174,1490,4295,379,1111,307,873,686,1984
412260,201902,1216,3361,857,2586,141,430,259,731,400,1161
412265,201902,786,2307,667,2068,133,445,292,865,425,1310
412270,201902,784,2254,518,1653,78,270,202,578,280,848
412280,201902,458,1349,363,1185,83,273,105,325,188,598
412290,201902,971,2510,645,1894,103,324,206,582,309,906
412300,201902,1406,3947,1112,3359,277,871,248,744,525,1615
412310,201902,763,2125,627,1881,54,239,336,958,390,1197
412320,201902,829,2149,559,1635,76,297,204,583,280,880
412330,201902,1428,3960,970,3023,170,565,358,1148,528,1713
412340,201902,1012,2951,628,2031,105,370,124,371,229,741
412350,201902,2665,7173,1722,5272,362,1105,358,1113,720,2218
412360,201902,247,693,154,486,12,41,70,208,82,249
412370,201902,763,2252,521,1734,101,383,37,129,138,512
412380,201902,1504,4210,1036,3206,285,915,160,539,445,1454
412382,201902,506,1293,333,980,57,188,110,276,167,464
412385,201902,2107,5973,1718,5189,584,1702,498,1636,1082,3338
412390,201902,2386,6073,1911,5313,346,985,799,2201,1145,3186
412395,201902,686,1979,468,1485,56,183,207,629,263,812
412400,201902,875,2387,630,1891,140,441,161,515,301,956
412402,201902,1734,4447,1228,3593,321,1021,140,415,461,1436
412405,201902,3063,8402,1967,6159,473,1726,59,173,532,1899
412410,201902,5261,14326,3787,11663,782,2719,1042,2995,1824,5714
412420,201902,478,1271,290,859,32,110,112,290,144,400
412430,201902,540,1409,354,1046,30,94,160,446,190,540
412440,201902,2665,7561,1779,5783,521,1817,273,904,794,2721
412450,201902,365,1119,243,801,47,150,22,49,69,199
412460,201902,971,2672,778,2345,140,477,323,960,463,1437
412470,201902,1620,5286,1314,4577,342,1245,325,1185,667,2430
412480,201902,915,2567,575,1776,106,349,133,357,239,706
412490,201902,1120,2922,916,2523,105,282,520,1374,625,1656
412500,201902,1811,4746,1366,3877,328,946,339,892,667,1838
412510,201902,1932,6041,1339,4474,312,1106,106,316,418,1422
412520,201902,1286,3420,679,2065,160,487,44,125,204,612
412530,201902,645,1763,467,1389,69,234,117,342,186,576
412535,201902,772,2097,526,1596,120,408,104,274,224,682
412540,201902,1219,3281,842,2498,95,336,270,825,365,1161
412545,201902,684,1794,461,1325,74,234,130,337,204,571
412550,201902,28922,80360,19891,61516,3815,12731,6847,19670,10662,32401
412555,201902,236,640,154,466,21,70,40,89,61,159
412560,201902,4707,14097,3476,11158,626,2176,1031,3275,1657,5451
412570,201902,3965,10514,2275,7092,510,1711,324,1101,834,2812
412575,201902,937,2488,758,2137,77,247,450,1186,527,1433
412580,201902,1332,3590,922,2781,136,467,418,1205,554,1672
412590,201902,396,1068,208,679,44,159,19,58,63,217
412600,201902,1358,3920,1009,3175,170,605,398,1202,568,1807
412610,201902,796,2185,517,1539,53,181,254,673,307,854
412620,201902,1253,3460,917,2847,192,673,274,793,466,1466
412625,201902,8156,22257,5127,16098,787,2782,308,909,1095,3691
412627,201902,1015,2901,664,2166,159,583,177,557,336,1140
412630,201902,2782,8239,1993,6458,394,1283,653,1912,1047,3195
412635,201902,335,897,223,639,37,116,65,160,102,276
412640,201902,1028,2852,573,1802,86,302,130,347,216,649
412650,201902,1539,4368,1216,3687,218,723,424,1114,642,1837
412660,201902,2435,6586,1705,5120,302,991,512,1379,814,2370
412665,201902,506,1267,293,866,57,169,109,303,166,472
412667,201902,1695,4540,1255,3661,175,570,497,1362,672,1932
412670,201902,778,1954,516,1480,95,322,173,459,268,781
412680,201902,1548,4310,1006,3196,130,477,411,1170,541,1647
412690,201902,856,2388,632,1910,112,358,213,609,325,967
412700,201902,2037,5523,1625,4852,255,911,769,2176,1024,3087
412710,201902,5746,17338,4470,14608,990,3567,1275,3871,2265,7438
412720,201902,1221,3633,912,2903,161,541,185,504,346,1045
412730,201902,2045,5697,1178,3814,242,851,218,671,460,1522
412740,201902,1691,4820,1109,3535,207,716,167,548,374,1264
412750,201902,3774,10457,3229,9622,405,1423,2046,5780,2451,7203
412760,201902,2813,7874,2338,7029,375,1242,1293,3727,1668,4969
412770,201902,9811,25425,5165,16013,759,2489,1045,2844,1804,5333
412780,201902,1201,3327,918,2803,205,672,346,1028,551,1700
412785,201902,1906,4930,1345,3910,203,605,734,2083,937,2688
412788,201902,1294,3779,1052,3292,260,827,452,1383,712,2210
412790,201902,1238,3322,668,2113,128,477,193,519,321,996
412795,201902,1310,3522,688,2151,127,422,129,385,256,807
412796,201902,2292,6881,1892,6023,395,1318,627,1868,1022,3186
412800,201902,3297,8328,2229,6281,300,946,928,2330,1228,3276
412810,201902,10379,26824,6251,18292,873,2909,2111,5427,2984,8336
412820,201902,6298,17765,4498,14121,1057,3460,1351,4299,2408,7759
412830,201902,342,985,224,712,37,106,48,147,85,253
412840,201902,1768,4632,1255,3615,167,528,435,1183,602,1711
412850,201902,2827,7663,2077,6305,366,1208,752,2185,1118,3393
412853,201902,1621,4281,1338,3692,161,490,678,1695,839,2185
412855,201902,1179,3188,751,2241,154,519,202,559,356,1078
412860,201902,768,2049,549,1663,75,248,253,740,328,988
412862,201902,703,1700,462,1282,70,210,210,558,280,768
412863,201902,1186,3690,1101,3553,131,438,773,2493,904,2931
412865,201902,710,2020,517,1644,95,315,179,568,274,883
412870,201902,874,2374,662,2025,203,704,140,449,343,1153
412880,201902,837,2338,529,1680,99,332,73,208,172,540
420005,201902,446,1347,242,864,37,137,103,376,140,513
420010,201902,3395,8570,2242,6523,178,575,1584,4597,1762,5172
420020,201902,470,1470,291,1016,50,198,43,123,93,321
420030,201902,84,288,58,233,20,84,14,55,34,139
420040,201902,561,1753,332,1228,55,228,18,51,73,279
420050,201902,656,1605,409,1149,49,162,256,674,305,836
420055,201902,155,467,77,278,14,61,23,76,37,137
420060,201902,111,322,69,216,12,47,16,28,28,75
420070,201902,781,2531,586,2058,123,452,207,706,330,1158
420075,201902,82,225,39,125,8,26,9,16,17,42
420080,201902,350,1049,271,878,88,309,80,250,168,559
420090,201902,401,1306,249,914,62,238,54,201,116,439
420100,201902,1129,3148,973,2911,50,176,783,2319,833,2495
420110,201902,242,808,218,760,45,177,89,287,134,464
420120,201902,415,1216,273,888,54,208,109,306,163,514
420125,201902,314,1034,243,872,62,243,113,384,175,627
420127,201902,278,802,92,333,19,80,20,69,39,149
420130,201902,2167,6316,1609,5252,300,1175,727,2191,1027,3366
420140,201902,3251,9033,2329,7392,657,2385,295,908,952,3293
420150,201902,562,1464,344,1088,60,212,165,487,225,699
420160,201902,235,601,111,349,13,46,36,101,49,147
420165,201902,157,463,92,309,22,74,27,84,49,158
420170,201902,251,767,154,534,21,73,29,84,50,157
420180,201902,183,573,104,374,14,52,36,117,50,169
420190,201902,162,536,94,359,32,133,18,63,50,196
420195,201902,1267,3436,933,2887,283,993,123,323,406,1316
420200,201902,3343,8884,1930,6077,311,1209,680,1825,991,3034
420205,201902,1341,3747,977,3100,160,516,546,1757,706,2273
420207,201902,1529,4196,970,3107,207,760,356,1092,563,1852
420208,201902,370,1044,207,757,38,156,84,308,122,464
420209,201902,144,492,93,333,25,110,31,95,56,205
420210,201902,2329,6295,1517,4958,348,1285,647,2038,995,3323
420213,201902,741,2384,619,2131,143,528,292,989,435,1517
420215,201902,209,638,147,502,44,151,23,65,67,216
420220,201902,223,682,136,481,29,123,55,171,84,294
420230,201902,4007,11392,3033,9571,444,1558,1604,4911,2048,6469
420240,201902,11194,30936,7054,21842,951,3450,3547,9727,4498,13177
420243,201902,375,1102,299,947,51,177,159,477,210,654
420245,201902,1213,3310,845,2647,95,385,468,1376,563,1761
420250,201902,416,1228,360,1123,74,267,183,522,257,789
420253,201902,498,1289,366,1088,29,97,197,570,226,667
420257,201902,179,472,104,330,19,66,54,166,73,232
420260,201902,1022,2880,751,2458,121,454,436,1404,557,1858
420270,201902,426,1155,197,603,23,76,71,208,94,284
420280,201902,1176,3399,812,2678,168,618,227,728,395,1346
420285,201902,96,259,52,169,6,27,7,16,13,43
420287,201902,443,1115,303,891,89,279,96,277,185,556
420290,201902,3797,11065,2882,9008,459,1672,1490,4211,1949,5883
420300,201902,6290,18137,3643,11943,739,2693,950,2754,1689,5447
420310,201902,821,1989,392,1115,72,215,175,452,247,667
420315,201902,811,2475,562,1961,136,511,206,717,342,1228
420320,201902,3896,11458,3051,9918,967,3457,685,2073,1652,5530
420325,201902,237,717,175,604,40,132,59,202,99,334
420330,201902,833,2544,542,1890,130,514,177,550,307,1064
420340,201902,920,2713,662,2188,161,557,60,189,221,746
420350,201902,1291,3508,907,2766,98,332,571,1704,669,2036
420360,201902,2422,6955,1300,4400,264,965,135,452,399,1417
420370,201902,1061,2974,852,2609,102,380,575,1689,677,2069
420380,201902,4579,12512,2976,9406,673,2286,972,2945,1645,5231
420390,201902,1044,2625,686,1858,113,373,313,631,426,1004
420395,201902,940,2788,617,2090,104,365,68,208,172,573
420400,201902,880,2609,575,1917,110,408,178,570,288,978
420410,201902,512,1444,381,1170,38,141,240,690,278,831
420415,201902,290,892,217,729,69,257,69,241,138,498
420417,201902,597,1850,490,1614,130,439,173,590,303,1029
420419,201902,150,542,118,454,44,181,10,32,54,213
420420,201902,10028,27347,6800,21346,2220,7660,1631,4721,3851,12381
420425,201902,660,1775,459,1387,44,162,206,606,250,768
420430,201902,2826,8038,1761,5596,461,1587,520,1463,981,3050
420435,201902,260,686,109,381,19,79,46,158,65,237
420440,201902,652,1929,380,1279,121,444,94,272,215,716
420445,201902,292,777,174,526,37,118,54,150,91,268
420450,201902,642,1943,467,1546,93,384,159,454,252,838
420455,201902,1905,4922,1408,4123,184,626,726,2021,910,2647
420460,201902,8319,22911,6193,18977,1038,3631,2956,8631,3994,12262
420470,201902,569,1562,323,1060,64,247,79,226,143,473
420475,201902,51,149,26,91,10,33,3,13,13,46
420480,201902,4753,12487,3096,9598,653,2206,986,2998,1639,5204
420490,201902,354,1070,239,818,57,226,74,245,131,471
420500,201902,1264,3790,892,3045,183,663,332,1116,515,1779
420510,201902,171,494,94,314,16,58,30,95,46,153
420515,201902,51,137,33,98,2,3,18,56,20,59
420517,201902,748,2092,648,1922,53,153,490,1450,543,1603
420519,201902,305,734,199,570,26,81,97,283,123,364
420520,201902,364,963,159,546,20,63,16,49,36,112
420530,201902,795,2353,560,1851,123,454,161,470,284,924
420535,201902,185,528,82,287,22,81,17,64,39,145
420540,201902,26072,63726,16423,46617,2900,9212,5851,14146,8751,23358
420543,201902,219,667,172,554,27,83,85,263,112,346
420545,201902,1036,3169,787,2605,172,609,292,926,464,1535
420550,201902,3325,9508,2145,7308,442,1661,881,3053,1323,4714
420555,201902,287,844,191,640,36,136,89,275,125,411
420560,201902,421,1093,292,888,68,202,149,449,217,651
420570,201902,1999,5818,1517,4864,318,1128,561,1683,879,2811
420580,201902,1629,4283,1177,3591,257,811,527,1611,784,2422
420590,201902,2759,7548,1605,5002,316,1135,387,926,703,2061
420600,201902,928,2823,708,2365,137,511,313,993,450,1504
420610,201902,316,953,183,638,47,163,46,165,93,328
420620,201902,503,1345,366,1110,107,337,130,395,237,732
420630,201902,871,2634,625,1999,123,439,290,826,413,1265
420640,201902,493,1415,233,825,63,230,19,55,82,285
420650,201902,2916,8104,1742,5516,302,1070,656,1777,958,2847
420660,201902,345,988,235,759,57,201,64,205,121,406
420665,201902,521,1414,328,1070,60,211,132,388,192,599
420670,201902,1370,3810,896,2892,144,592,351,997,495,1589
420675,201902,126,374,79,278,27,116,14,35,41,151
420680,201902,330,809,179,592,31,116,86,277,117,393
420690,201902,801,2511,489,1682,77,299,114,321,191,620
420700,201902,2636,7298,2021,6207,291,1022,1038,3047,1329,4069
420710,201902,691,2103,521,1709,75,313,281,822,356,1135
420720,201902,1285,3591,918,2987,228,729,397,1276,625,2005
420730,201902,2626,7164,2020,6186,337,1087,1137,3381,1474,4468
420740,201902,617,1884,380,1355,108,412,40,154,148,566
420750,201902,1722,5176,1147,3817,211,809,435,1329,646,2138
420757,201902,60,165,28,105,4,16,10,35,14,51
420760,201902,350,1057,149,486,36,128,26,75,62,203
420765,201902,362,1157,203,724,27,97,80,286,107,383
420768,201902,1173,3632,1011,3327,167,550,683,2234,850,2784
420770,201902,433,1183,198,711,34,136,83,278,117,414
420775,201902,371,1098,236,805,53,204,44,124,97,328
420780,201902,940,2714,549,1863,119,431,107,331,226,762
420785,201902,184,505,130,395,13,39,56,151,69,190
420790,201902,964,3119,720,2580,167,679,341,1147,508,1826
420800,201902,710,1833,327,1044,94,303,70,234,164,537
420810,201902,1417,4724,1161,4166,368,1479,312,968,680,2447
420820,201902,9799,25306,6732,20228,1391,4753,2940,7951,4331,12704
420830,201902,2933,8244,2204,6905,502,1708,856,2614,1358,4322
420840,201902,512,1579,237,880,64,235,46,169,110,404
420845,201902,1895,5069,1112,3644,229,847,380,1217,609,2064
420850,201902,1034,3427,631,2347,155,632,87,281,242,913
420860,201902,261,687,149,481,41,155,32,92,73,247
420870,201902,793,2176,624,1895,179,646,271,758,450,1404
420880,201902,880,2765,695,2380,148,551,237,743,385,1294
420890,201902,7436,20297,4217,13599,709,2528,1247,3424,1956,5952
420895,201902,154,464,91,295,26,87,29,93,55,180
420900,201902,1336,3455,795,2484,115,444,334,917,449,1361
420910,201902,24577,66703,15370,48652,2550,9121,5601,15995,8151,25116
420915,201902,515,1917,368,1474,63,250,167,678,230,928
420917,201902,330,892,176,521,26,85,76,218,102,303
420920,201902,78,224,28,108,4,17,2,9,6,26
420930,201902,16552,44263,11796,35854,2153,7213,5392,15603,7545,22816
420940,201902,2226,5709,1374,4208,330,1128,195,473,525,1601
420945,201902,125,369,97,305,24,91,36,97,60,188
420950,201902,308,918,168,574,26,99,45,132,71,231
420960,201902,941,2444,647,1908,118,407,259,677,377,1084
420970,201902,2393,7035,1605,5399,470,1623,246,869,716,2492
420980,201902,295,923,237,834,110,382,76,297,186,679
420985,201902,298,890,154,553,32,127,51,161,83,288
420990,201902,389,1204,200,744,43,165,33,102,76,267
421000,201902,465,1533,309,1144,76,310,71,221,147,531
421003,201902,446,1063,141,429,16,47,22,56,38,103
421005,201902,54,183,49,176,11,39,22,80,33,119
421010,201902,3341,9325,2386,7613,513,1813,568,1604,1081,3417
421020,201902,358,1118,282,983,35,139,168,568,203,707
421030,201902,712,2265,568,1962,173,659,159,499,332,1158
421040,201902,680,1626,414,1215,37,120,253,728,290,848
421050,201902,1055,3013,672,2147,133,460,230,671,363,1131
421055,201902,168,463,80,254,15,50,29,76,44,126
421060,201902,536,1627,341,1125,66,250,126,367,192,617
421070,201902,510,1584,286,1014,63,238,38,133,101,371
421080,201902,459,1363,404,1268,52,170,260,827,312,997
421085,201902,350,1063,141,538,26,109,22,63,48,172
421090,201902,282,757,162,506,21,68,49,153,70,221
421100,201902,894,2071,378,1141,86,287,58,166,144,453
421105,201902,1432,4041,1056,3326,163,495,549,1760,712,2255
421110,201902,1034,3010,870,2760,42,121,615,2042,657,2163
421120,201902,878,2833,618,2198,84,336,201,650,285,986
421125,201902,252,700,207,627,73,244,70,173,143,417
421130,201902,3769,11522,3167,10339,711,2585,1718,5399,2429,7984
421140,201902,279,776,181,574,36,122,62,169,98,291
421145,201902,441,1256,266,856,50,176,122,370,172,546
421150,201902,531,1452,274,917,52,193,92,298,144,491
421160,201902,557,1475,355,1114,50,173,205,623,255,796
421165,201902,189,589,128,441,29,99,51,179,80,278
421170,201902,1024,2822,815,2484,130,389,516,1604,646,1993
421175,201902,1029,2736,677,2162,134,488,268,777,402,1265
421180,201902,357,958,196,629,40,160,57,167,97,327
421185,201902,303,817,202,610,32,98,111,327,143,425
421187,201902,299,880,187,596,34,110,69,207,103,317
421189,201902,339,1019,259,845,42,136,88,279,130,415
421190,201902,9119,25158,5908,19212,1255,4467,1489,4593,2744,9060
421200,201902,626,1921,513,1688,85,295,269,859,354,1154
421205,201902,191,531,141,450,28,100,73,221,101,321
421210,201902,1050,2817,642,2075,158,515,204,653,362,1168
421220,201902,1292,4116,1027,3513,236,901,248,740,484,1641
421223,201902,366,1067,241,818,59,191,104,356,163,547
421225,201902,870,2697,752,2473,149,535,425,1410,574,1945
421227,201902,962,2557,558,1748,91,304,255,804,346,1108
421230,201902,578,1570,367,1169,97,335,107,333,204,668
421240,201902,302,925,122,461,14,72,15,56,29,128
421250,201902,1487,3938,989,3103,162,567,426,1294,588,1861
421260,201902,165,473,43,161,10,40,8,32,18,72
421265,201902,583,1722,543,1664,17,59,493,1520,510,1579
421270,201902,393,1061,177,649,31,116,64,231,95,347
421280,201902,1505,4486,1138,3792,243,957,505,1566,748,2523
421290,201902,763,2116,404,1274,80,262,83,258,163,520
421300,201902,234,642,134,431,19,68,37,121,56,189
421310,201902,155,481,119,398,22,80,54,182,76,262
421315,201902,194,567,121,400,36,116,21,67,57,183
421320,201902,601,1782,308,1037,51,175,47,112,98,287
421330,201902,609,1802,428,1436,94,350,117,368,211,718
421335,201902,344,1076,280,963,51,192,114,387,165,579
421340,201902,1243,3657,927,3058,211,757,372,1206,583,1963
421350,201902,1143,3220,809,2604,164,627,346,1037,510,1664
421360,201902,2162,6082,1310,4327,274,1075,465,1366,739,2441
421370,201902,474,1595,285,1086,63,250,71,259,134,509
421380,201902,803,2228,689,2024,96,322,410,1169,506,1491
421390,201902,176,474,63,211,11,32,18,51,29,83
421400,201902,240,796,167,618,33,142,77,256,110,398
421410,201902,248,681,107,375,18,66,38,135,56,201
421415,201902,223,693,132,441,38,130,29,83,67,213
421420,201902,503,1463,425,1313,72,250,247,721,319,971
421430,201902,117,393,91,332,13,51,33,105,46,156
421440,201902,589,1574,375,1217,74,244,185,603,259,847
421450,201902,350,1088,221,764,34,145,35,131,69,276
421460,201902,323,941,203,698,46,170,52,154,98,324
421470,201902,238,734,137,493,31,134,49,178,80,312
421480,201902,2593,7122,1692,5412,396,1407,549,1586,945,2993
421490,201902,106,338,69,241,10,42,18,50,28,92
421500,201902,1994,6114,1392,4850,400,1558,291,938,691,2496
421505,201902,289,863,257,810,35,124,154,458,189,582
421507,201902,373,1139,223,779,65,248,69,224,134,472
421510,201902,255,741,145,467,33,109,64,189,97,298
421520,201902,517,1395,321,956,42,149,177,484,219,633
421530,201902,311,990,184,663,43,196,42,115,85,311
421535,201902,388,1084,247,812,36,135,129,395,165,530
421540,201902,202,514,115,367,18,66,42,116,60,182
421545,201902,651,1965,476,1628,94,362,223,729,317,1091
421550,201902,1841,5377,1528,4868,345,1170,739,2306,1084,3476
421555,201902,185,572,67,248,12,55,10,24,22,79
421560,201902,82,275,50,191,13,51,13,48,26,99
421565,201902,853,2318,608,1915,150,524,187,612,337,1136
421567,201902,452,1577,289,1084,126,488,51,171,177,659
421568,201902,346,1030,243,799,33,122,113,357,146,479
421569,201902,187,558,75,266,19,68,28,100,47,168
421570,201902,928,2639,651,2099,187,661,152,469,339,1130
421575,201902,284,864,226,706,45,167,91,229,136,396
421580,201902,2824,8286,1920,6365,396,1550,636,1809,1032,3359
421590,201902,135,438,105,360,36,131,27,78,63,209
421600,201902,504,1425,344,1084,86,285,89,237,175,522
421605,201902,718,1924,488,1529,109,334,171,549,280,883
421610,201902,1075,2990,656,2145,133,451,157,519,290,970
421620,201902,3669,10187,2113,7213,546,2024,509,1673,1055,3697
421625,201902,196,547,82,267,18,53,14,44,32,97
421630,201902,2319,6390,1351,4334,239,909,341,944,580,1853
421635,201902,225,634,149,459,17,54,79,221,96,275
421640,201902,643,1805,454,1489,101,346,132,429,233,775
421650,201902,2103,6017,1344,4528,350,1339,306,853,656,2192
421660,201902,7417,21629,5517,17981,940,3470,2202,6627,3142,10097
421670,201902,727,2160,510,1648,105,391,239,745,344,1136
421680,201902,904,2732,696,2304,194,688,274,835,468,1523
421690,201902,1146,3496,814,2749,170,647,252,839,422,1486
421700,201902,451,1411,238,865,45,182,62,207,107,389
421710,201902,208,661,93,315,26,95,21,64,47,159
421715,201902,104,302,75,236,18,57,49,147,67,204
421720,201902,1857,5228,1060,3520,283,1015,263,756,546,1771
421725,201902,204,503,102,323,20,67,39,99,59,166
421730,201902,364,1111,189,600,27,98,78,222,105,320
421740,201902,590,1756,408,1345,122,412,98,302,220,714
421750,201902,835,2027,401,1201,81,258,162,463,243,721
421755,201902,173,495,101,320,15,56,47,133,62,189
421760,201902,823,2340,490,1644,90,332,150,428,240,760
421770,201902,2089,5756,1528,4750,396,1251,533,1807,929,3058
421775,201902,234,623,144,441,22,76,66,182,88,258
421780,201902,751,2358,506,1810,97,381,197,667,294,1048
421790,201902,652,1749,390,1278,86,294,188,595,274,889
421795,201902,214,628,136,424,23,84,51,144,74,228
421800,201902,2307,6663,1716,5527,305,1086,858,2642,1163,3728
421810,201902,601,1668,417,1307,54,210,230,678,284,888
421820,201902,808,2419,424,1456,80,305,101,311,181,616
421825,201902,1277,3677,1154,3482,136,464,814,2391,950,2855
421830,201902,1888,6018,1609,5487,364,1352,656,2140,1020,3492
421835,201902,211,568,121,397,15,67,50,144,65,211
421840,201902,199,630,131,474,34,129,26,80,60,209
421850,201902,356,1058,201,714,40,167,63,162,103,329
421860,201902,273,819,178,609,24,108,63,177,87,285
421870,201902,3289,8609,2284,6673,464,1544,1014,2689,1478,4233
421875,201902,201,604,102,367,19,76,21,54,40,130
421880,201902,469,1335,341,1091,100,378,68,213,168,591
421885,201902,186,554,129,435,38,133,29,81,67,214
421890,201902,730,2356,578,2035,119,477,258,834,377,1311
421895,201902,356,989,298,908,35,126,202,618,237,744
421900,201902,919,2395,646,1886,114,380,296,782,410,1162
421910,201902,309,951,214,738,48,195,41,120,89,315
421915,201902,373,1065,205,668,41,132,28,84,69,216
421917,201902,533,1365,318,1065,118,436,70,233,188,669
421920,201902,422,1322,305,1083,136,503,96,342,232,845
421930,201902,2226,5963,1040,3536,292,1085,163,522,455,1607
421935,201902,418,1375,325,1156,64,235,173,595,237,830
421940,201902,298,909,113,386,21,82,26,84,47,166
421950,201902,2893,7328,1426,4512,310,1101,312,872,622,1973
421960,201902,154,400,92,302,21,82,18,54,39,136
421970,201902,1800,4784,1006,3155,224,758,291,802,515,1560
421985,201902,248,662,145,452,11,45,48,155,59,200
422000,201902,1594,4390,1317,3920,162,573,840,2477,1002,3050
430003,201902,504,1472,340,1156,71,265,129,435,200,700
430005,201902,259,714,162,525,47,154,63,205,110,359
430010,201902,1621,4252,1298,3689,156,488,871,2383,1027,2871
430020,201902,573,1364,439,1181,67,208,262,661,329,869
430030,201902,987,2420,563,1654,165,492,161,449,326,941
430040,201902,9331,23378,5555,16413,1498,4844,442,1427,1940,6271
430045,201902,537,1402,361,1056,36,126,200,552,236,678
430047,201902,242,546,98,292,19,63,25,75,44,138
430050,201902,928,2428,522,1579,121,401,112,317,233,718
430055,201902,257,658,114,354,12,46,59,168,71,214
430057,201902,93,209,29,82,8,30,7,17,15,47
430060,201902,15577,44000,12227,38551,2977,10055,5179,16320,8156,26375
430063,201902,860,2436,678,2041,126,380,372,1104,498,1484
430064,201902,953,2754,725,2242,209,680,235,702,444,1382
430066,201902,107,245,75,194,4,11,55,130,59,141
430070,201902,703,1794,100,331,9,31,12,30,21,61
430080,201902,738,1925,453,1340,88,293,198,524,286,817
430085,201902,856,2013,504,1429,84,246,209,583,293,829
430087,201902,522,1430,423,1288,81,248,240,753,321,1001
430090,201902,554,1471,181,601,18,78,55,177,73,255
430100,201902,589,1483,325,972,65,207,116,311,181,518
430105,201902,970,2658,606,2030,118,436,277,948,395,1384
430107,201902,176,525,116,380,20,70,29,76,49,146
430110,201902,2072,5211,1485,4329,237,728,834,2407,1071,3135
430120,201902,1329,4049,817,2712,162,555,356,1199,518,1754
430130,201902,3372,8197,2555,7038,1005,2785,533,1695,1538,4480
430140,201902,873,2566,596,1984,154,500,233,789,387,1289
430150,201902,530,1408,300,944,65,216,92,276,157,492
430155,201902,251,664,119,372,23,72,26,68,49,140
430160,201902,17169,43605,13750,38463,2737,8066,6420,18228,9157,26294
430163,201902,2400,6063,1692,4933,138,457,1121,3249,1259,3706
430165,201902,349,829,83,266,12,31,11,27,23,58
430170,201902,893,2399,320,1105,64,222,63,200,127,422
430175,201902,652,2040,536,1778,136,440,254,840,390,1280
430180,201902,643,1682,515,1449,75,230,348,946,423,1176
430185,201902,447,1079,270,759,48,131,107,276,155,407
430187,201902,618,1551,434,1283,74,236,213,642,287,878
430190,201902,1392,3873,1115,3412,258,843,488,1413,746,2256
430192,201902,122,361,52,160,9,32,13,36,22,68
430195,201902,386,1160,63,225,10,35,6,23,16,58
430200,201902,1064,3281,868,2919,296,1042,252,864,548,1906
430205,201902,485,1312,398,1135,14,49,332,917,346,966
430210,201902,4744,12156,3264,9180,662,2002,1147,2630,1809,4632
430215,201902,298,797,187,557,37,114,71,206,108,320
430220,201902,653,1616,170,574,35,143,37,105,72,248
430222,201902,178,517,141,443,20,73,59,174,79,247
430223,201902,241,681,201,601,31,96,111,323,142,419
430225,201902,15,35,12,30,1,2,9,15,10,17
430230,201902,1696,4879,1493,4582,161,470,1139,3556,1300,4026
430235,201902,245,739,178,583,43,146,53,150,96,296
430237,201902,522,1298,357,1002,16,59,242,645,258,704
430240,201902,1091,2492,649,1791,65,219,384,1018,449,1237
430245,201902,665,2023,508,1699,170,572,222,744,392,1316
430250,201902,940,2501,733,2173,237,767,33,81,270,848
430258,201902,101,275,75,221,5,10,39,121,44,131
430260,201902,606,1660,438,1327,78,247,234,706,312,953
430265,201902,193,570,141,474,31,110,42,136,73,246
430270,201902,2686,6989,2167,6172,329,1039,1360,3749,1689,4788
430280,201902,4778,11788,3390,9287,734,2080,1410,3835,2144,5915
430290,201902,2084,5046,1801,4686,60,187,1534,3920,1594,4107
430300,201902,8555,23155,6730,19764,1213,3880,3366,9718,4579,13598
430310,201902,9446,24428,6290,18298,920,3082,2981,8027,3901,11109
430320,201902,931,2517,514,1622,79,222,264,862,343,1084
430330,201902,601,1542,393,1106,77,238,182,462,259,700
430340,201902,677,1547,354,1033,65,206,187,526,252,732
430350,201902,6085,16798,4604,13886,1049,3258,2032,6021,3081,9279
430355,201902,324,825,106,351,24,68,16,52,40,120
430360,201902,741,1864,519,1487,116,370,195,507,311,877
430367,201902,344,860,178,534,44,144,64,193,108,337
430370,201902,482,1342,224,729,45,156,58,163,103,319
430380,201902,677,1714,334,1066,70,259,75,242,145,501
430390,201902,2888,7245,1565,4712,304,1006,121,277,425,1283
430400,201902,1078,2365,819,1985,81,211,582,1355,663,1566
430410,201902,555,1363,371,1057,59,186,210,580,269,766
430420,201902,2629,7391,1999,5974,599,1873,703,2004,1302,3877
430430,201902,651,1707,310,965,74,235,65,197,139,432
430435,201902,1469,3836,1104,3234,247,771,479,1394,726,2165
430440,201902,3556,10271,2665,8488,458,1605,1416,4474,1874,6079
430450,201902,6600,17233,5246,14796,638,2061,3045,8361,3683,10422
430460,201902,27977,74138,19793,60359,4182,14164,8522,24628,12704,38792
430461,201902,392,989,108,338,21,69,29,82,50,151
430462,201902,240,663,142,474,18,65,49,175,67,240
430463,201902,4560,13025,3557,11212,686,2350,1782,5534,2468,7884
430465,201902,462,1257,382,1098,60,187,231,641,291,828
430466,201902,3781,9755,2974,8385,786,2315,1342,3580,2128,5895
430467,201902,474,1203,331,960,53,188,161,434,214,622
430468,201902,1299,3291,1023,2879,130,397,610,1693,740,2090
430469,201902,646,1814,77,269,11,37,11,19,22,56
430470,201902,5308,14282,3670,11314,1170,3856,871,2602,2041,6458
430471,201902,506,1541,429,1380,82,267,200,619,282,886
430480,201902,822,2164,423,1309,64,214,86,229,150,443
430485,201902,159,437,60,203,10,28,11,39,21,67
430490,201902,406,1057,225,661,29,97,107,283,136,380
430495,201902,358,1015,215,722,36,131,76,234,112,365
430500,201902,1013,2695,708,2159,212,704,223,607,435,1311
430510,201902,22310,59941,15815,46816,3247,10706,6329,17203,9576,27909
430511,201902,320,947,122,428,14,50,15,44,29,94
430512,201902,891,2118,698,1818,177,457,235,632,412,1089
430513,201902,772,1970,360,1042,57,167,167,465,224,632
430515,201902,393,1113,278,875,41,117,143,458,184,575
430517,201902,875,2803,747,2535,135,453,380,1345,515,1798
430520,201902,1276,3393,655,2043,123,371,130,386,253,757
430530,201902,1030,2666,376,1171,86,266,85,254,171,520
430535,201902,2962,7954,2099,6312,349,1095,1004,2958,1353,4053
430537,201902,309,1115,282,1029,34,114,216,792,250,906
430540,201902,555,1345,329,979,59,169,143,408,202,577
430543,201902,633,1239,381,941,58,132,211,546,269,678
430544,201902,627,1892,448,1471,96,339,210,670,306,1009
430545,201902,1852,5067,1381,4326,282,901,673,2188,955,3089
430550,201902,401,1146,248,804,46,153,70,211,116,364
430558,201902,112,254,49,134,8,21,16,41,24,62
430560,201902,322,718,134,403,11,43,43,120,54,163
430570,201902,786,1878,566,1531,84,261,345,869,429,1130
430580,201902,943,2342,638,1868,148,482,281,779,429,1261
430583,201902,191,474,38,122,3,10,7,21,10,31
430585,201902,219,524,115,304,16,43,55,119,71,162
430587,201902,190,563,133,431,23,77,58,188,81,265
430590,201902,1377,3382,1182,3080,54,164,1019,2618,1073,2782
430593,201902,18,66,12,44,2,8,6,21,8,29
430595,201902,397,937,85,280,8,32,17,40,25,72
430597,201902,334,922,206,626,23,75,74,173,97,248
430600,201902,1744,4637,801,2438,150,493,218,624,368,1117
430605,201902,1075,3059,797,2499,117,440,324,967,441,1407
430607,201902,582,1350,428,1106,34,92,299,782,333,874
430610,201902,5434,13527,3667,10737,1090,3446,618,1926,1708,5372
430613,201902,255,606,73,215,7,23,19,47,26,70
430620,201902,531,1413,412,1175,78,253,200,534,278,787
430630,201902,399,1126,123,403,19,63,24,63,43,126
430632,201902,515,1392,238,737,27,88,109,322,136,410
430635,201902,516,1360,382,1096,58,175,261,743,319,918
430637,201902,450,1159,354,1006,44,145,200,537,244,682
430640,201902,1059,2760,616,1850,99,318,208,575,307,893
430642,201902,338,938,257,754,49,143,135,382,184,525
430645,201902,227,502,81,219,17,49,13,36,30,85
430650,201902,1523,4660,1276,4228,352,1172,587,2013,939,3185
430655,201902,233,555,140,379,12,37,72,177,84,214
430660,201902,4644,12484,3540,10510,827,2640,1569,4574,2396,7214
430670,201902,590,1521,452,1270,40,131,299,845,339,976
430673,201902,564,1316,224,678,41,131,80,232,121,363
430675,201902,199,578,57,197,18,73,16,50,34,123
430676,201902,4232,10937,3288,9414,473,1469,1952,5440,2425,6909
430680,201902,935,2512,566,1753,153,483,144,432,297,915
430690,201902,2988,8356,2402,7258,793,2490,646,1900,1439,4390
430692,201902,208,641,157,554,13,44,112,401,125,445
430693,201902,997,2647,569,1754,108,384,124,353,232,737
430695,201902,490,1232,288,837,33,95,159,439,192,534
430697,201902,377,977,282,821,58,168,144,434,202,602
430700,201902,6476,16479,3511,10889,877,2929,422,1304,1299,4233
430705,201902,385,963,181,564,31,108,69,199,100,307
430710,201902,1637,3688,1132,2942,171,499,623,1588,794,2087
430720,201902,719,1754,377,1152,58,166,168,510,226,676
430730,201902,1057,2896,725,2262,120,354,347,1100,467,1454
430740,201902,556,1537,291,967,49,177,84,288,133,465
430745,201902,441,1241,237,761,40,143,62,178,102,321
430750,201902,1309,3472,930,2804,189,598,486,1409,675,2007
430755,201902,456,1131,290,793,18,62,157,399,175,461
430760,201902,1924,4931,1487,4262,372,1107,625,1745,997,2852
430770,201902,5795,14857,4434,12778,692,2238,2676,7476,3368,9714
430780,201902,2023,5065,1145,3546,230,743,351,1092,581,1835
430781,201902,387,1110,219,717,52,173,47,133,99,306
430783,201902,414,976,236,690,23,83,134,364,157,447
430786,201902,36,124,20,79,4,14,1,8,5,22
430790,201902,4335,11189,2964,8614,429,1425,1632,4424,2061,5849
430800,201902,728,1823,538,1483,48,152,349,940,397,1092
430805,201902,431,1177,258,782,24,81,153,427,177,508
430807,201902,324,743,206,563,14,49,116,291,130,340
430810,201902,802,1965,264,860,33,134,73,220,106,354
430820,201902,1274,3453,690,2280,151,512,151,519,302,1031
430825,201902,272,699,90,252,16,43,22,53,38,96
430830,201902,1602,4778,1324,4238,74,288,920,2928,994,3216
430840,201902,899,2453,703,2096,112,351,444,1313,556,1664
430843,201902,111,270,34,105,4,12,16,42,20,54
430845,201902,376,918,243,695,78,242,65,167,143,409
430850,201902,2204,5963,1627,4838,296,936,751,2223,1047,3159
430860,201902,777,1846,430,1232,67,228,199,498,266,726
430865,201902,506,1324,405,1146,73,216,206,559,279,775
430870,201902,629,1680,273,874,41,148,93,258,134,406
430880,201902,1203,2876,810,2265,174,516,380,1016,554,1532
430885,201902,201,492,90,295,8,39,48,145,56,184
430890,201902,985,2657,674,2083,56,265,116,330,172,595
430900,201902,2904,6683,1975,5287,180,574,1215,3052,1395,3626
430905,201902,747,1978,473,1438,92,307,167,489,259,796
430910,201902,1378,3781,930,2860,164,571,390,1076,554,1647
430912,201902,471,1324,318,1030,31,92,205,679,236,771
430915,201902,482,1512,358,1273,88,325,124,445,212,770
430920,201902,22211,57724,16930,48905,2501,8014,9836,27583,12337,35597
430925,201902,137,308,51,147,10,30,18,55,28,85
430930,201902,9413,22631,5741,16902,1294,4063,2089,6378,3383,10441
430940,201902,1105,3111,616,1936,198,657,72,170,270,827
430950,201902,689,1727,432,1241,49,175,257,668,306,843
430955,201902,220,576,61,192,14,42,13,33,27,75
430957,201902,177,620,164,589,30,114,90,317,120,431
430960,201902,1266,3030,771,2162,172,530,346,953,518,1483
430965,201902,1667,4124,1270,3491,78,242,946,2567,1024,2809
430970,201902,379,975,191,587,31,105,89,258,120,363
430975,201902,473,1486,360,1204,92,326,143,468,235,794
430980,201902,389,957,214,649,41,131,88,255,129,386
430990,201902,543,1615,328,1062,44,158,162,521,206,679
430995,201902,567,1487,409,1227,61,192,192,568,253,760
431000,201902,1312,3102,513,1502,87,278,33,79,120,357
431010,201902,2030,5414,1217,3948,219,789,136,381,355,1170
431020,201902,8034,18107,4881,13160,1161,3448,1581,3855,2742,7303
431030,201902,310,859,140,487,26,94,24,80,50,174
431033,201902,2969,7422,1896,5706,504,1568,576,1808,1080,3376
431036,201902,352,784,73,226,12,30,16,46,28,76
431040,201902,904,2398,588,1796,93,332,259,726,352,1058
431041,201902,457,1083,343,913,33,92,200,518,233,610
431043,201902,393,969,210,657,62,209,69,211,131,420
431046,201902,106,287,46,148,4,14,11,34,15,48
431050,201902,1359,3444,978,2836,169,507,527,1534,696,2041
431053,201902,517,1472,317,1035,70,241,102,311,172,552
431055,201902,587,1476,497,1340,39,97,374,998,413,1095
431057,201902,265,774,129,444,16,55,35,109,51,164
431060,201902,4917,13517,3476,10932,991,3344,690,2238,1681,5582
431065,201902,460,1229,311,962,66,205,106,326,172,531
431070,201902,436,1296,245,833,67,254,36,107,103,361
431075,201902,220,671,142,486,25,84,40,137,65,221
431080,201902,590,1653,409,1278,95,326,120,352,215,678
431085,201902,695,1904,494,1441,76,220,260,735,336,955
431087,201902,458,1328,366,1124,27,82,248,776,275,858
431090,201902,390,933,145,466,29,99,35,111,64,210
431100,201902,3069,7124,2215,5961,362,1026,1078,2909,1440,3935
431110,201902,1349,3224,937,2485,242,639,406,1034,648,1673
431112,201902,502,1539,422,1376,82,298,220,682,302,980
431113,201902,334,963,295,883,65,213,158,464,223,677
431115,201902,1044,3035,823,2619,133,462,460,1404,593,1866
431120,201902,2286,6588,1590,5138,535,1934,366,1071,901,3005
431123,201902,381,1092,235,775,49,135,119,420,168,555
431125,201902,1040,3140,774,2556,302,978,227,810,529,1788
431127,201902,254,673,59,192,8,24,8,17,16,41
431130,201902,2965,8032,2128,6493,424,1433,947,2819,1371,4252
431140,201902,4778,11546,2673,7526,371,1134,1112,2787,1483,3921
431142,201902,480,1335,362,1115,55,167,212,657,267,824
431150,201902,993,2741,696,2150,152,490,278,847,430,1337
431160,201902,668,1931,475,1518,91,292,163,531,254,823
431162,201902,483,1195,226,696,24,97,97,271,121,368
431164,201902,198,465,43,137,8,25,6,22,14,47
431170,201902,520,1456,353,1112,100,297,95,298,195,595
431171,201902,630,1578,520,1433,73,190,330,910,403,1100
431173,201902,377,1027,279,866,94,321,89,263,183,584
431175,201902,1013,2539,630,1866,138,409,161,471,299,880
431177,201902,677,2000,510,1714,153,554,233,774,386,1328
431179,201902,304,653,67,203,15,50,14,32,29,82
431180,201902,2176,5701,1330,4031,379,1148,266,819,645,1967
431190,201902,451,1245,236,760,29,90,53,150,82,240
431198,201902,308,959,267,884,105,362,67,245,172,607
431200,201902,376,976,87,274,13,36,2,6,15,42
431205,201902,182,524,79,278,19,72,28,96,47,168
431210,201902,611,1601,490,1419,119,325,242,739,361,1064
431213,201902,242,706,184,601,17,70,92,301,109,371
431215,201902,521,1270,238,712,30,98,97,263,127,361
431217,201902,157,449,104,341,8,29,62,188,70,217
431220,201902,591,1574,338,1072,31,121,176,510,207,631
431225,201902,1479,3667,1119,3052,121,357,728,1973,849,2330
431230,201902,667,1972,486,1515,74,249,278,825,352,1074
431235,201902,145,366,25,77,3,8,3,9,6,17
431237,201902,346,1052,271,906,43,170,145,460,188,630
431238,201902,24,63,19,51,6,14,6,15,12,29
431240,201902,3744,9759,2935,8446,621,1972,1334,3695,1955,5667
431242,201902,293,825,241,725,62,197,112,339,174,536
431244,201902,326,790,151,428,25,96,51,107,76,203
431245,201902,1290,3080,805,2206,107,311,392,1017,499,1328
431247,201902,215,598,106,345,20,71,22,52,42,123
431250,201902,1524,4184,1159,3641,261,803,547,1805,808,2608
431260,201902,216,610,120,415,22,92,41,128,63,220
431261,201902,239,760,191,665,22,84,94,304,116,388
431262,201902,380,1078,167,559,13,45,108,357,121,402
431265,201902,1415,3367,575,1692,81,274,189,465,270,739
431267,201902,237,668,141,427,4,15,96,264,100,279
431270,201902,2534,5979,1363,3935,360,1115,377,1101,737,2216
431275,201902,139,396,71,229,17,55,8,18,25,73
431280,201902,241,666,67,232,7,22,5,14,12,36
431290,201902,290,833,199,631,31,102,62,165,93,267
431295,201902,72,191,25,74,2,5,6,15,8,20
431300,201902,373,935,57,194,5,22,12,34,17,56
431301,201902,219,647,56,199,7,16,4,11,11,27
431303,201902,566,1529,325,1003,32,116,125,360,157,476
431306,201902,2083,5032,1235,3552,204,665,466,1166,670,1831
431308,201902,23,73,20,63,13,44,5,12,18,56
431310,201902,525,1526,345,1093,46,162,155,465,201,627
431320,201902,577,1575,263,880,49,162,43,129,92,291
431330,201902,1608,3899,748,2287,202,667,194,543,396,1210
431333,201902,222,618,112,330,17,43,40,113,57,156
431335,201902,40,116,24,81,6,14,4,8,10,22
431337,201902,2489,6843,1740,5525,451,1593,612,1856,1063,3449
431339,201902,404,1066,300,872,67,197,143,412,210,609
431340,201902,19245,48562,13319,38258,2708,8487,5088,13778,7796,22265
431342,201902,450,1025,328,842,19,54,281,714,300,768
431344,201902,386,998,226,671,12,39,147,424,159,463
431346,201902,257,656,99,328,16,50,28,91,44,141
431349,201902,634,1686,335,1010,66,211,123,346,189,557
431350,201902,3817,10278,2791,8481,437,1470,1362,4088,1799,5558
431360,201902,546,1325,307,876,75,230,102,280,177,510
431365,201902,1687,4327,1416,3932,149,489,1045,2863,1194,3352
431370,201902,4014,10478,2966,8668,759,2402,1265,3770,2024,6172
431380,201902,735,2101,623,1902,38,134,409,1242,447,1376
431390,201902,2402,6028,1387,4139,224,770,534,1396,758,2166
431395,201902,1191,3207,853,2671,221,710,343,1106,564,1816
431400,201902,333,960,176,566,29,93,44,126,73,219
431402,201902,829,1976,588,1566,85,247,367,917,452,1164
431403,201902,179,497,142,431,24,93,81,206,105,299
431405,201902,4292,11567,3395,10164,456,1597,1945,5590,2401,7187
431406,201902,432,1344,344,1153,88,276,168,580,256,856
431407,201902,449,1252,289,901,60,199,133,400,193,599
431410,201902,14884,39277,9547,29332,1757,6156,3952,11283,5709,17439
431413,201902,176,453,57,190,6,18,8,27,14,45
431415,201902,675,1720,411,1266,65,237,172,475,237,712
431417,201902,563,1294,385,1026,68,197,199,510,267,707
431420,201902,1426,3451,1104,2981,198,560,540,1472,738,2032
431430,201902,514,1346,249,802,38,136,66,184,104,320
431440,201902,24972,61572,18017,50257,3704,11060,6313,17127,10017,28187
431442,201902,100,286,46,161,7,25,7,20,14,45
431445,201902,425,1209,135,471,17,54,15,53,32,107
431446,201902,304,858,207,657,50,172,81,244,131,416
431447,201902,607,1686,404,1252,88,288,153,484,241,772
431449,201902,707,1887,427,1262,71,204,183,528,254,732
431450,201902,2049,4484,1676,3956,110,286,1280,2898,1390,3184
431454,201902,42,126,39,120,8,28,16,53,24,81
431455,201902,563,1387,294,821,42,139,144,356,186,495
431460,201902,2815,7201,2068,5819,563,1666,615,1753,1178,3419
431470,201902,1432,4096,1033,3254,198,643,447,1420,645,2063
431475,201902,248,719,32,131,2,9,2,10,4,19
431477,201902,417,1084,257,759,39,111,120,320,159,431
431478,201902,243,617,61,188,17,52,5,14,22,66
431480,201902,2990,7672,2324,6616,427,1276,1287,3640,1714,4916
431490,201902,98674,243725,79209,213622,7012,21875,57533,150140,64545,172015
431500,201902,475,1260,351,1015,68,189,181,509,249,698
431505,201902,343,823,219,630,20,54,137,395,157,449
431507,201902,338,805,143,412,32,108,50,126,82,234
431510,201902,1458,3899,1033,3058,248,780,393,1160,641,1940
431513,201902,231,543,121,345,9,22,82,238,91,260
431514,201902,80,213,43,136,6,18,22,69,28,87
431515,201902,484,1262,330,970,67,207,162,450,229,657
431517,201902,72,208,55,167,13,35,17,51,30,86
431520,201902,425,1055,163,529,32,114,54,156,86,270
431530,201902,3871,8410,2322,6221,647,1771,411,1139,1058,2910
431531,201902,194,536,128,398,14,42,55,172,69,214
431532,201902,540,1306,339,942,76,229,134,366,210,595
431535,201902,242,647,102,328,22,76,15,44,37,120
431540,201902,1698,5591,1587,5413,63,259,1281,4373,1344,4632
431545,201902,349,924,61,199,8,26,13,36,21,62
431550,201902,1875,5077,1519,4373,286,895,717,1972,1003,2867
431555,201902,668,1557,412,1115,28,91,255,675,283,766
431560,201902,20054,51573,13257,40447,2892,9485,3885,12544,6777,22029
431570,201902,4660,11484,3637,10025,529,1625,2291,6085,2820,7710
431575,201902,208,599,154,486,25,71,32,97,57,168
431580,201902,527,1425,301,943,49,187,141,405,190,592
431590,201902,667,1814,479,1427,90,265,194,596,284,861
431595,201902,322,918,220,692,46,151,84,245,130,396
431600,201902,1262,3144,917,2639,270,812,327,976,597,1788
431610,201902,1280,3486,892,2693,138,380,442,1389,580,1769
431620,201902,553,1509,235,724,41,134,101,290,142,424
431630,201902,1246,3233,577,1807,127,433,189,523,316,956
431640,201902,5799,15091,5122,14136,625,1813,3640,10084,4265,11897
431642,201902,468,1155,307,845,32,80,168,444,200,524
431643,201902,322,791,137,403,17,46,46,137,63,183
431645,201902,1690,4156,1349,3632,112,345,992,2646,1104,2991
431647,201902,211,545,101,293,12,39,24,60,36,99
431650,201902,160,457,109,358,17,61,40,120,57,181
431660,201902,834,2254,431,1415,78,290,88,261,166,551
431670,201902,1151,2844,760,2145,108,330,399,1073,507,1403
431673,201902,234,614,86,295,15,47,12,39,27,86
431675,201902,543,1333,114,356,10,37,31,78,41,115
431680,201902,6981,18688,5152,15143,1364,4153,1941,5690,3305,9843
431690,201902,20222,52000,13861,40487,3315,10246,4908,14476,8223,24722
431695,201902,148,385,95,286,17,60,41,95,58,155
431697,201902,464,1126,350,939,59,150,189,524,248,674
431700,201902,1388,3707,1176,3314,173,477,674,1889,847,2366
431710,201902,10912,28497,8250,24498,1927,5969,3503,10924,5430,16893
431720,201902,5500,14407,3440,10245,943,2983,549,1487,1492,4470
431725,201902,26,73,18,55,5,14,4,11,9,25
431730,201902,3538,9024,2290,6899,593,1918,693,2197,1286,4115
431740,201902,4817,12067,3217,9253,949,3061,656,1616,1605,4677
431750,201902,6792,18431,5683,16679,1080,3427,2923,8607,4003,12034
431755,201902,306,827,66,238,10,39,11,40,21,79
431760,201902,5383,12519,3481,9429,367,1222,2092,5266,2459,6488
431770,201902,1721,4312,1393,3868,114,359,1006,2748,1120,3107
431775,201902,204,547,97,305,23,81,17,42,40,123
431780,201902,1861,4827,1226,3630,233,733,448,1307,681,2040
431790,201902,865,2363,609,1853,118,362,264,772,382,1134
431795,201902,222,580,104,318,26,85,28,81,54,166
431800,201902,7051,18513,4874,14789,1494,5036,620,1964,2114,7000
431805,201902,291,687,84,281,6,23,33,100,39,123
431810,201902,3231,7919,2031,5662,380,1172,847,2207,1227,3379
431820,201902,2098,5995,1705,5321,453,1460,658,2135,1111,3595
431830,201902,8568,19603,6347,16408,1545,4471,2250,5841,3795,10312
431840,201902,2384,6615,1962,5889,357,1098,1148,3455,1505,4553
431842,201902,657,1633,222,695,30,102,66,192,96,294
431843,201902,309,852,237,705,34,107,115,323,149,430
431844,201902,196,525,64,212,17,63,20,58,37,121
431845,201902,511,1359,355,1038,28,87,217,624,245,711
431846,201902,251,709,223,668,18,50,181,545,199,595
431848,201902,153,385,82,250,9,30,13,28,22,58
431849,201902,402,953,60,167,10,24,5,11,15,35
431850,201902,3879,10833,3040,9120,764,2475,926,2723,1690,5198
431860,201902,646,1639,394,1129,77,231,196,532,273,763
431861,201902,110,288,45,142,6,21,15,40,21,61
431862,201902,420,1338,342,1201,78,294,172,595,250,889
431870,201902,16179,43934,13232,38913,2110,7006,7162,20251,9272,27257
431880,201902,3951,10422,2793,8331,516,1736,1183,3386,1699,5122
431890,201902,3955,10410,2470,7412,777,2548,342,1107,1119,3655
431900,201902,971,2550,613,1850,107,373,303,853,410,1226
431910,201902,782,1924,278,808,48,143,74,173,122,316
431912,201902,445,1297,357,1124,74,241,206,650,280,891
431915,201902,933,2493,761,2194,49,152,541,1528,590,1680
431920,201902,1133,2909,965,2654,46,156,814,2192,860,2348
431930,201902,671,1892,476,1529,124,369,233,770,357,1139
431935,201902,78,230,48,167,15,48,7,29,22,77
431936,201902,289,869,165,556,36,123,47,152,83,275
431937,201902,185,473,113,317,24,81,46,104,70,185
431940,201902,2750,6717,1579,4519,231,774,713,1909,944,2683
431950,201902,1723,4763,1427,4275,411,1257,593,1787,1004,3044
431960,201902,2664,6847,1987,5584,586,1712,536,1507,1122,3219
431970,201902,402,1052,153,490,35,100,36,103,71,203
431971,201902,59,150,32,102,4,16,5,10,9,26
431973,201902,445,1455,363,1291,40,137,254,920,294,1057
431975,201902,97,200,17,57,4,13,4,11,8,24
431980,201902,1059,2839,808,2408,187,603,350,997,537,1600
431990,201902,5547,13872,3629,10911,609,2053,1465,4258,2074,6311
432000,201902,9991,25171,7334,20902,1824,5392,3120,8929,4944,14321
432010,201902,1873,4931,1402,4052,210,676,798,2204,1008,2880
432020,201902,1769,4435,1213,3441,286,859,529,1409,815,2268
432023,201902,495,1228,259,755,47,150,121,321,168,471
432026,201902,993,2892,734,2363,176,563,292,930,468,1493
432030,201902,317,846,199,616,34,113,105,314,139,427
432032,201902,393,1050,269,800,31,107,140,376,171,483
432035,201902,678,1974,600,1844,219,710,206,632,425,1342
432040,201902,1067,2485,367,1170,72,265,110,305,182,570
432045,201902,178,500,106,348,22,74,35,117,57,191
432050,201902,487,1300,369,1078,94,267,136,405,230,672
432055,201902,672,1811,423,1311,132,438,113,323,245,761
432057,201902,236,625,171,472,33,82,73,182,106,264
432060,201902,429,1024,137,430,27,102,50,133,77,235
432065,201902,224,639,158,488,32,92,54,162,86,254
432067,201902,703,2116,602,1878,72,253,389,1170,461,1423
432070,201902,1766,4770,1096,3400,234,805,286,784,520,1589
432080,201902,3843,9892,2992,8428,653,2089,1252,3396,1905,5485
432085,201902,391,1013,256,805,90,279,88,294,178,573
432090,201902,1251,3322,898,2665,198,631,416,1178,614,1809
432100,201902,958,2576,425,1399,86,304,43,112,129,416
432110,201902,2083,5783,1390,4469,358,1309,96,322,454,1631
432120,201902,2630,7523,2130,6617,619,2055,563,1722,1182,3777
432130,201902,2420,6530,2067,6012,696,2116,815,2414,1511,4530
432132,201902,180,531,107,368,21,75,41,120,62,195
432135,201902,919,2314,606,1706,44,151,428,1177,472,1328
432140,201902,1488,4614,1112,3850,191,690,602,2124,793,2814
432143,201902,1309,3555,1022,3097,92,331,655,1962,747,2293
432145,201902,1312,3597,744,2336,123,429,188,516,311,945
432146,201902,107,306,70,232,21,73,14,41,35,114
432147,201902,445,1349,284,997,87,319,59,190,146,509
432149,201902,411,1070,223,669,19,52,107,316,126,368
432150,201902,2810,7631,2070,6228,506,1703,634,1837,1140,3540
432160,201902,4614,12999,3527,11145,1015,3479,1141,3521,2156,7000
432162,201902,271,610,37,109,7,19,5,16,12,35
432163,201902,143,374,27,83,0,0,2,5,2,5
432166,201902,517,1523,401,1269,68,228,153,441,221,669
432170,201902,1274,3564,802,2633,180,645,223,696,403,1341
432180,201902,2535,6449,1356,4100,284,924,394,1061,678,1985
432183,201902,330,981,214,701,62,235,58,174,120,409
432185,201902,780,2063,454,1406,32,112,250,737,282,849
432190,201902,1966,4954,1215,3600,275,940,463,1268,738,2208
432195,201902,918,2331,591,1748,173,489,219,676,392,1165
432200,201902,2978,8174,2163,6748,423,1350,1036,3314,1459,4664
432210,201902,322,913,219,706,44,169,97,290,141,459
432215,201902,619,1855,548,1745,50,147,392,1266,442,1413
432218,201902,251,630,120,341,18,54,53,139,71,193
432220,201902,3680,8969,2727,7414,390,1193,1630,4272,2020,5465
432225,201902,89,262,68,216,16,51,31,101,47,152
432230,201902,710,1762,387,1128,56,168,168,460,224,628
432232,201902,485,1226,318,932,64,198,124,357,188,555
432234,201902,295,772,131,397,30,83,22,54,52,137
432235,201902,88,248,31,99,8,24,8,28,16,52
432237,201902,354,907,303,817,19,53,225,580,244,633
432240,201902,13181,36058,10222,31750,867,3086,6423,20698,7290,23784
432250,201902,4087,12933,3475,11736,1087,3752,1250,4365,2337,8117
432252,201902,430,1100,268,771,41,129,118,321,159,450
432253,201902,1018,3181,592,2063,159,603,28,79,187,682
432254,201902,840,2084,161,522,30,98,16,48,46,146
432255,201902,120,299,55,170,5,18,22,59,27,77
432260,201902,4696,12387,3455,10057,977,2922,999,2901,1976,5823
432270,201902,1842,5360,1490,4645,467,1553,257,787,724,2340
432280,201902,1085,2858,599,1861,104,362,232,638,336,1000
432285,201902,189,586,22,78,0,0,2,5,2,5
432290,201902,349,1022,190,638,63,214,40,110,103,324
432300,201902,24748,65709,19051,56201,2888,9451,11129,31836,14017,41287
432310,201902,715,2020,526,1662,67,215,330,1047,397,1262
432320,201902,212,505,68,203,9,36,26,66,35,102
432330,201902,227,575,84,268,15,44,19,59,34,103
432335,201902,172,499,54,206,5,19,13,56,18,75
432340,201902,312,753,132,412,23,89,37,97,60,186
432345,201902,585,1423,521,1344,25,82,406,1033,431,1115
432350,201902,318,868,161,541,30,102,50,160,80,262
432360,201902,212,624,39,124,3,14,13,37,16,51
432370,201902,312,786,202,591,16,42,123,348,139,390
432375,201902,490,1252,372,1030,64,159,199,553,263,712
432377,201902,204,648,36,125,6,19,4,9,10,28
432380,201902,1456,4131,928,3091,186,703,418,1320,604,2023
500020,201902,2183,5902,1549,4807,295,1003,769,2334,1064,3337
500025,201902,1175,2697,741,1986,65,189,434,1135,499,1324
500060,201902,6151,17735,4595,15066,661,2239,2694,9243,3355,11482
500070,201902,3801,10123,2694,8250,537,1658,1177,3766,1714,5424
500080,201902,1216,3232,843,2578,158,563,385,1092,543,1655
500085,201902,1958,4929,1314,3889,300,955,638,1809,938,2764
500090,201902,1867,5116,1277,4067,240,789,499,1649,739,2438
500100,201902,3371,8807,2581,7505,349,1127,1422,4000,1771,5127
500110,201902,6844,18625,4433,14638,972,3487,1332,5121,2304,8608
500124,201902,1897,5903,1560,5294,307,1028,858,3067,1165,4095
500150,201902,1168,2710,730,2046,188,560,239,629,427,1189
500190,201902,4225,10383,2996,8570,747,2225,1119,3264,1866,5489
500200,201902,2110,5108,1550,4173,185,530,931,2382,1116,2912
500210,201902,4323,11610,3269,10083,879,2778,1418,4472,2297,7250
500215,201902,1337,3827,939,3061,95,352,485,1573,580,1925
500220,201902,2579,7341,1820,5988,320,1160,683,2213,1003,3373
500230,201902,2026,4961,1526,4225,208,573,963,2626,1171,3199
500240,201902,3439,10655,2381,8382,429,1685,750,2717,1179,4402
500260,201902,2988,6562,1823,4924,242,629,944,2503,1186,3132
500270,201902,126413,306189,73830,213555,14262,44923,24673,67798,38935,112721
500280,201902,1198,3094,834,2518,112,373,504,1483,616,1856
500290,201902,3511,8164,1925,5679,345,1121,710,1963,1055,3084
500295,201902,2879,7241,1712,5032,304,972,658,1727,962,2699
500310,201902,857,1956,609,1639,99,233,323,906,422,1139
500315,201902,3191,9501,2620,8573,279,919,1802,6078,2081,6997
500320,201902,17041,49185,12068,40642,3259,11686,3917,14018,7176,25704
500325,201902,4006,9379,2729,7529,291,867,1625,4496,1916,5363
500330,201902,6487,15229,4166,11637,363,1149,2334,6636,2697,7785
500345,201902,1921,4765,1233,3668,310,956,423,1236,733,2192
500348,201902,2514,6479,1898,5451,245,735,1111,3259,1356,3994
500350,201902,1245,3440,664,2169,85,294,257,849,342,1143
500370,201902,22158,59498,15105,47494,2428,8611,7153,22529,9581,31140
500375,201902,2288,6362,1606,4893,351,1187,531,1542,882,2729
500380,201902,3404,8632,2339,6882,664,2067,790,2368,1454,4435
500390,201902,500,1066,299,801,52,145,153,414,205,559
500400,201902,1102,3002,756,2293,155,526,255,710,410,1236
500410,201902,2295,6010,1679,5035,224,673,969,2971,1193,3644
500430,201902,2414,6305,1654,5135,258,918,650,2124,908,3042
500440,201902,1084,2658,683,2009,109,319,263,826,372,1145
500450,201902,1320,3398,724,2259,144,461,135,393,279,854
500460,201902,3334,9320,2090,6874,428,1576,576,1920,1004,3496
500470,201902,2272,6329,1430,4569,453,1577,279,786,732,2363
500480,201902,2157,6440,1854,5988,172,590,1251,4225,1423,4815
500490,201902,943,2294,548,1686,138,504,158,478,296,982
500500,201902,4066,11291,2682,9021,913,3514,583,2016,1496,5530
500510,201902,636,1618,423,1245,23,81,252,714,275,795
500515,201902,1857,4713,1457,4106,128,362,996,2790,1124,3152
500520,201902,2936,9865,2372,8726,692,2654,937,3553,1629,6207
500525,201902,860,2627,702,2375,81,305,423,1459,504,1764
500540,201902,4151,11049,2500,8082,739,2864,230,624,969,3488
500560,201902,5018,14819,4162,13623,328,1180,3127,10382,3455,11562
500568,201902,4073,9174,2467,6811,616,1869,787,2173,1403,4042
500570,201902,7093,17156,4094,11891,906,2895,1086,2942,1992,5837
500580,201902,3027,8248,2294,6999,482,1557,1138,3443,1620,5000
500600,201902,2945,7480,2056,6137,387,1225,893,2713,1280,3938
500620,201902,7003,19246,4786,14936,1052,3383,1802,5606,2854,8989
500625,201902,478,1342,266,871,52,190,104,319,156,509
500627,201902,714,1841,428,1308,62,185,144,444,206,629
500630,201902,5702,13988,3432,10127,795,2527,1057,3183,1852,5710
500635,201902,2682,8885,2111,8080,152,615,1538,6276,1690,6891
500640,201902,1617,3705,1094,2958,41,135,748,1950,789,2085
500660,201902,15465,43640,10970,36451,3896,14323,2472,8350,6368,22673
500690,201902,2124,6019,1488,5014,624,2378,88,214,712,2592
500710,201902,2841,8012,2165,6765,640,2110,623,1846,1263,3956
500720,201902,4766,12432,2989,9420,711,2437,769,2486,1480,4923
500730,201902,876,2327,570,1759,91,262,231,732,322,994
500740,201902,4472,10903,3147,8710,328,967,1810,5052,2138,6019
500750,201902,939,2482,651,1970,101,322,247,682,348,1004
500755,201902,823,2297,478,1621,99,344,70,225,169,569
500769,201902,4754,12100,2490,7566,494,1691,349,795,843,2486
500770,201902,1466,4081,920,3056,162,600,297,986,459,1586
500780,201902,1247,3128,796,2351,177,561,218,597,395,1158
500790,201902,7444,19878,5937,17455,1139,3629,3204,9458,4343,13087
500793,201902,1763,4640,1202,3685,393,1233,252,701,645,1934
500795,201902,2381,6426,1979,5882,133,375,1641,5032,1774,5407
500797,201902,694,1850,458,1402,107,337,171,516,278,853
500800,201902,2639,6375,1742,5049,594,1956,265,846,859,2802
500830,201902,16926,43353,11673,33791,2019,6375,5243,14416,7262,20791
500840,201902,1360,3432,774,2279,94,293,310,872,404,1165
510010,201902,1832,4388,1205,3517,170,475,722,2148,892,2623
510020,201902,3485,9142,1818,5678,431,1396,350,989,781,2385
510025,201902,6500,16908,3998,12435,706,2463,1387,4095,2093,6558
510030,201902,2158,4974,1408,3905,343,973,495,1413,838,2386
510035,201902,1198,3093,713,2322,94,321,414,1416,508,1737
510040,201902,2135,5008,1543,4187,145,409,975,2646,1120,3055
510050,201902,1929,4536,1295,3609,210,665,781,2054,991,2719
510060,201902,1334,3426,989,2895,187,617,387,1081,574,1698
510080,201902,1175,3245,778,2539,231,814,225,646,456,1460
510100,201902,629,1521,410,1148,55,163,212,565,267,728
510120,201902,252,468,141,338,8,24,104,248,112,272
510125,201902,2121,5361,1652,4651,218,807,764,1946,982,2753
510130,201902,1432,3662,1000,2956,221,738,290,858,511,1596
510140,201902,2797,7660,1946,6553,702,2725,683,2144,1385,4869
510160,201902,1667,4409,1223,3820,207,640,829,2617,1036,3257
510170,201902,4455,12197,3279,10258,791,2575,1337,4253,2128,6828
510180,201902,12945,31152,7884,23005,1938,6102,2265,7484,4203,13586
510185,201902,1602,4390,1072,3606,418,1374,341,1399,759,2773
510190,201902,1995,5792,1348,4650,440,1624,297,1077,737,2701
510250,201902,13840,37420,11348,33919,2224,6889,6399,19829,8623,26718
510260,201902,2045,8421,1663,7715,275,1335,970,4965,1245,6300
510263,201902,2837,8166,1759,5938,356,1302,215,668,571,1970
510267,201902,4569,13353,2809,9418,604,2110,528,1786,1132,3896
510268,201902,1350,3429,943,2720,131,382,523,1460,654,1842
510269,201902,1035,2904,659,2188,157,559,238,762,395,1321
510270,201902,2786,8351,2018,6973,397,1476,783,2679,1180,4155
510279,201902,1689,4586,1148,3615,215,755,546,1635,761,2390
510285,201902,1066,2954,751,2405,220,783,182,556,402,1339
510300,201902,3504,9102,2605,7864,364,1034,1549,4965,1913,5999
510305,201902,1444,4104,888,3012,187,693,245,908,432,1601
510310,201902,923,2408,654,1949,209,656,199,613,408,1269
510320,201902,3565,9370,2560,7608,593,1890,718,2178,1311,4068
510325,201902,4424,13381,3448,11744,983,3420,1345,4758,2328,8178
510330,201902,2809,8594,1902,6962,393,1480,688,2827,1081,4307
510335,201902,4517,13090,3387,11445,431,1575,1967,6965,2398,8540
510336,201902,456,1355,338,1160,64,217,155,566,219,783
510337,201902,1573,4748,1063,3801,421,1626,170,627,591,2253
510340,201902,83325,191095,50332,141425,14014,45973,12782,33338,26796,79311
510343,201902,991,2826,679,2214,136,493,254,785,390,1278
510345,201902,1214,3580,904,2967,168,558,394,1253,562,1811
510350,201902,2774,7468,1799,5811,425,1419,705,2272,1130,3691
510360,201902,1806,3927,1155,3139,67,181,828,2358,895,2539
510370,201902,1620,4935,1175,4104,204,791,618,2198,822,2989
510380,201902,482,1241,261,822,73,262,69,208,142,470
510385,201902,1013,3637,756,3105,84,393,469,2028,553,2421
510390,201902,1008,3073,769,2725,199,692,359,1413,558,2105
510395,201902,724,1658,475,1283,34,107,266,763,300,870
510410,201902,4234,12424,3189,10490,713,2426,1678,5692,2391,8118
510420,201902,2092,4710,1465,3847,130,395,891,2328,1021,2723
510450,201902,489,1227,285,846,73,214,46,159,119,373
510452,201902,632,1801,413,1380,81,272,199,676,280,948
510454,201902,853,2467,652,2103,69,196,403,1388,472,1584
510455,201902,888,2594,636,2030,100,386,239,701,339,1087
510460,201902,1822,4600,1310,3841,133,467,810,2259,943,2726
510480,201902,4530,11372,2959,8317,598,1827,1149,3105,1747,4932
510490,201902,1588,4491,1190,3936,248,860,609,2034,857,2894
510500,201902,1553,4046,927,2963,188,649,311,991,499,1640
510510,201902,3159,9750,2395,8263,725,2739,625,2308,1350,5047
510515,201902,5226,14080,3382,10558,753,2606,919,2607,1672,5213
510517,201902,1076,3179,819,2720,238,882,157,469,395,1351
510520,201902,2007,4153,1158,3119,71,203,649,1859,720,2062
510523,201902,984,2627,736,2199,150,427,410,1231,560,1658
510525,201902,5749,16462,4278,13470,748,2646,1891,5541,2639,8187
510530,201902,546,1406,402,1195,31,117,266,761,297,878
510550,201902,2498,7588,1823,6362,474,1716,706,2513,1180,4229
510558,201902,2010,5562,1554,4866,167,591,818,2723,985,3314
510560,201902,1518,4473,873,3201,210,845,231,896,441,1741
510562,201902,5011,13700,3579,10971,893,2955,1170,3648,2063,6603
510590,201902,2960,7685,2142,6623,285,905,1359,4292,1644,5197
510600,201902,1480,3494,945,2661,182,498,379,1100,561,1598
510610,201902,2708,6666,1830,5434,176,611,1105,3271,1281,3882
510615,201902,2024,5709,1480,4703,262,831,834,2719,1096,3550
510617,201902,927,2709,678,2293,109,399,394,1398,503,1797
510618,201902,1197,3306,844,2674,171,606,441,1349,612,1955
510619,201902,704,1838,418,1311,69,249,90,265,159,514
510620,201902,1385,3192,640,2026,159,581,47,112,206,693
510621,201902,1360,3797,848,2796,186,656,257,818,443,1474
510622,201902,3946,11523,2754,8821,1016,3492,418,1205,1434,4697
510623,201902,2550,6692,1805,5459,420,1508,505,1449,925,2957
510624,201902,1482,3936,657,2260,89,330,126,365,215,695
510625,201902,2483,6169,1380,4168,301,1036,282,837,583,1873
510626,201902,1512,3594,897,2656,271,922,197,585,468,1507
510627,201902,581,1531,343,1058,90,278,77,259,167,537
510628,201902,1507,3474,1020,2833,157,409,615,1820,772,2229
510629,201902,1521,4562,1148,3846,279,1009,368,1238,647,2247
510630,201902,3151,9116,1838,6519,425,1619,301,1170,726,2789
510631,201902,529,1304,379,1085,23,65,279,799,302,864
510637,201902,3207,8110,2342,6749,680,2171,638,1766,1318,3937
510642,201902,4957,14948,3969,13444,1067,3880,1620,5685,2687,9565
510645,201902,829,1836,489,1373,121,341,183,501,304,842
510650,201902,6771,18452,5472,17034,677,1943,3959,13204,4636,15147
510665,201902,1766,4101,1024,2865,166,502,414,1210,580,1712
510670,201902,404,866,228,604,27,83,126,332,153,415
510675,201902,5540,15957,3973,12993,1222,4341,690,2222,1912,6563
510677,201902,2085,5510,1443,4519,207,683,740,2307,947,2990
510680,201902,655,1768,386,1245,94,331,52,157,146,488
510682,201902,1532,4778,1140,4064,378,1471,241,866,619,2337
510685,201902,640,1879,469,1535,70,234,222,713,292,947
510700,201902,3641,9298,2530,7650,400,1282,1575,4810,1975,6092
510704,201902,9459,23351,6212,17632,1270,3926,1782,4827,3052,8753
510706,201902,1788,5449,1272,4616,230,883,675,2628,905,3511
510710,201902,2438,6509,1663,4987,361,1135,578,1651,939,2786
510715,201902,627,1454,455,1205,51,129,211,583,262,712
510718,201902,2350,5295,1312,4030,589,1827,232,989,821,2816
510719,201902,394,854,236,645,37,103,123,319,160,422
510720,201902,931,2320,615,1820,136,436,223,624,359,1060
510724,201902,692,1928,477,1543,87,311,220,687,307,998
510726,201902,1188,2166,603,1426,77,197,303,707,380,904
510729,201902,615,1477,281,858,42,143,66,206,108,349
510730,201902,2880,7210,1956,5748,395,1262,805,2310,1200,3572
510735,201902,995,3000,746,2633,82,320,522,1862,604,2182
510740,201902,900,2287,584,1703,85,234,293,885,378,1119
510757,201902,564,1821,458,1644,164,647,153,517,317,1164
510760,201902,39093,87341,22604,62319,5442,17298,6404,16131,11846,33429
510770,201902,3988,9433,2909,8093,300,773,1967,5716,2267,6489
510774,201902,326,922,222,712,37,125,115,387,152,512
510775,201902,591,1628,399,1318,94,346,82,256,176,602
510776,201902,450,1190,308,903,82,246,99,293,181,539
510777,201902,1591,4380,1163,3794,150,627,752,2371,902,2998
510779,201902,568,1585,447,1380,61,170,263,860,324,1030
510780,201902,3519,9579,2626,8221,667,2117,1036,3618,1703,5735
510785,201902,2029,5432,1150,3782,300,1069,168,612,468,1681
510787,201902,2403,6991,1625,5337,681,2367,82,243,763,2610
510788,201902,678,1625,472,1310,73,193,191,622,264,815
510790,201902,14329,38622,8788,27871,2134,7716,1407,3900,3541,11616
510792,201902,8051,22007,5153,16565,1082,3859,1137,3481,2219,7340
510794,201902,1175,3259,770,2527,253,923,158,447,411,1370
510795,201902,7254,20063,4897,15739,1208,4238,1200,3907,2408,8145
510800,201902,1640,4304,1080,3364,323,1034,208,600,531,1634
510805,201902,1584,4404,1040,3357,234,817,329,939,563,1756
510810,201902,639,1377,418,1070,109,298,197,494,306,792
510820,201902,774,1512,425,1074,42,133,201,504,243,637
510830,201902,802,2021,559,1675,73,221,355,1111,428,1332
510835,201902,508,1302,346,1059,52,177,175,521,227,698
510840,201902,46370,104482,32889,87542,6088,15622,17324,50026,23412,65648
510850,201902,1834,4507,1034,3202,335,1174,128,313,463,1487
510860,201902,2442,6694,1575,5211,510,1965,173,561,683,2526
510880,201902,644,1914,488,1611,127,431,206,696,333,1127
510885,201902,550,1409,382,1157,66,223,131,393,197,616
510890,201902,639,1934,488,1678,107,399,226,779,333,1178
510895,201902,1169,3106,781,2426,203,714,296,833,499,1547
520005,201902,2083,5606,1647,5064,412,1187,792,2760,1204,3947
520010,201902,2151,6399,1542,5140,408,1531,395,1134,803,2665
520013,201902,2545,6849,1770,5365,417,1326,450,1464,867,2790
520015,201902,527,1361,397,1179,102,315,131,423,233,738
520017,201902,1066,2878,806,2464,119,382,491,1478,610,1860
520020,201902,362,892,288,789,46,152,176,454,222,606
520025,201902,31770,90686,27835,85178,3114,10250,19849,60527,22963,70777
520030,201902,5042,13671,4086,12266,466,1523,2622,7858,3088,9381
520050,201902,405,956,257,698,19,45,151,432,170,477
520055,201902,1246,3277,892,2581,51,151,505,1412,556,1563
520060,201902,1370,3977,1034,3354,285,1002,262,860,547,1862
520080,201902,1806,4769,1364,4155,248,758,632,2115,880,2873
520082,201902,922,2371,756,2083,85,203,429,1245,514,1448
520085,201902,756,2111,580,1823,124,406,230,683,354,1089
520090,201902,809,1639,548,1348,97,194,370,966,467,1160
520110,201902,36991,102659,26171,84871,8841,32311,1879,5601,10720,37912
520120,201902,193,477,108,330,14,52,35,102,49,154
520130,201902,3643,9365,2916,8184,558,1628,1351,3844,1909,5472
520140,201902,36306,102405,26573,85511,9965,34710,2943,9960,12908,44670
520145,201902,521,1264,350,1005,70,212,154,407,224,619
520150,201902,572,1377,418,1175,74,209,225,646,299,855
520160,201902,793,1859,573,1523,96,239,285,775,381,1014
520170,201902,4952,10381,3503,8687,195,539,2755,6716,2950,7255
520180,201902,1950,5551,1608,5011,397,1320,717,2209,1114,3529
520215,201902,1894,4580,1361,3738,314,940,544,1430,858,2370
520235,201902,596,1441,369,1089,40,129,145,412,185,541
520250,201902,1442,3787,1064,3203,331,1104,206,642,537,1746
520260,201902,831,1976,502,1404,104,305,199,559,303,864
520280,201902,651,1702,512,1459,133,378,203,626,336,1004
520310,201902,1166,2667,768,2061,192,550,297,827,489,1377
520320,201902,1678,4712,1318,4114,144,486,715,2226,859,2712
520330,201902,3491,9971,2534,8320,465,1792,1126,3612,1591,5404
520340,201902,2216,5103,1458,4033,164,411,911,2608,1075,3019
520350,201902,2791,7030,2044,5820,687,2068,640,1791,1327,3859
520355,201902,1752,4932,1313,4081,323,1110,477,1410,800,2520
520357,201902,762,1943,596,1677,38,104,437,1244,475,1348
520360,201902,681,1830,511,1531,160,489,139,458,299,947
520380,201902,1262,3239,763,2278,74,269,395,1090,469,1359
520390,201902,950,2132,535,1602,172,549,137,438,309,987
520393,201902,521,1258,368,1020,47,162,177,442,224,604
520396,201902,774,2146,653,1927,64,200,415,1204,479,1404
520400,201902,1534,3995,1217,3551,221,679,753,2193,974,2872
520410,201902,1745,3855,1034,2808,127,354,555,1478,682,1832
520420,201902,379,911,288,742,29,87,205,499,234,586
520425,201902,1396,3436,911,2612,226,652,314,905,540,1557
520430,201902,2166,5074,1171,3515,223,786,42,114,265,900
520440,201902,3030,7445,1903,5470,477,1472,503,1403,980,2875
520450,201902,11217,27815,7381,21696,2435,7748,844,2590,3279,10338
520455,201902,640,1796,466,1522,124,425,142,473,266,898
520460,201902,882,2270,746,2083,97,230,558,1604,655,1834
520465,201902,796,2098,640,1868,108,332,404,1145,512,1477
520470,201902,1914,5463,1589,5032,369,1148,824,2781,1193,3929
520480,201902,858,2446,580,1956,171,601,129,461,300,1062
520485,201902,1538,4387,1302,4064,215,663,822,2570,1037,3233
520490,201902,3869,10989,2984,9611,863,2791,1313,4418,2176,7209
520495,201902,1483,3400,1148,2949,57,156,902,2333,959,2489
520500,201902,1368,3680,948,2890,221,738,348,1057,569,1795
520505,201902,731,1762,526,1485,81,238,291,808,372,1046
520510,201902,7269,18876,4894,15130,1155,3984,1273,4219,2428,8203
520520,201902,1106,2902,831,2464,200,613,263,803,463,1416
520530,201902,1924,5864,1443,5014,486,1721,402,1600,888,3321
520540,201902,2851,7685,1763,5456,352,1138,400,1204,752,2342
520545,201902,889,2458,694,2143,142,434,256,806,398,1240
520547,201902,733,2066,578,1775,155,487,250,763,405,1250
520549,201902,11605,32928,9620,29735,1784,5755,5655,17395,7439,23150
520551,201902,4209,11874,3582,10959,445,1612,2465,7345,2910,8957
520552,201902,817,2194,699,2045,115,318,470,1438,585,1756
520570,201902,602,1431,393,1122,106,293,137,414,243,707
520580,201902,2406,5549,1790,4799,146,423,1229,3287,1375,3710
520590,201902,1190,3211,844,2586,240,741,157,480,397,1221
520620,201902,7968,22092,6373,19743,1606,5066,2965,9414,4571,14480
520630,201902,796,2073,505,1566,95,301,128,405,223,706
520640,201902,2433,6106,1845,5095,460,1276,732,2108,1192,3384
520650,201902,897,2196,635,1796,118,335,303,895,421,1230
520660,201902,523,1262,251,771,48,156,54,176,102,332
520670,201902,928,2635,788,2434,73,231,522,1556,595,1787
520680,201902,698,1749,517,1469,95,259,251,734,346,993
520690,201902,353,831,240,674,83,224,72,221,155,445
520710,201902,483,1159,318,883,8,19,213,576,221,595
520725,201902,1568,3814,1117,3067,130,387,707,1885,837,2272
520735,201902,713,1805,497,1438,104,279,179,549,283,828
520740,201902,1924,4589,1490,4036,256,685,855,2406,1111,3091
520750,201902,643,1613,457,1308,88,244,216,648,304,892
520753,201902,1367,3673,1060,3084,203,616,444,1222,647,1838
520760,201902,1161,2545,1044,2395,72,133,875,2081,947,2214
520780,201902,1531,3731,1130,3157,126,362,581,1598,707,1960
520790,201902,3334,7987,2336,6443,253,719,1368,4004,1621,4723
520800,201902,14365,38530,11535,34521,2177,6644,6632,20573,8809,27217
520810,201902,1269,2717,910,2308,178,489,493,1292,671,1781
520815,201902,595,1782,432,1454,99,339,87,314,186,653
520830,201902,1816,4017,1284,3407,54,129,1018,2668,1072,2797
520840,201902,2268,6290,1856,5759,796,2593,533,1771,1329,4364
520850,201902,642,1754,455,1458,167,611,94,307,261,918
520860,201902,5859,16396,4479,14170,1100,3766,1724,5438,2824,9204
520870,201902,89118,214464,61385,173126,16090,49299,19198,53075,35288,102374
520880,201902,6015,17519,4731,15306,1350,4597,1467,4767,2817,9364
520890,201902,3720,9428,2589,7627,575,1808,1087,3202,1662,5010
520910,201902,4329,11196,2760,8420,747,2499,501,1559,1248,4058
520915,201902,609,1717,391,1256,71,265,133,403,204,668
520920,201902,4384,10336,2976,8414,409,1224,1564,4456,1973,5680
520929,201902,725,1779,505,1409,81,203,243,724,324,927
520940,201902,992,2694,791,2407,51,175,585,1737,636,1912
520945,201902,488,1130,388,976,28,65,267,660,295,725
520960,201902,1009,2617,801,2275,109,332,502,1373,611,1705
520970,201902,2368,6818,1931,6081,548,1883,481,1596,1029,3479
520980,201902,779,1959,584,1682,129,400,232,643,361,1043
520990,201902,2943,8350,2424,7624,284,935,1601,5074,1885,6009
520993,201902,1035,2462,687,1909,47,152,468,1271,515,1423
520995,201902,2203,5702,1684,4993,316,958,675,2019,991,2977
521000,201902,8034,21732,5588,17388,1323,4328,1564,4874,2887,9202
521010,201902,3689,9713,2781,8159,337,1009,1573,4599,1910,5608
521015,201902,693,1769,529,1500,61,183,327,899,388,1082
521020,201902,2850,7527,1724,5328,529,1724,157,512,686,2236
521030,201902,480,1062,328,853,42,87,164,470,206,557
521040,201902,7446,18319,5511,15319,1353,3949,2217,6277,3570,10226
521056,201902,852,2325,660,2033,206,645,192,638,398,1283
521060,201902,997,2592,746,2175,53,159,368,1092,421,1251
521080,201902,1059,2377,543,1534,68,199,201,493,269,692
521090,201902,3350,8873,2289,6918,661,2126,307,980,968,3106
521100,201902,1759,4145,1262,3445,219,590,708,1966,927,2556
521120,201902,4721,11109,3289,9315,280,735,1610,5213,1890,5948
521130,201902,903,2118,581,1584,32,113,325,892,357,1005
521140,201902,1244,3299,899,2694,160,513,374,1110,534,1623
521150,201902,11569,26218,7465,20488,1498,4675,3252,9091,4750,13766
521160,201902,605,1344,430,1074,59,148,251,598,310,746
521170,201902,1064,2540,760,2066,71,200,513,1359,584,1559
521180,201902,6563,19275,5500,17345,1071,3658,2497,7610,3568,11268
521190,201902,10206,26545,5894,18838,1487,5100,1140,3837,2627,8937
521200,201902,721,1809,497,1425,53,149,281,803,334,952
521205,201902,600,1545,450,1296,25,59,326,923,351,982
521210,201902,697,1804,398,1208,106,347,53,120,159,467
521220,201902,3858,9596,2533,7461,566,1827,698,1892,1264,3719
521225,201902,320,735,247,649,43,117,152,392,195,509
521230,201902,1260,3538,1164,3407,431,1240,592,1833,1023,3073
521250,201902,29681,82810,23627,74102,9283,30310,7116,23883,16399,54193
521260,201902,584,1368,424,1107,59,158,248,637,307,795
521270,201902,1799,4637,1543,4323,100,253,1185,3355,1285,3608
521280,201902,1849,5082,1393,4282,381,1259,502,1572,883,2831
521290,201902,464,1160,329,979,52,175,176,508,228,683
521295,201902,1107,2430,869,2176,79,177,669,1774,748,1951
521300,201902,1867,4747,1491,4228,299,800,887,2589,1186,3389
521305,201902,704,1789,495,1448,65,175,274,802,339,977
521308,201902,4600,12647,3338,10198,466,1444,1793,5409,2259,6853
521310,201902,7969,20989,5368,16413,1274,4227,1868,5493,3142,9720
521340,201902,414,969,296,796,19,54,219,576,238,630
521350,201902,2029,5240,1568,4541,166,552,1047,2924,1213,3476
521370,201902,1185,3076,720,2282,180,659,130,426,310,1085
521375,201902,1380,3515,979,2941,237,705,329,1065,566,1770
521377,201902,1465,3206,1088,2736,76,151,897,2320,973,2471
521380,201902,5791,15757,3887,12193,434,1509,937,3114,1371,4623
521385,201902,607,1500,477,1333,83,232,249,749,332,981
521390,201902,695,1753,495,1455,157,491,169,525,326,1016
521400,201902,2482,5732,1930,5084,179,473,1442,3923,1621,4396
521405,201902,1284,3311,957,2767,196,572,427,1223,623,1795
521410,201902,751,2039,597,1791,117,338,303,978,420,1316
521440,201902,1305,3408,956,2842,286,914,266,784,552,1698
521450,201902,3778,11501,2839,9601,660,2220,832,2982,1492,5202
521460,201902,5681,15423,4170,12723,1520,4844,876,2648,2396,7492
521470,201902,647,1800,397,1260,60,190,115,340,175,530
521480,201902,351,923,199,616,34,110,50,139,84,249
521483,201902,2468,5988,1716,4799,419,1259,618,1681,1037,2940
521486,201902,1665,4019,1264,3450,72,205,962,2598,1034,2803
521487,201902,449,1129,320,936,56,165,148,450,204,615
521490,201902,835,2301,617,1932,40,168,438,1326,478,1494
521500,201902,1930,4978,1404,4108,94,347,973,2764,1067,3111
521520,201902,754,1719,510,1357,88,236,210,574,298,810
521523,201902,10960,35743,9389,33129,3188,11981,2522,9196,5710,21177
521525,201902,1038,2423,765,2032,85,239,537,1410,622,1649
521530,201902,2233,5849,1283,3888,259,837,326,1044,585,1881
521540,201902,844,2169,546,1659,90,322,232,719,322,1041
521550,201902,1255,3249,763,2278,154,496,226,721,380,1217
521560,201902,4056,11211,2866,9583,569,2242,1392,4810,1961,7052
521565,201902,616,1546,493,1370,93,237,285,793,378,1030
521570,201902,3577,9625,2394,7387,499,1727,317,1058,816,2785
521580,201902,500,1244,279,838,38,122,63,161,101,283
521590,201902,599,1507,453,1284,104,328,220,591,324,919
521600,201902,389,1089,238,752,46,125,58,188,104,313
521630,201902,1623,3692,984,2699,207,594,319,850,526,1444
521640,201902,1873,4505,1354,3769,315,943,480,1288,795,2231
521645,201902,555,1476,356,1112,81,237,106,334,187,571
521680,201902,1122,3472,885,2990,266,950,101,380,367,1330
521690,201902,500,1336,434,1223,64,198,263,718,327,916
521710,201902,2923,7642,1946,5950,378,1315,432,1258,810,2573
521720,201902,2083,5067,1460,4130,175,541,829,2293,1004,2834
521730,201902,3574,10517,2790,9099,893,3228,533,1488,1426,4716
521740,201902,3873,10407,2962,9058,873,2893,988,3160,1861,6053
521760,201902,13900,40168,11122,35787,3361,11861,3747,12468,7108,24329
521770,201902,2851,7176,1995,5769,622,1928,450,1290,1072,3218
521800,201902,5833,16451,4559,14323,1233,3984,1532,5278,2765,9262
521805,201902,537,1281,389,1072,130,340,159,456,289,796
521810,201902,691,1626,470,1303,77,220,230,646,307,866
521830,201902,5124,14654,4176,13233,372,1378,2844,8872,3216,10250
521839,201902,664,1701,474,1365,96,293,205,541,301,834
521850,201902,5019,12815,3386,10119,662,2200,343,919,1005,3119
521860,201902,1731,4557,1177,3591,193,627,383,1150,576,1777
521870,201902,685,1955,474,1545,111,372,130,398,241,770
521878,201902,618,1650,457,1355,75,256,208,544,283,800
521880,201902,17744,43456,12031,34818,3164,9647,3883,11577,7047,21224
521890,201902,3015,8242,2020,6328,544,1807,278,829,822,2636
521900,201902,1585,3808,954,2869,265,776,200,644,465,1420
521910,201902,1145,2597,779,2151,79,220,457,1320,536,1540
521920,201902,426,1217,314,997,58,204,117,381,175,585
521925,201902,722,1987,537,1677,111,343,212,642,323,985
521930,201902,4568,11687,3234,9687,930,2708,1141,3741,2071,6449
521935,201902,873,2169,612,1714,68,201,355,950,423,1151
521940,201902,1268,2939,837,2344,191,581,336,914,527,1495
521945,201902,515,1456,409,1262,87,265,196,637,283,902
521950,201902,680,1647,502,1406,127,391,242,626,369,1017
521960,201902,711,1961,472,1471,69,226,222,658,291,884
521970,201902,2469,6337,2075,5868,125,345,1651,4739,1776,5084
521971,201902,751,1843,525,1498,143,413,127,362,270,775
521973,201902,1182,3226,929,2830,65,246,626,1860,691,2106
521975,201902,11692,31572,9875,29089,1630,4991,6151,18171,7781,23162
521980,201902,2536,6187,1964,5424,186,485,1448,4034,1634,4519
521990,201902,1128,3145,903,2775,139,428,425,1336,564,1764
522000,201902,2817,7802,2197,7025,244,771,1454,4835,1698,5606
522005,201902,344,845,258,728,52,130,121,356,173,486
522010,201902,3754,9441,2694,7736,758,2319,720,2002,1478,4321
522015,201902,929,2508,669,2088,146,480,264,823,410,1303
522020,201902,5089,12380,3411,9725,819,2427,1446,4232,2265,6659
522026,201902,635,1807,477,1519,90,298,181,569,271,867
522028,201902,466,1253,338,994,67,192,137,381,204,573
522040,201902,2922,6687,2071,5574,254,750,1385,3652,1639,4402
522045,201902,16246,46988,12175,39364,3028,10394,3021,9526,6049,19920
522050,201902,1009,2711,691,2167,145,487,275,825,420,1312
522060,201902,2453,6860,1955,6074,239,777,1129,3618,1368,4395
522068,201902,1750,4732,1389,4283,162,453,993,3159,1155,3612
522070,201902,591,1552,487,1391,33,119,371,1010,404,1129
522100,201902,603,1617,430,1335,61,199,225,694,286,893
522108,201902,890,2447,700,2152,47,210,556,1639,603,1849
522119,201902,1516,3976,1178,3518,191,599,624,1924,815,2523
522130,201902,368,924,266,789,55,170,143,444,198,614
522140,201902,15791,42951,11593,35571,3444,11285,2437,7239,5881,18524
522145,201902,826,2050,589,1702,136,343,276,866,412,1209
522150,201902,953,2373,688,1932,209,569,213,639,422,1208
522155,201902,864,2309,683,2004,144,414,328,969,472,1383
522157,201902,528,1359,450,1251,30,108,348,950,378,1058
522160,201902,5654,15128,3798,11674,1086,3617,297,994,1383,4611
522170,201902,2575,6763,1885,5680,433,1324,862,2647,1295,3971
522180,201902,437,1095,278,822,63,191,27,99,90,290
522185,201902,15898,40817,11901,35514,5141,16428,2713,8911,7854,25339
522190,201902,741,1828,533,1465,99,268,212,593,311,861
522200,201902,1640,4901,1054,3604,199,724,82,257,281,981
522205,201902,1583,3788,1209,3272,117,345,840,2262,957,2607
522220,201902,1289,3373,977,2895,145,423,525,1589,670,2012
522230,201902,1142,3046,953,2770,214,722,505,1394,719,2116
530010,201902,154734,440355,129315,400368,24559,83724,69143,210491,93702,294215
110001,201903,3619,10583,2537,8528,670,2391,967,3240,1637,5631
110002,201903,11324,30584,8121,25053,2371,7764,2516,7850,4887,15614
110003,201903,627,1887,450,1506,124,442,94,306,218,748
110004,201903,9450,26382,6536,20839,1656,5620,1723,5707,3379,11327
110005,201903,2419,6469,1499,4755,365,1239,425,1453,790,2692
110006,201903,1750,4991,1079,3570,236,875,172,536,408,1411
110007,201903,1036,2971,796,2579,285,958,229,842,514,1800
110008,201903,3074,8914,2272,7662,280,919,1529,5410,1809,6329
110009,201903,3991,11521,2602,8979,706,2517,906,3257,1612,5774
110010,201903,6291,21523,4928,18912,1168,4343,2308,9866,3476,14209
110011,201903,6193,17160,4425,13946,1582,5120,768,2539,2350,7659
110012,201903,13546,35401,8595,26574,2281,7433,1045,3470,3326,10903
110013,201903,5022,15158,3878,12831,1691,5726,577,2151,2268,7877
110014,201903,3621,9882,2519,7795,693,2182,961,2958,1654,5140
110015,201903,4810,13061,2735,8830,756,2659,418,1219,1174,3878
110018,201903,3331,8763,2001,6384,446,1609,549,1673,995,3282
110020,201903,71549,178046,49569,147007,10977,33767,20021,63755,30998,97522
110025,201903,4801,12105,3156,9193,687,2128,1432,4093,2119,6221
110026,201903,444,1259,340,1097,104,361,126,398,230,759
110028,201903,5935,16009,3859,12124,1097,3658,569,1784,1666,5442
110029,201903,1339,3315,781,2378,186,582,311,978,497,1560
110030,201903,12044,28998,7837,22925,1656,5627,2255,6914,3911,12541
110032,201903,2852,8489,1957,6583,657,2228,477,1667,1134,3895
110033,201903,3633,11819,2904,10423,1086,3973,698,2790,1784,6763
110034,201903,3305,8155,2226,6637,671,2146,905,2807,1576,4953
110037,201903,1585,5022,1266,4406,302,1068,588,2060,890,3128
110040,201903,2894,8399,2107,6918,669,2341,524,1659,1193,4000
110045,201903,4816,14352,3797,12538,1055,3760,1406,4682,2461,8442
110050,201903,1690,4939,1239,4065,536,1843,239,797,775,2640
110060,201903,765,2337,533,1827,217,789,61,214,278,1003
110070,201903,1699,5453,1329,4616,460,1693,276,883,736,2576
110080,201903,5867,14071,4230,12142,487,1298,2915,8859,3402,10157
110090,201903,567,1558,401,1265,114,404,149,447,263,851
110092,201903,1161,3507,861,2917,152,537,443,1577,595,2114
110094,201903,2792,8439,2150,7277,803,2856,557,1989,1360,4845
110100,201903,1673,5193,1384,4569,340,1183,651,2145,991,3328
110110,201903,1684,4872,1181,3944,395,1373,255,910,650,2283
110120,201903,1241,3775,945,3175,263,909,279,939,542,1848
110130,201903,2554,6677,1609,4945,362,1209,561,1724,923,2933
110140,201903,2012,6281,1448,5103,406,1466,365,1318,771,2784
110143,201903,1302,3591,891,2785,311,989,195,618,506,1607
110145,201903,864,2396,568,1837,139,476,192,645,331,1121
110146,201903,437,1197,302,987,56,185,155,530,211,715
110147,201903,749,1981,472,1417,72,221,186,480,258,701
110148,201903,765,2263,467,1609,118,451,55,190,173,641
110149,201903,2889,8285,2082,6992,808,2740,466,1734,1274,4474
110150,201903,2525,6498,1735,5392,582,2004,502,1661,1084,3665
110155,201903,639,1968,488,1622,126,444,160,507,286,951
110160,201903,1486,4689,1107,3851,364,1259,254,927,618,2186
110170,201903,2158,5721,1338,4095,262,837,669,1999,931,2836
110175,201903,1489,4390,1091,3705,198,704,510,1816,708,2520
110180,201903,1290,3641,888,2821,179,583,412,1300,591,1883
120001,201903,3080,9796,2624,9144,417,1403,1744,6307,2161,7710
120005,201903,1900,7332,1716,7040,170,766,1320,5525,1490,6291
120010,201903,5178,16157,4429,14939,552,1823,3078,10692,3630,12515
120013,201903,2139,7980,1995,7777,499,1858,1184,4926,1683,6784
120017,201903,2128,7188,1906,6834,328,1242,1182,4396,1510,5638
120020,201903,14178,58724,13277,56873,1289,6079,10160,44114,11449,50193
120025,201903,2876,8601,2377,7967,457,1536,1535,5281,1992,6817
120030,201903,6508,25905,6175,25307,419,2238,4912,20177,5331,22415
120032,201903,1631,7507,1567,7360,105,639,1286,5977,1391,6616
120033,201903,4016,15075,3759,14622,143,786,3223,12456,3366,13242
120034,201903,2567,9543,2196,8856,126,745,1753,6927,1879,7672
120035,201903,3473,14533,3309,14224,291,1394,2679,11641,2970,13035
120038,201903,2671,8839,2323,8246,559,2111,1208,4316,1767,6427
120039,201903,1927,8596,1805,8345,138,875,1417,6494,1555,7369
120040,201903,41253,135846,36476,127841,6092,22520,22198,78869,28290,101389
120042,201903,3300,12653,3027,12078,161,864,2425,9651,2586,10515
120043,201903,1372,5598,1251,5386,48,280,1105,4761,1153,5041
120045,201903,5835,16011,5150,15246,141,573,4712,13801,4853,14374
120050,201903,9025,33171,8276,31998,505,2532,6713,26025,7218,28557
120060,201903,9107,36344,8458,35320,431,2523,7217,30066,7648,32589
120070,201903,3023,10013,2659,9509,280,1044,1845,6864,2125,7908
120080,201903,4241,14426,3814,13731,598,2339,2550,9307,3148,11646
130002,201903,3108,12484,2800,12063,156,774,2434,10558,2590,11332
130006,201903,2339,8986,1919,8229,170,801,1428,6108,1598,6909
130008,201903,2550,9084,2294,8689,80,412,1939,7331,2019,7743
130010,201903,3889,11350,3316,10699,62,206,3099,10095,3161,10301
130014,201903,2993,9225,2375,8175,440,1559,1449,5079,1889,6638
130020,201903,2657,10672,2420,10289,163,972,1881,7948,2044,8920
130030,201903,9620,32187,8816,31242,223,946,7976,28516,8199,29462
130040,201903,3663,11130,3108,10380,157,574,2523,8492,2680,9066
130050,201903,7392,27446,6195,25903,222,1065,5542,23415,5764,24480
130060,201903,7328,29669,6325,28321,550,3149,4985,22201,5535,25350
130063,201903,6066,20344,5422,19628,137,651,5014,18205,5151,18856
130068,201903,3411,13034,2971,12264,243,1383,2155,8733,2398,10116
130070,201903,7620,22161,6378,20780,295,956,5403,17962,5698,18918
130080,201903,6750,25827,6005,24905,320,1866,4986,20796,5306,22662
130083,201903,2609,8969,2375,8675,190,811,1989,7215,2179,8026
130090,201903,3426,10856,3061,10379,66,295,2643,9129,2709,9424
130100,201903,7641,23549,6590,22436,72,190,6165,21558,6237,21748
130110,201903,8221,23849,6870,22169,844,2240,5267,18000,6111,20240
130115,201903,5428,17273,4751,16473,108,450,4192,14711,4300,15161
130120,201903,14266,52082,13003,50422,1230,5202,10557,41295,11787,46497
130130,201903,5160,17110,4072,15678,448,1936,3055,11755,3503,13691
130140,201903,6868,24966,6310,24338,224,1193,5589,21601,5813,22794
130150,201903,3635,13803,3416,13537,100,623,3098,12260,3198,12883
130160,201903,4973,18300,4322,17447,322,1508,3586,14645,3908,16153
130165,201903,3160,12241,2988,11997,116,608,2666,10696,2782,11304
130170,201903,11598,34946,9476,32399,712,2872,7726,26457,8438,29329
130180,201903,4418,14138,4172,13861,43,239,4021,13311,4064,13550
130185,201903,18076,45036,14728,41457,835,1575,12715,37392,13550,38967
130190,201903,18798,62798,15448,57808,1885,7249,10838,41735,12723,48984
130195,201903,2380,8824,1930,8238,79,425,1702,7267,1781,7692
130200,201903,2487,7333,2074,6765,126,500,1674,5460,1800,5960
130210,201903,1283,4914,1157,4766,99,595,938,3765,1037,4360
130220,201903,2173,7977,1953,7657,87,462,1659,6489,1746,6951
130230,201903,4252,18380,3777,17680,304,1811,3121,14612,3425,16423
130240,201903,11218,35234,9273,32554,205,1220,8186,28650,8391,29870
130250,201903,25646,78518,22442,74913,1669,5318,18343,63471,20012,68789
130255,201903,4240,14616,3771,13771,196,893,3009,10999,3205,11892
130260,201903,248366,726385,207743,665603,58579,199845,93534,304856,152113,504701
130270,201903,8589,32193,7396,30310,1081,4568,5099,21593,6180,26161
130280,201903,3508,14211,3238,13911,114,551,2980,12977,3094,13528
130290,201903,12929,44028,11445,42206,561,2345,10000,37335,10561,39680
130300,201903,4670,16771,4287,16209,170,927,3671,13774,3841,14701
130310,201903,5795,20543,5141,19631,376,1631,4194,16173,4570,17804
130320,201903,3402,11239,2931,10664,319,1122,2248,8433,2567,9555
130330,201903,4539,14707,3755,13759,210,943,3205,11746,3415,12689
130340,201903,22016,73002,19276,69798,1526,5261,15949,59538,17475,64799
130350,201903,3907,14431,3538,13947,154,902,3068,11964,3222,12866
130353,201903,6591,19025,5482,17615,916,2881,3664,12202,4580,15083
130356,201903,4943,16522,4258,15425,622,2308,2795,10463,3417,12771
130360,201903,3146,9433,2694,8917,62,199,2524,8426,2586,8625
130370,201903,5670,22310,5036,21448,295,1483,4218,17966,4513,19449
130380,201903,7229,30506,6852,29922,433,2477,5783,24960,6216,27437
130390,201903,5937,25010,5247,23795,568,3049,3836,17355,4404,20404
130395,201903,2332,7603,2028,7079,224,821,1497,5209,1721,6030
130400,201903,2652,8658,2308,8195,120,456,2027,7268,2147,7724
130406,201903,10812,39530,9378,37668,1752,7206,6340,26190,8092,33396
130410,201903,4002,14605,3495,13760,1095,4478,1630,6674,2725,11152
130420,201903,13189,47802,11236,45421,1055,5415,8858,35588,9913,41003
130423,201903,4144,13453,3664,12896,179,888,3222,11166,3401,12054
130426,201903,2832,11176,2700,10982,91,486,2490,10147,2581,10633
130430,201903,4141,12269,3635,11565,338,1214,2889,9064,3227,10278
130440,201903,4748,15009,4160,14318,109,465,3834,13245,3943,13710
140002,201903,2116,6349,1851,6001,96,383,1531,4911,1627,5294
140005,201903,3157,8926,2883,8622,139,409,2537,7646,2676,8055
140010,201903,55023,147221,43429,130107,11186,35216,17261,53340,28447,88556
140015,201903,3378,10612,2940,10072,221,810,2500,8660,2721,9470
140017,201903,3835,11454,3387,10867,326,1040,2575,8528,2901,9568
140020,201903,5066,15309,4325,14302,306,1324,3382,11105,3688,12429
140023,201903,2293,7053,1871,6448,232,831,1321,4632,1553,5463
140028,201903,2113,5477,1795,5062,129,424,1395,3879,1524,4303
140030,201903,4775,12883,4263,12265,338,795,3569,10583,3907,11378
140040,201903,2236,9286,2052,9009,116,733,1787,7688,1903,8421
140045,201903,2617,9727,2214,9152,417,1655,1442,6319,1859,7974
140047,201903,5801,17169,4960,15898,773,2643,3308,10715,4081,13358
140050,201903,1380,4147,1178,3847,135,467,838,2779,973,3246
140060,201903,1618,4373,1369,4006,127,362,1065,3170,1192,3532
140070,201903,1772,9521,1712,9361,145,970,1354,7323,1499,8293
150010,201903,44460,112441,40529,107375,981,2793,36087,94965,37068,97758
150013,201903,1928,5111,1598,4743,145,363,1232,3832,1377,4195
150020,201903,14040,43111,13124,41915,1130,2822,11101,36568,12231,39390
150030,201903,8603,32800,7881,31906,379,1800,6950,28258,7329,30058
150034,201903,4245,10906,3539,9990,256,714,2913,8346,3169,9060
150040,201903,15901,41565,13923,39347,1360,2340,11331,34896,12691,37236
150050,201903,6731,24088,6202,23335,148,706,5652,21414,5800,22120
150060,201903,20746,58128,17155,52762,2974,9205,10600,33456,13574,42661
150070,201903,6516,25114,5790,24232,192,1043,5225,22090,5417,23133
150080,201903,90775,210684,77226,192513,18129,48223,26725,79187,44854,127410
150085,201903,6822,20926,6261,20229,181,586,5784,18807,5965,19393
150090,201903,9998,37530,9402,36405,659,2882,7633,29596,8292,32478
150095,201903,5549,16810,4906,15970,291,756,4071,13752,4362,14508
150100,201903,3011,10649,2663,10046,194,760,2068,7848,2262,8608
150110,201903,4142,17927,3958,17695,226,1099,3576,16063,3802,17162
150120,201903,7616,24813,7373,24487,324,871,6503,22349,6827,23220
150125,201903,752,2075,569,1822,109,403,326,1022,435,1425
150130,201903,22935,67230,20115,63015,2704,7601,14414,46884,17118,54485
150140,201903,227852,548284,197284,506184,32252,81114,114586,308431,146838,389545
150145,201903,4516,13642,3857,12710,818,2432,2466,8721,3284,11153
150150,201903,15169,40312,13504,38213,808,2395,11009,31254,11817,33649
150157,201903,3309,9332,2748,8605,276,942,1972,6375,2248,7317
150160,201903,2965,9120,2774,8815,650,2030,1568,5178,2218,7208
150170,201903,24421,80942,21222,75604,3973,13469,12762,48414,16735,61883
150172,201903,4465,12666,3623,11474,273,781,2684,8807,2957,9588
150175,201903,1652,5176,1409,4723,243,871,878,2973,1121,3844
150178,201903,10255,28927,8599,26969,333,1023,7409,23620,7742,24643
150180,201903,20857,77422,19420,75641,1028,4045,16947,67141,17975,71186
150190,201903,6833,23251,6420,22710,296,1302,5609,19743,5905,21045
150195,201903,5378,17367,5133,17001,95,482,4741,15566,4836,16048
150200,201903,5570,16691,5110,16192,55,166,4804,15359,4859,15525
150210,201903,25571,90890,24025,88714,2066,7408,19378,73737,21444,81145
150215,201903,6988,20746,6047,19356,1505,4750,3112,10554,4617,15304
150220,201903,11650,34264,10392,32432,1418,4359,6733,21459,8151,25818
150230,201903,12296,35697,10718,33588,1250,3661,7407,24202,8657,27863
150240,201903,31975,90622,26493,81162,8183,25486,8038,25407,16221,50893
150250,201903,4098,16449,3907,16187,549,2281,3001,12682,3550,14963
150260,201903,2571,8810,2374,8490,201,716,1816,6592,2017,7308
150270,201903,8687,25258,6210,21163,2055,7313,1965,7057,4020,14370
150275,201903,6624,21722,6135,20993,257,1008,5274,17957,5531,18965
150276,201903,2267,6229,1949,5847,247,675,1360,4440,1607,5115
150277,201903,5228,13952,4271,12843,374,1047,3268,10451,3642,11498
150280,201903,6500,27037,6309,26680,546,2268,5233,22420,5779,24688
150285,201903,3205,11509,2841,10943,305,1243,1997,7839,2302,9082
150290,201903,10755,29321,9886,28374,373,847,8877,26074,9250,26921
150293,201903,9572,24050,7070,20710,1343,3916,3798,11940,5141,15856
150295,201903,7917,21648,5792,18793,2039,7184,1991,7075,4030,14259
150300,201903,2213,6894,1988,6588,55,248,1760,5826,1815,6074
150304,201903,4060,12452,3387,11345,613,1953,2111,7370,2724,9323
150307,201903,6246,20303,5816,19621,406,1329,4735,16186,5141,17515
150309,201903,6094,19013,4936,16965,1007,3324,2597,9403,3604,12727
150310,201903,7202,28559,6881,28160,240,1360,6077,25062,6317,26422
150320,201903,9445,25716,8592,24553,458,1418,6682,19049,7140,20467
150330,201903,13734,45269,12743,43587,1527,5083,9366,32855,10893,37938
150340,201903,2578,7607,2323,7240,333,982,1641,5214,1974,6196
150345,201903,7755,23284,7053,22365,407,1385,6023,19216,6430,20601
150350,201903,8905,23740,8173,22799,822,1664,6627,19212,7449,20876
150360,201903,23610,67277,19107,61463,2227,6466,13102,44297,15329,50763
150370,201903,10059,32457,8518,30309,980,3241,6223,23374,7203,26615
150375,201903,3313,13791,3008,13326,262,1297,2451,10918,2713,12215
150380,201903,10692,28345,8914,25946,237,834,7711,22507,7948,23341
150390,201903,7784,32076,7074,30880,1154,4684,4880,22425,6034,27109
150400,201903,6233,22995,5977,22498,285,1172,5144,19398,5429,20570
150405,201903,9183,24690,8141,23403,525,1176,6557,19560,7082,20736
150410,201903,1873,6131,1605,5652,217,730,1027,3723,1244,4453
150420,201903,39719,114301,30575,100257,9582,33008,9137,34811,18719,67819
150430,201903,8340,24981,7695,24122,810,2063,6047,19676,6857,21739
150440,201903,5597,18451,5256,17927,582,1820,3999,13981,4581,15801
150442,201903,24613,62153,20612,56841,2363,6352,13877,39264,16240,45616
150445,201903,6060,19275,5433,18298,256,933,4576,15437,4832,16370
150450,201903,4908,21673,4638,21298,376,1854,3929,18143,4305,19997
150460,201903,8369,27704,7745,26890,262,1077,6661,23942,6923,25019
150470,201903,20507,54644,18220,52017,662,1776,16643,47783,17305,49559
150475,201903,4619,15141,4101,14336,196,750,3408,12043,3604,12793
150480,201903,13664,45471,12265,43312,2103,6900,8371,31187,10474,38087
150490,201903,8018,28626,7521,27984,245,1164,6706,25018,6951,26182
150495,201903,5063,18085,4918,17876,117,587,4516,16354,4633,16941
150497,201903,2765,9124,2253,8204,555,2107,1123,4306,1678,6413
150500,201903,3294,8657,2925,8117,279,726,2249,6258,2528,6984
150503,201903,4387,12145,3142,10416,974,3414,1028,3816,2002,7230
150506,201903,9898,31177,8566,29275,1846,5605,5428,20227,7274,25832
150510,201903,9756,36194,8546,33862,1181,4526,5791,23998,6972,28524
150520,201903,7325,27732,7013,27337,204,1135,6431,24992,6635,26127
150530,201903,12272,42089,10752,39899,1579,4814,7717,30379,9296,35193
150540,201903,4920,13817,4225,12783,149,457,3639,10995,3788,11452
150543,201903,7102,19494,5825,17836,752,2373,4095,13103,4847,15476
150548,201903,9916,31456,8992,30212,316,1105,7939,26815,8255,27920
150549,201903,2026,6191,1750,5825,51,218,1520,5059,1571,5277
150550,201903,19581,58935,16732,54239,4041,13381,7533,26041,11574,39422
150553,201903,23856,73818,18987,64923,6277,22013,5817,21855,12094,43868
150555,201903,1827,5022,1443,4406,135,361,1002,3139,1137,3500
150560,201903,1814,5670,1616,5274,292,896,918,3117,1210,4013
150563,201903,2467,7792,2130,7179,451,1622,1173,3934,1624,5556
150565,201903,4242,13927,3776,13163,116,579,3098,10836,3214,11415
150570,201903,6141,20446,5874,20042,279,1114,5076,17238,5355,18352
150580,201903,10105,41337,9165,40273,649,3227,7595,34159,8244,37386
150590,201903,7348,26769,6680,25910,224,1231,6023,23260,6247,24491
150600,201903,9168,31526,8560,30749,237,1017,7846,28279,8083,29296
150610,201903,2711,8273,2435,7786,124,487,1977,6229,2101,6716
150611,201903,3016,8950,2721,8508,106,434,2363,7313,2469,7747
150613,201903,12785,35844,9744,30641,1881,6279,4703,14918,6584,21197
150616,201903,3274,9179,2416,7751,608,2050,912,2881,1520,4931
150618,201903,6856,20460,5565,18423,681,2229,3438,11901,4119,14130
150619,201903,6054,17865,5048,16359,220,841,4074,13229,4294,14070
150620,201903,6452,21631,5614,20294,811,2862,3860,14370,4671,17232
150630,201903,6160,17094,5677,16501,427,1180,4723,13951,5150,15131
150635,201903,4536,12996,3897,11937,627,1930,2401,7491,3028,9421
150640,201903,2204,6435,2025,6222,33,105,1893,5896,1926,6001
150650,201903,11404,32563,10100,30363,3113,8804,4481,14591,7594,23395
150655,201903,5736,16791,5229,16035,219,698,4470,13705,4689,14403
150658,201903,4409,12631,3527,11334,626,2117,2110,7098,2736,9215
150660,201903,5687,16608,5115,15789,557,1673,3511,11038,4068,12711
150670,201903,8129,19504,6443,17569,659,1521,5053,14405,5712,15926
150680,201903,64814,197673,50004,173891,12771,44033,22229,86292,35000,130325
150690,201903,2720,7521,2442,7158,129,330,2122,6326,2251,6656
150700,201903,6227,18774,5591,17955,396,1190,4418,14508,4814,15698
150710,201903,3768,12677,3440,12137,238,890,2655,9480,2893,10370
150715,201903,4988,14826,4196,13581,368,1130,3262,10744,3630,11874
150720,201903,6575,24639,6174,23959,441,1959,5078,19735,5519,21694
150730,201903,11355,35771,9986,33677,1106,3917,7559,25952,8665,29869
150740,201903,3793,10947,3356,10206,370,1014,2431,7537,2801,8551
150745,201903,5134,14982,4165,13536,860,2962,2636,8600,3496,11562
150746,201903,1568,4979,1441,4779,87,277,1166,3891,1253,4168
150747,201903,4854,15843,4334,14987,794,2438,2797,10252,3591,12690
150750,201903,3614,11535,3071,10684,227,848,2342,8327,2569,9175
150760,201903,11786,35041,10798,33768,1379,4028,7911,25382,9290,29410
150770,201903,6243,22898,5952,22507,200,645,5438,21169,5638,21814
150775,201903,896,2609,712,2331,136,504,384,1244,520,1748
150780,201903,4531,13705,4105,13188,115,361,3753,12220,3868,12581
150790,201903,5533,16206,4833,15449,234,596,3989,13847,4223,14443
150795,201903,13305,43181,12095,41139,3203,10323,6756,24499,9959,34822
150796,201903,3602,9342,3130,8774,174,483,2662,7533,2836,8016
150797,201903,3870,12270,3357,11500,152,472,2772,9624,2924,10096
150800,201903,12983,41598,12009,40384,1564,4856,9124,31759,10688,36615
150803,201903,6766,22854,6367,22228,392,1396,5391,18945,5783,20341
150805,201903,3366,10707,2876,9933,289,1032,2161,7527,2450,8559
150808,201903,5944,17484,4396,14839,1688,6212,612,2300,2300,8512
150810,201903,20481,56255,15730,50403,2958,9437,8639,30022,11597,39459
150812,201903,5361,15499,4764,14443,464,1521,3479,10328,3943,11849
150815,201903,8997,27875,7722,26260,715,2444,6127,21158,6842,23602
150820,201903,11968,32900,10044,30573,971,2600,7767,24497,8738,27097
150830,201903,11453,43367,10874,42643,398,2061,9466,37716,9864,39777
150835,201903,2132,7350,1899,6934,397,1447,960,3551,1357,4998
150840,201903,7199,21255,5753,18691,1148,3953,2901,9373,4049,13326
160005,201903,1181,3260,1071,3105,33,140,977,2809,1010,2949
160010,201903,2427,6258,2315,6142,18,95,2251,5900,2269,5995
160015,201903,2366,7460,2164,7190,82,288,1968,6564,2050,6852
160020,201903,2007,6778,1783,6474,228,840,1359,4993,1587,5833
160021,201903,1093,4300,1016,4191,76,445,817,3289,893,3734
160023,201903,1217,4415,1080,4183,119,425,766,3126,885,3551
160025,201903,1947,5474,1884,5399,11,36,1855,5318,1866,5354
160027,201903,8737,24631,7925,23623,555,1585,6520,19787,7075,21372
160030,201903,62762,185540,51685,170726,11661,36404,27367,99782,39028,136186
160040,201903,5282,18730,4813,18108,102,544,4422,16658,4524,17202
160050,201903,4400,14147,3570,12930,1440,4941,1248,5558,2688,10499
160053,201903,3593,11736,3322,11392,304,997,2686,9435,2990,10432
160055,201903,789,2528,770,2508,27,96,718,2333,745,2429
160060,201903,23008,63874,19255,59541,1116,3458,15403,49645,16519,53103
160070,201903,2903,11085,2627,10638,201,840,2074,8607,2275,9447
160080,201903,2964,10077,2736,9806,71,368,2440,8783,2511,9151
170025,201903,621,1697,464,1468,89,281,241,772,330,1053
170030,201903,1209,3756,956,3265,159,524,480,1696,639,2220
170035,201903,1473,3857,1066,3189,108,356,617,1846,725,2202
170040,201903,1813,5310,1458,4822,120,456,840,2898,960,3354
170070,201903,1766,4218,1254,3572,99,314,747,2168,846,2482
170100,201903,2444,7092,2020,6363,197,580,1311,4199,1508,4779
170105,201903,736,2182,507,1688,133,416,170,575,303,991
170110,201903,936,2954,724,2537,115,437,325,1140,440,1577
170130,201903,1328,4062,947,3302,170,616,463,1669,633,2285
170190,201903,1389,3999,946,3279,325,1108,178,826,503,1934
170200,201903,1771,4451,1085,3283,259,850,287,863,546,1713
170210,201903,24676,68259,18682,58143,6667,22384,1975,7265,8642,29649
170215,201903,1325,3650,1105,3349,55,234,841,2524,896,2758
170220,201903,5858,18377,4959,16682,1200,3797,2305,8388,3505,12185
170230,201903,1271,3869,956,3221,258,879,194,693,452,1572
170240,201903,2669,7553,2057,6564,171,664,1376,4275,1547,4939
170255,201903,3991,11808,2801,9524,502,1770,1284,4511,1786,6281
170270,201903,1036,2510,666,1991,25,78,432,1271,457,1349
170290,201903,2968,8699,2532,8172,129,383,2026,6793,2155,7176
170300,201903,1911,5403,1557,4858,180,594,1024,3228,1204,3822
170305,201903,718,2062,569,1788,70,246,278,854,348,1100
170307,201903,946,3298,753,2896,106,434,408,1580,514,2014
170310,201903,1616,4178,1112,3325,196,652,498,1497,694,2149
170320,201903,1037,2731,770,2311,66,208,484,1457,550,1665
170330,201903,896,2812,801,2658,54,244,635,2045,689,2289
170360,201903,467,1304,331,1076,43,155,190,581,233,736
170370,201903,1293,3517,930,2900,220,661,351,1184,571,1845
170380,201903,1781,5293,1331,4579,124,488,722,2561,846,3049
170382,201903,545,1679,442,1503,49,199,297,981,346,1180
170384,201903,1531,5696,1264,5157,312,1315,557,2324,869,3639
170386,201903,846,2346,524,1712,80,305,153,458,233,763
170388,201903,628,1820,448,1493,62,237,203,675,265,912
170389,201903,1053,3420,895,3150,49,208,695,2473,744,2681
170390,201903,1643,3892,1213,3354,73,180,952,2717,1025,2897
170410,201903,550,1647,398,1361,23,104,260,868,283,972
170460,201903,377,1012,298,878,45,133,183,549,228,682
170510,201903,874,2667,645,2216,58,259,387,1277,445,1536
170550,201903,6498,17773,4670,14670,1313,4427,974,3254,2287,7681
170555,201903,1347,3797,1060,3341,61,206,566,1849,627,2055
170560,201903,1019,2955,759,2575,84,324,439,1615,523,1939
170600,201903,1357,3784,1093,3384,238,609,617,2094,855,2703
170610,201903,1767,4848,1282,4074,77,295,788,2466,865,2761
170625,201903,431,1189,266,828,28,74,88,273,116,347
170650,201903,1294,3927,1014,3443,175,591,494,1766,669,2357
170700,201903,3387,10046,2524,8436,531,1855,1069,3663,1600,5518
170710,201903,1517,4145,1158,3512,190,636,647,1936,837,2572
170720,201903,1866,4745,1485,4181,72,155,1177,3443,1249,3598
170730,201903,1013,2873,743,2418,159,491,321,1118,480,1609
170740,201903,2037,6981,1737,6384,224,869,1151,4231,1375,5100
170755,201903,864,2488,605,1991,60,223,293,922,353,1145
170765,201903,1243,3257,847,2628,191,601,334,1091,525,1692
170770,201903,1798,5436,1515,4979,192,584,982,3333,1174,3917
170820,201903,3428,10891,2855,9802,488,1753,1457,5122,1945,6875
170825,201903,930,2238,751,1985,88,239,509,1341,597,1580
170830,201903,1379,3786,1148,3413,25,88,937,2784,962,2872
170900,201903,2649,8743,2267,8148,179,724,1768,6424,1947,7148
170930,201903,3702,10416,2879,8930,636,2097,1135,3513,1771,5610
170950,201903,11178,31505,7736,25267,2277,8422,1033,3599,3310,12021
170980,201903,416,1190,339,1061,21,100,233,685,254,785
171050,201903,1563,5082,1364,4709,56,275,1099,3755,1155,4030
171070,201903,1328,3930,1129,3635,217,661,639,2269,856,2930
171090,201903,1054,2616,853,2328,71,181,601,1653,672,1834
171110,201903,571,1600,404,1285,65,225,187,538,252,763
171150,201903,1058,2720,643,1983,74,255,401,1226,475,1481
171180,201903,752,2118,495,1615,87,271,194,656,281,927
171190,201903,1623,5737,1435,5397,234,905,864,3324,1098,4229
171195,201903,823,2716,690,2473,117,465,407,1440,524,1905
171200,201903,527,1551,396,1316,74,258,174,571,248,829
171215,201903,378,1085,292,929,53,188,163,499,216,687
171240,201903,748,2583,623,2329,40,206,395,1476,435,1682
171245,201903,628,1948,486,1644,57,218,272,895,329,1113
171250,201903,1081,2874,783,2404,171,570,370,1129,541,1699
171270,201903,381,1493,322,1345,74,324,131,589,205,913
171280,201903,849,2601,658,2255,104,339,343,1242,447,1581
171320,201903,3996,11401,3110,9852,577,1822,1323,4405,1900,6227
171330,201903,2713,7494,2074,6395,442,1321,973,3101,1415,4422
171360,201903,1439,4262,1177,3884,79,315,865,2864,944,3179
171370,201903,670,1752,519,1544,54,165,358,1084,412,1249
171380,201903,1473,4104,1226,3728,113,360,857,2614,970,2974
171395,201903,933,2746,636,2145,70,269,345,1132,415,1401
171420,201903,1890,5733,1372,4672,245,931,597,2022,842,2953
171430,201903,1022,3064,846,2713,74,270,572,1786,646,2056
171488,201903,2352,7074,1827,6192,305,1097,930,3246,1235,4343
171500,201903,976,2527,745,2162,44,131,557,1622,601,1753
171510,201903,761,2636,674,2455,46,210,463,1683,509,1893
171515,201903,474,1302,347,1088,32,134,208,621,240,755
171525,201903,656,1965,527,1735,38,181,315,963,353,1144
171550,201903,335,1003,237,829,36,147,128,436,164,583
171570,201903,1121,3446,939,3115,158,495,535,1845,693,2340
171575,201903,1813,4877,1134,3623,160,546,476,1488,636,2034
171610,201903,5695,16253,4260,13796,986,3493,1170,4036,2156,7529
171620,201903,2709,7710,2272,7070,132,519,1789,5545,1921,6064
171630,201903,955,2638,773,2378,123,392,497,1571,620,1963
171650,201903,2076,6082,1540,5096,408,1425,483,1708,891,3133
171660,201903,2367,6180,1637,4910,259,756,850,2588,1109,3344
171665,201903,1340,3814,1013,3275,170,629,476,1564,646,2193
171670,201903,1831,5014,1409,4325,210,737,784,2352,994,3089
171700,201903,1202,3505,883,2932,113,368,496,1644,609,2012
171720,201903,805,2136,621,1834,48,169,446,1309,494,1478
171750,201903,1238,3560,876,2891,219,741,128,509,347,1250
171780,201903,1229,3203,899,2721,70,251,621,1853,691,2104
171790,201903,1420,4811,1148,4232,248,899,506,1965,754,2864
171800,201903,730,2069,543,1773,69,270,302,977,371,1247
171820,201903,10837,31035,8141,26294,1945,6557,2728,9383,4673,15940
171830,201903,1458,4949,1225,4503,118,549,788,2838,906,3387
171840,201903,747,2012,584,1752,28,91,403,1203,431,1294
171845,201903,633,1656,462,1402,63,238,259,788,322,1026
171850,201903,857,2982,736,2704,65,318,521,1847,586,2165
171855,201903,1064,3297,910,3014,78,267,572,1869,650,2136
171865,201903,376,1219,309,1102,51,189,149,510,200,699
171870,201903,769,2211,545,1781,59,197,289,986,348,1183
171875,201903,1255,3772,1006,3363,59,257,732,2415,791,2672
171880,201903,1097,3475,974,3306,37,159,786,2701,823,2860
171884,201903,800,2204,582,1864,116,425,213,746,329,1171
171886,201903,1420,4059,995,3315,293,1057,203,698,496,1755
171888,201903,739,2104,504,1648,46,157,295,968,341,1125
171889,201903,423,1337,359,1219,73,268,157,531,230,799
171890,201903,1159,3235,861,2752,180,513,472,1577,652,2090
171900,201903,507,1790,357,1396,85,324,128,539,213,863
172000,201903,564,1741,467,1552,54,222,266,837,320,1059
172010,201903,1039,3673,894,3367,80,388,550,1986,630,2374
172015,201903,358,1273,266,1080,65,244,110,489,175,733
172020,201903,2432,7361,2191,7026,179,681,1644,5318,1823,5999
172025,201903,753,2098,546,1752,47,183,354,1117,401,1300
172030,201903,1250,3737,1072,3465,27,121,872,2795,899,2916
172049,201903,1252,3139,868,2582,226,694,438,1340,664,2034
172065,201903,1497,3748,1178,3363,93,198,983,2954,1076,3152
172080,201903,2284,6970,1865,6192,137,529,1248,4139,1385,4668
172085,201903,485,1355,312,978,59,168,105,320,164,488
172090,201903,3992,10344,3071,9102,138,490,2321,6880,2459,7370
172093,201903,496,1484,359,1235,40,160,188,621,228,781
172097,201903,603,1635,432,1348,66,214,207,659,273,873
172100,201903,48237,122203,32710,96672,6706,21771,10553,32012,17259,53783
172110,201903,1597,5990,1378,5635,161,679,1001,4285,1162,4964
172120,201903,4867,14787,3864,13124,587,2015,2083,7326,2670,9341
172125,201903,306,866,222,720,28,98,117,374,145,472
172130,201903,719,1933,592,1723,27,95,430,1208,457,1303
172208,201903,2473,6290,1984,5632,221,572,1341,3896,1562,4468
172210,201903,2758,7375,2100,6512,427,1392,1103,3496,1530,4888
210005,201903,19442,57388,15263,50503,4476,15382,5890,20346,10366,35728
210010,201903,1869,5894,1688,5636,57,262,1449,4869,1506,5131
210015,201903,3373,10131,2992,9610,130,344,2575,8424,2705,8768
210020,201903,7506,17210,6561,16112,93,242,6085,14951,6178,15193
210030,201903,4774,16001,4487,15577,198,947,3903,13459,4101,14406
210040,201903,1914,4755,1722,4525,30,56,1603,4258,1633,4314
210043,201903,6431,18045,5307,16591,608,1819,3875,12538,4483,14357
210047,201903,6674,21640,5643,20172,197,987,4871,17297,5068,18284
210050,201903,2234,7706,1759,6825,205,897,1154,4461,1359,5358
210055,201903,1841,6080,1687,5821,72,291,1404,4818,1476,5109
210060,201903,6975,26356,6209,24922,781,3270,4301,17758,5082,21028
210070,201903,7318,20790,6896,20283,38,137,6599,19512,6637,19649
210080,201903,4065,14055,3909,13872,44,272,3680,13093,3724,13365
210083,201903,5503,16156,4627,15222,70,381,4358,14259,4428,14640
210087,201903,3011,8349,2648,7872,128,321,2234,6836,2362,7157
210090,201903,9533,29857,8941,28844,349,1180,7832,25189,8181,26369
210095,201903,6298,20775,5826,20201,251,1059,4873,17426,5124,18485
210100,201903,6781,20537,6163,19574,271,1013,5153,16294,5424,17307
210110,201903,2883,9145,2686,8889,35,191,2494,8236,2529,8427
210120,201903,23283,64549,19652,59841,2356,6059,13182,42607,15538,48666
210125,201903,4193,11816,3742,11243,766,1876,2659,8510,3425,10386
210130,201903,4275,11576,3586,10689,152,388,3049,9140,3201,9528
210135,201903,1447,4436,1270,4144,59,202,1038,3420,1097,3622
210140,201903,17685,49158,13877,44153,2755,8700,7736,25655,10491,34355
210150,201903,4530,11075,4031,10369,115,325,3542,8995,3657,9320
210160,201903,16360,49034,14443,46469,1380,4602,10277,34071,11657,38673
210170,201903,14791,47549,13834,46265,665,2288,12196,40843,12861,43131
210173,201903,2309,8633,2122,8304,62,395,1914,7460,1976,7855
210177,201903,3329,9424,2998,9015,109,209,2705,8401,2814,8610
210180,201903,1460,4035,1308,3834,34,99,1170,3416,1204,3515
210190,201903,5001,14433,4410,13540,106,531,3702,11099,3808,11630
210193,201903,1254,3795,1123,3589,42,153,889,2895,931,3048
210197,201903,2009,6572,1873,6374,167,566,1498,5208,1665,5774
210200,201903,7546,24778,6855,23661,608,2188,5419,18860,6027,21048
210203,201903,6992,21104,6162,19965,553,1819,4918,16189,5471,18008
210207,201903,3415,9477,3019,8984,153,382,2506,7634,2659,8016
210210,201903,8274,26943,7696,26165,130,760,7051,23854,7181,24614
210215,201903,2204,7291,1996,6988,66,334,1767,6154,1833,6488
210220,201903,6115,21316,5803,20820,222,1353,5031,17625,5253,18978
210230,201903,5182,15952,4719,15263,299,794,4061,13371,4360,14165
210232,201903,11515,36777,9545,33856,1525,5482,6128,23119,7653,28601
210235,201903,3513,10511,3081,9919,81,375,2717,8728,2798,9103
210237,201903,2551,8858,2330,8571,27,161,2169,7978,2196,8139
210240,201903,2691,8557,2474,8175,86,357,2140,6991,2226,7348
210250,201903,5535,17128,5073,16546,84,475,4536,14751,4620,15226
210255,201903,2557,7919,2188,7230,249,863,1476,4827,1725,5690
210260,201903,5358,16479,4745,15570,262,1003,3965,12954,4227,13957
210270,201903,4778,13482,4293,12843,99,504,3853,11404,3952,11908
210275,201903,3634,9160,3242,8679,48,107,2991,8103,3039,8210
210280,201903,5486,16067,4434,14407,261,1202,3209,10137,3470,11339
210290,201903,6785,19386,6161,18599,152,485,5558,16791,5710,17276
210300,201903,33905,92495,28067,84600,1843,5635,20893,65566,22736,71201
210310,201903,3034,7947,2687,7445,125,294,2319,6480,2444,6774
210312,201903,2639,6968,2334,6621,48,202,2148,6012,2196,6214
210315,201903,2952,8337,2518,7832,75,205,2261,7204,2336,7409
210317,201903,4132,13153,3783,12748,123,601,3392,11360,3515,11961
210320,201903,18821,58461,17308,56437,483,2360,15237,49353,15720,51713
210325,201903,3421,10125,3018,9582,94,324,2687,8639,2781,8963
210330,201903,24264,71810,20828,67019,5845,17247,10392,37916,16237,55163
210340,201903,10010,30580,9033,29121,791,2557,6870,22688,7661,25245
210350,201903,9454,27518,8336,26126,197,728,7313,23024,7510,23752
210355,201903,4372,15471,3879,14685,134,712,3315,12619,3449,13331
210360,201903,13707,42675,12312,40673,525,2412,9961,32449,10486,34861
210370,201903,10524,23983,8294,21606,260,491,7530,20051,7790,20542
210375,201903,3271,8828,2462,7746,615,1939,1172,4067,1787,6006
210380,201903,5573,14622,4910,13807,248,634,4176,11809,4424,12443
210390,201903,2578,9375,2405,9055,133,645,1978,7377,2111,8022
210400,201903,4484,14098,4051,13555,143,444,3583,12108,3726,12552
210405,201903,7096,19386,5714,17407,1069,3096,3207,10355,4276,13451
210407,201903,1969,6632,1641,6009,106,486,1299,4662,1405,5148
210408,201903,2441,9326,2284,9080,148,749,1831,7302,1979,8051
210409,201903,3731,13072,3430,12660,115,640,2827,10441,2942,11081
210410,201903,3488,10893,2984,10053,229,873,2169,7270,2398,8143
210420,201903,3970,12757,3584,12090,194,602,3020,10293,3214,10895
210430,201903,2277,6680,2067,6419,101,297,1804,5632,1905,5929
210440,201903,4203,11780,3845,11290,74,279,3578,10456,3652,10735
210450,201903,2489,7545,2195,7087,104,378,1812,5831,1916,6209
210455,201903,4192,11198,3218,9964,916,2808,1599,5160,2515,7968
210460,201903,3506,10426,3059,9836,87,372,2666,8523,2753,8895
210462,201903,1560,5003,1372,4686,45,208,1099,3730,1144,3938
210465,201903,2613,7783,2293,7332,80,308,1969,6293,2049,6601
210467,201903,5654,18877,5129,18199,296,1230,4423,15777,4719,17007
210470,201903,2123,5567,1462,4619,90,206,1090,3580,1180,3786
210480,201903,15684,47500,13222,44404,1297,4092,9665,34448,10962,38540
210490,201903,3753,9627,3062,8638,86,253,2654,7480,2740,7733
210500,201903,6093,24425,5730,23774,373,1979,4659,19092,5032,21071
210510,201903,6066,20491,5454,19811,121,597,4876,17912,4997,18509
210515,201903,3737,10984,3262,10454,113,405,2856,9229,2969,9634
210520,201903,2541,7371,2302,7069,88,317,2034,6200,2122,6517
210530,201903,53616,131623,42520,115232,6847,23511,11589,40258,18436,63769
210535,201903,3113,10662,2907,10343,115,454,2448,8795,2563,9249
210540,201903,14317,42430,12053,39328,1471,4576,8497,28828,9968,33404
210542,201903,6330,15554,5207,14301,348,598,4436,12859,4784,13457
210545,201903,2256,7095,2126,6874,49,211,1871,5958,1920,6169
210547,201903,3568,12865,3165,12068,314,1178,2292,9000,2606,10178
210550,201903,6189,18753,5019,16972,362,1351,3770,13052,4132,14403
210560,201903,3458,10764,3140,10239,121,426,2655,8593,2776,9019
210565,201903,1470,5009,1235,4647,70,359,958,3657,1028,4016
210570,201903,10989,30141,9811,28729,304,866,8783,26099,9087,26965
210580,201903,3024,8388,2610,7893,201,396,2117,6711,2318,7107
210590,201903,4318,13054,3785,12334,91,491,3348,10821,3439,11312
210592,201903,2595,7739,2437,7488,38,184,2164,6585,2202,6769
210594,201903,2539,6909,1975,6046,83,228,1496,4717,1579,4945
210596,201903,2356,8632,2195,8298,145,614,1760,6679,1905,7293
210598,201903,1862,5345,1708,5125,31,144,1556,4628,1587,4772
210600,201903,3023,8292,2461,7467,79,207,2021,6247,2100,6454
210610,201903,2585,7570,2261,7177,72,348,1940,6099,2012,6447
210620,201903,2563,7259,2188,6807,49,151,1998,6328,2047,6479
210630,201903,3080,10581,2808,10153,149,775,2292,8125,2441,8900
210632,201903,4288,14146,3830,13477,285,1225,2964,10334,3249,11559
210635,201903,1801,6385,1703,6214,142,493,1386,5184,1528,5677
210637,201903,2306,7921,2074,7574,166,731,1555,5713,1721,6444
210640,201903,4515,16339,4307,16097,51,295,4074,15185,4125,15480
210650,201903,7319,20963,6738,20215,81,343,6244,18741,6325,19084
210660,201903,8371,24515,7428,23025,317,1168,6393,19613,6710,20781
210663,201903,2595,7786,2433,7600,110,277,2130,6833,2240,7110
210667,201903,1887,6205,1758,6014,52,215,1590,5471,1642,5686
210670,201903,4492,15523,4147,14951,140,678,3567,12772,3707,13450
210675,201903,5033,13869,4390,13006,286,732,3621,10993,3907,11725
210680,201903,4137,10702,3501,9909,130,259,3097,8975,3227,9234
210690,201903,7418,23787,6612,22857,276,1237,5778,20037,6054,21274
210700,201903,2717,7487,2215,6837,141,384,1731,5650,1872,6034
210710,201903,5049,15858,4457,14987,130,673,3883,12909,4013,13582
210720,201903,2828,9467,2643,9237,55,312,2389,8284,2444,8596
210725,201903,1346,4604,1160,4309,41,194,815,3124,856,3318
210730,201903,1211,3260,1015,2992,80,204,795,2380,875,2584
210735,201903,4646,14014,3991,13113,286,954,3305,11079,3591,12033
210740,201903,5292,14468,4658,13770,141,501,3841,11242,3982,11743
210745,201903,4536,12600,4219,12178,145,390,3818,11064,3963,11454
210750,201903,22459,57325,19654,53887,1567,4204,13788,39719,15355,43923
210760,201903,5798,15610,5099,14859,22,98,4861,14231,4883,14329
210770,201903,6081,15934,5264,15002,58,255,4928,13998,4986,14253
210780,201903,7090,23370,6357,22109,584,1895,4980,17672,5564,19567
210790,201903,4470,14036,4100,13561,235,706,3227,11315,3462,12021
210800,201903,4998,13389,4296,12457,63,269,3871,11064,3934,11333
210805,201903,3937,14597,3787,14373,112,613,3378,12760,3490,13373
210810,201903,4988,14796,4572,14259,232,525,3904,12559,4136,13084
210820,201903,7091,20465,6010,18728,787,2483,3749,11909,4536,14392
210825,201903,6600,20753,6119,20130,244,836,5327,17741,5571,18577
210830,201903,7685,22114,7208,21523,479,1078,6150,18999,6629,20077
210840,201903,3247,8692,2938,8268,93,292,2564,7121,2657,7413
210845,201903,6400,17601,5867,17007,29,101,5697,16552,5726,16653
210850,201903,5811,20160,5038,18972,297,1454,3917,14715,4214,16169
210860,201903,19563,52624,16604,48840,764,2123,13607,41475,14371,43598
210870,201903,6781,18811,5822,17679,244,747,5057,15384,5301,16131
210880,201903,4405,13611,3990,13137,248,941,3277,10783,3525,11724
210890,201903,4092,12369,3708,11914,236,623,3066,10156,3302,10779
210900,201903,4644,13672,3542,11682,1406,4951,601,2211,2007,7162
210905,201903,1926,5441,1632,5044,50,115,1471,4629,1521,4744
210910,201903,7247,22286,6197,20579,824,2810,4146,13850,4970,16660
210920,201903,3235,10757,2834,10215,88,481,2510,8956,2598,9437
210923,201903,1428,4490,1273,4242,65,247,970,3234,1035,3481
210927,201903,5212,16410,4618,15744,171,639,4001,13852,4172,14491
210930,201903,2458,8675,2235,8273,145,679,1749,6415,1894,7094
210940,201903,3940,11418,3703,11128,121,514,3357,9930,3478,10444
210945,201903,6055,18036,5583,17478,243,769,4828,15289,5071,16058
210950,201903,5124,14936,3995,13278,627,1762,2635,9333,3262,11095
210955,201903,1573,5064,1394,4763,140,459,1001,3497,1141,3956
210960,201903,8810,26936,7775,25383,1348,4056,4973,17154,6321,21210
210970,201903,1264,4014,1032,3615,65,294,780,2655,845,2949
210975,201903,1676,5423,1510,5143,103,375,1190,4058,1293,4433
210980,201903,10364,23608,9110,22319,114,233,8632,21294,8746,21527
210990,201903,16080,46317,12870,42076,1035,3615,9329,31021,10364,34636
211000,201903,14273,43308,12276,40997,605,2443,10068,34333,10673,36776
211003,201903,5386,16808,4601,15842,146,575,3974,13970,4120,14545
211010,201903,6336,22965,5769,22235,68,416,5244,20399,5312,20815
211020,201903,7690,23985,7116,23286,290,1176,6124,20096,6414,21272
211023,201903,2000,6673,1906,6542,99,412,1606,5459,1705,5871
211027,201903,2885,9533,2791,9377,180,663,2424,8074,2604,8737
211030,201903,3901,10981,3509,10506,253,583,2867,8843,3120,9426
211040,201903,4495,16482,4219,16022,136,793,3734,14047,3870,14840
211050,201903,9405,24173,8596,23154,168,449,7928,21353,8096,21802
211060,201903,6785,21313,6291,20640,152,622,5790,19000,5942,19622
211065,201903,2121,6111,1801,5683,85,296,1489,4762,1574,5058
211070,201903,7380,24533,6480,23096,521,1887,5060,18222,5581,20109
211080,201903,1283,3655,1034,3263,41,242,795,2349,836,2591
211085,201903,1968,5839,1723,5500,95,270,1493,4850,1588,5120
211090,201903,3252,9030,2932,8620,44,214,2671,7776,2715,7990
211100,201903,6666,17115,6206,16540,43,144,5692,15232,5735,15376
211102,201903,2944,10507,2726,10177,167,799,2327,8601,2494,9400
211105,201903,2319,7527,1933,6797,183,677,1359,4734,1542,5411
211107,201903,4461,14197,3878,13337,146,611,3179,11156,3325,11767
211110,201903,5921,16645,4601,14614,485,1411,3232,10542,3717,11953
211120,201903,41036,106161,36831,101285,4819,12315,23952,70508,28771,82823
211125,201903,2021,6149,1713,5670,52,212,1430,4734,1482,4946
211130,201903,192671,468020,175554,446504,25675,66018,75592,221007,101267,287025
211140,201903,4940,14991,4361,14198,194,607,3717,12133,3911,12740
211150,201903,9285,25997,7996,24299,327,1045,6743,20581,7070,21626
211153,201903,2535,7519,2055,6922,293,1054,1362,4765,1655,5819
211157,201903,1077,3439,899,3128,38,202,650,2233,688,2435
211160,201903,3879,11580,3135,10420,167,731,2335,7613,2502,8344
211163,201903,1771,5624,1626,5413,16,82,1503,5080,1519,5162
211167,201903,1564,5031,1457,4864,31,157,1342,4434,1373,4591
211170,201903,6344,15767,6001,15369,45,151,5720,14598,5765,14749
211172,201903,2404,6783,2093,6298,84,307,1711,5000,1795,5307
211174,201903,2799,8363,2569,8079,62,318,2327,7255,2389,7573
211176,201903,4230,12362,3309,11014,204,829,2562,8478,2766,9307
211178,201903,4637,10866,4029,10184,40,166,3781,9449,3821,9615
211180,201903,3997,13488,3714,13059,196,804,3176,11153,3372,11957
211190,201903,3044,9137,2629,8496,50,264,2258,7210,2308,7474
211195,201903,1370,3969,1161,3663,62,175,974,3144,1036,3319
211200,201903,2099,6254,1718,5751,188,661,1197,4073,1385,4734
211210,201903,6522,19909,5916,19109,277,1023,5102,16444,5379,17467
211220,201903,35437,92505,29602,85283,2896,8182,21814,64319,24710,72501
211223,201903,4847,13478,4248,12624,454,1310,3126,9395,3580,10705
211227,201903,1750,5921,1593,5689,44,220,1394,5027,1438,5247
211230,201903,7111,21800,6382,20657,408,1254,5142,16850,5550,18104
211240,201903,8177,26366,7719,25775,159,825,7049,23301,7208,24126
211245,201903,6668,17221,6276,16819,77,226,6103,16352,6180,16578
211250,201903,13461,40669,12262,39222,480,2052,10425,32917,10905,34969
211260,201903,7708,25446,7076,24591,207,954,6370,22205,6577,23159
211270,201903,10307,33382,8991,31602,387,1822,7386,26031,7773,27853
211280,201903,12955,36693,11623,35022,972,2379,9331,29385,10303,31764
211285,201903,1686,5864,1487,5554,204,812,906,3477,1110,4289
211290,201903,7206,22513,6681,21767,183,834,5743,18562,5926,19396
211300,201903,8054,22962,7302,21951,154,514,6665,20008,6819,20522
211400,201903,11216,33140,9278,30397,1317,4350,5918,20454,7235,24804
220005,201903,1834,4952,1662,4699,40,159,1367,3796,1407,3955
220010,201903,1471,4205,1235,3789,40,175,957,2888,997,3063
220020,201903,3342,9857,2974,9268,244,850,2298,7066,2542,7916
220025,201903,2202,5081,1882,4588,23,70,1588,3762,1611,3832
220027,201903,1240,3218,1070,2992,25,89,884,2421,909,2510
220030,201903,3301,8589,3135,8351,97,282,2745,7195,2842,7477
220040,201903,6924,21249,6198,19870,1240,3753,3699,12214,4939,15967
220045,201903,1447,4506,1223,4112,35,185,994,3269,1029,3454
220050,201903,4578,12932,3908,11961,97,442,3500,10573,3597,11015
220060,201903,2380,5113,2010,4683,24,67,1877,4351,1901,4418
220070,201903,2482,6396,2122,5870,77,176,1752,4848,1829,5024
220080,201903,696,1986,600,1838,28,112,512,1531,540,1643
220090,201903,1783,4368,1478,3942,19,76,1254,3419,1273,3495
220095,201903,649,1684,617,1648,16,29,564,1513,580,1542
220100,201903,1366,3837,1115,3420,49,193,881,2612,930,2805
220105,201903,2004,6347,1747,5807,144,478,1317,4398,1461,4876
220110,201903,3438,9519,3216,9115,48,230,2864,7986,2912,8216
220115,201903,2699,8108,2498,7809,69,298,2256,6924,2325,7222
220117,201903,1361,3323,1045,2869,17,67,883,2377,900,2444
220120,201903,12100,34006,11152,32823,107,436,10449,30695,10556,31131
220130,201903,1083,3040,915,2810,15,104,815,2444,830,2548
220140,201903,1954,4299,1685,3972,141,377,1438,3330,1579,3707
220150,201903,6461,19292,6032,18606,133,666,5126,15445,5259,16111
220155,201903,1103,3234,877,2813,28,110,624,1965,652,2075
220157,201903,1045,2580,868,2299,16,73,703,1797,719,1870
220160,201903,2718,7780,2349,7114,46,241,1942,5725,1988,5966
220170,201903,1494,3999,1262,3655,12,64,1112,3175,1124,3239
220173,201903,2013,5769,1659,5114,38,163,1328,4012,1366,4175
220177,201903,1954,5613,1876,5520,14,44,1834,5409,1848,5453
220180,201903,1139,2881,906,2467,6,33,674,1722,680,1755
220190,201903,6206,16656,5272,15344,408,1336,3922,11339,4330,12675
220191,201903,1390,4441,1277,4239,79,330,943,3051,1022,3381
220192,201903,1837,5005,1445,4306,29,108,1157,3375,1186,3483
220194,201903,1692,4906,1510,4603,65,270,1242,3690,1307,3960
220196,201903,1931,5228,1750,4940,37,167,1482,4073,1519,4240
220198,201903,1289,3545,1069,3262,9,23,984,3039,993,3062
220200,201903,4781,14358,4293,13709,219,808,3535,11279,3754,12087
220202,201903,2184,6168,1873,5639,30,156,1591,4695,1621,4851
220205,201903,2544,7191,2267,6732,48,208,1928,5612,1976,5820
220207,201903,777,2343,646,2111,60,220,418,1362,478,1582
220208,201903,1689,5295,1374,4668,232,855,702,2345,934,3200
220209,201903,1586,4588,1375,4232,27,134,1112,3377,1139,3511
220210,201903,1594,4134,1390,3803,16,72,1145,3043,1161,3115
220211,201903,1554,4056,1437,3894,15,54,1274,3471,1289,3525
220213,201903,1740,4728,1507,4289,29,106,1199,3295,1228,3401
220217,201903,2050,6237,1940,6116,37,124,1808,5757,1845,5881
220220,201903,10176,27146,8522,24548,551,1489,6038,17838,6589,19327
220225,201903,1100,2872,888,2600,9,44,806,2330,815,2374
220230,201903,5783,14394,4994,13314,203,516,4269,11397,4472,11913
220240,201903,2914,8603,2675,8150,93,313,2168,6598,2261,6911
220245,201903,1607,4007,1296,3610,14,80,1171,3275,1185,3355
220250,201903,2875,8299,2524,7838,23,131,2308,7119,2331,7250
220253,201903,1639,4505,1403,4089,83,263,1150,3264,1233,3527
220255,201903,1866,4617,1562,4160,45,214,1284,3246,1329,3460
220260,201903,4229,13241,3731,12370,180,656,2967,9828,3147,10484
220265,201903,1209,4008,1111,3853,54,227,892,3058,946,3285
220270,201903,6415,20261,6019,19539,265,1190,5005,15694,5270,16884
220271,201903,1470,3813,1274,3536,34,124,1119,3090,1153,3214
220272,201903,1707,4928,1524,4588,68,217,1134,3321,1202,3538
220273,201903,1211,3489,1001,3100,43,168,758,2289,801,2457
220275,201903,2255,5480,1755,4795,36,129,1519,4145,1555,4274
220277,201903,2114,5467,1828,5020,40,130,1546,4162,1586,4292
220280,201903,1599,3906,1325,3524,27,90,1126,2929,1153,3019
220285,201903,1484,3847,1250,3550,17,81,1108,3104,1125,3185
220290,201903,5990,17787,4839,16156,364,1356,3567,12029,3931,13385
220300,201903,1970,5866,1616,5381,45,273,1331,4336,1376,4609
220310,201903,2990,8208,2349,7468,53,262,1948,6120,2001,6382
220320,201903,3019,9011,2342,7699,116,512,1767,5627,1883,6139
220323,201903,1599,4902,1283,4370,71,280,1045,3501,1116,3781
220325,201903,1278,3777,1088,3450,33,147,900,2791,933,2938
220327,201903,1452,4250,1295,3989,44,200,1055,3174,1099,3374
220330,201903,4216,10426,3483,9508,99,307,3020,8149,3119,8456
220335,201903,1772,5296,1573,5057,26,99,1422,4560,1448,4659
220340,201903,1841,4889,1450,4238,46,148,1015,2846,1061,2994
220342,201903,1174,3516,1043,3312,46,217,812,2530,858,2747
220345,201903,3130,7173,2493,6265,19,61,2283,5707,2302,5768
220350,201903,3364,8747,2675,7664,131,411,1953,5559,2084,5970
220360,201903,1244,3185,990,2784,24,76,796,2220,820,2296
220370,201903,8808,25278,8008,24110,186,807,7026,20872,7212,21679
220375,201903,1548,4522,1388,4320,8,30,1322,4136,1330,4166
220380,201903,1520,3675,1255,3293,23,60,1079,2787,1102,2847
220385,201903,832,2012,663,1709,10,35,569,1442,579,1477
220390,201903,8400,23715,6885,21175,1797,5428,2962,9743,4759,15171
220400,201903,1465,3601,1130,3084,27,91,860,2280,887,2371
220410,201903,1143,3190,940,2851,51,151,753,2248,804,2399
220415,201903,810,2144,684,1939,15,46,529,1479,544,1525
220420,201903,1977,5508,1610,4809,53,163,1248,3663,1301,3826
220430,201903,2532,6827,2409,6648,86,282,2097,5689,2183,5971
220435,201903,1703,4560,1492,4233,53,174,1184,3284,1237,3458
220440,201903,2377,7603,2082,7122,108,449,1707,5757,1815,6206
220450,201903,2365,6382,1949,5846,135,476,1544,4619,1679,5095
220455,201903,1311,4045,1244,3956,22,107,1105,3499,1127,3606
220460,201903,931,2359,869,2288,25,85,753,1944,778,2029
220465,201903,2360,7399,2085,6962,174,619,1550,5233,1724,5852
220470,201903,3443,9760,3087,9186,84,274,2505,7335,2589,7609
220480,201903,2510,6695,2007,5864,148,380,1434,4139,1582,4519
220490,201903,2371,6204,2129,5888,43,193,1881,5114,1924,5307
220500,201903,2540,6810,2324,6466,45,182,1929,5184,1974,5366
220510,201903,2512,7215,2023,6353,91,267,1579,4955,1670,5222
220515,201903,1677,4062,1513,3837,36,82,1316,3317,1352,3399
220520,201903,4999,13033,4487,12299,102,316,3933,10692,4035,11008
220525,201903,1298,3372,1159,3184,21,95,1042,2805,1063,2900
220527,201903,1314,3688,1143,3421,16,55,984,2984,1000,3039
220530,201903,1361,3511,1186,3283,25,99,1097,2986,1122,3085
220535,201903,800,2242,733,2155,41,157,596,1719,637,1876
220540,201903,3309,10520,3102,10141,103,404,2665,8639,2768,9043
220545,201903,1363,4291,1267,4122,81,337,1037,3306,1118,3643
220550,201903,8577,26503,7721,25073,566,2023,5801,18630,6367,20653
220551,201903,1423,4173,1247,3865,38,150,1000,3040,1038,3190
220552,201903,1585,4636,1295,4095,46,218,1016,3090,1062,3308
220553,201903,1562,4304,1382,4052,53,125,1103,3329,1156,3454
220554,201903,860,2301,627,1909,41,100,422,1277,463,1377
220555,201903,2079,6578,1935,6340,55,262,1556,5198,1611,5460
220556,201903,1260,3706,1079,3343,60,248,763,2248,823,2496
220557,201903,1586,4817,1337,4326,82,309,965,3025,1047,3334
220558,201903,1393,3666,1083,3227,24,109,911,2677,935,2786
220559,201903,1609,4176,1358,3779,5,29,1097,3094,1102,3123
220560,201903,1767,4030,1423,3580,32,69,1273,3202,1305,3271
220570,201903,7163,21766,6532,20843,461,1539,5153,16406,5614,17945
220580,201903,6856,19266,6347,18422,113,414,5689,16327,5802,16741
220585,201903,1893,6187,1677,5786,54,205,1370,4734,1424,4939
220590,201903,1291,3582,1067,3240,96,291,749,2277,845,2568
220595,201903,2463,6829,2255,6545,19,91,2028,5818,2047,5909
220600,201903,1408,3149,1165,2842,113,174,949,2398,1062,2572
220605,201903,1656,4812,1395,4359,24,134,1111,3368,1135,3502
220610,201903,2812,8721,2640,8479,35,155,2431,7814,2466,7969
220620,201903,7892,24780,7330,24021,228,1118,6595,21327,6823,22445
220630,201903,360,1078,282,939,27,84,174,594,201,678
220635,201903,1629,5199,1435,4772,57,239,1086,3528,1143,3767
220640,201903,2625,7230,2245,6673,93,358,1805,5289,1898,5647
220650,201903,2081,5795,1783,5320,49,178,1394,4145,1443,4323
220660,201903,2640,8272,2288,7691,94,470,1863,6083,1957,6553
220665,201903,1280,3935,1096,3632,34,179,896,2905,930,3084
220667,201903,1608,5110,1431,4775,76,301,1132,3756,1208,4057
220669,201903,1685,5186,1615,5067,79,355,1370,4188,1449,4543
220670,201903,2211,5845,1773,5239,35,113,1512,4446,1547,4559
220672,201903,3138,7746,2545,7029,145,404,2190,6022,2335,6426
220675,201903,1220,3368,1117,3175,44,134,896,2523,940,2657
220680,201903,2654,7357,2523,7167,101,258,2278,6480,2379,6738
220690,201903,1488,4022,1311,3753,104,270,1004,2911,1108,3181
220695,201903,865,2453,805,2340,17,63,691,1993,708,2056
220700,201903,9371,23751,7427,20983,368,1118,5664,15841,6032,16959
220710,201903,859,2436,654,2038,28,93,480,1464,508,1557
220720,201903,2109,5060,1896,4763,21,77,1620,4013,1641,4090
220730,201903,1280,3650,1093,3350,20,101,923,2760,943,2861
220735,201903,966,2296,741,1938,21,70,617,1551,638,1621
220740,201903,1387,3822,1114,3462,38,122,938,2936,976,3058
220750,201903,3735,9810,3317,9201,228,543,2847,7959,3075,8502
220755,201903,1221,3107,1018,2791,33,118,801,2110,834,2228
220760,201903,3002,8709,2646,8216,111,363,2274,7149,2385,7512
220770,201903,20905,64624,17896,59317,5962,20438,6312,21736,12274,42174
220775,201903,1104,2913,1025,2814,14,53,987,2697,1001,2750
220777,201903,1650,4213,1249,3569,31,89,928,2632,959,2721
220779,201903,1326,3275,1166,3049,25,78,1011,2618,1036,2696
220780,201903,5456,14114,4804,13067,201,663,3942,10424,4143,11087
220785,201903,1484,3282,1325,3066,10,16,1275,2946,1285,2962
220790,201903,10129,29080,9099,27623,279,1301,7629,22740,7908,24041
220793,201903,865,2319,710,2046,18,44,578,1679,596,1723
220795,201903,1392,3665,1251,3491,29,118,1088,2998,1117,3116
220800,201903,16745,39880,14101,36117,760,1987,10479,26567,11239,28554
220810,201903,2949,8367,2538,7626,55,218,2105,6192,2160,6410
220820,201903,5150,13393,4406,12367,401,988,3236,9147,3637,10135
220830,201903,7231,19462,6513,18429,257,841,5462,15275,5719,16116
220840,201903,12096,37477,10270,33693,2451,7664,4904,16783,7355,24447
220850,201903,3105,9712,2782,9304,70,360,2431,8068,2501,8428
220855,201903,608,1652,536,1532,11,56,468,1310,479,1366
220860,201903,1023,2550,878,2319,17,68,784,2043,801,2111
220865,201903,2541,6734,1964,5743,66,240,1510,4300,1576,4540
220870,201903,2876,8249,2383,7587,34,168,2160,6834,2194,7002
220880,201903,5202,12521,4552,11723,82,279,4182,10651,4264,10930
220885,201903,1347,4255,1125,3881,56,234,891,3089,947,3323
220887,201903,1501,3343,1254,3020,9,30,1169,2780,1178,2810
220890,201903,1431,4546,1231,4206,69,253,974,3334,1043,3587
220900,201903,1992,4884,1674,4454,37,96,1444,3804,1481,3900
220910,201903,1485,4181,1265,3851,42,148,1058,3202,1100,3350
220915,201903,962,2599,771,2231,9,38,601,1690,610,1728
220920,201903,1371,4532,1173,4259,74,330,942,3407,1016,3737
220930,201903,1607,4549,1404,4236,30,117,1272,3793,1302,3910
220935,201903,1047,3010,845,2592,25,95,562,1630,587,1725
220937,201903,1369,3700,1179,3406,24,105,964,2722,988,2827
220940,201903,1457,4193,1175,3660,39,159,887,2698,926,2857
220945,201903,428,1484,375,1369,20,113,277,977,297,1090
220950,201903,1397,3280,912,2506,13,45,709,1890,722,1935
220955,201903,1573,4094,1342,3698,39,119,1120,3057,1159,3176
220960,201903,833,2109,632,1791,12,54,472,1278,484,1332
220965,201903,1761,4851,1541,4535,21,131,1322,3790,1343,3921
220970,201903,1840,4654,1391,3947,41,116,1123,3160,1164,3276
220975,201903,710,2126,620,2020,23,147,545,1683,568,1830
220980,201903,1166,3319,1038,3136,36,157,868,2579,904,2736
220985,201903,1183,3254,1064,3083,39,153,846,2341,885,2494
220987,201903,1497,4450,1283,4077,57,246,1034,3220,1091,3466
220990,201903,1690,4739,1477,4412,25,140,1212,3539,1237,3679
220995,201903,1159,3451,908,3011,48,190,645,2128,693,2318
220997,201903,2441,7164,2246,6878,53,235,2016,6080,2069,6315
221000,201903,4167,11741,3824,11246,94,459,3281,9452,3375,9911
221005,201903,1472,3955,1338,3732,42,174,1133,3035,1175,3209
221010,201903,1188,2841,964,2554,29,82,832,2156,861,2238
221020,201903,1519,4679,1404,4456,28,123,1050,3287,1078,3410
221030,201903,1595,4150,1369,3854,30,123,1194,3343,1224,3466
221035,201903,1445,3797,1261,3542,24,45,1104,3187,1128,3232
221037,201903,618,1790,520,1620,9,53,345,1019,354,1072
221038,201903,514,1464,409,1259,17,61,280,851,297,912
221039,201903,872,2363,762,2178,19,79,623,1701,642,1780
221040,201903,4068,12312,3623,11527,163,594,2874,9117,3037,9711
221050,201903,3790,10141,3365,9584,57,232,3043,8580,3100,8812
221060,201903,8346,23246,6891,20988,237,729,5528,16927,5765,17656
221062,201903,1165,3841,993,3526,45,219,800,2789,845,3008
221063,201903,1105,3176,943,2939,71,269,692,2077,763,2346
221065,201903,2605,6785,2288,6227,22,106,2007,5349,2029,5455
221070,201903,3319,10508,2767,9398,299,1027,1760,6084,2059,7111
221080,201903,3497,8571,2846,7612,53,209,2345,6164,2398,6373
221090,201903,1394,3680,1142,3245,13,54,976,2700,989,2754
221093,201903,1352,3848,1240,3614,126,370,847,2430,973,2800
221095,201903,898,2367,751,2139,7,20,622,1749,629,1769
221097,201903,822,2159,630,1807,22,71,463,1267,485,1338
221100,201903,104434,284667,89595,260450,12346,37560,56410,160686,68756,198246
221110,201903,9925,29748,9140,28732,198,1024,8126,25149,8324,26173
221120,201903,4520,12949,4093,12225,189,640,3463,10251,3652,10891
221130,201903,4977,13258,3712,10758,837,2344,1719,5017,2556,7361
221135,201903,1581,4333,1419,4111,44,166,1245,3575,1289,3741
221140,201903,1303,3155,1115,2898,9,41,985,2495,994,2536
221150,201903,1094,2716,869,2328,26,119,672,1674,698,1793
221160,201903,782,1945,691,1823,23,42,558,1471,581,1513
221170,201903,983,2883,905,2750,22,72,768,2328,790,2400
230010,201903,3156,8407,2535,7316,96,350,1953,5476,2049,5826
230015,201903,2935,9693,2634,9103,216,888,1815,6182,2031,7070
230020,201903,13039,41351,12322,40200,400,1690,10355,33357,10755,35047
230030,201903,12667,32531,10882,30070,203,659,9566,26347,9769,27006
230040,201903,4439,11632,3719,10445,84,357,3053,8414,3137,8771
230050,201903,2774,8774,2044,6993,361,1194,833,2789,1194,3983
230060,201903,2329,6392,1880,5547,45,199,1510,4344,1555,4543
230070,201903,3847,10557,3146,9166,155,516,2151,6213,2306,6729
230075,201903,9065,29494,8377,28296,367,1880,6836,22470,7203,24350
230080,201903,2981,6345,2279,5453,9,32,2041,4881,2050,4913
230090,201903,4112,10509,3536,9564,157,447,2764,7408,2921,7855
230100,201903,17545,47136,15670,44470,1389,4133,10870,30921,12259,35054
230110,201903,12203,36821,10552,33513,1730,5466,5807,18538,7537,24004
230120,201903,7363,20285,6496,18834,577,1502,4701,13862,5278,15364
230125,201903,3129,8397,2552,7447,82,306,1947,5602,2029,5908
230130,201903,5608,17627,4622,15422,357,1347,3050,9979,3407,11326
230140,201903,3385,10287,2903,9317,119,516,2183,6792,2302,7308
230150,201903,1613,4837,1354,4261,221,617,761,2494,982,3111
230160,201903,6520,17230,5651,15869,155,605,4711,12941,4866,13546
230170,201903,6004,17443,5071,15591,308,984,3679,11083,3987,12067
230180,201903,1622,4553,1384,4088,28,123,1095,3125,1123,3248
230185,201903,4199,12361,3590,11336,283,995,2625,8272,2908,9267
230190,201903,12933,38287,11031,34712,1691,5445,5954,18744,7645,24189
230195,201903,5028,15076,4580,14229,317,1056,3520,10828,3837,11884
230200,201903,4981,13802,4254,12392,148,501,3254,9244,3402,9745
230205,201903,3923,12155,3536,11520,154,654,2713,8661,2867,9315
230210,201903,10146,25113,8649,23002,431,1371,6636,17357,7067,18728
230220,201903,13425,34607,11991,32471,540,1551,9943,26604,10483,28155
230230,201903,6851,20901,6157,19454,424,1373,4472,14026,4896,15399
230240,201903,12379,33505,11011,31286,336,1177,9119,25538,9455,26715
230250,201903,8971,25985,8645,25458,281,1031,6833,19560,7114,20591
230260,201903,14360,44173,12661,41055,1599,5290,7407,24328,9006,29618
230270,201903,7366,20388,5763,17354,507,1498,3826,11571,4333,13069
230280,201903,20309,54963,16739,48916,579,2360,13124,36991,13703,39351
230290,201903,4760,13416,4030,11990,343,909,2972,8903,3315,9812
230300,201903,4575,12650,4229,12155,70,299,3732,10547,3802,10846
230310,201903,4664,13314,3958,12108,137,587,2836,8437,2973,9024
230320,201903,7596,22107,6585,20195,302,1188,5043,15134,5345,16322
230330,201903,4647,12864,3817,11261,176,562,2810,8126,2986,8688
230340,201903,3567,11309,3052,10249,298,1018,2017,6741,2315,7759
230350,201903,18341,51251,16176,47763,1053,3608,10376,30864,11429,34472
230360,201903,2842,7883,2275,6828,150,472,1525,4542,1675,5014
230365,201903,3053,7680,2562,6911,49,248,2157,5707,2206,5955
230370,201903,54092,156651,46505,144827,8276,26083,25249,80733,33525,106816
230380,201903,6430,17944,5086,15428,161,608,3710,11056,3871,11664
230390,201903,3253,9813,2851,9154,118,492,2189,6958,2307,7450
230393,201903,3010,9230,2491,8192,98,542,1910,6005,2008,6547
230395,201903,5718,15701,4992,14450,394,1110,3413,9911,3807,11021
230400,201903,5782,16159,5111,15063,153,740,3966,11268,4119,12008
230410,201903,14373,43116,11787,38136,1117,3877,7702,24880,8819,28757
230420,201903,26862,76523,22522,68482,2805,8884,12892,38925,15697,47809
230423,201903,4751,14182,4148,12944,102,460,3335,10178,3437,10638
230425,201903,5458,17160,4974,16147,442,1516,3508,11327,3950,12843
230426,201903,2618,7042,1949,5703,39,160,1475,4220,1514,4380
230427,201903,1856,5283,1313,4067,67,231,891,2662,958,2893
230428,201903,9566,26274,8442,24538,1168,3444,5074,14644,6242,18088
230430,201903,4671,13456,3808,11991,162,620,2871,8847,3033,9467
230435,201903,5544,15130,4751,13768,542,1582,3036,8776,3578,10358
230440,201903,393439,1007979,330320,911932,42516,123588,197789,541348,240305,664936
230445,201903,4294,11462,3523,10121,210,580,2414,6810,2624,7390
230450,201903,3616,10604,3139,9850,244,951,2263,6926,2507,7877
230460,201903,2078,5920,1832,5522,78,298,1501,4501,1579,4799
230465,201903,3972,11290,3398,10227,97,428,2500,7218,2597,7646
230470,201903,11090,37184,10044,35191,862,3677,7303,25124,8165,28801
230480,201903,1402,4112,1189,3729,99,389,853,2565,952,2954
230490,201903,2427,6916,2081,6259,192,652,1299,3702,1491,4354
230495,201903,5794,17493,5102,16205,403,1601,3316,10322,3719,11923
230500,201903,8921,29571,8217,28220,345,1433,6545,22383,6890,23816
230510,201903,1626,5108,1213,4150,215,784,539,1825,754,2609
230520,201903,4458,12914,3920,11907,302,947,2763,8326,3065,9273
230523,201903,14268,42869,11807,37585,2803,8861,3179,10727,5982,19588
230526,201903,3902,11236,3292,10146,158,576,2425,7387,2583,7963
230530,201903,5280,16552,4513,15089,363,1325,3172,10559,3535,11884
230533,201903,4149,10536,3571,9537,104,295,2921,7711,3025,8006
230535,201903,5305,14899,4524,13556,242,738,3201,9682,3443,10420
230540,201903,15949,44228,14017,41325,262,1146,11780,34226,12042,35372
230550,201903,19908,54439,16390,48291,1719,5263,10051,29437,11770,34700
230560,201903,7821,19770,6479,17535,80,309,5452,14598,5532,14907
230565,201903,3022,8479,2539,7592,83,359,1926,5660,2009,6019
230570,201903,3526,8958,3052,8343,67,209,2598,7067,2665,7276
230580,201903,10317,27712,9053,25917,342,1106,7575,21512,7917,22618
230590,201903,8812,25668,7351,22916,489,1744,5240,15798,5729,17542
230600,201903,3649,9637,2788,8026,85,269,1872,5444,1957,5713
230610,201903,6570,18441,5819,17226,502,1426,4443,13184,4945,14610
230620,201903,2087,5711,1591,4722,136,447,954,2751,1090,3198
230625,201903,7812,22819,6668,20655,2062,6601,1767,5832,3829,12433
230630,201903,10356,31594,9105,28952,1973,5914,4456,14895,6429,20809
230640,201903,27761,84565,25084,80183,1567,6065,19505,61414,21072,67479
230650,201903,5059,14065,4273,12628,162,683,3353,9618,3515,10301
230655,201903,9254,32113,8787,31265,692,2715,6854,24473,7546,27188
230660,201903,6193,18389,5041,16316,178,937,4065,12839,4243,13776
230670,201903,6128,14901,4515,12231,158,484,3547,9385,3705,9869
230680,201903,2543,7171,2183,6526,162,501,1522,4546,1684,5047
230690,201903,6786,20503,5984,18863,440,1573,3745,11534,4185,13107
230700,201903,9562,25070,8120,22437,348,1092,6091,16360,6439,17452
230710,201903,6848,21641,5936,19743,567,2045,4110,13405,4677,15450
230720,201903,1947,5789,1595,5052,126,380,1058,3286,1184,3666
230725,201903,3798,11761,3362,10893,497,1748,1674,5323,2171,7071
230730,201903,54893,152492,44438,135832,10478,34486,15049,48309,25527,82795
230740,201903,6050,17170,5239,15817,135,575,4195,12536,4330,13111
230750,201903,8393,22806,7058,20580,194,750,5520,15631,5714,16381
230760,201903,11065,29985,9821,28028,633,2101,7280,20241,7913,22342
230763,201903,4428,12638,3804,11456,139,591,3012,8777,3151,9368
230765,201903,40550,113639,34181,102926,6200,19376,15296,46114,21496,65490
230770,201903,25309,64685,21477,59445,2573,7435,13668,37838,16241,45273
230780,201903,5964,21458,5589,20647,839,3162,3301,12487,4140,15649
230790,201903,2939,8633,2620,8103,130,552,1939,5802,2069,6354
230800,201903,7779,25320,6986,23668,800,3023,4215,13970,5015,16993
230810,201903,11755,35514,10470,33361,446,1711,7984,24875,8430,26586
230820,201903,3237,10700,2733,9541,296,1226,1657,5505,1953,6731
230830,201903,7625,21129,6487,19116,162,714,5264,15097,5426,15811
230835,201903,4129,10001,3220,8582,87,284,2576,6736,2663,7020
230837,201903,3077,9646,2663,8878,110,541,2092,6773,2202,7314
230840,201903,8959,26793,7806,24891,602,2049,5769,18443,6371,20492
230850,201903,9268,27461,8014,24945,441,1565,5703,17551,6144,19116
230860,201903,5219,13580,4366,12330,98,356,3732,10426,3830,10782
230870,201903,16664,41101,14282,37342,454,1279,11513,29792,11967,31071
230880,201903,2090,6448,1902,6118,60,325,1483,4631,1543,4956
230890,201903,4401,14451,4081,13820,350,1323,2974,9894,3324,11217
230900,201903,3021,8931,2583,8059,213,752,1693,5136,1906,5888
230910,201903,2914,8118,2405,7252,79,385,1920,5662,1999,6047
230920,201903,4486,12893,3845,11849,164,643,2915,8772,3079,9415
230930,201903,6439,18425,5414,16463,365,1151,3731,11307,4096,12458
230940,201903,7689,20265,6774,18844,202,604,5691,15700,5893,16304
230945,201903,6512,18971,5632,17197,388,1327,3884,11777,4272,13104
230950,201903,6254,15885,5669,15137,141,329,5021,13586,5162,13915
230960,201903,12985,38471,11654,35963,1862,5837,5930,18528,7792,24365
230970,201903,13103,35953,11150,32898,2048,6155,5697,16976,7745,23131
230980,201903,2721,8087,2379,7452,446,1331,1383,4485,1829,5816
230990,201903,1702,4852,1412,4269,75,303,948,2721,1023,3024
231000,201903,2489,6656,2062,5831,77,216,1485,4108,1562,4324
231010,201903,3324,8062,2682,6952,84,278,2234,5602,2318,5880
231020,201903,7823,25261,7071,23680,1244,3914,4118,14306,5362,18220
231025,201903,7339,20893,6464,19469,837,2520,4345,13168,5182,15688
231030,201903,7071,21496,5679,18512,952,3049,2995,9820,3947,12869
231040,201903,3040,8937,2643,8182,98,369,2047,6202,2145,6571
231050,201903,11838,31040,9609,27047,678,1865,7016,19417,7694,21282
231060,201903,2688,7817,2391,7315,80,292,1912,5813,1992,6105
231070,201903,8012,23635,6797,21454,904,2895,4016,12656,4920,15551
231080,201903,3997,11579,3506,10745,150,684,2654,7891,2804,8575
231085,201903,6312,16068,5138,14615,245,694,3915,11172,4160,11866
231090,201903,4290,11427,3253,9352,109,414,2267,6306,2376,6720
231095,201903,2147,6561,1750,5666,136,468,1194,3855,1330,4323
231100,201903,2966,8803,2494,7911,132,473,1887,5914,2019,6387
231110,201903,3483,10617,3245,10154,143,557,2414,7438,2557,7995
231120,201903,2141,6432,1827,5882,91,345,1249,3969,1340,4314
231123,201903,1925,5065,1609,4511,79,216,1166,3228,1245,3444
231126,201903,5580,15621,4499,13506,234,730,3243,9570,3477,10300
231130,201903,20221,54041,17018,49801,1287,4635,12059,34589,13346,39224
231135,201903,4156,11721,3480,10454,161,567,2498,7348,2659,7915
231140,201903,16672,47855,13581,42287,755,3181,9340,28130,10095,31311
231150,201903,5484,15528,4381,13289,777,2353,1961,6084,2738,8437
231160,201903,5940,18458,5335,17292,1032,3166,2899,9708,3931,12874
231170,201903,4379,13092,3605,11520,219,808,2429,7510,2648,8318
231180,201903,13905,40356,11638,35421,3014,9074,4336,13421,7350,22495
231190,201903,3792,10885,3255,9871,111,480,2538,7476,2649,7956
231195,201903,4606,14434,3917,12972,212,864,2901,9377,3113,10241
231200,201903,7755,24818,6795,22779,266,1356,5152,16723,5418,18079
231210,201903,4772,14309,4114,13147,188,729,3094,9637,3282,10366
231220,201903,11986,32060,9496,27251,499,1556,6773,18693,7272,20249
231230,201903,9072,29060,8073,27346,495,1969,5959,20215,6454,22184
231240,201903,11611,34663,10260,31999,1676,5226,5820,18320,7496,23546
231250,201903,2054,5402,1338,3773,103,284,786,2178,889,2462
231260,201903,3228,9326,2821,8674,295,895,1854,5845,2149,6740
231270,201903,6443,16973,5352,15174,138,543,4046,11175,4184,11718
231280,201903,1659,5284,1556,5083,121,408,1140,3702,1261,4110
231290,201903,36990,112517,31675,101586,5558,18025,14562,46451,20120,64476
231300,201903,4001,11261,3167,9546,269,867,2017,5966,2286,6833
231310,201903,7222,19224,5865,16662,538,1512,3881,10862,4419,12374
231320,201903,7645,21419,6084,18542,104,472,4705,14152,4809,14624
231325,201903,2477,6761,2056,6074,246,646,1298,3933,1544,4579
231330,201903,9597,29404,8039,26268,1529,4854,4206,14201,5735,19055
231335,201903,5649,15016,4778,13573,83,394,4153,11579,4236,11973
231340,201903,17550,55124,15718,51901,1319,4484,11372,37916,12691,42400
231350,201903,15624,42804,14183,40782,345,1206,12617,35927,12962,37133
231355,201903,4399,13371,3943,12548,215,811,3037,9551,3252,10362
231360,201903,7462,22893,6497,21166,404,1443,4888,15883,5292,17326
231370,201903,2279,6172,1807,5330,40,128,1381,4031,1421,4159
231375,201903,4392,13841,4007,13176,152,705,3285,10631,3437,11336
231380,201903,5875,16061,5400,15442,216,591,4402,12777,4618,13368
231390,201903,3356,9910,3017,9341,163,629,2182,6541,2345,7170
231395,201903,3968,11964,3343,10950,550,1774,1833,6138,2383,7912
231400,201903,9169,26860,7981,24620,336,1359,6086,18376,6422,19735
231410,201903,14650,46156,13232,43787,752,2865,10345,33757,11097,36622
240010,201903,2475,6731,1924,5698,218,714,1147,3287,1365,4001
240020,201903,11530,33476,9985,30717,790,2950,6520,19666,7310,22616
240030,201903,2735,7029,2525,6710,103,285,2206,5810,2309,6095
240040,201903,821,2351,681,2101,16,75,508,1518,524,1593
240050,201903,3144,8475,2624,7528,54,160,2079,5856,2133,6016
240060,201903,1391,3764,1172,3365,35,114,941,2656,976,2770
240070,201903,2100,6305,1962,6025,216,727,1447,4350,1663,5077
240080,201903,2790,7682,2382,6909,63,266,1836,5196,1899,5462
240090,201903,2251,5613,1825,4881,18,59,1519,4000,1537,4059
240100,201903,9469,24156,7738,20909,313,971,5974,15601,6287,16572
240110,201903,4277,12537,3734,11540,208,797,2721,8216,2929,9013
240120,201903,3525,9614,2616,8562,216,842,1741,5834,1957,6676
240130,201903,3556,7600,3007,6854,45,135,2726,6104,2771,6239
240140,201903,1923,5797,1651,5284,197,702,1079,3365,1276,4067
240145,201903,6368,18268,5310,16363,762,2420,3162,9822,3924,12242
240150,201903,875,2586,795,2427,51,182,618,1828,669,2010
240160,201903,1424,4356,1217,3938,60,281,871,2797,931,3078
240165,201903,923,2571,790,2314,59,194,599,1719,658,1913
240170,201903,2328,6554,1982,5935,216,737,1274,3678,1490,4415
240180,201903,3056,9083,2454,7879,537,1682,1190,3979,1727,5661
240185,201903,1250,4034,1132,3839,62,258,916,3063,978,3321
240190,201903,1005,3023,880,2808,25,112,721,2272,746,2384
240200,201903,10552,27912,8747,24773,1046,3185,4767,13274,5813,16459
240210,201903,2931,7501,2554,6926,31,143,2161,5678,2192,5821
240220,201903,7306,22513,6578,21358,428,1872,4994,15832,5422,17704
240230,201903,5772,14867,4711,13048,236,647,3711,10248,3947,10895
240240,201903,1927,5891,1222,4118,123,407,471,1559,594,1966
240250,201903,2836,7703,2553,7285,145,385,2062,5917,2207,6302
240260,201903,13376,40379,11716,37478,1683,5234,7177,23975,8860,29209
240270,201903,2262,6727,2010,6335,112,315,1536,4963,1648,5278
240280,201903,1675,4323,1417,3916,44,137,1145,3106,1189,3243
240290,201903,1194,3512,989,3071,33,144,686,1993,719,2137
240300,201903,2151,5636,1579,4537,78,234,1008,2816,1086,3050
240310,201903,8686,23355,7030,20407,883,2631,3775,10875,4658,13506
240320,201903,2023,5543,1491,4491,27,131,1130,3269,1157,3400
240325,201903,29289,80851,23004,69668,5247,16618,8181,25431,13428,42049
240330,201903,1675,4603,1312,3906,47,163,920,2624,967,2787
240340,201903,1912,4595,1570,4058,53,148,1271,3199,1324,3347
240350,201903,2046,5417,1910,5259,29,118,1702,4687,1731,4805
240360,201903,7932,22729,7108,21408,1027,3059,4515,14036,5542,17095
240370,201903,1951,5255,1528,4391,80,236,1042,2916,1122,3152
240375,201903,888,2279,749,2002,30,117,595,1507,625,1624
240380,201903,2238,6392,1652,5096,155,471,973,2963,1128,3434
240390,201903,955,2442,672,1871,21,53,434,1127,455,1180
240400,201903,1352,3429,1066,2903,35,131,741,1908,776,2039
240410,201903,552,1738,467,1551,57,243,276,866,333,1109
240420,201903,4595,16524,4065,15319,553,2475,2226,8194,2779,10669
240430,201903,3308,8946,2821,7994,232,736,2018,5520,2250,6256
240440,201903,2524,5726,2133,5162,139,326,1686,4032,1825,4358
240450,201903,4169,11739,3418,10367,327,1156,2078,6070,2405,7226
240460,201903,2875,8368,2663,8030,270,881,2089,6264,2359,7145
240470,201903,3503,10754,2748,9169,375,1275,1516,5060,1891,6335
240480,201903,547,1528,395,1206,33,108,170,503,203,611
240485,201903,2076,6042,1716,5343,161,517,1118,3480,1279,3997
240490,201903,1723,4356,1367,3712,57,138,1091,2974,1148,3112
240500,201903,2162,5796,1897,5413,44,159,1630,4595,1674,4754
240510,201903,1661,4419,1490,4177,81,269,1231,3360,1312,3629
240520,201903,1303,3355,1067,3029,44,160,852,2375,896,2535
240530,201903,1986,6065,1839,5808,114,403,1463,4576,1577,4979
240540,201903,2224,5640,1950,5217,93,223,1641,4375,1734,4598
240550,201903,669,1893,614,1793,28,109,477,1339,505,1448
240560,201903,3261,8673,2790,8033,270,719,2054,5997,2324,6716
240570,201903,2861,7587,1926,5484,271,822,827,2162,1098,2984
240580,201903,7691,22697,6982,21420,555,1741,5593,17156,6148,18897
240590,201903,698,1865,610,1716,11,44,464,1284,475,1328
240600,201903,1767,4822,1295,3837,54,188,856,2441,910,2629
240610,201903,4289,11771,3617,10524,148,519,2729,7775,2877,8294
240615,201903,1103,3062,876,2608,63,235,596,1679,659,1914
240620,201903,1829,5202,1570,4740,90,269,1249,3741,1339,4010
240630,201903,2022,5863,1819,5510,129,320,1279,4010,1408,4330
240640,201903,901,2450,724,2155,32,132,530,1538,562,1670
240650,201903,3886,10849,3428,10033,205,624,2653,7707,2858,8331
240660,201903,2875,7640,2595,7269,54,201,2353,6519,2407,6720
240670,201903,2431,6863,2009,6006,140,435,1302,3805,1442,4240
240680,201903,1613,4367,1292,3806,61,215,952,2713,1013,2928
240690,201903,924,2386,737,2063,13,56,596,1609,609,1665
240700,201903,2340,6834,1951,6126,72,297,1519,4668,1591,4965
240710,201903,15937,41916,13483,37629,2235,6077,7746,21892,9981,27969
240720,201903,5081,13137,4421,12117,519,1534,3001,8055,3520,9589
240725,201903,1080,3124,838,2617,33,118,567,1721,600,1839
240730,201903,2065,5911,1764,5315,80,259,1363,4033,1443,4292
240740,201903,1840,4978,1530,4400,61,244,1126,3067,1187,3311
240750,201903,2226,7453,1869,6684,273,1084,1022,3662,1295,4746
240760,201903,1505,3710,1092,3078,51,121,848,2424,899,2545
240770,201903,3106,8770,2689,8160,159,626,2087,6179,2246,6805
240780,201903,5225,14364,4158,12582,532,1601,2519,7794,3051,9395
240790,201903,846,2441,713,2185,17,67,524,1571,541,1638
240800,201903,43406,109213,34732,95727,4981,14305,17093,47146,22074,61451
240810,201903,81298,218291,71153,201222,12221,34835,41393,116775,53614,151610
240820,201903,5628,17187,4864,15812,767,2554,2861,9437,3628,11991
240830,201903,8645,25375,7885,24170,317,1406,6381,19132,6698,20538
240840,201903,1140,2895,905,2492,51,131,625,1664,676,1795
240850,201903,1240,3471,906,2760,48,159,521,1552,569,1711
240860,201903,1226,3368,923,2804,19,90,687,1990,706,2080
240870,201903,1140,2886,889,2460,88,271,588,1583,676,1854
240880,201903,1275,4005,1157,3784,78,300,930,2983,1008,3283
240890,201903,4513,12420,3439,10346,514,1675,1712,4958,2226,6633
240895,201903,2684,8569,2435,8192,178,641,2032,6812,2210,7453
240910,201903,3169,8902,2747,8084,66,235,2232,6472,2298,6707
240920,201903,805,2370,698,2169,63,186,396,1275,459,1461
240930,201903,3662,8508,3057,7766,188,269,2384,6270,2572,6539
240933,201903,1776,4265,1461,3790,50,190,1251,3178,1301,3368
240940,201903,6149,15291,4893,13144,281,793,3523,9133,3804,9926
240950,201903,937,2858,820,2625,29,125,671,2105,700,2230
240960,201903,696,2134,620,1977,38,145,473,1459,511,1604
240970,201903,1840,4803,1509,4232,47,184,1257,3427,1304,3611
240980,201903,2934,9196,2675,8702,167,680,2049,6495,2216,7175
240990,201903,2543,7363,2326,6917,272,888,1661,4798,1933,5686
241000,201903,943,2519,760,2163,45,109,530,1514,575,1623
241010,201903,2779,8936,2549,8432,187,748,1864,6034,2051,6782
241020,201903,2028,5489,1500,4400,143,426,949,2705,1092,3131
241025,201903,1727,4976,1384,4309,64,257,952,2903,1016,3160
241030,201903,2465,7851,2032,6924,213,765,1330,4511,1543,5276
241040,201903,2255,7196,2020,6793,97,442,1613,5386,1710,5828
241050,201903,1259,3528,1032,3090,34,118,790,2312,824,2430
241060,201903,715,2036,642,1891,38,118,453,1290,491,1408
241070,201903,642,1781,566,1647,23,81,437,1217,460,1298
241080,201903,1122,3200,862,2680,10,39,646,1987,656,2026
241090,201903,2020,5871,1628,5209,57,281,1273,3996,1330,4277
241100,201903,1133,3220,898,2702,51,155,616,1802,667,1957
241105,201903,1028,3115,831,2731,265,872,263,908,528,1780
241110,201903,899,2614,681,2131,36,139,453,1352,489,1491
241120,201903,7440,21491,6398,19616,1080,3227,3550,11278,4630,14505
241140,201903,3213,8592,2613,7401,153,449,1918,5279,2071,5728
241142,201903,758,2063,558,1666,30,106,315,875,345,981
241150,201903,5749,15440,5131,14398,175,633,4165,11393,4340,12026
241160,201903,1319,3692,1109,3325,136,393,746,2224,882,2617
241170,201903,1298,3317,1128,3037,39,150,941,2410,980,2560
241180,201903,992,2592,718,2061,73,211,419,1172,492,1383
241190,201903,1079,2879,899,2518,26,95,656,1751,682,1846
241200,201903,18462,49270,16048,45616,2798,8115,8997,25674,11795,33789
241210,201903,1349,3763,1010,3082,108,359,600,1784,708,2143
241220,201903,8562,26022,7541,24238,1957,6254,3348,11298,5305,17552
241230,201903,2900,7829,2579,7313,113,397,2132,5910,2245,6307
241240,201903,1168,3345,709,2273,47,168,342,1096,389,1264
241250,201903,5266,15756,4408,14111,190,884,3264,10010,3454,10894
241255,201903,2000,6565,1760,6040,137,592,1267,4222,1404,4814
241260,201903,4812,12792,3786,11045,106,467,2951,8367,3057,8834
241270,201903,1782,5187,1481,4604,136,479,1022,3117,1158,3596
241280,201903,2117,5422,1833,4913,66,196,1542,4070,1608,4266
241290,201903,3402,8436,2608,7115,78,289,2023,5337,2101,5626
241300,201903,1442,3947,1158,3430,39,147,779,2236,818,2383
241310,201903,2007,5210,1718,4804,22,103,1452,4043,1474,4146
241320,201903,986,3218,823,2883,99,399,500,1743,599,2142
241330,201903,1771,4589,1389,4110,29,119,1179,3487,1208,3606
241335,201903,3053,8690,2759,8156,95,348,2317,6755,2412,7103
241340,201903,1648,4781,1288,4017,270,869,540,1653,810,2522
241350,201903,1978,5799,1757,5398,110,380,1327,4001,1437,4381
241355,201903,1290,3539,1073,3128,24,90,829,2379,853,2469
241360,201903,2064,5388,1596,4450,60,182,1138,3046,1198,3228
241370,201903,1346,3760,1061,3186,70,248,700,2002,770,2250
241380,201903,638,1788,501,1517,76,224,270,828,346,1052
241390,201903,2694,8146,2446,7745,198,616,1875,5964,2073,6580
241400,201903,3503,9825,3166,9331,185,609,2573,7510,2758,8119
241410,201903,2314,6973,1900,6141,347,1170,1007,3249,1354,4419
241415,201903,1626,4830,1339,4274,72,277,955,2958,1027,3235
241420,201903,2151,7125,1843,6551,466,1802,785,2769,1251,4571
241430,201903,564,1631,396,1227,26,89,242,725,268,814
241440,201903,7214,23102,6488,21785,433,1714,5049,16680,5482,18394
241445,201903,1074,2786,982,2672,24,68,895,2479,919,2547
241450,201903,2707,6841,2357,6283,270,646,1716,4610,1986,5256
241460,201903,3599,9932,3027,8716,173,563,2144,6000,2317,6563
241470,201903,1431,3765,1135,3327,31,122,924,2679,955,2801
241475,201903,1198,3427,942,2935,31,160,683,2016,714,2176
241480,201903,2760,8769,2338,7882,820,2714,668,2592,1488,5306
241490,201903,662,1620,530,1429,25,74,354,925,379,999
241500,201903,817,2341,705,2195,11,45,621,1943,632,1988
250010,201903,2598,7819,2175,6938,76,304,1582,4913,1658,5217
250020,201903,1591,4358,1140,3462,56,158,814,2440,870,2598
250030,201903,6746,18801,6074,17757,473,1450,4649,13366,5122,14816
250040,201903,4054,12618,3513,11603,234,940,2497,8074,2731,9014
250050,201903,3450,9535,3165,9124,142,509,2579,7331,2721,7840
250053,201903,1165,3383,1053,3202,79,263,768,2347,847,2610
250057,201903,642,2324,605,2267,3,18,549,2091,552,2109
250060,201903,5287,14272,4840,13713,404,1076,3805,10949,4209,12025
250070,201903,3938,11258,3460,10401,57,270,2751,8037,2808,8307
250073,201903,732,2002,603,1797,7,28,496,1421,503,1449
250077,201903,2198,5996,1648,5072,80,275,1194,3648,1274,3923
250080,201903,4494,11784,3990,11103,98,372,3432,9393,3530,9765
250090,201903,3039,7715,2687,7234,65,214,2307,6084,2372,6298
250100,201903,3699,11479,3425,10962,158,628,2753,8574,2911,9202
250110,201903,4798,13600,4362,12965,360,1302,3339,9646,3699,10948
250115,201903,538,1570,461,1444,12,69,342,1032,354,1101
250120,201903,1848,5413,1534,4893,44,198,1209,3819,1253,4017
250130,201903,5425,15300,4639,14143,86,480,3829,11439,3915,11919
250135,201903,1153,3166,1035,2983,15,61,933,2684,948,2745
250140,201903,2115,6478,2009,6326,119,553,1725,5297,1844,5850
250150,201903,4771,15178,4321,14362,174,796,3456,11237,3630,12033
250153,201903,1446,3749,1206,3393,27,95,984,2720,1011,2815
250157,201903,1709,5173,1533,4819,86,306,1192,3683,1278,3989
250160,201903,3854,9787,3119,8788,33,131,2798,7834,2831,7965
250170,201903,1758,4563,1578,4296,39,135,1359,3648,1398,3783
250180,201903,18327,46572,16078,43606,872,2710,12374,32849,13246,35559
250190,201903,4019,11050,3432,10121,395,1125,2288,6709,2683,7834
250200,201903,1850,5102,1586,4689,52,185,1351,3972,1403,4157
250205,201903,817,2620,711,2441,24,126,585,1979,609,2105
250210,201903,1571,4760,1425,4520,54,270,1126,3482,1180,3752
250215,201903,1562,4425,1291,3974,65,218,795,2429,860,2647
250220,201903,672,1920,550,1732,29,121,374,1115,403,1236
250230,201903,1606,3726,1170,3058,26,83,932,2352,958,2435
250240,201903,2204,6735,1975,6333,42,187,1677,5302,1719,5489
250250,201903,4506,12598,3922,11748,97,317,3303,9878,3400,10195
250260,201903,1726,4796,1442,4319,43,136,1149,3411,1192,3547
250270,201903,1205,3681,1085,3535,75,240,805,2728,880,2968
250280,201903,3245,9247,2826,8599,101,335,2235,6775,2336,7110
250290,201903,1600,4239,1364,3916,29,81,1093,3155,1122,3236
250300,201903,5433,14805,5012,14312,207,910,4161,11423,4368,12333
250310,201903,1165,3247,984,2939,41,130,751,2208,792,2338
250320,201903,10487,25334,9264,23857,375,1102,7965,20239,8340,21341
250330,201903,2302,6625,1952,6154,127,436,1552,4843,1679,5279
250340,201903,1105,2846,968,2659,7,23,861,2333,868,2356
250350,201903,4015,11237,3645,10664,147,385,2974,8929,3121,9314
250355,201903,1977,6059,1771,5777,32,181,1594,5157,1626,5338
250360,201903,1780,5035,1618,4793,43,156,1325,3895,1368,4051
250370,201903,12272,33010,10444,30257,369,1419,8564,24307,8933,25726
250375,201903,1145,2997,946,2748,9,25,875,2564,884,2589
250380,201903,1605,4223,1475,4051,40,163,1244,3292,1284,3455
250390,201903,1778,4633,1494,4169,132,361,1098,3058,1230,3419
250400,201903,69525,172370,50418,142909,13917,41559,15517,45987,29434,87546
250403,201903,1649,4773,1508,4591,87,425,1181,3422,1268,3847
250407,201903,1211,3104,1005,2806,64,143,737,2088,801,2231
250410,201903,595,1641,521,1518,4,19,434,1238,438,1257
250415,201903,1864,5321,1642,4957,48,191,1366,4091,1414,4282
250420,201903,1212,3480,1093,3320,14,64,1021,3094,1035,3158
250430,201903,6148,15396,5318,14240,160,498,4412,11602,4572,12100
250435,201903,1504,4231,1250,3798,26,111,950,2827,976,2938
250440,201903,4504,12082,3896,11330,80,286,3381,9795,3461,10081
250450,201903,1805,4909,1525,4524,34,129,1271,3754,1305,3883
250460,201903,7245,19754,6518,18720,361,1079,5322,15242,5683,16321
250470,201903,1548,4000,1284,3613,58,189,986,2699,1044,2888
250480,201903,4027,11022,3513,10406,19,89,3165,9476,3184,9565
250485,201903,720,1648,533,1388,34,73,385,969,419,1042
250490,201903,4845,12116,4364,11538,208,663,3754,9747,3962,10410
250500,201903,1928,5367,1716,5012,74,241,1398,4078,1472,4319
250510,201903,5403,13668,4686,12739,88,282,4119,11198,4207,11480
250520,201903,1763,4891,1535,4564,141,446,1074,3174,1215,3620
250523,201903,2201,5438,1982,5165,84,354,1660,4171,1744,4525
250527,201903,1664,4340,1517,4166,29,78,1342,3702,1371,3780
250530,201903,617,1667,533,1549,8,26,469,1356,477,1382
250535,201903,1332,3958,1224,3751,37,161,996,2963,1033,3124
250540,201903,2902,6819,2403,6251,66,156,2097,5515,2163,5671
250550,201903,784,2519,688,2336,17,75,537,1781,554,1856
250560,201903,1638,4605,1472,4372,47,177,1230,3561,1277,3738
250570,201903,2610,7865,2257,7225,84,338,1784,5586,1868,5924
250580,201903,1034,2711,949,2588,57,185,768,2070,825,2255
250590,201903,821,2332,729,2198,17,84,604,1812,621,1896
250600,201903,8195,21209,6882,19493,342,1001,5657,15977,5999,16978
250610,201903,2982,8369,2700,7966,110,434,2235,6484,2345,6918
250620,201903,698,1917,594,1722,12,54,458,1294,470,1348
250625,201903,2546,7420,2292,7016,50,260,1902,5649,1952,5909
250630,201903,9459,26946,7965,24205,884,2838,5221,15395,6105,18233
250640,201903,3298,9451,3040,9096,88,423,2566,7451,2654,7874
250650,201903,909,2249,759,2045,24,74,639,1673,663,1747
250660,201903,1599,4043,1374,3731,43,120,1146,3047,1189,3167
250670,201903,2321,7266,2151,6984,50,236,1861,5908,1911,6144
250680,201903,5871,13621,5214,12863,107,393,4698,11308,4805,11701
250690,201903,6692,15503,5860,14437,116,299,5225,12708,5341,13007
250700,201903,4304,12170,3782,11373,335,1006,2806,8366,3141,9372
250710,201903,4428,12802,3835,11991,290,1013,2808,8751,3098,9764
250720,201903,2743,7291,2484,6919,41,190,2197,6026,2238,6216
250730,201903,4027,10834,3546,10186,121,450,2946,8200,3067,8650
250740,201903,1948,4996,1598,4523,105,318,1241,3470,1346,3788
250750,201903,97583,250138,85120,232435,7762,23024,60662,162340,68424,185364
250760,201903,2352,6123,2048,5645,113,334,1579,4227,1692,4561
250770,201903,3845,11893,3498,11416,346,1165,2516,8215,2862,9380
250780,201903,1711,4695,1434,4177,86,295,1060,3006,1146,3301
250790,201903,2421,7308,2112,6854,228,878,1368,4344,1596,5222
250800,201903,2454,6553,2116,6020,89,204,1748,4996,1837,5200
250810,201903,1255,3400,1032,3074,26,73,880,2638,906,2711
250820,201903,1861,5529,1779,5432,50,219,1610,4880,1660,5099
250830,201903,5650,17067,4786,15349,327,1242,3304,10310,3631,11552
250840,201903,790,2516,671,2268,22,91,486,1646,508,1737
250850,201903,1823,5513,1646,5211,43,223,1359,4185,1402,4408
250855,201903,953,2792,826,2581,70,242,606,1871,676,2113
250860,201903,2955,9161,2504,8352,422,1483,1412,4719,1834,6202
250870,201903,1043,2865,889,2603,32,112,722,2087,754,2199
250880,201903,1547,4068,1271,3663,138,399,889,2567,1027,2966
250890,201903,9693,26651,8868,25489,465,1990,7135,19505,7600,21495
250900,201903,2762,7991,2381,7290,72,283,1989,5959,2061,6242
250905,201903,2298,6600,2110,6323,51,200,1881,5614,1932,5814
250910,201903,5804,14685,4804,13509,103,383,4054,11432,4157,11815
250915,201903,1941,4725,1454,4201,14,32,1320,3863,1334,3895
250920,201903,3440,8914,3026,8269,325,836,2179,5880,2504,6716
250930,201903,2142,5864,1958,5611,61,235,1681,4713,1742,4948
250933,201903,1122,3431,997,3200,25,136,752,2341,777,2477
250937,201903,714,1959,602,1769,28,100,436,1295,464,1395
250939,201903,1691,4671,1505,4391,59,208,1201,3442,1260,3650
250940,201903,3828,10459,3412,9883,60,256,2934,8416,2994,8672
250950,201903,1679,4291,1355,3885,24,104,1157,3282,1181,3386
250960,201903,1081,3211,954,3002,28,145,773,2337,801,2482
250970,201903,8250,21779,7159,20006,326,1069,5670,15515,5996,16584
250980,201903,2476,6667,2228,6270,48,189,1871,5128,1919,5317
250990,201903,1921,6060,1665,5570,82,366,1225,4037,1307,4403
251000,201903,2080,5838,1708,5229,34,142,1419,4306,1453,4448
251010,201903,2614,7424,2370,7037,31,133,2141,6332,2172,6465
251020,201903,1693,4537,1538,4323,34,137,1354,3736,1388,3873
251030,201903,986,2664,839,2395,30,86,594,1658,624,1744
251040,201903,1848,5362,1578,4898,50,235,1240,3797,1290,4032
251050,201903,1085,2972,899,2622,48,162,658,1855,706,2017
251060,201903,1033,2239,773,1915,11,48,638,1542,649,1590
251065,201903,439,1215,353,1075,12,34,257,755,269,789
251070,201903,740,2004,640,1868,8,29,544,1570,552,1599
251080,201903,18476,48197,15310,43481,1986,5957,9807,27858,11793,33815
251090,201903,2585,7566,2230,6925,51,197,1827,5629,1878,5826
251100,201903,811,2544,722,2388,26,104,553,1765,579,1869
251110,201903,1680,4605,1461,4206,51,148,1128,3215,1179,3363
251120,201903,6987,20416,5978,19095,256,1077,4707,14875,4963,15952
251130,201903,3849,8995,3454,8550,174,451,3012,7418,3186,7869
251140,201903,4171,11882,3797,11348,96,379,3141,9294,3237,9673
251150,201903,2665,7802,2397,7376,110,483,1916,5702,2026,6185
251160,201903,2039,6147,1801,5799,125,445,1440,4601,1565,5046
251170,201903,1526,4263,1375,4089,40,167,1208,3558,1248,3725
251180,201903,2532,7023,2124,6455,179,568,1421,4261,1600,4829
251190,201903,4324,11446,4034,11109,55,264,3673,9914,3728,10178
251200,201903,4065,12365,3712,11919,92,394,3223,10382,3315,10776
251203,201903,924,3044,874,2934,33,149,662,2162,695,2311
251207,201903,1056,2978,830,2584,19,90,587,1776,606,1866
251210,201903,7389,19366,6049,17630,269,730,4669,13741,4938,14471
251220,201903,1166,2891,903,2524,45,116,711,2003,756,2119
251230,201903,4587,12692,4011,11754,131,536,3212,9120,3343,9656
251240,201903,3593,9997,2997,9057,162,531,2244,6637,2406,7168
251250,201903,9804,26976,8745,25238,783,2398,6431,17977,7214,20375
251260,201903,470,1404,431,1330,14,72,329,978,343,1050
251270,201903,4075,12827,3692,12327,108,456,3110,10521,3218,10977
251272,201903,1326,3656,1211,3491,35,153,1042,2910,1077,3063
251274,201903,882,2504,729,2241,50,182,496,1452,546,1634
251275,201903,1225,3430,1052,3156,48,223,782,2227,830,2450
251276,201903,1329,3563,1167,3354,33,165,956,2652,989,2817
251278,201903,558,1595,498,1495,38,102,372,1125,410,1227
251280,201903,2216,6210,1989,5839,49,205,1645,4725,1694,4930
251290,201903,5697,14061,5287,13534,198,716,4549,11168,4747,11884
251300,201903,801,2428,745,2348,10,41,632,1982,642,2023
251310,201903,2792,8048,2442,7478,62,311,1931,5751,1993,6062
251315,201903,1674,5317,1544,5090,66,251,1177,3808,1243,4059
251320,201903,1646,4352,1142,3478,33,113,830,2510,863,2623
251330,201903,2020,4761,1668,4340,23,84,1541,4020,1564,4104
251335,201903,1005,3113,916,2983,29,119,777,2481,806,2600
251340,201903,3618,9019,2891,8024,126,396,2156,5882,2282,6278
251350,201903,1064,3156,950,2970,30,142,790,2400,820,2542
251360,201903,1812,5148,1498,4716,22,98,1296,4084,1318,4182
251365,201903,698,1996,561,1701,10,35,429,1296,439,1331
251370,201903,22028,61237,19691,57967,2344,7174,13095,38717,15439,45891
251380,201903,1180,3421,1051,3201,23,127,881,2569,904,2696
251385,201903,712,1864,561,1592,17,50,418,1137,435,1187
251390,201903,6256,18845,5490,17559,658,2260,3351,10617,4009,12877
251392,201903,955,2649,796,2398,25,125,623,1829,648,1954
251394,201903,592,1779,485,1583,25,102,362,1158,387,1260
251396,201903,698,1889,593,1718,23,63,407,1168,430,1231
251398,201903,915,2394,661,1930,17,75,497,1405,514,1480
251400,201903,1162,2967,951,2669,32,118,735,1987,767,2105
251410,201903,1552,3698,1298,3334,23,110,1115,2761,1138,2871
251420,201903,1898,5126,1564,4741,50,198,1219,3642,1269,3840
251430,201903,1542,4801,1377,4524,35,171,1195,3887,1230,4058
251440,201903,1109,3149,910,2769,31,100,717,2186,748,2286
251445,201903,1495,4311,1392,4159,54,230,1152,3312,1206,3542
251450,201903,4306,12994,3927,12426,94,401,3290,10307,3384,10708
251455,201903,906,2732,817,2573,27,100,623,1938,650,2038
251460,201903,890,2587,790,2425,29,110,644,1976,673,2086
251465,201903,437,1293,371,1153,7,33,282,860,289,893
251470,201903,1156,3239,864,2623,68,218,534,1558,602,1776
251480,201903,948,2540,795,2279,22,96,603,1663,625,1759
251490,201903,1876,5073,1497,4548,60,201,1088,3294,1148,3495
251500,201903,1883,5488,1740,5270,56,239,1513,4510,1569,4749
251510,201903,2632,8115,2211,7244,152,567,1460,4683,1612,5250
251520,201903,935,2479,712,2050,71,188,473,1345,544,1533
251530,201903,14066,34376,11651,31349,129,715,10279,27078,10408,27793
251540,201903,2788,8331,2567,7919,112,445,2058,6200,2170,6645
251550,201903,3668,8872,2931,7933,87,245,2463,6653,2550,6898
251560,201903,576,1735,512,1635,79,266,333,1011,412,1277
251570,201903,890,2582,739,2274,19,94,566,1675,585,1769
251580,201903,1902,4602,1695,4302,72,229,1446,3547,1518,3776
251590,201903,1590,4119,1360,3848,61,202,1087,2962,1148,3164
251593,201903,894,2697,836,2599,93,310,534,1609,627,1919
251597,201903,2084,5849,1903,5606,29,120,1662,4813,1691,4933
251600,201903,6318,17332,5619,16261,171,553,4708,13411,4879,13964
251610,201903,3263,9338,2803,8496,302,884,1905,5832,2207,6716
251615,201903,1222,3088,987,2705,20,70,783,2083,803,2153
251620,201903,17948,42414,14295,38035,222,736,11941,32251,12163,32987
251630,201903,4674,11193,3777,9958,201,590,2921,7593,3122,8183
251640,201903,2070,5929,1880,5585,45,216,1607,4649,1652,4865
251650,201903,4069,10813,3570,10196,138,476,3067,8704,3205,9180
251660,201903,3427,10297,3006,9548,88,426,2486,7714,2574,8140
251670,201903,4097,11637,3607,10967,52,268,3203,9634,3255,9902
251675,201903,648,1904,586,1826,79,272,390,1204,469,1476
251680,201903,2574,6957,2142,6373,48,175,1713,5080,1761,5255
251690,201903,3193,9085,2716,8220,84,268,2035,6044,2119,6312
251700,201903,1894,5748,1716,5517,51,242,1451,4554,1502,4796
251710,201903,791,2088,544,1564,51,180,307,860,358,1040
251720,201903,1336,3793,1104,3381,30,131,836,2468,866,2599
251740,201903,632,1781,507,1543,35,137,362,1052,397,1189
260005,201903,29327,62503,24010,55707,1812,4330,18154,41202,19966,45532
260010,201903,9893,26143,8155,23458,500,1537,4936,14335,5436,15872
260020,201903,6809,16211,5795,14737,133,582,4813,11990,4946,12572
260030,201903,6392,16971,5450,15531,198,700,4339,12235,4537,12935
260040,201903,7794,21233,6452,19121,560,1667,4276,12891,4836,14558
260050,201903,13163,35252,11405,33279,266,898,10175,29977,10441,30875
260060,201903,3921,10120,3375,9229,201,541,2641,7188,2842,7729
260070,201903,10315,26636,8864,24492,493,1658,6849,18490,7342,20148
260080,201903,6505,15091,5657,13900,147,478,4682,11214,4829,11692
260090,201903,4896,12710,4384,12036,665,1804,2935,8150,3600,9954
260100,201903,3127,8447,2619,7683,85,343,2109,6070,2194,6413
260105,201903,5144,13877,4571,13069,157,581,3753,10529,3910,11110
260110,201903,22485,61019,20182,57768,1136,3684,16510,46494,17646,50178
260120,201903,14165,38836,11935,35403,1570,4704,7344,22172,8914,26876
260130,201903,2972,7935,2675,7470,213,649,1980,5397,2193,6046
260140,201903,13230,30453,11328,28094,608,1696,9368,22896,9976,24592
260150,201903,3534,8453,3023,7824,131,426,2556,6493,2687,6919
260160,201903,6601,17478,5592,16188,118,487,4890,14237,5008,14724
260170,201903,18372,46023,15752,42314,1486,3883,11737,31431,13223,35314
260180,201903,3290,9186,2907,8667,106,378,2429,7114,2535,7492
260190,201903,18497,37898,15556,34447,188,536,13639,29541,13827,30077
260200,201903,11003,26900,9566,25086,463,1165,8091,21258,8554,22423
260210,201903,11851,33983,10058,31051,359,1456,8000,24457,8359,25913
260220,201903,10268,25238,9495,24260,195,663,8298,20839,8493,21502
260230,201903,10448,26447,9116,24606,243,759,7544,20041,7787,20800
260240,201903,2745,8234,2403,7622,169,586,1819,5730,1988,6316
260250,201903,2189,5858,1896,5430,113,314,1436,4079,1549,4393
260260,201903,12814,33890,11254,31458,488,1693,8796,24085,9284,25778
260270,201903,3924,10075,3443,9458,150,632,2760,7350,2910,7982
260280,201903,12926,39413,11625,37587,551,2333,9778,31195,10329,33528
260290,201903,38576,101741,33579,94209,4036,11694,21907,60860,25943,72554
260300,201903,9610,26086,8351,24306,253,1098,6889,19844,7142,20942
260310,201903,4713,12561,4225,11912,325,893,3257,9289,3582,10182
260320,201903,7359,21649,6492,20158,276,861,5294,16482,5570,17343
260330,201903,2520,7777,2244,7203,67,249,1825,5732,1892,5981
260340,201903,2037,5494,1762,5070,39,191,1467,4085,1506,4276
260345,201903,24393,65700,20671,60129,3497,10981,10223,29017,13720,39998
260350,201903,5121,12608,4541,11894,103,315,3991,10365,4094,10680
260360,201903,2495,6592,2266,6180,48,214,1571,4202,1619,4416
260370,201903,5471,15909,4718,14611,232,835,3603,11061,3835,11896
260380,201903,4884,14752,4200,13615,192,716,3108,9911,3300,10627
260390,201903,4297,13094,3652,11809,230,800,2495,7911,2725,8711
260392,201903,3455,11010,3069,10518,138,804,2435,8295,2573,9099
260400,201903,16385,39731,14342,37025,639,1943,11142,27693,11781,29636
260410,201903,68789,171181,53536,149666,10375,30560,23882,68428,34257,98988
260415,201903,4312,12031,3682,10906,94,413,2870,8258,2964,8671
260420,201903,12848,27173,10879,24960,175,494,9817,22251,9992,22745
260430,201903,2813,8725,2413,7963,137,526,1661,5437,1798,5963
260440,201903,3630,9804,3175,9029,109,395,2543,7044,2652,7439
260450,201903,5618,14451,5091,13796,291,683,4181,11501,4472,12184
260460,201903,5149,15811,4455,14491,516,1899,2607,8262,3123,10161
260470,201903,4979,13065,4231,12197,118,282,3780,11095,3898,11377
260480,201903,4068,10878,3407,9942,265,966,2305,6729,2570,7695
260490,201903,5267,12408,4640,11440,68,270,4127,9923,4195,10193
260500,201903,6069,15629,5171,14312,481,1262,3563,9992,4044,11254
260510,201903,9484,23561,7999,21490,167,605,6983,18478,7150,19083
260515,201903,4283,12019,3327,10149,158,517,2185,6515,2343,7032
260520,201903,17476,41165,15426,38464,967,2504,12338,30337,13305,32841
260530,201903,9663,28023,8323,25910,192,898,7032,21583,7224,22481
260540,201903,7075,15605,6286,14592,381,821,5357,12420,5738,13241
260545,201903,42,136,17,79,3,11,4,18,7,29
260550,201903,2907,8391,2419,7505,151,644,1569,4731,1720,5375
260560,201903,5962,15384,5108,14157,145,620,4270,11510,4415,12130
260570,201903,7520,21132,6672,19939,464,1495,5154,15373,5618,16868
260580,201903,4403,10630,3921,9971,32,138,3564,8995,3596,9133
260590,201903,6715,15875,5660,14671,253,658,4652,12170,4905,12828
260600,201903,30131,79867,24743,71427,1398,4459,18258,51905,19656,56364
260610,201903,7021,18897,6392,18044,417,1321,4755,13263,5172,14584
260620,201903,15439,41967,13681,39360,1548,4870,9322,26323,10870,31193
260630,201903,2334,6407,1935,5757,42,183,1556,4529,1598,4712
260640,201903,20511,48171,17529,44678,925,2516,13879,35015,14804,37531
260650,201903,5712,15811,4741,14511,176,748,3977,12038,4153,12786
260660,201903,7260,19336,6237,17958,178,761,5239,14739,5417,15500
260670,201903,2195,5759,1807,5179,87,228,1345,3823,1432,4051
260680,201903,25855,63685,21779,57611,1917,5407,14376,37252,16293,42659
260690,201903,3638,9393,2963,8373,117,419,2355,6559,2472,6978
260700,201903,5974,17450,5674,17108,19,55,5501,16730,5520,16785
260710,201903,1328,3539,1196,3376,45,158,901,2541,946,2699
260720,201903,21448,57280,18890,53574,2598,7608,12173,34147,14771,41755
260730,201903,7268,21696,6461,20511,328,1242,5298,16534,5626,17776
260740,201903,1334,3747,1114,3391,16,85,884,2706,900,2791
260750,201903,6847,19343,5914,18105,131,450,5252,16289,5383,16739
260760,201903,5568,13437,4830,12518,227,658,3880,10083,4107,10741
260765,201903,7680,22967,6755,21644,547,2308,4601,14289,5148,16597
260770,201903,3799,9895,3253,8965,88,302,2597,7056,2685,7358
260775,201903,5223,14153,4661,13286,244,914,3532,9717,3776,10631
260780,201903,3635,10986,3244,10334,323,1212,2043,6306,2366,7518
260790,201903,115090,264021,96325,238988,15298,37221,58500,144837,73798,182058
260795,201903,3028,8098,2621,7529,127,426,1971,5658,2098,6084
260800,201903,5401,12628,4885,11912,171,528,4259,10036,4430,10564
260805,201903,3567,10407,3005,9406,182,686,2165,6638,2347,7324
260810,201903,6579,18029,5844,16617,579,1643,4136,11514,4715,13157
260820,201903,4397,10599,3871,9905,163,573,3139,7803,3302,8376
260825,201903,2877,8749,2487,8044,126,472,1839,5895,1965,6367
260830,201903,4300,12604,3573,11277,473,1365,2284,7398,2757,8763
260840,201903,4082,10961,3634,10300,195,557,3015,8531,3210,9088
260845,201903,4132,11218,3721,10485,264,741,2748,7667,3012,8408
260850,201903,4815,13878,4120,12516,401,1312,2580,7600,2981,8912
260860,201903,3437,9847,2943,8976,89,334,2378,7091,2467,7425
260870,201903,4465,10810,3857,10049,99,399,3403,8662,3502,9061
260875,201903,6697,17358,5600,15676,647,1826,3716,10398,4363,12224
260880,201903,9701,27432,8461,25240,457,1357,6698,20046,7155,21403
260890,201903,13226,34788,11688,32496,858,2653,8317,22588,9175,25241
260900,201903,5213,15141,4373,13830,328,1208,2909,9063,3237,10271
260910,201903,3154,8715,2745,8074,109,366,2145,6242,2254,6608
260915,201903,5145,15157,4535,14436,59,287,4098,13077,4157,13364
260920,201903,3305,8594,2842,8053,105,331,2413,6832,2518,7163
260930,201903,3492,11344,3096,10639,173,736,2343,7908,2516,8644
260940,201903,14555,35498,12672,32761,866,2448,9479,23969,10345,26417
260950,201903,6492,18059,5257,15781,484,1682,3101,8854,3585,10536
260960,201903,65269,152140,52788,135419,6871,18534,31719,80064,38590,98598
260970,201903,5228,14156,4679,13423,164,449,3631,10440,3795,10889
260980,201903,4427,13179,3999,12628,68,279,3616,11472,3684,11751
260990,201903,17725,50155,15107,46632,866,3147,11632,35484,12498,38631
261000,201903,16076,39022,13580,35654,507,1881,10612,27152,11119,29033
261010,201903,2446,6390,2136,5976,76,209,1856,5176,1932,5385
261020,201903,6074,16821,5225,15291,258,925,4146,11676,4404,12601
261030,201903,4076,11584,3532,10677,164,578,2788,8226,2952,8804
261040,201903,5180,15441,4231,13551,205,811,3072,9653,3277,10464
261050,201903,7649,20510,6912,19280,577,1373,4887,13745,5464,15118
261060,201903,13633,35138,12010,33046,439,1433,9774,26593,10213,28026
261070,201903,59569,132724,49524,119270,3260,7723,36699,86904,39959,94627
261080,201903,6231,15752,5744,15101,174,465,5222,13718,5396,14183
261090,201903,18158,44568,16224,42059,392,1352,13875,35354,14267,36706
261100,201903,8091,23175,7057,21621,586,1961,5086,15580,5672,17541
261110,201903,59780,171207,50605,155384,9303,30033,26657,81998,35960,112031
261120,201903,3814,9512,3262,8776,87,267,2823,7572,2910,7839
261130,201903,7475,18163,6610,17054,123,397,5845,14956,5968,15353
261140,201903,3505,8318,3134,7820,193,553,2514,6129,2707,6682
261150,201903,5238,14054,4632,13112,100,405,3960,11025,4060,11430
261153,201903,1929,5711,1660,5243,74,296,1140,3579,1214,3875
261160,201903,205753,489878,169470,439326,42704,113846,67979,179514,110683,293360
261170,201903,5864,15057,5248,14133,364,956,4118,11021,4482,11977
261180,201903,9774,25040,8629,23536,522,1572,6183,16725,6705,18297
261190,201903,4681,14022,4207,13204,267,1085,3117,9470,3384,10555
261200,201903,3363,7823,2992,7332,152,381,2480,5969,2632,6350
261210,201903,1933,4709,1640,4305,69,213,1372,3549,1441,3762
261220,201903,13682,39588,11388,35164,1494,4992,6377,19399,7871,24391
261230,201903,4245,12169,3529,11183,74,316,2900,9258,2974,9574
261240,201903,5095,13256,4495,12315,266,759,3654,9917,3920,10676
261245,201903,3521,10116,3008,9224,100,468,2360,6963,2460,7431
261247,201903,2943,8861,2469,7994,147,552,1701,5445,1848,5997
261250,201903,20903,48889,18066,45548,1938,4570,13307,34350,15245,38920
261255,201903,3991,11939,3375,10741,153,684,2484,7609,2637,8293
261260,201903,12967,34868,11161,32561,417,1704,9330,26825,9747,28529
261270,201903,3986,10520,3539,9918,209,735,2887,7880,3096,8615
261280,201903,2555,7267,2260,6748,86,351,1759,5106,1845,5457
261290,201903,2949,7812,2510,7290,90,363,2020,5878,2110,6241
261300,201903,11798,33868,10054,30833,603,2304,7198,21559,7801,23863
261310,201903,8450,22245,7228,20488,808,2512,5003,13827,5811,16339
261320,201903,5960,16961,5199,15646,88,404,4330,12780,4418,13184
261330,201903,5992,14955,5435,14206,161,567,4707,12065,4868,12632
261340,201903,4161,12234,3624,11493,193,795,2831,8853,3024,9648
261350,201903,8633,25512,7721,23968,137,684,6249,18970,6386,19654
261360,201903,8298,20440,7029,18640,257,804,5561,14274,5818,15078
261370,201903,21485,55718,18262,51243,2532,7154,11226,31686,13758,38840
261380,201903,3961,12329,3559,11604,468,1688,2332,7468,2800,9156
261390,201903,15869,46213,13540,42408,1267,4357,8772,27296,10039,31653
261400,201903,4596,14823,3996,13576,174,822,2957,9748,3131,10570
261410,201903,9408,24231,7856,21752,534,1499,6103,16662,6637,18161
261420,201903,7177,22370,6551,21572,874,3300,4431,14473,5305,17773
261430,201903,3434,9750,2866,8876,81,328,2353,7169,2434,7497
261440,201903,1445,4383,1239,3985,42,196,867,2693,909,2889
261450,201903,14881,40536,13312,38018,262,1064,11035,31215,11297,32279
261460,201903,7366,20417,6579,19256,210,760,5502,15984,5712,16744
261470,201903,4232,10592,3742,9961,43,204,3163,8400,3206,8604
261480,201903,4840,15184,4213,14123,238,982,3194,10489,3432,11471
261485,201903,4974,14290,4278,13179,411,1441,2908,8766,3319,10207
261500,201903,5569,14812,4920,13907,471,1185,3345,9843,3816,11028
261510,201903,1829,5567,1586,5134,67,251,1166,3824,1233,4075
261520,201903,2386,7347,2198,6968,99,365,1524,4840,1623,5205
261530,201903,11197,33954,9254,30219,1206,4562,4355,13863,5561,18425
261540,201903,7772,22786,7001,21596,1096,3294,3993,12822,5089,16116
261550,201903,3591,9659,3148,8948,229,757,2236,6194,2465,6951
261560,201903,7659,23140,6677,21660,378,1464,4928,15939,5306,17403
261570,201903,3441,9418,2796,8367,213,773,1918,5601,2131,6374
261580,201903,6617,17597,5842,16563,127,584,5219,14580,5346,15164
261590,201903,2709,7021,2153,6210,83,262,1587,4534,1670,4796
261600,201903,5128,13251,4295,11991,442,1129,2830,8187,3272,9316
261610,201903,2370,6515,1967,5858,106,396,1426,4199,1532,4595
261618,201903,2571,6540,2251,6079,78,231,1782,4745,1860,4976
261620,201903,3996,11664,3707,11232,852,2343,2241,7158,3093,9501
261630,201903,6458,18193,5520,16453,430,1599,3604,10181,4034,11780
261640,201903,36545,83558,31572,77322,1734,3612,24358,60917,26092,64529
261650,201903,4123,10411,3608,9755,149,537,2683,7158,2832,7695
270010,201903,4265,14694,3758,13790,179,1000,2899,10337,3078,11337
270020,201903,3862,9909,3416,9321,195,618,2825,7546,3020,8164
270030,201903,33631,93455,28993,86088,4241,12423,18711,55966,22952,68389
270040,201903,11245,30386,9700,28533,446,1779,7900,22922,8346,24701
270050,201903,5493,12715,4666,11789,187,468,4113,10424,4300,10892
270060,201903,2029,5313,1735,4962,130,348,1371,3959,1501,4307
270070,201903,4595,13174,4035,12377,149,622,3380,10155,3529,10777
270080,201903,1432,3981,1179,3547,49,164,885,2548,934,2712
270090,201903,1878,5778,1662,5355,72,330,1316,4095,1388,4425
270100,201903,5561,15214,4856,14156,236,937,3884,10996,4120,11933
270110,201903,3282,7987,2619,7202,127,330,2063,5883,2190,6213
270120,201903,2987,8080,2594,7575,77,310,2231,6446,2308,6756
270130,201903,5204,13798,4540,13019,189,617,3800,10936,3989,11553
270135,201903,2025,4938,1718,4585,54,173,1538,4073,1592,4246
270140,201903,9750,22734,8013,20358,369,1367,6464,15523,6833,16890
270150,201903,2724,8174,2542,7913,8,36,2435,7567,2443,7603
270160,201903,5690,16226,5001,15398,77,459,4580,13914,4657,14373
270170,201903,3495,10280,2980,9571,237,1044,2174,6699,2411,7743
270180,201903,2245,6955,2044,6687,47,228,1800,5797,1847,6025
270190,201903,1660,4995,1494,4782,55,261,1283,4043,1338,4304
270200,201903,2451,7432,2101,6955,127,499,1540,4995,1667,5494
270210,201903,5616,13651,4885,12824,143,510,4410,11405,4553,11915
270220,201903,1449,3978,1185,3598,231,727,649,1967,880,2694
270230,201903,9212,26496,7698,24115,747,2717,5236,16082,5983,18799
270235,201903,5909,18332,5147,17078,174,767,4137,13576,4311,14343
270240,201903,10500,28846,8591,26407,977,3321,6119,18731,7096,22052
270250,201903,2850,7370,2514,6908,226,594,1920,5313,2146,5907
270255,201903,4634,13328,3545,11311,161,650,2569,8018,2730,8668
270260,201903,5621,16810,5128,16003,119,594,4408,13360,4527,13954
270270,201903,1052,2790,902,2592,121,343,625,1787,746,2130
270280,201903,3893,9480,3106,8481,474,845,2148,6283,2622,7128
270290,201903,7742,24733,6970,23446,261,1169,5881,19538,6142,20707
270300,201903,4110,11100,3244,10147,189,600,2447,7789,2636,8389
270310,201903,7121,20003,6139,18558,151,784,5185,15223,5336,16007
270320,201903,5642,16556,4942,15245,560,1795,3422,10290,3982,12085
270330,201903,3828,12745,3437,12132,263,1118,2647,9246,2910,10364
270340,201903,1635,4585,1396,4264,65,206,1134,3438,1199,3644
270350,201903,1851,4544,1545,4174,183,542,1051,2872,1234,3414
270360,201903,2441,6390,2189,6101,72,201,1984,5543,2056,5744
270370,201903,1409,4393,1274,4134,47,207,1021,3262,1068,3469
270375,201903,3078,7345,2624,6816,20,65,2446,6348,2466,6413
270380,201903,5565,16340,4741,15222,446,1469,3294,10858,3740,12327
270390,201903,1211,3106,986,2830,27,140,805,2270,832,2410
270400,201903,6181,16778,5252,15322,236,770,4063,11602,4299,12372
270410,201903,4561,13508,3970,12527,199,742,3199,9971,3398,10713
270420,201903,5525,16604,5030,15886,180,804,4235,13090,4415,13894
270430,201903,137665,339914,110242,304561,22907,66105,50549,141892,73456,207997
270440,201903,4804,13165,4123,12317,105,485,3491,10276,3596,10761
270450,201903,6766,18754,6061,17899,279,1054,5042,14767,5321,15821
270460,201903,3766,8456,3283,7896,81,239,3024,7170,3105,7409
270470,201903,10939,31473,9612,29522,889,2909,7033,21671,7922,24580
270480,201903,2826,7767,2443,7193,143,557,1938,5507,2081,6064
270490,201903,966,2767,852,2626,49,182,671,2030,720,2212
270500,201903,4854,15115,4370,14393,232,961,3494,11338,3726,12299
270510,201903,5607,15447,4817,14370,419,1608,3505,9977,3924,11585
270520,201903,3936,11508,3140,10117,708,2348,1199,4057,1907,6405
270530,201903,1200,3573,1048,3325,61,187,766,2455,827,2642
270540,201903,2149,6415,1890,6076,64,312,1631,5131,1695,5443
270550,201903,6697,17843,5503,16516,543,1428,4162,12922,4705,14350
270560,201903,3078,8316,2720,7824,168,522,2115,5985,2283,6507
270570,201903,4038,11498,3448,10580,102,417,2829,8537,2931,8954
270580,201903,2294,6555,2087,6253,103,321,1786,5312,1889,5633
270590,201903,1621,4805,1491,4632,16,81,1408,4346,1424,4427
270600,201903,2757,8623,2487,8191,65,332,2173,7035,2238,7367
270610,201903,3703,9756,3153,9034,91,350,2787,7884,2878,8234
270620,201903,1233,3846,1136,3670,54,236,951,2973,1005,3209
270630,201903,16342,42053,14306,39169,754,2504,11710,31429,12464,33933
270640,201903,5445,15775,4743,14688,195,810,3794,11398,3989,12208
270642,201903,2447,7980,2185,7555,148,717,1674,5571,1822,6288
270644,201903,3521,8877,2892,8062,251,683,2176,6166,2427,6849
270650,201903,3180,9523,2836,9015,436,1567,1890,5802,2326,7369
270660,201903,2114,5272,1714,4709,75,296,1296,3473,1371,3769
270670,201903,15838,38275,13388,35302,571,1786,11113,28764,11684,30550
270680,201903,5260,13211,4719,12603,139,217,4380,11876,4519,12093
270690,201903,9085,22906,7579,21034,995,2584,5374,15065,6369,17649
270700,201903,548,1648,478,1526,29,123,350,1104,379,1227
270710,201903,5658,17136,5146,16388,268,1177,4220,13100,4488,14277
270720,201903,3394,10321,3014,9682,74,434,2631,8239,2705,8673
270730,201903,7931,18369,7094,17440,302,745,5673,15043,5975,15788
270740,201903,2351,6277,2091,5958,105,369,1716,4782,1821,5151
270750,201903,5474,14957,4830,14103,156,639,4129,11944,4285,12583
270760,201903,3358,9518,2920,8914,64,324,2462,7404,2526,7728
270770,201903,21453,52438,16849,46809,3102,7953,9583,28391,12685,36344
270780,201903,1771,5198,1657,5039,90,317,1376,4124,1466,4441
270790,201903,1541,4516,1322,4191,111,368,867,2728,978,3096
270800,201903,10690,29827,9595,28294,388,1577,8155,23429,8543,25006
270810,201903,3246,9412,2559,8227,188,788,1759,5513,1947,6301
270820,201903,1681,5085,1418,4646,68,292,1107,3530,1175,3822
270830,201903,5319,13004,4346,11798,196,682,3455,9259,3651,9941
270840,201903,8203,24448,7370,23280,198,1066,6423,19728,6621,20794
270850,201903,8837,21816,7959,20719,560,1762,6629,16805,7189,18567
270860,201903,12359,29815,10203,27238,465,1526,8344,21791,8809,23317
270870,201903,2069,6016,1779,5515,220,725,1219,3804,1439,4529
270880,201903,8138,24498,7301,23264,260,1120,5984,18705,6244,19825
270890,201903,2645,7344,2299,6871,187,642,1615,4741,1802,5383
270895,201903,2896,9423,2686,9142,84,467,2360,7842,2444,8309
270900,201903,1788,4683,1362,4012,47,164,1069,3099,1116,3263
270910,201903,3830,11325,3293,10421,122,490,2575,8016,2697,8506
270915,201903,9122,27274,7522,24527,782,3009,4958,15738,5740,18747
270920,201903,5355,16777,4889,15990,235,1093,3955,12472,4190,13565
270930,201903,17240,41204,13583,36877,1888,4669,9247,25978,11135,30647
270940,201903,6162,17328,5406,16384,266,1249,4228,12368,4494,13617
280010,201903,696,1915,565,1640,21,87,388,1014,409,1101
280020,201903,4699,12347,4041,11309,544,1435,2657,7513,3201,8948
280030,201903,72633,174499,57195,152682,13701,36940,23465,65368,37166,102308
280040,201903,3052,8615,2663,8031,292,940,1764,5243,2056,6183
280050,201903,3901,11236,3364,10345,542,1761,1995,6093,2537,7854
280060,201903,5370,14667,4340,13090,771,2435,2163,6737,2934,9172
280067,201903,6966,17705,5884,16047,379,1115,4204,11182,4583,12297
280070,201903,1909,5810,1791,5608,80,292,1499,4618,1579,4910
280100,201903,3810,10562,3227,9605,340,1061,2231,6611,2571,7672
280110,201903,1350,3744,1189,3492,21,105,1021,2924,1042,3029
280120,201903,7533,22260,6804,21065,716,2060,5062,15929,5778,17989
280130,201903,8889,21602,7799,20022,566,1540,6037,15425,6603,16965
280140,201903,5524,13551,4873,12671,246,706,4070,10473,4316,11179
280150,201903,3896,10109,3429,9490,208,592,2788,7648,2996,8240
280160,201903,1228,3593,1016,3227,128,429,630,1955,758,2384
280170,201903,5184,13776,4606,12997,252,733,3679,10328,3931,11061
280190,201903,1193,2747,1028,2518,56,157,817,1947,873,2104
280200,201903,1336,3524,1082,3117,108,386,735,2052,843,2438
280210,201903,15675,40697,13691,37871,1821,5352,8348,23036,10169,28388
280220,201903,1727,4687,1497,4385,38,205,1220,3533,1258,3738
280230,201903,3848,9998,3408,9353,261,671,2479,6761,2740,7432
280240,201903,3418,9148,3068,8624,66,327,2587,7052,2653,7379
280250,201903,805,2075,660,1847,80,245,389,1044,469,1289
280260,201903,2137,5241,1920,4972,41,111,1766,4581,1807,4692
280270,201903,2296,6558,2038,6154,129,475,1689,4963,1818,5438
280280,201903,4005,12472,3594,11887,475,1456,2472,8504,2947,9960
280290,201903,17155,46857,14959,43662,1525,4831,9971,29229,11496,34060
280300,201903,11126,28110,9648,26493,273,927,7567,21940,7840,22867
280310,201903,1325,3518,1106,3151,31,116,823,2263,854,2379
280320,201903,8561,23767,7422,22003,885,2676,4837,14162,5722,16838
280330,201903,4789,11979,4037,10881,264,747,3001,7988,3265,8735
280340,201903,5510,11447,4689,10552,244,454,4040,9202,4284,9656
280350,201903,24500,59610,21347,55264,1398,3885,16201,41276,17599,45161
280360,201903,5835,16649,5119,15414,878,2683,2848,8613,3726,11296
280370,201903,2212,5451,1816,4747,70,193,1439,3680,1509,3873
280380,201903,967,2727,841,2553,99,332,532,1599,631,1931
280390,201903,3538,9065,2923,8050,135,408,2280,6179,2415,6587
280400,201903,3939,10329,3393,9517,482,1274,2100,6088,2582,7362
280410,201903,2120,6081,1712,5362,183,619,1028,3140,1211,3759
280420,201903,4324,11689,3929,11159,96,352,3527,9953,3623,10305
280430,201903,2041,5109,1785,4755,82,314,1417,3652,1499,3966
280440,201903,4377,11913,3821,11062,211,719,3096,8724,3307,9443
280445,201903,2312,5928,2040,5441,61,200,1522,3868,1583,4068
280450,201903,10337,23766,9098,22129,404,796,7581,18555,7985,19351
280460,201903,6727,16423,6095,15525,476,1132,4949,12551,5425,13683
280470,201903,1754,5002,1506,4550,65,247,1104,3250,1169,3497
280480,201903,39373,98289,34528,91536,2904,8414,24752,64337,27656,72751
280490,201903,3772,10838,3246,9960,91,415,2464,7299,2555,7714
280500,201903,966,2358,822,2159,41,138,675,1751,716,1889
280510,201903,2562,6755,2210,6242,95,374,1669,4605,1764,4979
280520,201903,1628,4168,1427,3898,77,215,1142,3083,1219,3298
280530,201903,2681,6565,2304,6092,316,730,1617,4372,1933,5102
280540,201903,8968,24276,8172,23114,238,923,7112,19708,7350,20631
280550,201903,6722,15911,5458,14096,255,838,4323,10781,4578,11619
280560,201903,7070,20168,6630,19513,157,596,5761,16712,5918,17308
280570,201903,6384,16040,5171,14468,231,861,3782,10419,4013,11280
280580,201903,5477,15137,4716,13944,562,1558,3242,9724,3804,11282
280590,201903,2993,6999,2517,6423,138,544,1888,4540,2026,5084
280600,201903,3420,9437,3039,8865,185,615,2172,6305,2357,6920
280610,201903,2532,6344,2290,6003,169,425,1832,4763,2001,5188
280620,201903,5378,13664,4580,12568,428,1025,3247,9205,3675,10230
280630,201903,3777,10983,3428,10469,177,662,2752,8338,2929,9000
280640,201903,2451,6635,2203,6359,63,185,1961,5676,2024,5861
280650,201903,1245,3253,976,2849,88,286,686,1938,774,2224
280660,201903,3203,7534,2824,7083,93,257,2484,6166,2577,6423
280670,201903,19458,44546,16905,41261,1036,2728,13289,32173,14325,34901
280680,201903,2744,6794,2349,6200,197,425,1687,4452,1884,4877
280690,201903,951,2434,794,2211,33,103,592,1598,625,1701
280700,201903,1110,2864,954,2623,22,93,746,2008,768,2101
280710,201903,15101,34110,12850,31534,488,975,11065,27582,11553,28557
280720,201903,2681,6076,2161,5468,109,333,1457,3831,1566,4164
280730,201903,1068,2747,950,2550,61,194,715,1861,776,2055
280740,201903,14113,34936,12033,31757,980,2713,8340,21575,9320,24288
280750,201903,3527,10087,3106,9341,181,646,2226,6569,2407,7215
280760,201903,6160,17132,5443,16001,575,1664,3645,10954,4220,12618
290010,201903,3130,6664,2108,5054,9,31,1726,3947,1735,3978
290020,201903,5412,14495,4959,13883,382,788,4135,11900,4517,12688
290030,201903,4256,10371,3555,9575,178,462,2964,8027,3142,8489
290035,201903,5226,11589,4210,10270,330,563,3326,8454,3656,9017
290040,201903,4285,10506,3635,9714,139,398,2834,7833,2973,8231
290050,201903,2102,6728,1746,5970,132,553,1177,3916,1309,4469
290060,201903,1300,3203,966,2644,86,305,648,1692,734,1997
290070,201903,35005,80059,30174,73897,2149,5510,22223,53952,24372,59462
290080,201903,5380,16060,4573,14846,507,1754,3104,10173,3611,11927
290090,201903,2200,4238,1583,3576,32,83,1422,3172,1454,3255
290100,201903,9829,26327,8114,23727,1100,3047,4756,14312,5856,17359
290110,201903,5103,13863,4594,12968,416,1204,3236,9055,3652,10259
290115,201903,4192,12262,3560,11186,233,821,2660,8270,2893,9091
290120,201903,6671,16505,5529,15058,138,498,4762,12727,4900,13225
290130,201903,4580,11298,3649,10135,131,475,2909,7969,3040,8444
290135,201903,4323,10273,3514,8956,228,602,2641,6534,2869,7136
290140,201903,4660,12505,3707,11234,117,452,3138,9416,3255,9868
290150,201903,2452,6584,2139,6184,168,529,1597,4564,1765,5093
290160,201903,3121,7536,2825,7152,292,661,2171,5532,2463,6193
290170,201903,3233,8533,2874,8116,111,359,2554,7206,2665,7565
290180,201903,2964,8071,2441,7258,89,322,1954,5735,2043,6057
290190,201903,4131,11982,3651,11324,166,681,2959,9034,3125,9715
290195,201903,2336,5935,1864,5259,41,190,1528,4262,1569,4452
290200,201903,4030,11351,3344,10227,230,776,2546,7712,2776,8488
290205,201903,3428,8885,3021,8284,152,575,2372,6274,2524,6849
290210,201903,13187,37222,11728,35050,976,2642,8921,27373,9897,30015
290220,201903,2773,7153,2492,6799,173,525,1988,5344,2161,5869
290225,201903,3486,7353,2775,6589,107,281,2449,5755,2556,6036
290230,201903,2468,6657,2244,6396,44,164,1988,5638,2032,5802
290240,201903,3629,9256,2976,8418,115,373,2449,6888,2564,7261
290250,201903,4080,11878,3515,11073,141,472,2848,9159,2989,9631
290260,201903,5403,13597,4440,12204,209,735,3558,9532,3767,10267
290265,201903,3598,10562,2912,9244,154,599,2139,6665,2293,7264
290270,201903,11333,38729,10712,37652,611,2713,8528,29510,9139,32223
290280,201903,6089,18335,5274,16751,358,1329,3771,11786,4129,13115
290290,201903,10110,29811,8304,26429,836,2915,5544,17421,6380,20336
290300,201903,4233,11618,3148,9574,180,623,2215,6724,2395,7347
290310,201903,1507,3921,1265,3604,88,343,944,2598,1032,2941
290320,201903,24020,64692,19579,57845,4521,13378,9311,28683,13832,42061
290323,201903,3756,10250,3293,9565,77,269,2671,7687,2748,7956
290327,201903,4280,12371,3634,11153,287,860,2543,7771,2830,8631
290330,201903,2096,4520,1677,4058,46,101,1476,3569,1522,3670
290340,201903,5656,14886,4473,13391,522,1642,3181,9634,3703,11276
290350,201903,4630,13054,3853,11729,303,995,2745,8343,3048,9338
290360,201903,5024,13368,4395,12537,130,402,3774,10749,3904,11151
290370,201903,5336,13042,3982,11299,194,490,2971,8574,3165,9064
290380,201903,5590,15016,4776,13888,134,402,4141,12126,4275,12528
290390,201903,14196,40569,12103,37437,1272,3956,8210,25744,9482,29700
290395,201903,2755,8226,2303,7439,66,326,1792,5708,1858,6034
290400,201903,3616,9924,2926,8803,98,415,2217,6493,2315,6908
290405,201903,4663,13724,3913,12411,261,897,2768,8887,3029,9784
290410,201903,5699,15844,4483,13826,121,577,3415,10162,3536,10739
290420,201903,2987,8454,2451,7595,102,364,1891,5831,1993,6195
290430,201903,3089,8725,2558,7878,280,893,1674,5142,1954,6035
290440,201903,2741,7037,2010,5876,47,155,1452,4293,1499,4448
290450,201903,3272,8778,2664,7885,153,524,2036,5948,2189,6472
290460,201903,11659,32898,10048,29878,2189,6600,4655,13806,6844,20406
290470,201903,4425,11275,3292,9676,346,1144,1893,5590,2239,6734
290475,201903,6429,18802,5450,17036,110,569,4419,13461,4529,14030
290480,201903,1737,4532,1478,4144,124,377,976,2607,1100,2984
290485,201903,4486,13346,3976,12584,125,655,3364,10391,3489,11046
290490,201903,9073,21689,8103,20375,529,1293,6346,16041,6875,17334
290500,201903,3938,11990,3046,10053,524,1810,1395,4484,1919,6294
290510,201903,3364,8666,2839,7980,86,309,2433,6733,2519,7042
290515,201903,3784,10183,3197,9446,67,202,2801,8454,2868,8656
290520,201903,11124,32418,8659,27610,478,1770,5518,17289,5996,19059
290530,201903,4980,14252,4262,13070,152,544,3537,10834,3689,11378
290540,201903,3571,9535,3205,9090,72,262,2920,8226,2992,8488
290550,201903,4360,11348,3815,10705,24,91,3527,10009,3551,10100
290560,201903,6558,17222,5079,15008,468,1684,3344,9542,3812,11226
290570,201903,43223,108822,39092,103527,2783,7724,31120,81828,33903,89552
290580,201903,7841,23479,6862,22046,647,2089,5008,16426,5655,18515
290590,201903,6994,21779,5996,19997,160,679,4862,16212,5022,16891
290600,201903,18376,51961,16519,49069,686,2259,13225,39147,13911,41406
290610,201903,2496,7988,1996,6962,105,440,1379,4730,1484,5170
290620,201903,6610,18501,5714,17013,210,643,4755,14072,4965,14715
290630,201903,9040,22250,7263,19935,613,1670,5594,15425,6207,17095
290640,201903,2772,7262,2101,6242,83,269,1542,4571,1625,4840
290650,201903,12383,32384,11191,30916,2924,7644,6184,18213,9108,25857
290660,201903,3680,9511,3086,8647,56,137,2317,6759,2373,6896
290670,201903,6622,18802,5711,17315,451,1340,4351,13329,4802,14669
290680,201903,10503,29656,9024,27470,228,1192,7350,21773,7578,22965
290682,201903,4585,12230,4042,11459,140,362,3411,9700,3551,10062
290685,201903,3601,8097,2399,6424,183,471,1532,4342,1715,4813
290687,201903,6642,18332,5355,16211,723,2150,3352,10436,4075,12586
290689,201903,2781,7977,2274,7092,140,478,1665,5196,1805,5674
290690,201903,5666,14816,4608,13331,428,1258,3216,9225,3644,10483
290700,201903,2638,7293,2350,6910,91,318,1918,5643,2009,5961
290710,201903,8584,24208,7281,22411,189,783,6150,18784,6339,19567
290720,201903,18908,51774,17312,49408,974,3194,13840,38945,14814,42139
290730,201903,7177,17522,6118,16267,270,650,4770,12717,5040,13367
290740,201903,1063,2919,806,2472,39,158,616,1878,655,2036
290750,201903,10819,28029,9388,25557,841,2441,6612,17469,7453,19910
290755,201903,2103,5940,1697,5191,94,312,1205,3678,1299,3990
290760,201903,3846,11258,3050,9731,260,771,1941,6410,2201,7181
290770,201903,2605,8482,2372,8194,57,291,1977,6889,2034,7180
290780,201903,8334,20804,7186,19254,330,746,5693,15447,6023,16193
290790,201903,4612,12706,4019,11907,145,467,3398,10140,3543,10607
290800,201903,7302,15197,5257,12826,349,807,3871,9575,4220,10382
290810,201903,5613,15083,4499,13385,116,431,3350,10006,3466,10437
290820,201903,5064,13617,4513,12782,236,728,3311,9460,3547,10188
290830,201903,4621,10612,4129,9966,58,174,3573,8479,3631,8653
290840,201903,16611,45322,14570,42141,1801,4488,9565,29004,11366,33492
290850,201903,6377,16064,5780,15400,340,814,4831,13130,5171,13944
290860,201903,5854,17522,5118,16637,231,827,4300,14182,4531,15009
290870,201903,4857,13445,3712,11353,122,426,2639,7976,2761,8402
290880,201903,1412,3578,1109,3168,75,204,768,2243,843,2447
290890,201903,8711,18402,7832,17381,176,422,7268,16020,7444,16442
290900,201903,2343,6225,1782,5275,107,305,1146,3336,1253,3641
290910,201903,5076,12521,3928,10776,51,207,3235,8746,3286,8953
290920,201903,5145,12731,4712,12216,59,132,4425,11506,4484,11638
290930,201903,7914,22313,6416,19695,203,938,5054,15018,5257,15956
290940,201903,3677,10405,3069,9538,168,643,2425,7521,2593,8164
290950,201903,1478,3786,1233,3431,65,185,889,2481,954,2666
290960,201903,5398,14527,4847,13837,137,422,4099,11666,4236,12088
290970,201903,3527,10291,2896,9202,152,528,2187,6911,2339,7439
290980,201903,11547,28604,9713,25729,918,2612,5878,15166,6796,17778
290990,201903,9270,25304,8115,23389,327,1276,6641,18504,6968,19780
291000,201903,3389,9063,2700,8203,205,570,2100,6524,2305,7094
291005,201903,14991,37026,13286,34816,851,2317,10785,28037,11636,30354
291010,201903,3016,9164,2436,7957,141,505,1598,5112,1739,5617
291020,201903,1286,3226,1020,2726,29,99,723,1833,752,1932
291030,201903,2408,6012,1677,4700,93,258,1094,2970,1187,3228
291040,201903,5272,14945,4542,13905,196,818,3585,10825,3781,11643
291050,201903,7338,20043,6349,18603,840,2706,4265,12301,5105,15007
291060,201903,5792,18759,5034,17671,408,1780,3693,12795,4101,14575
291070,201903,15736,43033,13234,39135,533,1924,10634,31123,11167,33047
291072,201903,23850,63169,17469,51566,3519,10773,7073,21083,10592,31856
291075,201903,5162,13458,4581,12517,131,393,3732,9983,3863,10376
291077,201903,1593,4188,1250,3572,52,148,881,2512,933,2660
291080,201903,86025,231304,70354,208012,25221,76433,14621,46323,39842,122756
291085,201903,5733,14558,4774,13141,193,626,3983,10836,4176,11462
291090,201903,1953,3760,1443,3195,33,94,1217,2643,1250,2737
291100,201903,3161,7035,2178,5847,120,380,1660,4373,1780,4753
291110,201903,5874,17915,5029,16432,370,1506,3716,11673,4086,13179
291120,201903,7817,19371,6698,17897,396,1144,5005,13331,5401,14475
291125,201903,2167,3825,1583,3174,125,179,1194,2495,1319,2674
291130,201903,3134,9189,2384,7702,88,407,1699,5310,1787,5717
291140,201903,4735,13099,3525,10829,415,1124,2245,6963,2660,8087
291150,201903,2257,5173,1890,4753,15,45,1759,4405,1774,4450
291160,201903,5004,14131,4228,12990,387,1309,2832,8577,3219,9886
291165,201903,2174,6024,1688,5104,48,198,1223,3556,1271,3754
291170,201903,20675,52830,17439,47475,1024,3041,11391,30641,12415,33682
291180,201903,5820,14114,4523,12260,438,1152,3313,9043,3751,10195
291185,201903,3184,8739,2770,8045,81,263,2146,6178,2227,6441
291190,201903,7639,19079,6344,17343,360,1072,4920,13427,5280,14499
291200,201903,2884,8048,2138,6634,87,299,1317,4007,1404,4306
291210,201903,6886,15254,5298,13388,173,553,3953,9966,4126,10519
291220,201903,4019,11646,3626,11037,241,861,2796,8402,3037,9263
291230,201903,4453,9767,3439,8643,74,160,3057,7782,3131,7942
291240,201903,4219,11007,3674,10090,67,231,3143,8491,3210,8722
291250,201903,3437,10188,2697,8838,174,578,1751,5760,1925,6338
291260,201903,1396,3293,1198,3039,34,108,976,2486,1010,2594
291270,201903,4998,13812,4058,12344,670,2014,2563,7935,3233,9949
291280,201903,2459,6423,1865,5485,168,577,1113,3152,1281,3729
291290,201903,5878,15726,4679,13849,428,1347,3144,9253,3572,10600
291300,201903,3954,10712,2967,9062,137,459,2187,6610,2324,7069
291310,201903,5057,13757,4351,12432,125,441,3618,10125,3743,10566
291320,201903,6005,17331,4716,14814,1091,3202,2286,7546,3377,10748
291330,201903,1838,4660,1537,4158,75,199,1128,2974,1203,3173
291340,201903,4159,10905,3489,9786,83,298,2709,7443,2792,7741
291345,201903,2987,9132,2735,8740,126,453,2240,7157,2366,7610
291350,201903,6808,17288,5302,15345,93,285,4490,13211,4583,13496
291360,201903,34906,84062,28157,75571,3429,9473,17288,47331,20717,56804
291370,201903,7880,21769,7095,20621,522,1660,5329,15343,5851,17003
291380,201903,3322,9509,2979,8987,104,457,2467,7289,2571,7746
291390,201903,12894,28849,10226,25850,430,1146,8381,21110,8811,22256
291400,201903,13678,36321,11500,33017,1635,4265,6848,21020,8483,25285
291410,201903,2891,7640,2206,6495,55,242,1623,4647,1678,4889
291420,201903,1918,4803,1533,4321,44,179,1305,3637,1349,3816
291430,201903,2936,8265,2531,7615,99,439,2012,5875,2111,6314
291440,201903,6391,18560,5491,17059,316,1088,4334,13479,4650,14567
291450,201903,8720,22574,7316,20931,132,263,6390,18856,6522,19119
291460,201903,15154,41096,13337,38358,738,2366,9936,28378,10674,30744
291465,201903,8882,22807,7138,20768,216,947,5977,17208,6193,18155
291470,201903,15401,36598,13139,34035,638,1598,9843,26187,10481,27785
291480,201903,40108,90941,29648,76633,3842,10462,15449,39864,19291,50326
291490,201903,5343,13840,4695,13035,179,589,4148,11450,4327,12039
291500,201903,5032,12397,4203,11271,61,262,3796,10104,3857,10366
291510,201903,3867,10259,3014,9111,91,437,2406,7222,2497,7659
291520,201903,4417,10319,3414,8996,162,462,2597,6812,2759,7274
291530,201903,2216,5270,1616,4465,294,735,951,2859,1245,3594
291535,201903,3109,9486,2885,9109,169,512,2241,7187,2410,7699
291540,201903,2272,5175,1605,4374,54,210,1335,3528,1389,3738
291550,201903,5464,12811,4293,11267,406,948,2880,7689,3286,8637
291560,201903,19414,44602,13598,37409,1051,2779,8950,25632,10001,28411
291570,201903,2357,5642,1890,5056,72,175,1550,4254,1622,4429
291580,201903,6164,16503,4865,14727,286,1000,3538,10525,3824,11525
291590,201903,1875,5099,1679,4828,135,432,1354,3828,1489,4260
291600,201903,5127,12816,3849,10804,491,1508,2355,6395,2846,7903
291610,201903,5635,15433,5252,15010,82,308,4860,13867,4942,14175
291620,201903,3210,7112,2319,6119,120,322,1755,4723,1875,5045
291630,201903,3254,7486,2421,6403,199,615,1828,4746,2027,5361
291640,201903,15322,39221,11717,33840,1906,5359,4980,15195,6886,20554
291650,201903,9035,23650,7982,22341,459,1045,6740,19167,7199,20212
291660,201903,2064,5071,1512,4205,130,435,1004,2636,1134,3071
291670,201903,2057,5415,1742,4977,108,273,1345,3891,1453,4164
291680,201903,4070,10322,3314,9167,289,849,2395,6524,2684,7373
291685,201903,4682,11360,3731,10136,253,531,2823,7985,3076,8516
291690,201903,4286,9579,2887,7566,177,432,2234,5803,2411,6235
291700,201903,8550,25111,7622,23480,433,1544,6183,18748,6616,20292
291710,201903,5221,12815,3916,10962,283,900,2759,7549,3042,8449
291720,201903,4347,13542,3648,12113,417,1507,2389,7725,2806,9232
291730,201903,6369,16767,5495,15608,254,820,4518,12770,4772,13590
291733,201903,2916,7543,2458,6918,64,218,1822,5344,1886,5562
291735,201903,2974,7714,2414,6811,78,230,1909,5344,1987,5574
291740,201903,3836,9969,2941,8424,99,297,2200,6198,2299,6495
291750,201903,19611,47678,15905,42128,1626,4376,10520,27942,12146,32318
291760,201903,10254,30435,8159,26914,2583,9633,2128,7039,4711,16672
291770,201903,7011,19470,5859,17376,459,1449,4200,12163,4659,13612
291780,201903,5031,13605,4540,12889,105,399,3944,11043,4049,11442
291790,201903,2641,7578,2431,7299,257,687,1804,5532,2061,6219
291800,201903,28835,74370,22174,64203,3398,9509,11795,35240,15193,44749
291810,201903,10556,25717,8847,23588,241,766,7650,20206,7891,20972
291820,201903,3809,10178,3329,9512,110,368,2632,7532,2742,7900
291830,201903,4212,10357,3585,9482,213,552,2870,7609,3083,8161
291835,201903,6335,19053,4933,16296,734,2503,2861,9645,3595,12148
291840,201903,46709,129299,40541,120352,4784,14832,27743,82636,32527,97468
291845,201903,2409,6525,1970,5980,96,312,1613,4934,1709,5246
291850,201903,4005,11479,3292,10278,276,800,2351,7549,2627,8349
291855,201903,2147,4381,1702,3861,52,137,1509,3402,1561,3539
291860,201903,2258,5953,1561,4605,36,121,1064,3022,1100,3143
291870,201903,1313,3312,880,2561,53,161,583,1642,636,1803
291875,201903,2672,8100,2350,7458,92,348,1794,5532,1886,5880
291880,201903,5540,16127,4785,14796,293,926,3493,10788,3786,11714
291890,201903,1553,3325,1014,2684,150,367,660,1737,810,2104
291900,201903,1188,3014,919,2579,22,82,729,1985,751,2067
291905,201903,2655,6670,2070,5725,87,297,1552,4153,1639,4450
291910,201903,2839,7326,2411,6810,77,277,2065,5816,2142,6093
291915,201903,7259,20962,5999,18800,229,884,4522,14149,4751,15033
291920,201903,25275,68479,21960,63854,2629,8215,14602,41767,17231,49982
291930,201903,2429,6818,2084,6279,252,815,1360,4049,1612,4864
291940,201903,3807,9974,2550,7802,228,679,1479,4457,1707,5136
291950,201903,9039,27598,7752,25089,450,1689,5210,16716,5660,18405
291955,201903,14501,37208,13081,35372,1254,3469,10070,27445,11324,30914
291960,201903,3156,8443,2557,7602,148,482,1945,5873,2093,6355
291970,201903,4255,11321,3668,10519,192,683,2734,7804,2926,8487
291980,201903,10132,28742,7999,25345,685,2073,5360,17264,6045,19337
291990,201903,2136,5678,1870,5379,22,104,1775,5095,1797,5199
291992,201903,4198,10249,3151,8810,267,667,2441,6939,2708,7606
291995,201903,2169,5869,1746,5244,58,276,1369,3993,1427,4269
292000,201903,2608,6344,2105,5708,127,473,1587,4219,1714,4692
292010,201903,6021,14003,4929,12471,211,638,4054,10045,4265,10683
292020,201903,4531,13341,3798,12037,245,903,2740,8426,2985,9329
292030,201903,1731,5474,1648,5332,77,308,1054,3296,1131,3604
292040,201903,4274,11219,3439,9998,257,703,2646,7856,2903,8559
292045,201903,3981,10580,2954,9048,49,126,2594,8102,2643,8228
292050,201903,6487,18492,5203,16101,305,1067,3264,9954,3569,11021
292060,201903,11990,27750,11126,26692,603,1401,9569,22684,10172,24085
292070,201903,5734,15174,5045,14327,284,865,4326,12207,4610,13072
292080,201903,3224,8130,2656,7410,90,285,2335,6510,2425,6795
292090,201903,4546,9944,3295,8465,245,638,2517,6548,2762,7186
292100,201903,10338,26114,8816,24142,1110,3211,5656,15387,6766,18598
292105,201903,3368,8788,2973,8202,84,262,2425,6642,2509,6904
292110,201903,6084,15310,4338,12405,993,2893,1979,5660,2972,8553
292120,201903,6854,17869,5587,15681,418,1220,4130,11400,4548,12620
292130,201903,3378,8210,2759,7458,128,389,2132,5695,2260,6084
292140,201903,5127,12169,4249,10896,283,676,3384,8685,3667,9361
292145,201903,2325,6888,1957,6219,76,264,1465,4667,1541,4931
292150,201903,13388,37472,11916,35170,291,1266,9885,28669,10176,29935
292160,201903,2886,7288,2245,6461,64,201,1852,5436,1916,5637
292170,201903,8188,22167,6835,19907,470,1515,4908,14078,5378,15593
292180,201903,2820,7727,2057,6377,239,718,1239,3798,1478,4516
292190,201903,2894,7752,2479,7134,160,471,1836,5315,1996,5786
292200,201903,7811,20449,5957,17698,1054,3215,3167,9582,4221,12797
292205,201903,3887,10776,3356,9992,61,297,2938,8643,2999,8940
292210,201903,6254,15022,5126,13559,95,418,4549,11833,4644,12251
292220,201903,2078,5159,1837,4796,70,211,1428,3627,1498,3838
292225,201903,3189,9386,2824,8835,78,340,2375,7307,2453,7647
292230,201903,8435,20304,7537,19132,193,688,6396,15862,6589,16550
292240,201903,4828,14028,4147,12758,362,1085,2773,8553,3135,9638
292250,201903,5208,14345,4698,13543,568,1552,3151,9223,3719,10775
292260,201903,3302,8846,2956,8404,122,333,2549,7292,2671,7625
292265,201903,3352,9373,2838,8571,78,385,2204,6480,2282,6865
292270,201903,4264,9982,3415,8960,185,521,2758,7237,2943,7758
292273,201903,2627,5766,2102,5126,60,114,1587,4056,1647,4170
292275,201903,1650,4356,1319,3888,56,134,1002,3015,1058,3149
292280,201903,2595,6225,2111,5673,101,223,1745,4845,1846,5068
292285,201903,2531,6224,2001,5485,93,231,1574,4361,1667,4592
292290,201903,7050,19401,5759,17493,190,733,4676,14134,4866,14867
292300,201903,10058,26158,7954,23421,858,2743,5280,15534,6138,18277
292303,201903,2876,8305,2535,7768,76,194,2150,6647,2226,6841
292305,201903,2490,6643,2305,6381,44,216,2043,5525,2087,5741
292310,201903,6654,17222,5719,16071,187,620,4867,13574,5054,14194
292320,201903,6193,16961,5008,14760,284,915,3688,10586,3972,11501
292330,201903,2758,6122,2159,5449,110,265,1664,4300,1774,4565
292335,201903,4722,12310,4216,11587,277,695,3502,9717,3779,10412
292340,201903,5776,16129,4873,14412,227,741,3658,10631,3885,11372
292350,201903,2541,6825,2082,6208,86,318,1696,5059,1782,5377
292360,201903,4907,13176,4126,11823,321,1029,2854,7960,3175,8989
292370,201903,11016,25195,9543,23228,138,493,8780,20920,8918,21413
292380,201903,6819,19257,6102,17982,420,1263,4603,13465,5023,14728
292390,201903,4394,8658,3202,7270,103,237,2796,6332,2899,6569
292400,201903,21767,63534,19072,59081,1872,6186,13174,40651,15046,46837
292405,201903,4321,10678,3567,9583,148,383,2887,7721,3035,8104
292410,201903,2142,5171,1846,4805,57,175,1620,4198,1677,4373
292420,201903,3632,11047,3305,10509,159,722,2747,8532,2906,9254
292430,201903,4783,14521,3684,12554,305,1116,2421,8260,2726,9376
292440,201903,8476,27062,7820,26048,132,665,7019,23319,7151,23984
292450,201903,3822,11241,3105,9817,116,432,2397,7551,2513,7983
292460,201903,4825,13524,3980,12068,369,1065,2817,8558,3186,9623
292465,201903,2570,6803,2137,6216,88,225,1483,4566,1571,4791
292467,201903,1802,5194,1623,4953,224,625,1119,3535,1343,4160
292470,201903,2972,7586,2324,6561,71,165,1801,5092,1872,5257
292480,201903,6454,15354,5163,13788,76,288,4615,12131,4691,12419
292490,201903,2107,5599,1756,5080,104,302,1331,3889,1435,4191
292500,201903,6456,18064,5290,15934,580,1794,3449,10302,4029,12096
292510,201903,12490,34088,9997,30315,542,1971,7277,22010,7819,23981
292520,201903,6774,17137,6006,16018,606,1660,4437,11794,5043,13454
292525,201903,5760,13790,4762,12640,119,330,4141,11047,4260,11377
292530,201903,26493,71851,20847,62320,5634,17100,7414,22935,13048,40035
292540,201903,4120,8057,3269,7134,118,218,2878,6292,2996,6510
292550,201903,7834,21508,6116,19346,423,1464,4515,14668,4938,16132
292560,201903,4298,10978,3680,10120,90,318,3028,8290,3118,8608
292570,201903,3831,9964,3262,9046,73,263,2832,7692,2905,7955
292575,201903,6896,20201,6380,19511,280,925,5262,16100,5542,17025
292580,201903,7445,19101,6303,17407,159,527,5271,14420,5430,14947
292590,201903,7450,19710,6456,18114,277,889,5431,14905,5708,15794
292593,201903,2855,7048,2375,6256,83,198,1955,5130,2038,5328
292595,201903,5411,14317,4670,13412,177,613,3886,10995,4063,11608
292600,201903,10992,29952,9486,27700,413,1159,7449,21808,7862,22967
292610,201903,4278,11241,3578,10033,220,529,2573,7355,2793,7884
292620,201903,6386,17740,5408,16596,81,205,5075,15756,5156,15961
292630,201903,8612,21224,7022,18689,573,1534,4787,12747,5360,14281
292640,201903,8155,24349,7129,22667,224,959,5117,16279,5341,17238
292650,201903,4612,11311,4155,10717,141,419,3734,9475,3875,9894
292660,201903,11125,30503,9549,28200,486,1573,7443,21900,7929,23473
292665,201903,2188,6526,1947,6224,77,251,1657,5376,1734,5627
292670,201903,3576,9695,2745,8148,125,422,1886,5510,2011,5932
292680,201903,3968,10728,3186,9278,191,567,2318,6581,2509,7148
292690,201903,2606,6896,1847,5641,182,529,1126,3603,1308,4132
292700,201903,9828,26993,8531,25011,810,2283,5781,17409,6591,19692
292710,201903,2446,7719,2260,7467,50,192,2024,6735,2074,6927
292720,201903,9254,22228,7771,20562,288,783,6233,16655,6521,17438
292730,201903,4396,10474,4132,10152,195,325,3617,9013,3812,9338
292740,201903,320828,798946,285240,746272,44871,118935,173244,450207,218115,569142
292750,201903,6266,16763,5432,15540,280,833,4098,11814,4378,12647
292760,201903,3839,11210,3374,10392,245,820,2453,7504,2698,8324
292770,201903,5992,16291,4858,14648,775,2459,2939,9134,3714,11593
292780,201903,1998,4178,1486,3514,44,147,1183,2664,1227,2811
292790,201903,4119,8808,3195,7809,149,414,2727,6628,2876,7042
292800,201903,10963,27719,9482,25461,360,1010,7828,20766,8188,21776
292805,201903,3414,8486,2683,7503,150,417,2034,5691,2184,6108
292810,201903,10522,28277,8343,24909,247,985,6220,18138,6467,19123
292820,201903,7442,20538,5406,17270,509,1767,3661,11492,4170,13259
292830,201903,2891,6799,2460,6264,84,287,2128,5343,2212,5630
292840,201903,8794,23149,7621,21547,177,682,6570,18111,6747,18793
292850,201903,2532,6843,2116,6200,142,470,1461,4172,1603,4642
292860,201903,16643,38006,14856,35784,694,1703,12291,29315,12985,31018
292870,201903,17251,44167,15012,41023,1089,3295,9957,26795,11046,30090
292880,201903,11230,30697,9712,28456,337,1413,7579,21427,7916,22840
292890,201903,6508,18653,5773,17518,265,1030,4820,14442,5085,15472
292895,201903,2997,6543,2184,5320,95,237,1715,4121,1810,4358
292900,201903,2646,7296,2438,6964,59,249,1974,5466,2033,5715
292905,201903,4304,11554,3384,10168,187,642,2421,7200,2608,7842
292910,201903,4933,13641,4501,12979,259,835,3383,9658,3642,10493
292920,201903,9793,27072,9208,26257,280,1089,7981,22301,8261,23390
292925,201903,5360,15283,4631,14017,238,741,3405,10140,3643,10881
292930,201903,6493,19528,5597,17771,507,1882,3478,10683,3985,12565
292935,201903,2343,6038,1828,5459,41,212,1614,4811,1655,5023
292937,201903,3111,7486,2713,7009,69,204,2417,6237,2486,6441
292940,201903,2997,7690,2422,6808,182,423,1738,5036,1920,5459
292950,201903,9754,25242,8557,23400,483,1305,6431,17372,6914,18677
292960,201903,5251,12741,4467,11655,125,376,3586,9157,3711,9533
292970,201903,3820,11218,3340,10490,114,516,2763,8658,2877,9174
292975,201903,4472,9773,3961,9193,174,343,3536,8293,3710,8636
292980,201903,3322,8101,2652,7089,103,323,2110,5540,2213,5863
292990,201903,11403,31316,9603,28148,686,2217,7060,20425,7746,22642
293000,201903,2547,6190,2222,5730,38,145,1752,4536,1790,4681
293010,201903,18119,46938,14710,41477,1980,5781,8962,25117,10942,30898
293015,201903,7879,24776,6286,21606,465,1940,4252,14525,4717,16465
293020,201903,9748,28706,8836,27424,143,668,7831,24540,7974,25208
293030,201903,5370,14521,4101,12549,120,406,2791,8765,2911,9171
293040,201903,3905,10966,3396,10274,90,336,2937,8849,3027,9185
293050,201903,21708,54185,19307,50783,1248,3456,14291,37231,15539,40687
293060,201903,3500,9267,2858,8163,216,659,2055,5744,2271,6403
293070,201903,24867,61498,21116,56496,2693,7465,13809,37237,16502,44702
293075,201903,3324,10705,2940,10072,206,860,2300,7832,2506,8692
293076,201903,3596,8951,3205,8457,92,246,2745,7298,2837,7544
293077,201903,6043,17041,4887,15261,460,1478,3140,10108,3600,11586
293080,201903,4857,14343,4206,13244,121,540,3339,10282,3460,10822
293090,201903,3196,9411,2469,8199,249,903,1586,5241,1835,6144
293100,201903,5744,15550,4635,13572,276,842,3571,10351,3847,11193
293105,201903,3646,11581,3200,10690,211,757,2331,7682,2542,8439
293110,201903,2466,6139,2087,5615,68,277,1727,4484,1795,4761
293120,201903,4338,11944,3878,11212,120,316,3218,9316,3338,9632
293130,201903,3808,10554,3361,9970,92,384,2874,8423,2966,8807
293135,201903,29019,69997,21565,59678,3773,11440,9665,26893,13438,38333
293140,201903,2343,5395,2029,4998,80,204,1682,4108,1762,4312
293150,201903,5416,16414,4495,14683,407,1403,3047,9945,3454,11348
293160,201903,3878,9536,3307,8878,255,468,2706,7614,2961,8082
293170,201903,4477,9983,3885,9204,112,301,3292,7673,3404,7974
293180,201903,4566,12580,3744,11176,121,517,2988,8654,3109,9171
293190,201903,14066,38741,12291,36197,223,986,10689,31220,10912,32206
293200,201903,8012,20200,6561,17921,227,868,5219,13889,5446,14757
293210,201903,5254,13896,4430,12590,315,861,3374,9624,3689,10485
293220,201903,4945,13259,3728,11126,859,2596,1489,4600,2348,7196
293230,201903,3884,10169,2915,8754,255,852,1960,5964,2215,6816
293240,201903,4413,11732,3552,10313,93,271,2718,8089,2811,8360
293245,201903,3893,10533,3512,9998,178,550,2954,8308,3132,8858
293250,201903,5573,13602,4751,12476,243,646,3855,10110,4098,10756
293260,201903,4414,12269,3639,11065,108,349,2566,7760,2674,8109
293270,201903,6934,15918,5594,14471,474,812,4333,11927,4807,12739
293280,201903,4816,12682,4132,11739,260,657,3185,9101,3445,9758
293290,201903,13443,41071,12041,38828,2272,7316,6956,23094,9228,30410
293300,201903,5911,14277,5036,13022,320,778,3676,9613,3996,10391
293305,201903,4010,10014,3536,9391,51,160,3132,8264,3183,8424
293310,201903,2142,5517,1756,4866,71,212,1353,3683,1424,3895
293315,201903,4135,10067,3373,8902,172,435,2719,7138,2891,7573
293317,201903,2508,6238,2204,5790,148,328,1709,4524,1857,4852
293320,201903,10829,27841,9972,26838,374,1053,8730,23424,9104,24477
293325,201903,1702,4378,1355,3880,187,543,866,2504,1053,3047
293330,201903,44606,136872,38146,125309,8539,28402,16813,56717,25352,85119
293340,201903,2364,6603,1917,5845,118,416,1296,3889,1414,4305
293345,201903,3320,9278,2697,8359,316,747,1874,6220,2190,6967
293350,201903,6756,19149,5948,18248,60,239,5472,17057,5532,17296
293360,201903,15312,39322,13091,36463,458,1718,11349,31074,11807,32792
310010,201903,842,2018,579,1637,59,203,263,683,322,886
310020,201903,2300,6574,1684,5439,360,1282,287,873,647,2155
310030,201903,2027,5917,1579,5104,241,869,963,2999,1204,3868
310040,201903,950,2489,770,2192,42,166,527,1417,569,1583
310050,201903,1552,4821,1362,4503,187,760,803,2556,990,3316
310060,201903,3262,9325,2844,8781,133,561,2317,7048,2450,7609
310070,201903,363,819,247,644,8,20,186,480,194,500
310080,201903,815,2222,547,1673,82,285,216,612,298,897
310090,201903,4494,12342,3687,10999,301,992,2644,7720,2945,8712
310100,201903,3272,9339,2773,8508,109,484,2213,6560,2322,7044
310110,201903,4774,12827,3765,11047,798,2556,1647,4649,2445,7205
310120,201903,633,1579,398,1182,62,225,211,553,273,778
310130,201903,367,1006,312,919,40,150,202,549,242,699
310140,201903,226,702,164,585,32,133,50,151,82,284
310150,201903,4838,13437,3679,11259,629,2145,1533,4514,2162,6659
310160,201903,7092,18708,5267,15680,1188,3902,1662,4875,2850,8777
310163,201903,984,2910,784,2541,230,837,217,623,447,1460
310170,201903,8960,23494,7297,20887,698,2064,5117,14617,5815,16681
310180,201903,1710,4401,1297,3720,110,392,885,2431,995,2823
310190,201903,2851,8744,2292,7652,550,2047,321,1004,871,3051
310200,201903,1759,5357,1307,4434,240,908,527,1749,767,2657
310205,201903,1063,2960,786,2517,167,602,289,910,456,1512
310210,201903,2676,7086,2189,6285,98,285,1673,4751,1771,5036
310220,201903,1113,3067,872,2650,93,312,599,1764,692,2076
310230,201903,2279,6543,1864,5735,227,813,1114,3192,1341,4005
310240,201903,895,2881,763,2646,55,236,531,1813,586,2049
310250,201903,1016,2762,829,2463,32,130,588,1710,620,1840
310260,201903,2776,7474,1734,5624,516,1920,352,831,868,2751
310270,201903,2671,6777,2096,5981,113,438,1693,4753,1806,5191
310280,201903,2347,5619,1825,4869,302,877,1003,2526,1305,3403
310285,201903,1874,6164,1615,5718,172,730,970,3391,1142,4121
310290,201903,1155,3098,970,2767,205,675,517,1331,722,2006
310300,201903,1451,4450,1278,4146,184,748,677,2002,861,2750
310310,201903,309,795,207,607,31,99,115,334,146,433
310320,201903,512,1332,328,1014,27,109,163,481,190,590
310330,201903,485,1163,290,802,40,130,126,312,166,442
310340,201903,7655,21326,6125,18695,976,2907,3025,9496,4001,12403
310350,201903,12339,30529,8373,24024,1921,5867,3013,8369,4934,14236
310360,201903,489,1177,371,1024,12,42,276,743,288,785
310370,201903,1287,4100,1071,3677,214,797,335,1176,549,1973
310375,201903,834,2204,559,1776,100,341,234,736,334,1077
310380,201903,387,908,206,593,35,94,79,215,114,309
310390,201903,443,1349,356,1186,95,338,91,242,186,580
310400,201903,9456,23593,6651,19265,937,3132,3569,10012,4506,13144
310410,201903,792,2315,491,1747,101,376,141,461,242,837
310420,201903,4032,10565,2623,7761,450,1522,861,2265,1311,3787
310430,201903,1468,4078,954,3105,201,732,305,904,506,1636
310440,201903,566,1459,393,1155,25,109,232,664,257,773
310445,201903,1312,3877,998,3264,49,188,712,2278,761,2466
310450,201903,4708,12056,3541,10187,208,757,2624,7296,2832,8053
310460,201903,1593,4321,1097,3384,218,718,316,943,534,1661
310470,201903,3859,8451,3055,7401,308,799,2261,5444,2569,6243
310480,201903,988,2667,749,2232,110,363,462,1336,572,1699
310490,201903,2877,8137,2249,7028,317,1185,1121,3231,1438,4416
310500,201903,1422,4088,1034,3373,198,720,483,1544,681,2264
310510,201903,1907,5157,1222,3849,249,854,400,1268,649,2122
310520,201903,1281,3262,921,2646,133,373,520,1473,653,1846
310530,201903,773,2021,441,1346,59,211,115,281,174,492
310540,201903,3254,9434,2683,8425,646,2133,1122,3382,1768,5515
310550,201903,1248,3267,856,2582,77,294,503,1430,580,1724
310560,201903,13937,37660,10230,31144,2029,6970,3684,10105,5713,17075
310570,201903,1114,2998,882,2656,82,310,581,1686,663,1996
310590,201903,4102,11157,3313,9736,263,893,1901,5278,2164,6171
310600,201903,1412,4247,1145,3708,183,664,558,1684,741,2348
310610,201903,493,1331,313,1029,55,203,160,481,215,684
310620,201903,162275,427334,119244,349294,22158,73794,50322,131900,72480,205694
310630,201903,4464,12475,3646,10916,268,940,2412,6980,2680,7920
310640,201903,994,3050,827,2707,199,726,295,906,494,1632
310650,201903,2414,7133,1778,5912,207,763,992,3185,1199,3948
310660,201903,1269,3473,1065,3217,43,150,879,2615,922,2765
310665,201903,1339,3528,1057,3115,44,171,862,2506,906,2677
310670,201903,50942,136106,42826,121771,5116,16710,27274,73460,32390,90170
310680,201903,683,1696,579,1546,25,82,459,1186,484,1268
310690,201903,1730,4730,1273,3952,132,472,699,2071,831,2543
310700,201903,492,1109,373,968,38,124,262,644,300,768
310710,201903,5329,15614,3786,13357,906,3732,483,1575,1389,5307
310720,201903,919,2315,732,2066,48,165,524,1416,572,1581
310730,201903,9388,26268,8089,24125,498,1866,5752,16758,6250,18624
310740,201903,5435,15452,3642,11615,671,2308,1094,3244,1765,5552
310750,201903,1215,2994,868,2493,134,449,375,978,509,1427
310760,201903,556,1493,406,1256,31,105,199,634,230,739
310770,201903,1082,3018,724,2451,100,391,345,1099,445,1490
310780,201903,4056,10203,3337,9081,123,378,2479,6642,2602,7020
310790,201903,1792,5717,1564,5239,423,1517,470,1555,893,3072
310800,201903,2250,6806,1622,5524,410,1644,97,301,507,1945
310810,201903,1139,2958,916,2550,48,161,627,1679,675,1840
310820,201903,1151,3064,700,2234,154,520,152,477,306,997
310825,201903,2474,7897,2017,7099,87,492,1577,5325,1664,5817
310830,201903,1543,4548,1059,3526,221,817,421,1322,642,2139
310840,201903,1889,5235,1325,4240,355,1239,323,909,678,2148
310850,201903,1528,4208,1289,3881,64,308,990,2832,1054,3140
310855,201903,3261,8807,2531,7622,213,768,1737,5057,1950,5825
310860,201903,6909,20236,5511,17434,539,1832,3359,10646,3898,12478
310870,201903,1055,2540,798,2167,88,249,564,1533,652,1782
310880,201903,1016,3063,785,2589,90,311,465,1482,555,1793
310890,201903,2254,6411,1437,4841,303,1108,179,512,482,1620
310900,201903,4185,11783,3101,9698,484,1653,1411,4065,1895,5718
310910,201903,1787,4614,1175,3545,127,461,193,510,320,971
310920,201903,1844,4957,1411,4268,256,799,723,2184,979,2983
310925,201903,955,2728,793,2438,103,357,512,1503,615,1860
310930,201903,5756,15575,4160,12970,789,2558,2028,6484,2817,9042
310940,201903,6289,15911,5070,14096,269,993,3668,9840,3937,10833
310945,201903,1237,3297,1014,2957,113,388,592,1670,705,2058
310950,201903,1842,5565,1240,4200,242,907,431,1327,673,2234
310960,201903,721,1885,431,1346,63,212,147,464,210,676
310970,201903,1153,3484,802,2715,200,748,166,494,366,1242
310980,201903,332,795,222,624,26,76,137,371,163,447
310990,201903,1220,3558,946,3019,209,685,402,1246,611,1931
311000,201903,4014,11486,2982,9720,782,2727,1121,3496,1903,6223
311010,201903,757,2374,611,2049,246,886,169,545,415,1431
311020,201903,974,2590,657,2003,71,241,309,914,380,1155
311030,201903,1524,3982,1027,3089,239,817,406,1105,645,1922
311040,201903,323,1031,256,866,70,242,72,226,142,468
311050,201903,2482,6491,1888,5590,421,1394,835,2353,1256,3747
311060,201903,2851,7666,1972,5881,314,1102,768,2062,1082,3164
311070,201903,2041,5419,1487,4503,192,714,728,2065,920,2779
311080,201903,1006,2454,828,2149,49,194,609,1468,658,1662
311090,201903,2027,6622,1589,5811,375,1545,473,1693,848,3238
311100,201903,2027,5916,1247,4346,289,1135,186,583,475,1718
311110,201903,3653,7750,2043,5450,435,1256,736,1974,1171,3230
311115,201903,1291,3155,1050,2816,66,214,833,2172,899,2386
311120,201903,6457,17353,4815,14284,803,2719,1696,4476,2499,7195
311130,201903,1870,5036,1448,4437,140,562,778,2277,918,2839
311140,201903,1393,3480,1029,2955,82,269,642,1826,724,2095
311150,201903,1532,4914,1223,4318,201,799,635,2157,836,2956
311160,201903,3662,10824,2552,8734,686,2635,723,2409,1409,5044
311170,201903,863,2323,684,2066,45,141,430,1338,475,1479
311180,201903,1323,3053,843,2349,177,527,360,1002,537,1529
311190,201903,1005,2789,735,2246,115,406,296,820,411,1226
311200,201903,1792,4926,1257,3910,293,1003,358,983,651,1986
311205,201903,880,2710,720,2384,54,244,416,1321,470,1565
311210,201903,1005,3006,881,2845,121,376,639,2117,760,2493
311220,201903,734,2109,608,1883,73,255,333,954,406,1209
311230,201903,7573,23152,5679,19352,1041,3727,2042,7156,3083,10883
311240,201903,972,2664,749,2351,183,628,351,1077,534,1705
311250,201903,885,2563,691,2218,164,544,294,907,458,1451
311260,201903,2426,6085,1536,4539,287,892,562,1563,849,2455
311265,201903,1244,3313,943,2813,61,218,658,1889,719,2107
311270,201903,3014,9156,2629,8518,201,892,1924,5919,2125,6811
311280,201903,1158,3097,537,1757,98,354,84,245,182,599
311290,201903,1880,5863,1738,5547,173,585,1179,3728,1352,4313
311300,201903,4579,13229,3816,11952,229,1008,2936,8925,3165,9933
311310,201903,560,1616,475,1456,61,199,246,715,307,914
311320,201903,3099,9714,2637,8668,454,1706,1169,3522,1623,5228
311330,201903,4798,13114,3935,11688,452,1512,2185,6529,2637,8041
311340,201903,10041,29212,7973,25404,2389,8191,1989,6138,4378,14329
311350,201903,2196,5678,1546,4477,159,560,820,2110,979,2670
311360,201903,1105,2757,693,2102,220,754,195,548,415,1302
311370,201903,4377,11122,3245,9232,172,682,2028,5468,2200,6150
311380,201903,379,1167,301,1014,80,280,102,355,182,635
311390,201903,1689,5337,1351,4882,574,2379,345,1075,919,3454
311400,201903,1398,4001,1010,3252,149,539,411,1180,560,1719
311410,201903,1606,4873,1333,4492,225,848,707,2407,932,3255
311420,201903,1535,4637,1047,3584,188,703,178,488,366,1191
311430,201903,3440,9437,2254,7026,441,1419,663,2080,1104,3499
311440,201903,2447,7156,1723,5869,379,1480,561,1870,940,3350
311450,201903,1717,5331,1265,4462,324,1284,303,912,627,2196
311455,201903,955,2246,661,1797,181,507,239,665,420,1172
311460,201903,480,1549,325,1228,71,347,91,305,162,652
311470,201903,436,1406,310,1096,76,317,56,182,132,499
311480,201903,1158,3234,996,3004,41,113,816,2500,857,2613
311490,201903,228,692,178,587,48,180,78,228,126,408
311500,201903,416,1082,306,903,31,107,182,525,213,632
311510,201903,2902,7871,1929,6070,341,1237,698,2017,1039,3254
311520,201903,574,1703,519,1589,105,365,278,812,383,1177
311530,201903,8590,20562,5386,15279,1325,4163,1377,3850,2702,8013
311535,201903,740,2033,500,1572,80,286,155,445,235,731
311540,201903,513,1617,446,1498,95,329,262,882,357,1211
311545,201903,2014,5787,1750,5426,96,382,1342,4080,1438,4462
311547,201903,1474,3822,1288,3531,41,125,923,2571,964,2696
311550,201903,2683,7701,2128,6643,329,1171,854,2546,1183,3717
311560,201903,281,633,195,514,28,82,109,256,137,338
311570,201903,1828,4321,1316,3604,59,174,1021,2854,1080,3028
311580,201903,2161,4069,1394,3175,163,336,897,2093,1060,2429
311590,201903,481,1360,389,1222,66,233,205,624,271,857
311600,201903,1692,3908,1421,3572,57,162,1207,2968,1264,3130
311610,201903,2353,7915,1953,7013,307,1158,970,3448,1277,4606
311615,201903,2961,8842,2443,7974,168,633,1822,5847,1990,6480
311620,201903,409,1128,351,1050,24,91,273,801,297,892
311630,201903,1348,3747,1085,3236,92,295,719,2061,811,2356
311640,201903,546,1591,428,1368,82,309,204,595,286,904
311650,201903,1894,5009,1588,4525,135,472,1075,2920,1210,3392
311660,201903,2708,7863,1975,6500,381,1371,456,1302,837,2673
311670,201903,1552,4098,1144,3401,179,600,506,1523,685,2123
311680,201903,2066,6072,1583,5224,281,949,931,3072,1212,4021
311690,201903,565,1247,433,1078,51,122,307,804,358,926
311700,201903,2246,5462,1756,4775,35,147,1456,3839,1491,3986
311710,201903,1507,4425,1030,3496,262,974,356,1186,618,2160
311720,201903,408,1260,328,1103,34,148,180,578,214,726
311730,201903,4126,10548,2596,7771,805,2646,413,1223,1218,3869
311740,201903,814,2342,702,2200,37,101,618,1971,655,2072
311750,201903,3858,11874,3121,10625,484,1787,1611,5254,2095,7041
311760,201903,606,1775,506,1593,85,343,221,581,306,924
311770,201903,1957,5824,1531,5014,288,1027,610,1888,898,2915
311780,201903,1264,3765,863,2916,176,683,234,680,410,1363
311783,201903,2184,6215,1801,5526,60,277,1428,4232,1488,4509
311787,201903,681,2002,496,1587,77,275,182,502,259,777
311790,201903,1426,3782,930,2926,226,787,295,889,521,1676
311800,201903,4727,14550,3852,12636,751,2702,675,2016,1426,4718
311810,201903,955,2989,751,2603,62,255,453,1553,515,1808
311820,201903,768,1972,570,1638,82,264,314,846,396,1110
311830,201903,8133,23994,5638,18506,1589,5558,657,2059,2246,7617
311840,201903,3162,8511,2694,7835,284,911,1944,5576,2228,6487
311850,201903,310,861,254,764,16,48,162,477,178,525
311860,201903,55503,144357,42697,122533,6773,20712,23378,64826,30151,85538
311870,201903,1974,5300,1275,4026,209,741,457,1282,666,2023
311880,201903,6188,16469,5237,15127,332,912,3976,11605,4308,12517
311890,201903,1543,3925,1203,3429,107,362,799,2175,906,2537
311900,201903,719,1894,548,1651,68,241,358,1040,426,1281
311910,201903,4141,10792,3121,9446,593,1782,1608,4991,2201,6773
311920,201903,1984,5626,1595,5010,154,477,945,3003,1099,3480
311930,201903,3209,8060,2451,6958,892,2725,727,1932,1619,4657
311940,201903,13874,37796,10317,31000,1549,5121,4690,13238,6239,18359
311950,201903,2132,6046,1595,5114,94,425,1067,3324,1161,3749
311960,201903,552,1372,447,1209,29,135,290,654,319,789
311970,201903,438,1430,293,1065,60,248,63,194,123,442
311980,201903,420,1184,222,766,32,122,61,206,93,328
311990,201903,534,1317,354,1063,77,275,149,411,226,686
311995,201903,975,2761,520,1703,21,69,57,127,78,196
312000,201903,581,1565,479,1414,32,115,335,987,367,1102
312010,201903,883,2519,678,2166,68,249,398,1221,466,1470
312015,201903,1316,3986,1174,3735,68,305,898,2758,966,3063
312020,201903,1143,3603,923,3184,240,872,301,1003,541,1875
312030,201903,2030,5054,1785,4769,31,130,1635,4320,1666,4450
312040,201903,780,2520,595,2092,64,243,256,875,320,1118
312050,201903,1236,4001,966,3436,224,929,259,806,483,1735
312060,201903,835,2136,555,1764,137,448,251,794,388,1242
312070,201903,872,2561,615,2050,66,250,310,993,376,1243
312080,201903,2733,6866,2044,5830,140,465,1290,3486,1430,3951
312083,201903,873,2371,665,2039,67,238,419,1233,486,1471
312087,201903,2319,6302,1931,5705,70,247,1484,4388,1554,4635
312090,201903,9332,25551,7161,21956,1285,4314,3290,9894,4575,14208
312100,201903,1575,4747,1157,3975,133,591,543,1778,676,2369
312110,201903,1003,3204,845,2879,223,866,254,775,477,1641
312120,201903,724,2063,517,1700,158,600,160,440,318,1040
312125,201903,1579,4287,1331,3910,128,408,942,2679,1070,3087
312130,201903,909,2286,668,1881,63,196,270,714,333,910
312140,201903,740,2216,612,1949,132,454,246,716,378,1170
312150,201903,451,1292,386,1147,11,55,280,762,291,817
312160,201903,7855,22789,6013,19443,901,3334,2664,8117,3565,11451
312170,201903,874,2393,666,2009,40,138,452,1320,492,1458
312180,201903,1351,3759,1073,3207,160,513,546,1553,706,2066
312190,201903,566,1688,400,1347,83,296,85,280,168,576
312200,201903,4713,12784,3726,11200,811,2516,1832,5501,2643,8017
312210,201903,1356,3206,971,2634,52,185,675,1773,727,1958
312220,201903,1850,5771,1587,5271,127,470,969,3210,1096,3680
312230,201903,11735,31689,7769,24295,2130,7309,1311,3636,3441,10945
312235,201903,1795,4858,1458,4334,100,352,1021,2968,1121,3320
312240,201903,674,2205,507,1854,111,435,147,528,258,963
312245,201903,2524,6778,2094,6112,81,290,1674,4846,1755,5136
312247,201903,904,2300,636,1893,134,420,307,914,441,1334
312250,201903,953,2506,612,1843,98,302,242,720,340,1022
312260,201903,905,2592,734,2313,53,219,510,1545,563,1764
312270,201903,699,1963,537,1643,32,138,291,808,323,946
312280,201903,422,1247,324,1065,100,334,37,111,137,445
312290,201903,720,2215,582,1939,128,478,194,625,322,1103
312300,201903,905,2719,628,2085,168,605,117,311,285,916
312310,201903,764,2541,643,2300,106,429,279,967,385,1396
312320,201903,1752,4668,1286,3850,367,1168,246,681,613,1849
312330,201903,856,2557,689,2229,66,227,453,1422,519,1649
312340,201903,250,664,180,549,42,147,67,186,109,333
312350,201903,278,587,209,511,23,65,141,328,164,393
312352,201903,1635,4880,1426,4516,114,382,872,2912,986,3294
312360,201903,2494,7477,1835,6098,393,1410,468,1490,861,2900
312370,201903,1720,4775,1435,4274,249,857,726,2047,975,2904
312380,201903,2189,5049,1819,4578,16,43,1626,4071,1642,4114
312385,201903,1271,3595,990,3069,149,536,480,1394,629,1930
312390,201903,1872,5590,1411,4714,229,839,489,1490,718,2329
312400,201903,2804,8432,2253,7368,739,2540,655,2178,1394,4718
312410,201903,11400,32649,9357,29082,1815,5892,4698,14385,6513,20277
312420,201903,3618,10307,3072,9346,573,1872,1605,4775,2178,6647
312430,201903,7997,21385,6386,18534,558,1818,4224,11992,4782,13810
312440,201903,903,2954,695,2456,352,1310,70,208,422,1518
312450,201903,1175,3567,892,3031,255,914,296,1031,551,1945
312460,201903,422,1124,288,909,37,142,160,512,197,654
312470,201903,493,1236,318,934,53,190,119,296,172,486
312480,201903,1159,2950,805,2444,113,364,406,1185,519,1549
312490,201903,2056,5102,1557,4337,223,627,798,2160,1021,2787
312500,201903,866,2221,695,1970,53,190,459,1273,512,1463
312510,201903,3613,9889,2704,8157,689,2018,835,2522,1524,4540
312520,201903,154,487,137,455,38,122,64,212,102,334
312530,201903,575,1486,494,1385,20,67,434,1216,454,1283
312540,201903,1480,4328,978,3226,171,614,472,1517,643,2131
312550,201903,760,2090,557,1652,40,128,358,984,398,1112
312560,201903,1955,5078,1596,4548,69,257,1251,3536,1320,3793
312570,201903,2140,5606,1661,4969,518,1627,611,1861,1129,3488
312580,201903,585,1707,440,1390,62,222,193,568,255,790
312590,201903,1631,4903,1327,4310,125,527,754,2289,879,2816
312595,201903,1632,5106,1450,4781,305,941,835,2911,1140,3852
312600,201903,986,2460,531,1716,79,299,182,593,261,892
312610,201903,6381,16669,4046,12255,617,2070,1289,3661,1906,5731
312620,201903,2469,6399,1799,5476,59,270,1408,4336,1467,4606
312630,201903,266,833,200,706,39,164,78,263,117,427
312640,201903,572,1568,378,1239,54,181,124,429,178,610
312650,201903,2091,5499,1413,4183,85,269,948,2663,1033,2932
312660,201903,1347,3343,1009,2788,91,322,672,1759,763,2081
312670,201903,4954,13530,4058,12101,242,1031,2824,8007,3066,9038
312675,201903,1208,3367,980,2996,65,268,759,2252,824,2520
312680,201903,1370,3920,1144,3588,71,317,897,2715,968,3032
312690,201903,2443,5715,1930,5061,101,304,1559,3988,1660,4292
312695,201903,944,2756,804,2513,58,174,606,1916,664,2090
312700,201903,2061,5541,1473,4449,165,572,805,2336,970,2908
312705,201903,1305,3369,1086,3023,21,85,924,2526,945,2611
312707,201903,1394,4187,1082,3595,77,390,654,2029,731,2419
312710,201903,6339,14659,3687,10504,1054,3252,953,2789,2007,6041
312720,201903,1036,2923,764,2464,95,340,423,1311,518,1651
312730,201903,1623,3947,1188,3353,97,308,704,1916,801,2224
312733,201903,1456,3865,1101,3212,39,142,730,2039,769,2181
312735,201903,647,1778,546,1586,71,244,357,929,428,1173
312737,201903,829,1958,555,1547,80,263,306,770,386,1033
312738,201903,588,1581,414,1268,64,229,193,545,257,774
312740,201903,424,1074,241,762,62,210,55,137,117,347
312750,201903,1330,4270,1070,3753,186,742,420,1378,606,2120
312760,201903,1822,5533,1317,4492,254,921,433,1418,687,2339
312770,201903,43093,105477,26898,77961,6209,19054,8230,23478,14439,42532
312780,201903,2425,7540,2052,6898,230,889,1300,4332,1530,5221
312790,201903,263,653,164,517,11,55,55,139,66,194
312800,201903,4822,14139,3765,12053,837,2915,1445,4489,2282,7404
312810,201903,1675,4565,1090,3562,269,993,333,957,602,1950
312820,201903,1778,4913,1461,4314,60,231,1043,2984,1103,3215
312825,201903,1336,3204,1145,2948,26,91,960,2430,986,2521
312830,201903,2305,6688,1489,5092,346,1327,352,1173,698,2500
312840,201903,1172,3442,911,2949,134,533,398,1195,532,1728
312850,201903,851,2170,601,1781,48,192,319,862,367,1054
312860,201903,1307,3348,864,2646,234,762,226,671,460,1433
312870,201903,6317,17573,3808,12466,638,2277,882,2727,1520,5004
312880,201903,1399,3612,1109,3148,52,194,614,1741,666,1935
312890,201903,2056,5454,1419,4309,153,487,625,1923,778,2410
312900,201903,1179,3159,948,2855,86,283,555,1759,641,2042
312910,201903,1611,3012,830,1982,143,307,311,708,454,1015
312920,201903,1020,2821,692,2239,158,596,267,785,425,1381
312930,201903,2124,5575,1699,4928,365,1104,733,2102,1098,3206
312940,201903,903,2568,713,2263,97,357,342,1056,439,1413
312950,201903,3086,7850,2018,6070,529,1725,668,1926,1197,3651
312960,201903,1886,5021,1576,4561,108,312,1172,3475,1280,3787
312965,201903,1655,4893,1404,4437,143,459,896,2811,1039,3270
312970,201903,1125,3287,873,2856,177,690,410,1224,587,1914
312980,201903,22002,63106,18049,55843,3064,10610,9416,27568,12480,38178
312990,201903,444,1181,272,884,57,220,116,361,173,581
313000,201903,420,1252,331,1096,38,163,177,549,215,712
313005,201903,2553,7452,2179,6822,142,484,1592,4866,1734,5350
313010,201903,4632,13339,3778,11881,686,2425,2172,6587,2858,9012
313020,201903,907,2793,601,2095,103,386,99,296,202,682
313030,201903,1184,2887,790,2265,93,346,469,1257,562,1603
313040,201903,772,2443,629,2120,59,247,345,1092,404,1339
313050,201903,1731,4996,1222,4234,216,900,350,1071,566,1971
313055,201903,1821,5118,1648,4848,52,176,1387,4046,1439,4222
313060,201903,941,2424,639,1924,214,720,134,342,348,1062
313065,201903,1648,5158,1460,4838,87,379,1073,3432,1160,3811
313070,201903,954,2526,713,2087,77,242,420,1207,497,1449
313080,201903,367,1022,267,831,66,234,85,210,151,444
313090,201903,4698,13180,4023,11998,600,1976,2389,6961,2989,8937
313100,201903,1404,3712,1069,3212,54,204,756,2232,810,2436
313110,201903,1497,4041,1054,3231,95,358,581,1641,676,1999
313115,201903,2448,7435,2060,6684,314,1124,1027,3123,1341,4247
313120,201903,3660,8819,2721,7574,299,914,1658,4588,1957,5502
313130,201903,28027,75961,21876,64175,2913,9668,11612,32069,14525,41737
313140,201903,565,1300,352,980,26,87,235,636,261,723
313150,201903,1356,3924,992,3204,279,951,267,809,546,1760
313160,201903,984,2578,755,2183,48,174,538,1491,586,1665
313170,201903,11278,33557,7972,27072,1475,5363,2901,9298,4376,14661
313180,201903,2216,6033,1554,4680,211,696,807,2352,1018,3048
313190,201903,4257,12494,3109,10122,581,2000,1049,3169,1630,5169
313200,201903,1073,3077,930,2825,27,116,772,2253,799,2369
313210,201903,3746,11192,3068,9942,416,1476,1765,5540,2181,7016
313220,201903,1750,4713,1171,3613,193,673,413,1114,606,1787
313230,201903,2956,8336,2484,7763,92,324,2042,6439,2134,6763
313240,201903,8833,22492,5500,17016,1028,3624,2253,6446,3281,10070
313250,201903,5772,17373,4602,15144,629,2188,2370,7681,2999,9869
313260,201903,604,1605,423,1260,50,181,204,566,254,747
313270,201903,5514,15079,4430,13365,681,2145,2665,8077,3346,10222
313280,201903,423,1217,282,919,40,131,109,347,149,478
313290,201903,838,2708,652,2411,231,921,197,705,428,1626
313300,201903,1560,4493,1139,3684,323,1108,209,590,532,1698
313310,201903,1043,3188,833,2732,144,541,211,579,355,1120
313320,201903,2130,5686,1474,4626,299,1057,638,1991,937,3048
313330,201903,3957,10917,3059,9515,212,891,1973,5937,2185,6828
313340,201903,1309,3024,932,2488,109,294,641,1708,750,2002
313350,201903,2157,6189,1455,4696,223,825,551,1600,774,2425
313360,201903,1294,3315,884,2638,150,523,450,1257,600,1780
313370,201903,1286,3819,1135,3528,148,541,654,1896,802,2437
313375,201903,1681,4445,1052,3321,206,747,239,707,445,1454
313380,201903,5687,14839,4015,11713,826,2628,1681,4434,2507,7062
313390,201903,867,2842,763,2671,56,266,489,1623,545,1889
313400,201903,3614,9295,2862,8280,197,630,2177,6147,2374,6777
313410,201903,1284,3451,979,2908,71,236,703,2051,774,2287
313420,201903,14941,34003,7534,21391,1663,5178,1000,2896,2663,8074
313430,201903,855,2528,644,2110,106,410,268,803,374,1213
313440,201903,5890,12997,3862,10314,314,911,2494,6607,2808,7518
313450,201903,613,1756,445,1415,94,329,143,394,237,723
313460,201903,2117,6311,1701,5646,356,1366,778,2434,1134,3800
313470,201903,2974,7616,2364,6757,243,677,1554,4494,1797,5171
313480,201903,881,2590,504,1730,85,310,124,388,209,698
313490,201903,1665,3927,799,2553,266,969,80,262,346,1231
313500,201903,420,1269,331,1058,44,148,122,357,166,505
313505,201903,9559,25854,8156,23979,314,1168,6692,19539,7006,20707
313507,201903,1468,3847,1209,3458,33,133,972,2726,1005,2859
313510,201903,12394,34889,10187,30808,1299,4244,5184,15222,6483,19466
313520,201903,13402,39187,10940,34841,775,2905,7798,24334,8573,27239
313530,201903,524,1517,409,1299,21,77,201,602,222,679
313535,201903,2340,6504,2028,5922,146,409,1436,4146,1582,4555
313540,201903,793,2455,604,1976,116,371,230,720,346,1091
313545,201903,1182,4007,1008,3645,170,648,543,1896,713,2544
313550,201903,1728,5344,1448,4711,363,1311,659,2025,1022,3336
313560,201903,2561,5201,1901,4398,68,145,1615,3715,1683,3860
313570,201903,955,2933,774,2591,190,685,301,964,491,1649
313580,201903,5442,14716,4144,12529,547,1790,2296,7061,2843,8851
313590,201903,951,2746,732,2424,229,821,292,992,521,1813
313600,201903,3750,10429,3137,9447,106,417,2580,7636,2686,8053
313610,201903,983,2558,790,2208,103,297,478,1285,581,1582
313620,201903,5512,14924,4357,12912,700,2271,2291,6571,2991,8842
313630,201903,8190,20673,5671,16788,703,2411,3084,8964,3787,11375
313640,201903,970,2382,614,1895,174,584,207,622,381,1206
313650,201903,1768,5390,1461,4877,103,412,957,3210,1060,3622
313652,201903,775,2569,710,2418,124,474,420,1383,544,1857
313655,201903,1084,2935,871,2640,55,194,664,1995,719,2189
313657,201903,1248,3381,968,2922,48,205,698,1999,746,2204
313660,201903,851,2448,689,2139,94,361,384,1093,478,1454
313665,201903,4529,12508,3514,10710,522,1810,1976,5738,2498,7548
313670,201903,44718,113881,28852,86310,5054,16617,11599,32806,16653,49423
313680,201903,991,2706,831,2458,65,219,535,1518,600,1737
313690,201903,815,2672,644,2319,146,556,196,670,342,1226
313695,201903,1699,4820,1312,4181,93,330,901,2855,994,3185
313700,201903,3042,9985,2665,9494,254,968,2030,7216,2284,8184
313710,201903,1333,3256,957,2709,91,274,641,1807,732,2081
313720,201903,5264,14827,3824,11920,594,2085,1625,4664,2219,6749
313730,201903,1281,3045,981,2645,82,200,646,1710,728,1910
313740,201903,1669,5979,1350,5166,343,1483,213,695,556,2178
313750,201903,1878,5267,1457,4436,315,1057,580,1644,895,2701
313753,201903,2139,5185,1428,4047,152,474,819,2219,971,2693
313760,201903,4962,14012,3688,11511,843,2809,1389,4114,2232,6923
313770,201903,3695,10613,2957,9461,224,794,2069,6639,2293,7433
313780,201903,4009,10962,2941,9127,294,1070,784,2482,1078,3552
313790,201903,474,1503,418,1395,57,210,224,716,281,926
313800,201903,1329,3175,1000,2679,143,435,532,1326,675,1761
313810,201903,1576,4168,1248,3692,75,284,905,2628,980,2912
313820,201903,14341,34869,9503,26206,1558,4697,3424,9076,4982,13773
313830,201903,355,1012,267,844,56,191,111,322,167,513
313835,201903,898,2731,728,2401,78,302,356,1107,434,1409
313840,201903,6437,17242,4613,14085,1221,3943,954,2974,2175,6917
313850,201903,933,2345,750,2079,122,414,391,968,513,1382
313860,201903,2561,7146,1886,5792,310,1051,723,2070,1033,3121
313862,201903,1528,3420,774,2244,68,211,390,1072,458,1283
313865,201903,2268,6278,1947,5764,135,412,1459,4237,1594,4649
313867,201903,1112,3531,936,3191,253,916,468,1575,721,2491
313868,201903,1662,5169,1401,4673,68,319,1054,3390,1122,3709
313870,201903,767,2137,569,1783,117,392,188,529,305,921
313880,201903,1444,3910,1055,3254,187,653,461,1273,648,1926
313890,201903,1971,4517,1447,3839,87,271,997,2617,1084,2888
313900,201903,3698,11298,2762,9403,753,2821,665,2113,1418,4934
313910,201903,591,1811,434,1507,104,391,86,288,190,679
313920,201903,2847,9163,2393,8224,501,1712,1161,4029,1662,5741
313925,201903,1581,4149,1267,3567,215,582,764,2148,979,2730
313930,201903,4845,14788,3942,13163,338,1293,2569,8435,2907,9728
313940,201903,8105,24251,5810,20159,1113,4527,1364,5157,2477,9684
313950,201903,4833,11153,3485,9408,475,1643,2092,5468,2567,7111
313960,201903,5309,13474,3618,10571,790,2554,1203,3249,1993,5803
313970,201903,1333,3812,1176,3540,34,132,749,2236,783,2368
313980,201903,1329,3542,862,2781,128,483,313,951,441,1434
313990,201903,1762,5872,1293,4752,352,1435,375,1222,727,2657
314000,201903,9381,25318,7913,22762,534,1978,5352,15084,5886,17062
314010,201903,1338,3375,1078,3011,41,147,818,2210,859,2357
314015,201903,2054,5753,1575,4991,222,858,815,2473,1037,3331
314020,201903,489,1358,291,967,58,240,50,174,108,414
314030,201903,752,2244,597,1940,74,248,296,944,370,1192
314040,201903,642,1751,517,1512,96,310,255,711,351,1021
314050,201903,1668,4568,1207,3701,169,611,600,1699,769,2310
314053,201903,1791,5415,1438,4720,257,818,739,2540,996,3358
314055,201903,2296,6310,1965,5811,53,209,1596,4731,1649,4940
314060,201903,1210,3301,918,2829,44,164,623,1895,667,2059
314070,201903,4428,12499,3478,10752,758,2406,1441,4346,2199,6752
314080,201903,2121,5747,1350,4299,207,794,477,1321,684,2115
314085,201903,2042,6151,1686,5590,328,1134,843,2828,1171,3962
314090,201903,4028,11631,3415,10651,249,994,2247,6923,2496,7917
314100,201903,3129,7494,2444,6545,75,198,1887,5074,1962,5272
314110,201903,4195,12376,3466,10926,464,1667,1845,5438,2309,7105
314120,201903,765,1770,325,989,79,288,57,167,136,455
314130,201903,686,1859,389,1258,38,148,193,607,231,755
314140,201903,4576,13355,3517,11242,564,1908,1597,4981,2161,6889
314150,201903,1458,3745,1087,3101,96,295,718,1963,814,2258
314160,201903,2213,6012,1599,4907,252,841,644,1995,896,2836
314170,201903,994,2847,793,2438,71,247,473,1359,544,1606
314180,201903,5314,15243,4367,13688,415,1481,2523,7852,2938,9333
314190,201903,599,1574,427,1315,93,331,180,495,273,826
314200,201903,2836,8206,2333,7321,143,580,1646,4974,1789,5554
314210,201903,1935,5188,1527,4448,141,438,828,2355,969,2793
314220,201903,1270,3626,905,2967,222,845,298,895,520,1740
314225,201903,1112,3230,948,2975,80,251,684,2160,764,2411
314230,201903,764,2044,632,1880,88,281,379,1169,467,1450
314240,201903,1050,2873,816,2538,189,631,321,1007,510,1638
314250,201903,513,1448,323,1056,49,177,124,370,173,547
314260,201903,929,2764,751,2479,171,630,368,1151,539,1781
314270,201903,3148,9131,2581,8233,109,430,1885,5924,1994,6354
314280,201903,3241,7636,2074,5799,291,897,950,2496,1241,3393
314290,201903,4407,11679,3678,10418,361,1040,2476,6898,2837,7938
314300,201903,1690,5033,1172,3868,269,972,353,1121,622,2093
314310,201903,4388,11875,3069,9580,953,3171,567,1654,1520,4825
314315,201903,892,3200,771,2932,62,302,526,1920,588,2222
314320,201903,2712,7483,1763,5731,366,1258,648,2082,1014,3340
314330,201903,46557,131856,35173,112111,10239,34072,7802,25794,18041,59866
314340,201903,2252,5684,1245,3815,270,969,285,701,555,1670
314345,201903,1363,4180,1135,3768,157,541,661,2152,818,2693
314350,201903,889,2522,601,1993,131,481,158,488,289,969
314360,201903,564,1652,349,1189,63,237,96,304,159,541
314370,201903,690,1910,540,1669,34,143,386,1139,420,1282
314380,201903,1104,3165,756,2488,187,701,145,468,332,1169
314390,201903,11921,31717,7715,23720,1671,5484,2158,5930,3829,11414
314400,201903,3976,11916,3092,10291,843,2925,1102,3773,1945,6698
314410,201903,2699,7643,1838,5980,284,1047,650,2206,934,3253
314420,201903,786,1945,601,1696,17,84,449,1203,466,1287
314430,201903,6874,17900,4921,14441,855,2643,2020,5697,2875,8340
314435,201903,1537,4321,1240,3816,50,207,917,2766,967,2973
314437,201903,940,2454,658,1980,56,205,324,952,380,1157
314440,201903,582,1698,420,1380,113,404,93,263,206,667
314450,201903,1317,3638,1097,3289,111,384,669,1925,780,2309
314460,201903,3334,10341,2390,8264,606,2236,433,1459,1039,3695
314465,201903,2195,6483,1900,5902,55,250,1448,4310,1503,4560
314467,201903,814,2277,702,2080,25,84,565,1641,590,1725
314470,201903,2190,6455,1753,5516,329,1141,760,2216,1089,3357
314480,201903,5903,17611,4252,14003,770,2775,1265,3762,2035,6537
314490,201903,961,2698,714,2171,79,275,415,1219,494,1494
314500,201903,1603,4121,1167,3432,220,667,491,1435,711,2102
314505,201903,1945,4917,1614,4454,106,319,1171,3162,1277,3481
314510,201903,1800,4810,1241,3944,260,904,537,1663,797,2567
314520,201903,4162,13135,2944,10385,576,2232,357,1115,933,3347
314530,201903,5428,18007,4875,16918,447,1828,3383,11508,3830,13336
314535,201903,2574,6830,2094,6116,127,495,1569,4484,1696,4979
314537,201903,1095,3193,845,2757,61,237,592,1890,653,2127
314540,201903,418,1098,288,854,24,92,143,396,167,488
314545,201903,1727,4423,1531,4169,46,136,1271,3582,1317,3718
314550,201903,649,1622,485,1384,38,152,256,650,294,802
314560,201903,3919,12226,2953,10069,504,1828,930,2980,1434,4808
314570,201903,291,821,225,701,29,107,104,323,133,430
314580,201903,444,1368,337,1148,92,319,76,274,168,593
314585,201903,656,2102,499,1736,64,282,247,799,311,1081
314587,201903,1975,5550,1505,4797,208,593,832,2723,1040,3316
314590,201903,3453,9799,2427,7792,393,1415,910,2728,1303,4143
314600,201903,1808,5137,1069,3661,227,851,116,348,343,1199
314610,201903,8525,22574,5971,18743,1210,4416,2400,7297,3610,11713
314620,201903,2093,5101,1632,4494,62,224,1325,3547,1387,3771
314625,201903,1486,4307,1265,3993,61,328,1022,3113,1083,3441
314630,201903,5088,13474,4187,12207,120,489,3458,10074,3578,10563
314640,201903,629,1569,441,1256,79,254,212,549,291,803
314650,201903,867,2138,545,1622,49,178,262,693,311,871
314655,201903,1541,4363,1112,3569,215,690,491,1552,706,2242
314660,201903,328,789,211,563,8,14,126,318,134,332
314670,201903,1659,3862,1160,3152,37,129,718,1930,755,2059
314675,201903,1727,4706,1470,4264,103,383,1116,3123,1219,3506
314690,201903,2056,5982,1578,5223,482,1719,429,1441,911,3160
314700,201903,9772,28435,6256,21260,1308,4904,1576,5184,2884,10088
314710,201903,7438,21265,5305,16821,1171,4067,1273,3594,2444,7661
314720,201903,2086,6330,1448,4990,326,1240,353,1187,679,2427
314730,201903,2047,5823,1474,4673,375,1234,352,1090,727,2324
314740,201903,2751,7893,2179,6884,291,1032,1115,3436,1406,4468
314750,201903,320,888,250,751,20,74,132,358,152,432
314760,201903,1827,5665,1191,4159,180,726,301,872,481,1598
314770,201903,1068,3199,539,1782,53,186,138,403,191,589
314780,201903,350,854,229,675,49,167,113,294,162,461
314790,201903,9525,26360,6541,20899,1726,6247,1796,5316,3522,11563
314795,201903,1435,3889,1208,3515,44,190,935,2599,979,2789
314800,201903,10657,27600,6206,19187,1246,4173,1235,3456,2481,7629
314810,201903,8367,23093,6134,19151,1707,5626,1794,5651,3501,11277
314820,201903,970,2509,751,2157,67,267,472,1277,539,1544
314830,201903,1458,4548,1228,4080,277,982,554,1828,831,2810
314840,201903,883,2881,686,2554,64,333,462,1640,526,1973
314850,201903,1895,4733,1547,4244,45,161,1329,3629,1374,3790
314860,201903,3119,9648,2597,8607,363,1385,1582,5058,1945,6443
314870,201903,6107,16273,4713,14344,356,1196,3396,10348,3752,11544
314875,201903,1722,5270,1534,5016,116,334,1232,4080,1348,4414
314880,201903,881,2157,689,1887,32,88,460,1307,492,1395
314890,201903,407,1196,294,944,51,185,110,319,161,504
314900,201903,624,1706,480,1452,105,338,184,553,289,891
314910,201903,1629,4787,1223,4126,260,1017,584,1850,844,2867
314915,201903,2214,6689,1872,6087,140,514,1239,3922,1379,4436
314920,201903,465,1206,295,944,11,42,198,629,209,671
314930,201903,5080,15020,3863,12702,786,2806,1377,4301,2163,7107
314940,201903,400,1060,338,950,37,98,203,535,240,633
314950,201903,445,1172,280,898,27,120,123,343,150,463
314960,201903,799,2051,628,1733,42,132,442,1150,484,1282
314970,201903,756,2231,604,1951,102,360,292,901,394,1261
314980,201903,1312,3533,948,2958,248,879,306,927,554,1806
314990,201903,2281,6702,1539,4975,341,1221,319,887,660,2108
314995,201903,1617,4645,1289,4047,72,306,825,2465,897,2771
315000,201903,1080,2889,777,2402,69,224,499,1491,568,1715
315010,201903,387,1110,283,913,49,197,124,366,173,563
315015,201903,2178,6363,1927,5952,196,688,1259,3843,1455,4531
315020,201903,765,2323,566,1881,71,291,240,706,311,997
315030,201903,577,1611,377,1218,97,329,78,234,175,563
315040,201903,812,2401,694,2119,94,312,437,1331,531,1643
315050,201903,1110,2945,845,2550,71,282,459,1342,530,1624
315053,201903,1142,3047,879,2576,70,228,503,1422,573,1650
315057,201903,1600,5145,1383,4716,171,601,877,3024,1048,3625
315060,201903,572,1781,408,1439,77,286,96,326,173,612
315070,201903,558,1502,397,1209,100,341,104,280,204,621
315080,201903,2550,7823,2004,6689,383,1315,992,3248,1375,4563
315090,201903,777,2437,577,2027,103,384,195,649,298,1033
315100,201903,1152,3552,721,2536,136,538,283,886,419,1424
315110,201903,1557,4075,1182,3448,137,407,577,1702,714,2109
315120,201903,11623,27812,8320,22806,1146,3074,4253,12120,5399,15194
315130,201903,1288,3795,1040,3315,159,594,397,1181,556,1775
315140,201903,2798,7945,2135,6725,422,1491,1032,3022,1454,4513
315150,201903,4146,10432,2908,8372,457,1475,1280,3556,1737,5031
315160,201903,1581,4020,1014,3082,215,659,423,1270,638,1929
315170,201903,1390,4457,941,3360,233,856,170,605,403,1461
315180,201903,16444,41280,8524,25990,1261,4425,2355,6286,3616,10711
315190,201903,2052,4721,1619,4144,206,546,1190,3016,1396,3562
315200,201903,3626,10750,2641,8924,801,2918,612,2010,1413,4928
315210,201903,7926,21241,5619,16299,718,2299,2584,6790,3302,9089
315213,201903,1119,3018,964,2796,27,83,767,2208,794,2291
315217,201903,2500,7805,1989,6904,100,482,1322,4430,1422,4912
315220,201903,7912,22099,6356,19401,1601,5184,2364,7188,3965,12372
315230,201903,3078,7320,2591,6728,124,256,2033,5521,2157,5777
315240,201903,2297,7071,1986,6501,504,1772,1006,3214,1510,4986
315250,201903,10658,30043,7829,24741,1356,4654,3298,10013,4654,14667
315260,201903,973,2817,520,1751,88,292,41,118,129,410
315270,201903,783,2347,530,1840,78,311,153,439,231,750
315280,201903,2801,7127,1614,4886,375,1221,251,750,626,1971
315290,201903,1187,3035,713,2276,204,708,185,600,389,1308
315300,201903,693,1684,446,1335,141,472,150,452,291,924
315310,201903,1289,3735,959,3096,80,284,529,1602,609,1886
315320,201903,694,2041,487,1639,61,262,209,644,270,906
315330,201903,740,2598,415,1683,74,326,117,419,191,745
315340,201903,3127,7847,2314,6673,144,481,1481,4227,1625,4708
315350,201903,1511,4212,1146,3596,173,604,602,1850,775,2454
315360,201903,1648,5073,1195,4065,192,698,460,1484,652,2182
315370,201903,441,1315,348,1114,66,209,143,446,209,655
315380,201903,174,536,128,427,34,118,21,46,55,164
315390,201903,1160,3436,874,2873,174,643,332,1002,506,1645
315400,201903,3997,11349,3138,9747,469,1534,1570,4699,2039,6233
315410,201903,2276,5315,1761,4573,445,1264,401,1040,846,2304
315415,201903,1202,3406,960,3026,221,829,399,1239,620,2068
315420,201903,1135,3311,735,2536,147,523,101,332,248,855
315430,201903,3528,8845,2477,7214,477,1655,986,2645,1463,4300
315440,201903,978,2670,791,2349,87,320,436,1191,523,1511
315445,201903,2012,4937,1437,4091,121,383,991,2782,1112,3165
315450,201903,2175,6310,1808,5719,252,772,1121,3581,1373,4353
315460,201903,32364,94393,26840,84269,5810,19965,11983,35488,17793,55453
315470,201903,455,1294,366,1138,41,156,203,590,244,746
315480,201903,1285,3776,882,2906,178,612,265,852,443,1464
315490,201903,2977,7455,2004,5966,262,819,737,2155,999,2974
315500,201903,491,1364,294,922,33,132,125,335,158,467
315510,201903,1249,3452,1072,3178,28,138,912,2626,940,2764
315520,201903,1060,2975,827,2577,57,215,590,1786,647,2001
315530,201903,607,1827,470,1553,165,589,175,547,340,1136
315540,201903,1326,3669,904,2857,113,434,378,1152,491,1586
315550,201903,1831,4950,1225,3879,280,1016,330,983,610,1999
315560,201903,6197,19486,5347,17900,346,1190,3525,11887,3871,13077
315570,201903,1850,5307,1555,4788,99,418,916,2690,1015,3108
315580,201903,2279,5818,1729,4926,351,1125,594,1644,945,2769
315590,201903,900,2430,716,2135,98,348,346,966,444,1314
315600,201903,2363,7764,1736,6524,269,1015,926,3593,1195,4608
315610,201903,894,2318,685,1916,131,439,296,704,427,1143
315620,201903,312,1005,285,966,43,160,171,591,214,751
315630,201903,873,2454,699,2152,154,525,248,682,402,1207
315640,201903,331,878,275,804,30,107,170,468,200,575
315645,201903,948,2508,628,1959,155,529,162,470,317,999
315650,201903,1705,4379,1368,3892,44,181,1110,3047,1154,3228
315660,201903,2452,6034,1830,4961,118,340,1272,3309,1390,3649
315670,201903,13291,37914,10302,32417,2225,7357,4380,13341,6605,20698
315680,201903,3003,9163,2198,7559,381,1447,953,3139,1334,4586
315690,201903,2521,6696,1652,5114,389,1228,500,1707,889,2935
315700,201903,7507,21566,5709,17935,995,3319,2510,7560,3505,10879
315710,201903,1843,4727,1330,3931,61,268,911,2550,972,2818
315720,201903,4214,12177,3557,10976,198,886,2484,7328,2682,8214
315725,201903,1848,5277,1438,4476,164,504,941,2983,1105,3487
315727,201903,531,1427,395,1189,58,197,156,449,214,646
315730,201903,622,1923,545,1770,66,243,242,748,308,991
315733,201903,1390,3626,955,2839,150,541,353,984,503,1525
315737,201903,1090,3228,866,2796,48,197,596,1860,644,2057
315740,201903,921,2636,720,2217,113,410,393,1107,506,1517
315750,201903,1231,3370,992,2968,86,271,633,1907,719,2178
315760,201903,1209,2889,1106,2765,48,125,954,2369,1002,2494
315765,201903,1854,5000,1524,4573,35,114,1323,3967,1358,4081
315770,201903,1000,3059,843,2838,324,1202,241,751,565,1953
315780,201903,27352,77972,23018,70132,1965,7330,14527,42157,16492,49487
315790,201903,3532,11086,3022,10122,222,767,1986,6800,2208,7567
315800,201903,1185,4418,841,3438,158,715,190,715,348,1430
315810,201903,1321,3312,1107,2985,55,198,872,2220,927,2418
315820,201903,2502,7181,2053,6479,219,778,1374,4256,1593,5034
315830,201903,1050,3093,767,2565,68,271,312,975,380,1246
315840,201903,798,1996,501,1446,55,187,231,609,286,796
315850,201903,1103,3372,892,2999,176,651,446,1411,622,2062
315860,201903,488,1480,339,1196,75,302,91,299,166,601
315870,201903,459,1211,361,1068,34,117,241,664,275,781
315880,201903,1094,2852,728,2219,72,281,201,540,273,821
315890,201903,1557,4657,1240,4181,338,1224,566,1848,904,3072
315895,201903,5892,16383,4521,13643,510,1759,2279,6415,2789,8174
315900,201903,827,2171,715,2014,53,169,535,1451,588,1620
315910,201903,507,1510,423,1368,70,262,269,829,339,1091
315920,201903,1578,4147,835,2584,145,487,233,666,378,1153
315930,201903,1062,2492,705,1944,135,376,301,825,436,1201
315935,201903,777,2407,632,2124,125,437,210,718,335,1155
315940,201903,598,1743,483,1539,58,195,248,770,306,965
315950,201903,1159,3260,982,2970,104,306,748,2280,852,2586
315960,201903,3918,11239,2263,7861,739,2981,159,350,898,3331
315970,201903,642,1726,489,1520,64,213,322,1006,386,1219
315980,201903,4170,9298,2241,6080,411,1178,743,1854,1154,3032
315990,201903,3545,9120,2758,7806,291,889,1616,4471,1907,5360
316000,201903,524,1425,405,1253,66,251,174,499,240,750
316010,201903,798,2133,602,1811,37,135,386,1069,423,1204
316020,201903,958,2961,777,2602,79,340,472,1450,551,1790
316030,201903,2831,7932,2074,6593,238,800,1300,4192,1538,4992
316040,201903,2532,7577,1835,6203,306,1095,446,1396,752,2491
316045,201903,2039,5448,1835,5178,99,229,1518,4400,1617,4629
316050,201903,364,1083,272,914,44,166,148,475,192,641
316060,201903,668,1816,505,1563,33,145,342,978,375,1123
316070,201903,5337,15373,4398,13540,833,2688,1978,5869,2811,8557
316080,201903,715,2266,560,1940,144,542,71,230,215,772
316090,201903,416,1265,290,987,38,159,124,374,162,533
316095,201903,1271,4015,1037,3457,240,843,398,1287,638,2130
316100,201903,2462,7517,1745,5886,317,1153,560,1720,877,2873
316105,201903,848,2297,652,1994,61,206,430,1342,491,1548
316110,201903,12601,38041,10605,34592,1046,3774,6981,22588,8027,26362
316120,201903,1068,3198,669,2186,123,435,175,455,298,890
316130,201903,1189,2711,729,1980,61,207,403,1048,464,1255
316140,201903,1100,3005,726,2322,122,422,343,1078,465,1500
316150,201903,1775,4084,1463,3662,229,704,602,1378,831,2082
316160,201903,1031,2888,836,2547,67,236,530,1560,597,1796
316165,201903,902,2292,672,1925,101,344,348,939,449,1283
316170,201903,1072,2806,796,2389,75,271,495,1416,570,1687
316180,201903,1237,3612,811,2714,176,671,134,367,310,1038
316190,201903,2585,7523,1518,4935,239,784,529,1496,768,2280
316200,201903,3265,9643,2332,7833,526,1974,525,1649,1051,3623
316210,201903,4274,12800,3059,10016,980,3417,388,1220,1368,4637
316220,201903,600,1832,393,1345,81,314,48,188,129,502
316225,201903,1429,3387,1086,2805,41,163,802,1931,843,2094
316230,201903,413,1122,315,967,37,112,169,536,206,648
316240,201903,5667,16696,5029,15641,435,1439,3804,11673,4239,13112
316245,201903,2904,9879,2626,9419,165,943,1962,6678,2127,7621
316250,201903,9432,23818,6654,19275,1620,5086,2033,5780,3653,10866
316255,201903,2815,8029,2443,7440,199,667,1748,5346,1947,6013
316257,201903,1223,3027,869,2457,141,407,444,1239,585,1646
316260,201903,1826,4851,1376,4122,96,309,738,2301,834,2610
316265,201903,1155,3149,896,2699,42,153,620,1818,662,1971
316270,201903,3513,11212,2998,10054,553,1959,1374,4399,1927,6358
316280,201903,2921,8817,2503,8018,373,1308,1352,4207,1725,5515
316290,201903,3267,9363,2549,7953,362,1309,994,3065,1356,4374
316292,201903,4676,12821,3835,11472,470,1597,2610,7603,3080,9200
316294,201903,772,2337,567,1980,113,453,106,352,219,805
316295,201903,2747,7927,2271,7074,133,549,1590,4700,1723,5249
316300,201903,951,2963,811,2711,57,218,546,1823,603,2041
316310,201903,937,2386,543,1714,97,358,108,284,205,642
316320,201903,588,1681,455,1442,51,199,206,616,257,815
316330,201903,1044,2913,777,2400,61,228,531,1571,592,1799
316340,201903,1018,2918,752,2401,80,327,388,1160,468,1487
316350,201903,1193,3531,1021,3244,115,383,676,2138,791,2521
316360,201903,650,1718,518,1502,57,188,364,1028,421,1216
316370,201903,4747,13239,3588,11049,731,2593,1179,3223,1910,5816
316380,201903,1620,3984,1266,3493,47,116,918,2547,965,2663
316390,201903,850,2308,607,1871,211,739,139,391,350,1130
316400,201903,1182,3431,784,2640,132,494,272,831,404,1325
316410,201903,1082,3249,910,2971,66,251,703,2246,769,2497
316420,201903,1781,5163,1558,4886,58,251,1275,3900,1333,4151
316430,201903,836,2314,523,1715,112,401,130,404,242,805
316440,201903,706,2244,549,1975,129,528,86,291,215,819
316443,201903,540,1574,412,1324,109,382,98,311,207,693
316447,201903,1817,5030,1591,4668,53,198,1287,3718,1340,3916
316450,201903,2199,6802,1682,5729,210,778,1002,3346,1212,4124
316460,201903,957,2540,766,2226,192,600,395,1087,587,1687
316470,201903,6147,18049,4506,14662,846,3149,1579,4722,2425,7871
316480,201903,205,581,171,523,33,107,82,237,115,344
316490,201903,291,782,212,639,24,82,90,234,114,316
316500,201903,1182,3886,775,2844,161,636,139,484,300,1120
316510,201903,702,2381,554,2087,116,473,239,910,355,1383
316520,201903,1047,2797,816,2399,129,452,384,1046,513,1498
316530,201903,1019,2829,751,2330,109,446,339,924,448,1370
316540,201903,759,2106,620,1896,115,414,280,785,395,1199
316550,201903,1319,4027,1144,3678,80,316,843,2652,923,2968
316553,201903,3443,10548,2352,7916,511,1862,606,1827,1117,3689
316555,201903,2487,8332,2266,8012,152,647,1725,6157,1877,6804
316556,201903,572,1400,401,1112,23,68,226,565,249,633
316557,201903,934,3094,805,2856,318,1181,225,790,543,1971
316560,201903,266,817,203,728,56,233,57,184,113,417
316570,201903,1101,3384,961,3110,253,825,351,1139,604,1964
316580,201903,399,923,252,668,48,143,110,266,158,409
316590,201903,1302,3472,940,2764,157,462,511,1434,668,1896
316600,201903,957,3033,822,2745,137,487,427,1387,564,1874
316610,201903,584,1876,489,1726,59,274,304,1016,363,1290
316620,201903,2009,5666,1736,5294,91,317,1273,3918,1364,4235
316630,201903,1534,4630,1221,4032,333,1111,473,1698,806,2809
316640,201903,140,382,111,340,22,69,52,140,74,209
316650,201903,1004,3285,804,2970,71,290,497,1870,568,2160
316660,201903,196,499,91,280,10,34,11,35,21,69
316670,201903,1820,4742,1359,3989,341,1076,458,1306,799,2382
316680,201903,2101,5506,1623,4686,139,455,1168,3282,1307,3737
316690,201903,1099,3344,906,2970,169,602,403,1300,572,1902
316695,201903,980,2917,813,2621,39,166,550,1747,589,1913
316700,201903,363,893,304,829,13,56,233,598,246,654
316710,201903,2790,9483,2130,8060,535,2139,785,2979,1320,5118
316720,201903,19903,56526,14649,46162,2936,9961,5661,16970,8597,26931
316730,201903,393,1132,314,969,56,196,138,375,194,571
316740,201903,692,2117,607,1967,60,264,392,1246,452,1510
316750,201903,393,1212,298,1009,63,231,118,372,181,603
316760,201903,3616,11657,2957,10284,1239,4624,756,2529,1995,7153
316770,201903,1525,3743,1218,3321,34,118,1028,2830,1062,2948
316780,201903,548,1688,430,1463,143,565,72,213,215,778
316790,201903,706,1912,478,1475,117,377,138,391,255,768
316800,201903,5891,17176,4767,15130,441,1635,2647,8121,3088,9756
316805,201903,988,2194,819,2013,21,40,713,1802,734,1842
316810,201903,630,1790,429,1368,88,339,204,614,292,953
316820,201903,320,796,161,499,16,55,51,162,67,217
316830,201903,677,1956,551,1741,86,332,341,1020,427,1352
316840,201903,2668,7372,2216,6578,298,1050,1339,3781,1637,4831
316850,201903,1996,5340,1435,4324,212,711,629,1841,841,2552
316860,201903,17081,46353,13017,40144,2408,8465,5891,17716,8299,26181
316870,201903,6804,19476,5100,16141,919,3229,2063,6039,2982,9268
316880,201903,785,2143,642,1943,136,460,290,857,426,1317
316890,201903,1125,2567,685,1967,127,442,371,936,498,1378
316900,201903,2230,6222,1724,5213,361,1218,567,1539,928,2757
316905,201903,509,1550,395,1323,90,326,159,536,249,862
316910,201903,851,2314,560,1818,145,534,55,163,200,697
316920,201903,1551,4036,1024,3179,189,618,413,1293,602,1911
316930,201903,7662,23299,5568,19243,1076,3985,1233,4119,2309,8104
316935,201903,3823,10721,2750,8740,580,1939,969,2982,1549,4921
316940,201903,6463,19622,4944,16316,881,3223,1712,5250,2593,8473
316950,201903,1760,4279,1358,3715,56,185,1058,2840,1114,3025
316960,201903,4881,11499,3598,9674,449,1337,2304,6010,2753,7347
316970,201903,3376,9994,2942,9137,643,2087,1085,3194,1728,5281
316980,201903,711,2162,515,1763,161,619,70,252,231,871
316990,201903,10213,28951,7245,22625,1988,6588,864,2436,2852,9024
317000,201903,2570,7926,2298,7515,164,541,1658,5458,1822,5999
317005,201903,2568,7548,2066,6498,373,1210,1028,3152,1401,4362
317010,201903,22286,53648,13698,40510,3321,10767,4136,12695,7457,23462
317020,201903,60321,146367,34121,99897,6460,20601,9488,25553,15948,46154
317030,201903,643,1787,516,1602,28,115,390,1189,418,1304
317040,201903,10337,27211,7397,22078,1800,5620,2648,8088,4448,13708
317043,201903,808,1908,598,1617,80,212,383,1064,463,1276
317047,201903,1152,2838,780,2224,116,307,444,1284,560,1591
317050,201903,1178,3725,806,2826,112,404,307,962,419,1366
317052,201903,2344,6850,1911,6121,268,920,1189,3765,1457,4685
317057,201903,1633,4163,1158,3335,57,211,706,1975,763,2186
317060,201903,437,1187,262,810,43,147,96,270,139,417
317065,201903,1228,3596,1001,3167,55,216,646,1905,701,2121
317070,201903,7549,21212,5099,16404,1124,4083,1116,3412,2240,7495
317075,201903,855,2379,585,1869,114,391,158,469,272,860
317080,201903,5864,14336,4318,11786,1358,3930,1215,3085,2573,7015
317090,201903,4320,13481,3924,12815,376,1200,2809,9157,3185,10357
317100,201903,2384,5828,1602,4623,441,1394,565,1565,1006,2959
317103,201903,1779,5582,1561,5183,159,768,1044,3230,1203,3998
317107,201903,1315,3671,1031,3104,56,243,631,1678,687,1921
317110,201903,675,1495,327,976,40,149,108,328,148,477
317115,201903,1097,3183,923,2854,58,170,650,2013,708,2183
317120,201903,12033,34646,9460,30261,1401,5087,4949,15248,6350,20335
317130,201903,9797,23730,6089,17578,1174,3737,1937,5496,3111,9233
317140,201903,644,1842,518,1635,43,151,325,1043,368,1194
317150,201903,1015,2516,785,2223,35,132,614,1684,649,1816
317160,201903,3555,8736,2393,6967,211,646,1384,4056,1595,4702
317170,201903,1896,4890,1323,3856,229,784,477,1187,706,1971
317180,201903,1721,5627,1293,4543,280,1024,343,1150,623,2174
317190,201903,1218,3385,907,2882,118,390,524,1662,642,2052
317200,201903,4892,13208,3634,10967,966,3181,729,2020,1695,5201
317210,201903,1141,2896,898,2556,40,149,644,1856,684,2005
317220,201903,275,881,240,807,63,216,86,296,149,512
320010,201903,4445,13252,3621,11643,414,1479,2285,7168,2699,8647
320013,201903,1580,4744,1140,3762,191,602,524,1773,715,2375
320016,201903,2980,7850,2373,6954,117,331,1880,5483,1997,5814
320020,201903,3841,10502,2890,8832,731,2390,974,3079,1705,5469
320030,201903,1486,4449,1033,3491,219,808,344,1100,563,1908
320035,201903,1698,4847,1420,4374,382,1274,604,1817,986,3091
320040,201903,3543,10512,2909,9316,443,1553,1534,4808,1977,6361
320050,201903,1754,4092,1512,3732,247,704,866,2071,1113,2775
320060,201903,10602,30631,7936,25276,1366,4761,3399,10309,4765,15070
320070,201903,1382,4043,1002,3269,202,720,334,1053,536,1773
320080,201903,5330,14102,3814,11131,829,2524,1342,3780,2171,6304
320090,201903,7126,19559,5013,15289,1148,3761,2070,5933,3218,9694
320100,201903,2578,7553,2048,6567,434,1489,977,3052,1411,4541
320110,201903,1342,3525,1028,2987,213,646,426,1223,639,1869
320115,201903,1750,5838,1524,5444,667,2470,469,1747,1136,4217
320120,201903,16998,45232,11759,35782,2064,6814,4673,13585,6737,20399
320130,201903,37543,109901,31643,99141,5061,17343,17529,53480,22590,70823
320140,201903,2877,8438,2143,6907,400,1469,842,2661,1242,4130
320150,201903,12603,33895,8899,26541,2530,8009,1475,4150,4005,12159
320160,201903,5276,15553,4026,13102,681,2360,1870,6021,2551,8381
320170,201903,1447,4354,1070,3574,298,1019,400,1348,698,2367
320180,201903,704,2302,563,2009,193,733,130,438,323,1171
320190,201903,2743,9035,2107,7540,513,1943,501,1749,1014,3692
320200,201903,1064,3006,769,2452,199,724,251,794,450,1518
320210,201903,4381,11497,3425,9822,582,1832,1818,4972,2400,6804
320220,201903,2616,7314,1972,6188,365,1235,951,2925,1316,4160
320225,201903,1317,4227,911,3205,346,1303,133,453,479,1756
320230,201903,4532,13082,3447,11254,828,2939,1393,4493,2221,7432
320240,201903,13475,36135,10301,30879,2288,7272,4222,12567,6510,19839
320245,201903,2861,8895,2340,7820,950,3255,538,1787,1488,5042
320250,201903,1905,5491,1274,3997,317,1135,314,867,631,2002
320255,201903,1688,5558,1491,5204,529,1874,634,2332,1163,4206
320260,201903,1002,3008,709,2298,200,717,182,493,382,1210
320265,201903,2318,7339,1949,6607,920,3271,396,1322,1316,4593
320270,201903,2168,6373,1629,5261,353,1239,713,2295,1066,3534
320280,201903,5808,16359,4737,14456,1156,3725,1762,5350,2918,9075
320290,201903,1264,3895,853,2889,239,872,201,639,440,1511
320300,201903,3457,10973,2827,9601,897,3258,572,1870,1469,5128
320305,201903,4681,13798,3740,11873,828,2810,1715,5270,2543,8080
320310,201903,1836,5273,1272,4052,247,829,537,1661,784,2490
320313,201903,2207,5817,1396,4178,324,1046,293,835,617,1881
320316,201903,1456,4253,1205,3767,193,621,694,2164,887,2785
320320,201903,20064,54339,14338,44416,3534,11445,5315,16502,8849,27947
320330,201903,2833,8004,2242,6922,541,1645,1035,3298,1576,4943
320332,201903,5372,15836,4393,14096,1086,3745,2125,6718,3211,10463
320334,201903,1846,5491,1303,4302,297,1161,281,748,578,1909
320335,201903,1600,4715,1022,3404,266,947,208,644,474,1591
320340,201903,4710,12344,3923,11113,567,1694,2180,6241,2747,7935
320350,201903,5036,12840,3513,10047,484,1497,1778,4846,2262,6343
320360,201903,1432,3724,1056,2998,149,408,509,1409,658,1817
320370,201903,2370,7708,1886,6574,565,2035,638,2177,1203,4212
320380,201903,2247,6307,1882,5680,278,904,1116,3293,1394,4197
320390,201903,7236,20256,5415,16486,1160,3714,2141,6227,3301,9941
320400,201903,3185,9304,2543,7954,691,2286,1001,3031,1692,5317
320405,201903,4311,11778,3297,10041,541,1771,1601,4810,2142,6581
320410,201903,4659,12572,3564,10800,576,1723,1839,5842,2415,7565
320420,201903,2721,7532,2134,6559,618,2085,570,1720,1188,3805
320425,201903,1947,4777,1511,4061,110,336,1014,2614,1124,2950
320430,201903,2771,7137,2162,5976,327,990,1311,3454,1638,4444
320435,201903,2243,7229,1765,6239,629,2326,510,1841,1139,4167
320440,201903,1272,3681,938,3019,146,505,421,1314,567,1819
320450,201903,1554,4665,1235,4059,300,1087,533,1665,833,2752
320455,201903,3786,11774,2572,8875,725,2643,737,2420,1462,5063
320460,201903,2087,6431,1473,5039,381,1373,362,1166,743,2539
320465,201903,1209,3530,920,2945,122,428,518,1646,640,2074
320470,201903,3639,10229,2514,7881,635,2176,578,1683,1213,3859
320480,201903,1618,4689,1359,4196,236,824,717,2134,953,2958
320490,201903,18717,50842,13944,42296,2591,8766,5643,16813,8234,25579
320495,201903,1370,3848,936,3008,207,747,320,974,527,1721
320500,201903,47104,130161,38559,115084,6285,20158,21406,61572,27691,81730
320501,201903,4400,13026,3186,10791,904,3381,985,3289,1889,6670
320503,201903,2000,6249,1460,5079,457,1713,455,1448,912,3161
320506,201903,2623,7976,1821,6145,542,1978,164,530,706,2508
320510,201903,9510,26688,7724,23428,1092,3677,4429,12997,5521,16674
320515,201903,1711,4763,1323,3967,391,1253,417,1214,808,2467
320517,201903,2015,6320,1627,5474,560,2031,398,1319,958,3350
320520,201903,32771,88882,24669,74998,4668,15508,10274,30316,14942,45824
320530,201903,28971,79847,22900,68941,2685,9545,13650,38645,16335,48190
330010,201903,19761,54826,16269,48836,2818,8902,9384,27619,12202,36521
330015,201903,1451,3726,1129,3198,182,595,613,1640,795,2235
330020,201903,19448,50020,16998,46532,2307,7205,12167,32396,14474,39601
330022,201903,1933,5255,1470,4461,245,782,866,2571,1111,3353
330023,201903,4421,10857,3034,8822,594,1823,1428,4075,2022,5898
330025,201903,4684,11753,3170,9207,995,3081,961,2767,1956,5848
330030,201903,10099,28199,7639,23860,961,3499,4447,13124,5408,16623
330040,201903,13086,35560,10716,31370,1264,4214,6983,19621,8247,23835
330045,201903,81100,197279,67759,179756,6822,17588,51330,135242,58152,152830
330050,201903,2345,6356,1752,5353,395,1280,784,2278,1179,3558
330060,201903,4823,13233,4010,11839,880,2859,1716,4721,2596,7580
330070,201903,21621,57538,17865,51766,3311,10263,9700,27812,13011,38075
330080,201903,8482,22371,7393,20745,1010,2971,4857,13403,5867,16374
330090,201903,3425,7290,2226,5676,187,512,1428,3587,1615,4099
330093,201903,2408,6216,1789,5257,175,541,1259,3703,1434,4244
330095,201903,1163,3463,916,2982,85,347,517,1549,602,1896
330100,201903,65897,181016,56039,166068,4022,14321,41276,120102,45298,134423
330110,201903,1944,5776,1717,5426,300,1055,881,2678,1181,3733
330115,201903,2042,5302,1551,4565,245,781,898,2571,1143,3352
330120,201903,3393,7865,2504,6660,221,656,1757,4526,1978,5182
330130,201903,3578,10179,2978,9258,472,1556,1789,5534,2261,7090
330140,201903,3364,9151,2759,8240,418,1408,1684,4852,2102,6260
330150,201903,2054,5656,1585,4872,330,1081,685,2039,1015,3120
330160,201903,1309,3666,1031,3203,181,639,542,1588,723,2227
330170,201903,94206,250021,79336,229265,11671,33663,51528,150316,63199,183979
330180,201903,2099,5365,1643,4651,120,409,1117,3061,1237,3470
330185,201903,9218,24612,7666,22133,777,2654,5563,15507,6340,18161
330187,201903,3830,10087,3079,8930,441,1419,1888,5445,2329,6864
330190,201903,30216,76546,26316,71078,2252,6515,20441,54396,22693,60911
330200,201903,14209,38394,11958,35529,2537,7136,7300,22411,9837,29547
330205,201903,2072,5281,1597,4470,108,366,1095,2951,1203,3317
330210,201903,3275,8538,2365,6848,400,1255,968,2593,1368,3848
330220,201903,10717,27861,7728,22649,1828,5873,2369,6335,4197,12208
330225,201903,3377,9088,2697,8067,247,909,1856,5384,2103,6293
330227,201903,16477,41925,14280,39107,863,2697,11857,31934,12720,34631
330230,201903,1639,3847,1189,3270,80,243,831,2255,911,2498
330240,201903,21162,56984,17108,50298,2908,9264,9893,28245,12801,37509
330245,201903,1637,4153,932,2898,218,703,279,883,497,1586
330250,201903,34038,91778,28863,83853,6424,18980,15141,44484,21565,63464
330260,201903,4206,11230,3300,9903,485,1588,1936,5572,2421,7160
330270,201903,25141,52923,15350,38787,2839,7752,6464,16022,9303,23774
330280,201903,2322,6242,1738,5213,204,676,976,2808,1180,3484
330285,201903,20775,52173,16724,46274,1771,5599,11593,31036,13364,36635
330290,201903,3440,8956,2784,7991,407,1275,1689,4691,2096,5966
330300,201903,5328,13214,3798,10879,426,1379,2352,6577,2778,7956
330310,201903,2219,5820,1692,4925,101,285,1114,3253,1215,3538
330320,201903,14778,37168,11880,33398,1585,4550,8329,23469,9914,28019
330330,201903,31249,73875,25158,65367,2911,8333,17475,44242,20386,52575
330340,201903,13713,35417,10108,29535,1924,6220,4784,13328,6708,19548
330350,201903,105873,263869,89334,242902,7726,22197,69145,187052,76871,209249
330360,201903,7475,18624,6476,17425,319,914,5448,14578,5767,15492
330370,201903,4608,13512,3409,11375,799,2788,1334,4574,2133,7362
330380,201903,5037,14266,3862,12140,830,2889,1675,5057,2505,7946
330385,201903,3876,11720,3216,10706,816,2976,1433,4794,2249,7770
330390,201903,23525,68107,18562,58720,3173,11118,9519,28757,12692,39875
330395,201903,3129,8108,2613,7409,226,702,1768,4907,1994,5609
330400,201903,2962,8265,2603,7644,195,727,1884,5208,2079,5935
330410,201903,2839,7906,2106,6585,431,1447,918,2708,1349,4155
330411,201903,2700,7438,2157,6409,179,634,1491,4227,1670,4861
330412,201903,1434,4320,1181,3869,166,612,656,2008,822,2620
330414,201903,22772,59385,18643,53609,2076,6014,12873,36836,14949,42850
330415,201903,3594,10112,2808,8770,389,1218,1560,4955,1949,6173
330420,201903,9733,24734,6525,19390,959,3124,2822,7941,3781,11065
330430,201903,8709,22202,7524,20445,570,1874,5562,14528,6132,16402
330440,201903,2112,5971,1599,5120,359,1305,762,2316,1121,3621
330450,201903,1302,3883,1054,3416,158,564,524,1649,682,2213
330452,201903,14872,39108,11788,34266,2028,6419,6747,19036,8775,25455
330455,201903,533797,1310909,407909,1123070,66658,194349,241602,654105,308260,848454
330460,201903,1166,3333,893,2896,182,635,435,1365,617,2000
330470,201903,4618,12031,3446,10188,1001,3050,1240,3713,2241,6763
330475,201903,8750,23458,7057,21176,1340,4447,4230,12427,5570,16874
330480,201903,5828,15780,4998,14496,539,1747,3258,9159,3797,10906
330490,201903,113748,271260,95049,245108,10933,30011,67074,170140,78007,200151
330500,201903,6139,16366,5210,15043,664,2119,3657,10387,4321,12506
330510,201903,37458,99113,29502,87625,6935,21366,15465,45704,22400,67070
330513,201903,1255,3336,991,2943,225,722,470,1378,695,2100
330515,201903,2461,6854,2027,6157,546,1768,918,2693,1464,4461
330520,201903,10601,29402,8784,26361,1359,4530,4937,14307,6296,18837
330530,201903,1653,4177,1207,3426,270,829,518,1413,788,2242
330540,201903,2851,7821,2207,6664,649,1982,789,2375,1438,4357
330550,201903,7889,22855,6458,20660,2207,7544,2007,6305,4214,13849
330555,201903,13652,32277,11419,29443,1262,3604,8224,21238,9486,24842
330560,201903,4260,11696,3477,10344,522,1611,2042,5891,2564,7502
330570,201903,2836,7969,2332,7095,405,1342,1392,4177,1797,5519
330575,201903,5347,14288,4635,13046,364,1168,3535,9592,3899,10760
330580,201903,13967,39236,10736,33120,2345,7825,4697,13884,7042,21709
330590,201903,1492,4183,1298,3936,191,578,880,2711,1071,3289
330600,201903,11308,31136,8946,27107,1313,4208,4984,14941,6297,19149
330610,201903,9076,25124,7512,22634,754,2672,4952,14493,5706,17165
330615,201903,2040,5717,1564,5039,325,1137,923,2983,1248,4120
330620,201903,3742,11320,3026,10014,852,3080,1063,3257,1915,6337
330630,201903,24075,62831,18932,54419,1856,6304,12750,35128,14606,41432
350010,201903,1904,5146,933,2937,238,776,112,273,350,1049
350020,201903,688,1825,361,1157,52,176,130,367,182,543
350030,201903,3756,10885,2751,8952,717,2481,918,2875,1635,5356
350040,201903,657,1958,396,1382,64,256,123,347,187,603
350050,201903,917,2447,646,1953,139,501,220,525,359,1026
350055,201903,799,2133,667,1944,49,169,514,1475,563,1644
350060,201903,105,281,74,230,14,44,37,112,51,156
350070,201903,3646,9704,2238,7033,443,1490,708,2022,1151,3512
350075,201903,598,1854,440,1525,190,689,50,161,240,850
350080,201903,614,1662,373,1173,43,150,165,468,208,618
350090,201903,627,1524,361,1039,80,240,112,297,192,537
350100,201903,2092,5688,1372,4343,163,621,702,2085,865,2706
350110,201903,464,1219,325,973,22,79,177,520,199,599
350115,201903,1301,3866,1053,3322,190,671,524,1497,714,2168
350120,201903,665,1640,355,1028,50,158,166,455,216,613
350130,201903,3069,8461,2450,7271,407,1294,1230,3462,1637,4756
350140,201903,717,2120,470,1606,42,186,244,763,286,949
350150,201903,513,1592,421,1414,101,346,103,319,204,665
350160,201903,10680,26923,7018,20382,874,3033,4156,11282,5030,14315
350170,201903,1786,5370,1368,4391,286,956,488,1476,774,2432
350180,201903,1111,2803,544,1666,123,385,145,419,268,804
350190,201903,2815,8117,1978,6384,420,1556,747,1978,1167,3534
350200,201903,413,1160,329,1007,23,76,226,656,249,732
350210,201903,5279,12476,3508,9770,638,1868,1930,5199,2568,7067
350220,201903,2781,7671,1867,5881,444,1475,628,1794,1072,3269
350230,201903,943,2612,782,2356,157,509,399,1170,556,1679
350240,201903,695,2082,456,1503,84,276,142,451,226,727
350250,201903,2345,7212,1777,6174,632,2412,319,1152,951,3564
350260,201903,808,1999,516,1465,60,177,307,842,367,1019
350270,201903,4562,12765,3628,10917,620,2005,1796,5056,2416,7061
350275,201903,2297,6493,1832,5664,311,1076,994,2893,1305,3969
350280,201903,18797,42706,11068,30178,2052,5950,3991,10535,6043,16485
350290,201903,3056,8568,2032,6445,392,1384,775,2294,1167,3678
350300,201903,666,1852,470,1439,84,283,203,577,287,860
350310,201903,798,2392,591,1933,99,396,229,641,328,1037
350315,201903,549,1484,375,1160,39,146,163,454,202,600
350320,201903,12686,34042,9671,28663,2425,7770,2966,8406,5391,16176
350330,201903,13622,34529,9723,26786,1302,3859,5633,14643,6935,18502
350335,201903,356,1021,264,840,21,82,155,476,176,558
350340,201903,1101,2943,644,2078,118,404,225,731,343,1135
350350,201903,753,2020,592,1835,86,310,314,941,400,1251
350360,201903,999,3102,817,2685,249,821,235,779,484,1600
350370,201903,592,1545,403,1186,125,348,100,284,225,632
350380,201903,4434,12142,2940,9203,790,2506,729,2345,1519,4851
350390,201903,9339,26035,7479,22725,1901,5997,2974,8878,4875,14875
350395,201903,422,1091,203,659,22,65,63,192,85,257
350400,201903,7784,20024,5409,15961,1404,4518,1524,4259,2928,8777
350410,201903,8995,26037,6519,21070,1550,5585,2126,6337,3676,11922
350420,201903,648,1827,475,1503,89,316,106,310,195,626
350430,201903,670,1869,554,1675,66,238,340,942,406,1180
350440,201903,1725,4584,1387,4042,144,510,876,2459,1020,2969
350450,201903,6417,18464,5044,15938,1169,3979,1934,5806,3103,9785
350460,201903,1640,4216,810,2530,139,470,157,422,296,892
350470,201903,260,660,195,541,8,33,125,316,133,349
350480,201903,853,2312,548,1714,113,396,79,212,192,608
350490,201903,1779,4875,1299,4023,312,993,408,1170,720,2163
350500,201903,654,1779,505,1505,86,284,240,673,326,957
350510,201903,1067,2872,759,2280,97,317,402,1150,499,1467
350520,201903,1907,6108,1466,5169,257,1036,625,2021,882,3057
350530,201903,2576,6632,1872,5253,258,811,1053,2759,1311,3570
350535,201903,1440,4078,1247,3791,180,636,783,2289,963,2925
350540,201903,1715,4494,1245,3726,203,647,662,1957,865,2604
350550,201903,9054,22375,6026,17398,673,2256,3143,8508,3816,10764
350560,201903,3753,10861,2990,9401,277,945,1828,5549,2105,6494
350570,201903,21975,63662,17686,55020,3808,12965,8210,24226,12018,37191
350580,201903,1848,5172,987,3213,236,830,145,388,381,1218
350590,201903,4408,12372,3214,9682,546,1904,1743,4767,2289,6671
350600,201903,37091,88814,23158,63533,3314,10056,11009,27589,14323,37645
350610,201903,6455,18229,4701,14705,961,3183,2006,6079,2967,9262
350620,201903,420,1053,255,798,33,119,137,402,170,521
350630,201903,1472,3931,1066,3191,75,301,656,1830,731,2131
350635,201903,7609,19713,5764,16742,1049,3441,3173,8691,4222,12132
350640,201903,917,2527,487,1526,60,198,166,444,226,642
350650,201903,7590,20967,5040,15693,1039,3476,1577,4559,2616,8035
350660,201903,4421,12002,3444,10332,658,1970,1707,5174,2365,7144
350670,201903,1761,4836,1459,4397,169,546,930,2796,1099,3342
350680,201903,1105,3024,716,2275,150,508,293,883,443,1391
350690,201903,1155,3231,862,2683,156,506,439,1309,595,1815
350700,201903,4917,12588,3161,9823,567,1973,1294,3746,1861,5719
350710,201903,2646,7498,2227,6755,330,1144,1251,3593,1581,4737
350715,201903,861,2488,703,2181,74,282,326,903,400,1185
350720,201903,167,409,120,332,26,80,52,131,78,211
350730,201903,529,1550,416,1326,39,157,270,803,309,960
350740,201903,1566,4405,1032,3258,185,605,282,814,467,1419
350745,201903,544,1504,331,1058,35,129,147,431,182,560
350750,201903,9198,25188,7050,21231,1332,4558,2925,7803,4257,12361
350760,201903,13215,34348,9259,27418,2374,7622,2723,7247,5097,14869
350770,201903,918,2300,581,1709,54,164,346,1004,400,1168
350775,201903,670,1693,474,1372,53,161,201,561,254,722
350780,201903,1936,5047,1370,4152,288,965,430,1465,718,2430
350790,201903,1659,4560,1028,3340,195,695,223,613,418,1308
350800,201903,3159,9533,2733,8769,431,1494,1493,4664,1924,6158
350810,201903,2449,6289,1926,5529,303,915,1043,3027,1346,3942
350820,201903,850,2047,475,1348,55,167,227,590,282,757
350830,201903,845,2410,464,1530,71,253,129,374,200,627
350840,201903,2813,8634,2070,7158,522,1958,765,2460,1287,4418
350850,201903,6583,19187,5020,16164,1249,4287,1771,5528,3020,9815
350860,201903,3256,9188,2889,8648,144,555,2161,6338,2305,6893
350870,201903,2684,7758,1962,6557,321,1199,998,3209,1319,4408
350880,201903,1204,3602,963,3072,233,771,308,954,541,1725
350890,201903,574,1538,359,1087,52,173,123,325,175,498
350900,201903,6348,18127,4052,12991,1148,3970,816,2431,1964,6401
350910,201903,849,2243,728,2037,109,348,481,1302,590,1650
350920,201903,11618,30068,9926,27179,559,1848,7771,20390,8330,22238
350925,201903,4357,12300,3134,9960,629,2139,1352,3914,1981,6053
350930,201903,1441,3735,960,2819,123,398,519,1453,642,1851
350940,201903,2025,5709,1621,4968,207,683,1009,3019,1216,3702
350945,201903,857,2456,645,2036,119,427,284,815,403,1242
350950,201903,80374,215622,62352,179913,9103,28830,36218,99437,45321,128267
350960,201903,5638,16055,4392,13681,673,2360,2452,7211,3125,9571
350970,201903,3489,10609,2599,8698,859,3156,390,1151,1249,4307
350980,201903,599,1699,473,1459,151,497,175,530,326,1027
350990,201903,1696,5058,1278,4342,319,1226,437,1397,756,2623
350995,201903,763,2473,689,2316,47,207,465,1479,512,1686
351000,201903,2647,7040,1864,5624,379,1241,592,1722,971,2963
351010,201903,306,762,189,544,17,52,97,266,114,318
351015,201903,729,2243,595,1980,88,350,282,842,370,1192
351020,201903,8985,25191,6801,21446,1392,4585,3392,10441,4784,15026
351030,201903,2491,7676,2024,6704,332,1233,1038,3327,1370,4560
351040,201903,4548,11858,3863,10762,236,833,3045,8155,3281,8988
351050,201903,16774,41781,11243,32877,2447,7611,4389,12618,6836,20229
351060,201903,45166,117408,34668,99000,4502,14021,21788,60175,26290,74196
351070,201903,1327,3488,779,2490,237,815,110,335,347,1150
351080,201903,2576,6715,1886,5836,334,1204,1053,3039,1387,4243
351090,201903,325,987,228,794,43,153,57,203,100,356
351100,201903,2309,6430,1489,4737,358,1189,403,1339,761,2528
351110,201903,5746,15086,3767,11407,746,2467,1456,4088,2202,6555
351120,201903,742,1974,505,1550,81,261,216,618,297,879
351130,201903,1056,2773,457,1489,100,341,76,218,176,559
351140,201903,1811,5340,1297,4326,331,1226,394,1154,725,2380
351150,201903,1953,5824,1232,4168,263,944,390,1182,653,2126
351160,201903,1092,3562,863,3027,200,741,269,829,469,1570
351170,201903,1350,3910,1168,3540,131,440,744,2163,875,2603
351190,201903,873,2510,602,1902,108,328,231,690,339,1018
351200,201903,1603,4002,1222,3415,77,246,819,2189,896,2435
351210,201903,1531,3859,885,2540,89,296,483,1268,572,1564
351220,201903,3070,9032,2656,8318,346,1142,1700,5261,2046,6403
351230,201903,1768,5031,1304,4191,273,1018,525,1479,798,2497
351240,201903,1973,5230,1292,3785,262,807,557,1506,819,2313
351250,201903,1097,2924,598,1878,75,253,222,698,297,951
351260,201903,938,2491,689,2035,160,465,235,708,395,1173
351270,201903,387,1133,319,1016,51,200,173,473,224,673
351280,201903,3930,10813,3026,9063,530,1741,1416,4023,1946,5764
351290,201903,1036,2725,703,2119,127,391,332,984,459,1375
351300,201903,14933,42322,10253,33064,2120,7315,3897,12357,6017,19672
351310,201903,3088,8127,2357,6913,233,837,1541,4222,1774,5059
351320,201903,878,2685,656,2151,112,397,244,743,356,1140
351330,201903,607,1870,526,1719,47,133,395,1320,442,1453
351340,201903,6197,18361,4960,16159,1296,4371,1980,6471,3276,10842
351350,201903,11437,30107,9613,27025,1063,3219,6956,18991,8019,22210
351360,201903,3798,10525,3141,9452,808,2625,1080,2994,1888,5619
351370,201903,2122,6120,1422,4624,366,1229,449,1303,815,2532
351380,201903,44704,112762,32228,90088,5103,15117,17021,45766,22124,60883
351385,201903,281,722,157,476,33,92,51,151,84,243
351390,201903,1351,3449,847,2661,131,483,483,1419,614,1902
351400,201903,939,2690,737,2263,159,486,386,1160,545,1646
351410,201903,2380,6792,1738,5527,344,1115,719,2237,1063,3352
351420,201903,359,869,188,555,37,99,80,229,117,328
351430,201903,823,2434,710,2238,71,237,485,1489,556,1726
351440,201903,3291,8863,2144,6443,409,1329,552,1398,961,2727
351450,201903,1713,4551,1132,3479,236,789,235,636,471,1425
351460,201903,774,2118,610,1832,166,482,306,927,472,1409
351470,201903,1181,3117,898,2617,90,310,560,1535,650,1845
351480,201903,2552,7775,2067,6916,340,1249,938,2988,1278,4237
351490,201903,1850,5508,1600,5022,91,366,1192,3563,1283,3929
351492,201903,338,947,274,807,15,54,177,504,192,558
351495,201903,203,571,145,447,18,58,74,215,92,273
351500,201903,35022,89877,25894,73595,4794,14441,13622,36942,18416,51383
351510,201903,11928,30919,8697,25063,1264,4104,5159,14160,6423,18264
351512,201903,480,1347,316,965,49,154,103,281,152,435
351515,201903,3146,7282,1887,5206,359,1118,512,1417,871,2535
351518,201903,2294,5981,1471,4489,211,747,783,2154,994,2901
351519,201903,739,2064,415,1347,62,200,73,220,135,420
351520,201903,1142,2911,446,1400,60,210,170,463,230,673
351530,201903,343,976,195,631,38,125,62,162,100,287
351535,201903,2038,5005,1449,4006,203,639,792,2045,995,2684
351540,201903,2108,5429,1377,4174,402,1370,295,744,697,2114
351550,201903,6039,15714,4083,11872,475,1616,2233,5985,2708,7601
351560,201903,405,1205,328,1050,78,290,91,263,169,553
351565,201903,184,570,144,493,34,126,43,141,77,267
351570,201903,18679,51811,13960,41647,1763,5759,8390,23922,10153,29681
351580,201903,268,701,155,478,16,50,59,185,75,235
351590,201903,498,1145,263,719,34,113,136,327,170,440
351600,201903,1499,3993,1136,3317,127,420,673,1813,800,2233
351610,201903,740,1778,471,1305,25,78,242,611,267,689
351620,201903,20644,57697,15299,47658,2696,9564,6344,17633,9040,27197
351630,201903,25642,70996,20860,62374,3687,11582,12364,35919,16051,47501
351640,201903,15684,43226,12178,36448,1457,4920,7791,22305,9248,27225
351650,201903,417,1139,183,609,21,73,40,121,61,194
351660,201903,753,2227,461,1519,81,295,85,245,166,540
351670,201903,5265,14641,3717,11186,765,2332,1697,4778,2462,7110
351680,201903,401,1199,254,818,48,133,65,199,113,332
351685,201903,429,1285,345,1135,83,274,117,357,200,631
351690,201903,1038,2678,602,1774,110,356,230,605,340,961
351700,201903,1207,3109,873,2488,128,362,486,1328,614,1690
351710,201903,752,2065,502,1582,50,190,232,647,282,837
351720,201903,1448,3876,928,2889,165,558,356,1039,521,1597
351730,201903,914,2516,758,2233,87,321,456,1254,543,1575
351740,201903,3601,9280,2795,7720,519,1524,1286,3267,1805,4791
351750,201903,1260,3499,772,2577,159,573,255,842,414,1415
351760,201903,3299,9513,2323,7453,500,1781,792,2326,1292,4107
351770,201903,1806,5457,1460,4782,342,1145,646,2096,988,3241
351780,201903,1399,3636,725,2231,132,483,209,594,341,1077
351790,201903,1239,3087,989,2739,170,456,594,1669,764,2125
351800,201903,528,1242,262,739,33,102,89,214,122,316
351810,201903,984,2666,798,2349,55,157,573,1623,628,1780
351820,201903,2434,7052,1678,5517,439,1562,321,1014,760,2576
351830,201903,4208,11697,3226,9918,372,1348,1897,5550,2269,6898
351840,201903,7779,22691,5906,19136,1015,3601,2708,8271,3723,11872
351850,201903,1780,4779,1106,3500,222,793,314,877,536,1670
351860,201903,2770,8269,2181,7105,403,1382,1153,3759,1556,5141
351870,201903,22547,59910,17293,51075,5453,16547,6024,18496,11477,35043
351880,201903,112127,307837,84194,256801,23456,77187,28450,82265,51906,159452
351885,201903,842,2413,664,2061,100,333,356,1062,456,1395
351890,201903,668,1889,489,1574,111,354,69,188,180,542
351900,201903,1031,2881,800,2511,152,488,382,1193,534,1681
351905,201903,383,1092,257,830,25,87,92,261,117,348
351907,201903,21625,57969,16752,49082,1809,5845,10996,31112,12805,36957
351910,201903,1244,3325,858,2523,100,327,466,1236,566,1563
351920,201903,868,2325,626,1850,74,268,313,848,387,1116
351925,201903,904,2553,702,2167,110,368,322,927,432,1295
351930,201903,3105,9026,2834,8494,387,1290,2103,6140,2490,7430
351940,201903,1084,2857,778,2315,108,355,400,1148,508,1503
351950,201903,1543,3659,1101,2992,75,225,701,1842,776,2067
351960,201903,5079,13371,3779,11064,855,2713,1602,4377,2457,7090
351970,201903,6077,19165,5084,17356,899,3470,2727,8928,3626,12398
351980,201903,1039,2511,663,1878,86,287,378,989,464,1276
351990,201903,1390,3407,969,2740,93,335,413,1054,506,1389
352000,201903,2426,7211,2066,6449,257,956,1299,3735,1556,4691
352010,201903,2068,5863,1665,5125,434,1436,302,977,736,2413
352020,201903,1461,4095,1148,3561,198,655,545,1604,743,2259
352030,201903,5360,14679,4246,12874,899,2961,2141,6316,3040,9277
352040,201903,2482,6874,1547,4926,282,946,427,1196,709,2142
352042,201903,3180,7964,1894,5692,380,1215,756,2263,1136,3478
352044,201903,2027,5623,1145,3875,203,739,229,702,432,1441
352050,201903,11849,32607,7614,23948,1911,6737,1187,3237,3098,9974
352060,201903,733,2043,524,1632,73,257,243,704,316,961
352070,201903,772,1607,532,1290,74,204,292,664,366,868
352080,201903,465,1223,282,839,36,119,104,269,140,388
352090,201903,1422,4342,1144,3722,167,613,446,1294,613,1907
352100,201903,2999,8648,2496,7698,611,2029,1129,3294,1740,5323
352110,201903,562,1745,436,1463,99,354,167,517,266,871
352115,201903,514,1512,425,1366,69,248,234,736,303,984
352120,201903,855,2636,673,2240,80,305,375,1155,455,1460
352130,201903,1871,5350,1198,3656,233,727,455,1296,688,2023
352140,201903,1259,3454,832,2595,130,444,394,1187,524,1631
352150,201903,807,2231,608,1868,131,422,314,952,445,1374
352160,201903,980,2469,714,2052,96,328,361,976,457,1304
352170,201903,2932,8164,2312,6896,420,1388,1183,3246,1603,4634
352180,201903,2573,7161,2052,6170,509,1712,655,1723,1164,3435
352190,201903,1140,3127,854,2664,141,460,374,1194,515,1654
352200,201903,373,1144,257,891,34,131,87,285,121,416
352210,201903,18035,44315,14066,38801,1369,4135,10159,27634,11528,31769
352215,201903,524,1428,460,1347,50,154,317,911,367,1065
352220,201903,16440,43274,11143,33327,2874,8971,3626,10433,6500,19404
352230,201903,12410,37788,9460,31993,2374,8843,3181,10086,5555,18929
352240,201903,10903,28892,8137,24123,1835,6200,3253,8739,5088,14939
352250,201903,21897,63439,17734,55880,3770,12510,9371,29028,13141,41538
352260,201903,4862,12742,3356,9699,507,1738,1852,4820,2359,6558
352265,201903,907,2636,800,2454,54,207,579,1713,633,1920
352270,201903,1472,4576,1100,3753,243,915,352,1099,595,2014
352280,201903,2346,6146,1795,5316,194,717,995,2710,1189,3427
352290,201903,1088,3302,895,2890,161,570,435,1269,596,1839
352300,201903,964,2670,666,2040,98,348,320,868,418,1216
352310,201903,44157,119687,32614,99081,8448,26014,13782,42177,22230,68191
352320,201903,6059,16708,4648,13813,767,2545,2294,6124,3061,8669
352330,201903,2116,5891,1617,5162,324,1200,763,2315,1087,3515
352340,201903,4958,13673,3600,11193,706,2440,1555,4477,2261,6917
352350,201903,2058,6109,1608,5059,197,754,840,2363,1037,3117
352360,201903,1188,3238,1014,2940,105,376,742,2038,847,2414
352370,201903,1035,3058,892,2788,36,153,678,2063,714,2216
352380,201903,800,2305,619,1951,142,472,206,621,348,1093
352390,201903,15793,39607,10641,30690,1720,5457,5694,15472,7414,20929
352400,201903,3522,9858,2946,8806,482,1771,1782,4918,2264,6689
352410,201903,3016,8131,2288,6864,246,882,1373,3937,1619,4819
352420,201903,875,2177,602,1747,115,352,208,570,323,922
352430,201903,7139,18747,5117,15162,1378,4519,2025,5604,3403,10123
352440,201903,16843,47455,12840,39558,2958,9566,5205,15432,8163,24998
352450,201903,810,2131,397,1320,55,190,111,347,166,537
352460,201903,2894,8265,1965,6465,422,1533,652,2022,1074,3555
352470,201903,3445,8761,2481,7156,306,1016,1369,3655,1675,4671
352480,201903,3383,8411,2261,6363,379,1205,1071,2750,1450,3955
352490,201903,711,2184,559,1866,112,420,243,759,355,1179
352500,201903,9988,26519,6946,20750,3225,10477,846,1608,4071,12085
352510,201903,3396,9527,2514,7949,584,2028,981,2912,1565,4940
352520,201903,2494,7092,1937,6069,448,1562,916,2622,1364,4184
352530,201903,8977,24858,5768,18116,1303,4608,1032,2478,2335,7086
352540,201903,530,1582,391,1263,79,267,101,292,180,559
352550,201903,955,2848,668,2255,131,492,194,610,325,1102
352560,201903,568,1617,411,1283,69,227,159,452,228,679
352570,201903,1959,5813,1276,4368,324,1180,174,510,498,1690
352580,201903,712,1983,578,1739,99,344,289,820,388,1164
352585,201903,238,708,180,587,19,80,96,290,115,370
352590,201903,13298,35916,9322,28038,2767,8944,3654,10155,6421,19099
352600,201903,1912,5380,1449,4458,244,806,740,2133,984,2939
352610,201903,2953,8486,2207,7132,491,1743,816,2496,1307,4239
352620,201903,5600,15004,4372,13092,1392,4205,1532,4681,2924,8886
352630,201903,829,2093,625,1789,105,347,285,744,390,1091
352640,201903,2924,7787,2124,6384,212,682,1281,3704,1493,4386
352650,201903,568,1655,401,1265,57,211,145,424,202,635
352660,201903,1001,3101,809,2704,177,614,340,1113,517,1727
352670,201903,8314,23459,5321,17232,1491,5130,704,2238,2195,7368
352680,201903,3235,9918,2279,7605,400,1556,1027,3109,1427,4665
352690,201903,27964,72123,20653,58840,1958,6401,13117,35523,15075,41924
352700,201903,555,1442,414,1238,170,558,89,222,259,780
352710,201903,4964,13214,3535,10560,916,3000,1404,3903,2320,6903
352720,201903,7834,22545,6089,19018,2842,9031,829,2285,3671,11316
352725,201903,528,1346,271,810,20,64,121,337,141,401
352730,201903,2752,7965,2339,6990,381,1285,1328,3611,1709,4896
352740,201903,2196,5328,1627,4464,221,679,909,2376,1130,3055
352750,201903,408,1024,213,655,42,131,76,204,118,335
352760,201903,1519,4374,1160,3620,154,509,569,1721,723,2230
352770,201903,915,2516,597,1877,119,386,215,631,334,1017
352780,201903,655,1945,455,1536,94,349,143,472,237,821
352790,201903,522,1403,347,1046,37,116,125,323,162,439
352800,201903,1238,3951,893,3111,221,802,157,499,378,1301
352810,201903,1097,2642,669,1848,91,276,374,961,465,1237
352820,201903,506,1327,323,1004,75,243,70,222,145,465
352830,201903,588,1512,254,785,37,123,51,126,88,249
352840,201903,3786,11353,3143,10144,1108,3838,962,2979,2070,6817
352850,201903,10081,25751,6732,20223,1914,6173,1980,5594,3894,11767
352860,201903,1017,2857,724,2292,146,496,231,699,377,1195
352870,201903,887,2281,612,1683,44,145,394,1036,438,1181
352880,201903,1817,4463,1255,3435,187,546,702,1760,889,2306
352885,201903,282,813,207,672,35,126,114,352,149,478
352890,201903,720,1753,440,1162,46,126,237,546,283,672
352900,201903,17533,46838,11741,35336,2067,6738,5134,14381,7201,21119
352910,201903,462,1225,217,680,24,71,53,150,77,221
352920,201903,2571,6844,1856,5528,161,542,1184,3360,1345,3902
352930,201903,5663,15850,4164,12824,768,2511,1824,5282,2592,7793
352940,201903,22003,63244,16368,50950,4147,14120,5269,15423,9416,29543
352950,201903,482,1287,268,856,61,199,30,87,91,286
352960,201903,699,1942,356,1169,64,227,67,208,131,435
352965,201903,268,718,153,505,40,127,33,96,73,223
352970,201903,2980,7251,2259,6082,249,701,1488,3955,1737,4656
352980,201903,1370,3824,1066,3329,263,864,480,1454,743,2318
352990,201903,4003,11433,3268,10219,635,2220,1700,5119,2335,7339
353000,201903,458,1269,222,718,33,116,48,136,81,252
353010,201903,2516,6470,1643,4861,407,1315,547,1485,954,2800
353020,201903,3617,9474,2085,6279,316,1045,731,2019,1047,3064
353030,201903,4126,10970,2820,8514,712,2291,632,1883,1344,4174
353040,201903,589,1426,430,1174,60,187,242,607,302,794
353050,201903,5014,14987,3681,12178,807,2891,1568,4940,2375,7831
353060,201903,46154,121700,37915,108229,3137,10830,27368,74895,30505,85725
353070,201903,9256,26918,6521,21202,1448,5019,2179,6688,3627,11707
353080,201903,4107,11841,2839,9291,608,2206,949,2780,1557,4986
353090,201903,571,1763,426,1445,48,189,222,715,270,904
353100,201903,302,837,121,402,25,88,30,85,55,173
353110,201903,7330,20747,5979,18707,1045,3428,3444,10940,4489,14368
353120,201903,467,1190,304,881,42,137,123,319,165,456
353130,201903,2334,5838,1564,4592,460,1492,495,1351,955,2843
353140,201903,2368,6111,1761,4965,163,523,1092,2870,1255,3393
353150,201903,1477,3836,1056,3127,227,709,432,1198,659,1907
353160,201903,564,1512,404,1244,82,282,159,437,241,719
353170,201903,501,1444,397,1288,79,304,188,566,267,870
353180,201903,9687,24649,7552,21061,956,3008,5182,13987,6138,16995
353190,201903,3288,9082,2610,7721,288,957,1605,4416,1893,5373
353200,201903,2024,5478,919,3035,130,462,205,616,335,1078
353205,201903,337,1083,288,959,62,227,131,425,193,652
353210,201903,978,2334,609,1715,29,100,386,1053,415,1153
353215,201903,394,1139,306,956,47,161,136,379,183,540
353220,201903,769,2107,466,1465,106,319,79,238,185,557
353230,201903,786,2279,641,2050,178,637,255,720,433,1357
353240,201903,2203,6215,1775,5419,254,883,1034,3033,1288,3916
353250,201903,1268,2896,743,2014,115,328,370,966,485,1294
353260,201903,1074,2598,608,1801,121,398,233,658,354,1056
353270,201903,652,1786,530,1549,44,138,345,963,389,1101
353280,201903,725,2002,501,1550,96,290,158,451,254,741
353282,201903,1777,5146,1515,4632,183,638,893,2558,1076,3196
353284,201903,364,891,180,519,30,110,68,161,98,271
353286,201903,152,391,91,289,22,77,33,100,55,177
353290,201903,1556,4109,947,2869,101,361,478,1315,579,1676
353300,201903,1701,4721,1257,3803,214,751,545,1458,759,2209
353310,201903,387,979,268,752,27,99,157,410,184,509
353320,201903,618,1634,526,1474,19,59,430,1202,449,1261
353325,201903,612,1851,420,1418,93,322,145,470,238,792
353330,201903,556,1471,342,1018,43,134,170,481,213,615
353340,201903,2725,7560,1878,5918,485,1632,706,2150,1191,3782
353350,201903,3168,8704,2137,6482,480,1610,450,1166,930,2776
353360,201903,585,1707,459,1465,54,184,237,737,291,921
353370,201903,564,1721,462,1541,40,137,305,978,345,1115
353380,201903,264,812,212,700,36,132,97,292,133,424
353390,201903,5550,14280,4086,11655,626,1953,2063,5549,2689,7502
353400,201903,394,1145,298,947,56,203,72,177,128,380
353410,201903,532,1461,411,1240,80,263,217,640,297,903
353420,201903,457,1239,273,833,54,150,22,47,76,197
353430,201903,2196,6296,1592,5140,395,1417,584,1730,979,3147
353440,201903,61786,173939,43757,137490,8361,27974,21136,63331,29497,91305
353450,201903,388,1029,264,809,44,157,117,327,161,484
353460,201903,3275,9052,2341,7149,201,711,1052,3123,1253,3834
353470,201903,7418,20053,5130,15706,975,3300,1936,5431,2911,8731
353475,201903,1406,3821,983,2893,139,448,464,1256,603,1704
353480,201903,1655,4491,1280,3781,86,297,832,2361,918,2658
353490,201903,972,2665,644,1967,117,384,275,791,392,1175
353500,201903,984,2395,773,2077,188,512,411,1121,599,1633
353510,201903,809,2469,586,1900,147,493,119,342,266,835
353520,201903,1100,2936,702,2191,85,295,318,945,403,1240
353530,201903,2428,6631,1880,5589,250,845,937,2575,1187,3420
353540,201903,2018,5745,1661,5134,330,1053,875,2644,1205,3697
353550,201903,5744,15391,4561,13380,879,2709,2313,6516,3192,9225
353560,201903,2011,5828,1485,4938,498,1790,364,1132,862,2922
353570,201903,547,1475,399,1210,61,183,226,648,287,831
353580,201903,2022,5451,1594,4658,389,1148,706,1997,1095,3145
353590,201903,707,1973,445,1408,108,374,136,412,244,786
353600,201903,1751,4462,1351,3738,172,475,713,1923,885,2398
353610,201903,556,1719,394,1363,88,343,97,308,185,651
353620,201903,2573,7115,1809,5717,379,1340,552,1565,931,2905
353625,201903,490,1226,313,913,31,109,191,538,222,647
353630,201903,1182,3825,932,3221,220,822,266,830,486,1652
353640,201903,1366,3599,1069,3122,122,392,641,1841,763,2233
353650,201903,8949,24742,6461,19560,831,2809,3520,9883,4351,12692
353657,201903,351,956,248,766,33,121,120,327,153,448
353660,201903,1127,2476,763,1964,310,795,211,509,521,1304
353670,201903,3737,10835,2972,9290,646,2249,1461,4190,2107,6439
353680,201903,713,1983,533,1707,101,344,280,864,381,1208
353690,201903,459,1214,177,585,14,53,19,52,33,105
353700,201903,1892,5297,1595,4730,167,548,1088,3101,1255,3649
353710,201903,4108,9363,2258,6045,246,676,1299,3183,1545,3859
353715,201903,472,1239,269,845,16,63,72,206,88,269
353720,201903,1874,5210,1479,4610,189,670,935,2822,1124,3492
353730,201903,4235,11690,3112,9507,502,1685,1436,4084,1938,5769
353740,201903,1915,5148,1291,3986,321,1096,385,1113,706,2209
353750,201903,809,2522,568,2035,141,527,96,377,237,904
353760,201903,11764,28800,9231,25209,1490,4292,5598,14950,7088,19242
353770,201903,733,2211,352,1202,60,205,41,112,101,317
353780,201903,4842,14366,3707,11972,889,3153,1368,4048,2257,7201
353790,201903,2441,7655,1808,6296,530,2107,383,1148,913,3255
353800,201903,16533,45700,12716,39157,2162,7164,6396,19559,8558,26723
353810,201903,1103,3025,720,2244,110,370,289,858,399,1228
353820,201903,1713,4902,1192,3779,259,865,400,1250,659,2115
353830,201903,633,1584,441,1257,66,189,190,509,256,698
353850,201903,1603,4636,1222,3878,322,1008,388,1268,710,2276
353860,201903,2519,7335,1983,6295,503,1743,822,2407,1325,4150
353870,201903,27879,75133,19301,58377,2826,9582,9230,25455,12056,35037
353880,201903,2855,8290,2275,7127,235,863,1320,3951,1555,4814
353890,201903,2386,5360,1539,4138,161,462,995,2556,1156,3018
353900,201903,670,1890,481,1519,94,324,188,560,282,884
353910,201903,1797,5318,1510,4828,207,759,1006,3158,1213,3917
353920,201903,2080,5785,1409,4453,299,1090,336,896,635,1986
353930,201903,4082,11083,2705,8605,606,2148,828,2351,1434,4499
353940,201903,1058,3154,708,2409,153,534,215,683,368,1217
353950,201903,2940,8361,2345,7231,451,1537,1249,3549,1700,5086
353960,201903,738,2025,484,1510,104,333,162,476,266,809
353970,201903,711,1761,520,1473,49,146,310,842,359,988
353980,201903,14242,37693,11015,31737,1168,3710,7224,20077,8392,23787
353990,201903,890,2194,531,1518,65,211,272,727,337,938
354000,201903,2493,6209,1347,3980,294,899,210,620,504,1519
354010,201903,350,943,261,794,30,97,162,481,192,578
354020,201903,3405,9995,2676,8357,724,2424,927,2598,1651,5022
354025,201903,725,2008,458,1470,83,304,93,266,176,570
354030,201903,493,1084,240,644,42,107,98,251,140,358
354040,201903,775,1869,483,1362,32,107,322,868,354,975
354050,201903,925,2761,645,2215,167,609,180,618,347,1227
354060,201903,3625,10652,2455,8093,600,2059,714,2192,1314,4251
354070,201903,3232,9161,2259,7213,487,1704,712,1972,1199,3676
354075,201903,2354,7159,1792,6075,254,1016,944,3111,1198,4127
354080,201903,1406,3974,902,2938,171,584,236,718,407,1302
354085,201903,421,901,329,783,1,3,225,498,226,501
354090,201903,1443,4164,1268,3804,113,376,939,2766,1052,3142
354100,201903,17365,49957,12180,40362,2818,9994,4646,15244,7464,25238
354105,201903,1517,3879,999,2925,132,403,445,1261,577,1664
354110,201903,472,1303,322,1031,65,229,101,319,166,548
354120,201903,1520,4192,998,3047,200,625,326,891,526,1516
354130,201903,5638,15200,3639,11282,1040,3474,219,448,1259,3922
354140,201903,19053,47388,12426,35300,2456,7513,4784,12581,7240,20094
354150,201903,3136,7747,2306,6355,493,1425,958,2569,1451,3994
354160,201903,3093,9257,2287,7539,673,2357,677,2100,1350,4457
354165,201903,589,1803,449,1521,89,346,212,660,301,1006
354170,201903,1516,4419,1222,3795,90,304,742,2190,832,2494
354180,201903,443,1263,314,976,63,209,119,329,182,538
354190,201903,1456,4176,1026,3294,99,356,390,1239,489,1595
354200,201903,891,2287,686,1963,92,279,383,1019,475,1298
354210,201903,666,1918,550,1693,52,185,356,1014,408,1199
354220,201903,3080,8581,2245,6870,437,1440,1015,2939,1452,4379
354230,201903,690,1806,534,1602,51,187,355,1013,406,1200
354240,201903,1510,4347,983,3210,185,659,283,803,468,1462
354250,201903,522,1361,339,1069,103,325,95,312,198,637
354260,201903,8029,21929,6120,18565,1419,4457,2265,6771,3684,11228
354270,201903,1038,3224,823,2802,189,656,288,966,477,1622
354280,201903,741,1932,621,1758,76,275,378,983,454,1258
354290,201903,880,2857,733,2530,122,416,350,1226,472,1642
354300,201903,3548,10778,3054,9852,1011,3332,973,3058,1984,6390
354310,201903,659,2014,521,1722,124,447,154,445,278,892
354320,201903,894,2294,556,1670,76,284,215,562,291,846
354323,201903,494,1248,326,928,40,104,132,360,172,464
354325,201903,1199,3674,849,2894,149,522,350,1156,499,1678
354330,201903,7988,21012,5354,15539,787,2711,3006,8027,3793,10738
354340,201903,27074,71351,18554,55986,3829,12666,8160,23460,11989,36126
354350,201903,1173,3142,932,2691,122,378,599,1640,721,2018
354360,201903,545,1499,322,1073,65,219,48,155,113,374
354370,201903,1001,3071,833,2768,151,542,438,1420,589,1962
354380,201903,772,2076,537,1680,96,356,121,303,217,659
354390,201903,13262,33175,8245,24154,1619,4998,2798,7816,4417,12814
354400,201903,1540,5047,1193,4234,210,794,427,1498,637,2292
354410,201903,5260,15031,3982,12395,970,3248,1647,4887,2617,8135
354420,201903,1449,3945,1054,3176,136,454,621,1775,757,2229
354425,201903,2518,6362,1787,5054,422,1211,692,2006,1114,3217
354430,201903,1508,4173,1172,3598,162,564,621,1773,783,2337
354440,201903,573,1575,354,1102,41,142,164,468,205,610
354450,201903,411,1098,224,738,32,103,64,187,96,290
354460,201903,930,2424,600,1831,89,302,302,869,391,1171
354470,201903,508,1296,319,903,23,71,154,385,177,456
354480,201903,1065,2475,722,1935,65,188,479,1215,544,1403
354490,201903,796,2401,575,1921,122,423,219,675,341,1098
354500,201903,1989,5761,1656,5255,555,1937,383,1190,938,3127
354510,201903,750,2102,600,1770,73,223,320,861,393,1084
354515,201903,293,896,220,746,39,151,80,252,119,403
354520,201903,6491,18639,4264,13513,670,2374,2207,6501,2877,8875
354530,201903,4025,12063,3090,10123,756,2579,1157,3709,1913,6288
354540,201903,1271,3471,919,2817,227,726,297,935,524,1661
354550,201903,533,1431,408,1188,63,188,237,654,300,842
354560,201903,1996,5046,1082,3170,150,460,529,1462,679,1922
354570,201903,1149,2979,481,1423,91,275,83,246,174,521
354580,201903,9206,24560,5931,18251,970,3262,2744,8015,3714,11277
354600,201903,1707,4881,1319,4133,176,627,782,2332,958,2959
354610,201903,400,1076,220,692,34,121,77,228,111,349
354620,201903,446,1290,285,964,41,150,106,308,147,458
354625,201903,308,863,176,601,23,83,48,140,71,223
354630,201903,1820,5589,1485,4920,618,2152,188,600,806,2752
354640,201903,3135,9271,2247,7364,397,1475,698,2092,1095,3567
354650,201903,899,2424,723,2109,72,217,426,1219,498,1436
354660,201903,2850,7214,1789,5398,154,563,1081,3135,1235,3698
354670,201903,1062,3030,724,2301,148,523,275,805,423,1328
354680,201903,4624,12896,3710,11335,905,2867,1847,5730,2752,8597
354690,201903,571,1820,390,1392,92,352,105,355,197,707
354700,201903,918,2469,632,1876,105,349,281,746,386,1095
354710,201903,508,1399,359,1102,57,205,151,401,208,606
354720,201903,323,796,137,411,44,131,29,89,73,220
354730,201903,9379,27081,6978,22415,1036,3639,3781,11742,4817,15381
354740,201903,321,871,125,420,16,61,22,56,38,117
354750,201903,2481,6744,1572,4937,311,1085,594,1647,905,2732
354760,201903,1904,5329,1311,4161,352,1217,350,1036,702,2253
354765,201903,329,889,135,445,23,86,26,71,49,157
354770,201903,2294,5830,1638,4703,327,1028,709,1884,1036,2912
354780,201903,52763,137866,39897,111669,5505,17173,22838,59719,28343,76892
354790,201903,958,2758,764,2420,107,373,430,1305,537,1678
354800,201903,2568,6977,1986,5957,498,1562,823,2336,1321,3898
354805,201903,1329,3223,887,2485,123,358,433,1088,556,1446
354810,201903,613,1809,358,1266,63,245,88,280,151,525
354820,201903,923,2765,656,2209,129,503,158,441,287,944
354830,201903,477,1193,309,886,72,205,107,291,179,496
354840,201903,954,2434,503,1487,56,167,246,693,302,860
354850,201903,20642,55761,14260,43703,1977,7002,8012,23014,9989,30016
354860,201903,1557,4501,1023,3402,201,721,323,948,524,1669
354870,201903,52185,134748,40631,113301,5301,16196,23837,63156,29138,79352
354880,201903,5698,14551,2604,7654,329,1082,848,2011,1177,3093
354890,201903,16449,42399,12644,35816,1821,5793,7256,19775,9077,25568
354900,201903,424,1139,276,867,42,137,73,210,115,347
354910,201903,5057,13814,2915,9695,645,2288,337,1039,982,3327
354920,201903,448,1189,183,619,23,94,36,105,59,199
354925,201903,280,829,149,528,24,93,30,89,54,182
354930,201903,409,998,222,668,19,70,92,238,111,308
354940,201903,1994,6295,1407,4918,482,1818,197,624,679,2442
354950,201903,1466,4055,1161,3579,75,333,777,2247,852,2580
354960,201903,844,2300,646,2010,90,321,331,967,421,1288
354970,201903,3952,11535,3082,9918,429,1470,1794,5645,2223,7115
354980,201903,29787,72602,19327,54108,2379,7870,10652,27657,13031,35527
354990,201903,59303,155090,43570,125927,4664,15203,26114,71485,30778,86688
354995,201903,2502,6148,1877,5269,254,805,1216,3236,1470,4041
355000,201903,1470,3948,1151,3435,190,650,464,1261,654,1911
355010,201903,3326,9534,2056,6664,687,2299,181,595,868,2894
355020,201903,3368,9848,2428,8086,755,2752,625,1964,1380,4716
355030,201903,1303788,3275654,935973,2538809,161005,477160,448872,1120671,609877,1597831
355040,201903,2778,7514,2246,6741,390,1228,1392,4172,1782,5400
355050,201903,962,2402,686,1953,206,598,196,513,402,1111
355060,201903,5580,15836,4059,12809,716,2562,1920,5506,2636,8068
355070,201903,7891,21287,6272,18572,812,2798,3781,10456,4593,13254
355080,201903,836,2439,508,1779,111,422,56,157,167,579
355090,201903,1128,3347,843,2815,220,739,240,825,460,1564
355100,201903,20940,56583,16337,49703,2953,9620,9605,28781,12558,38401
355110,201903,954,2767,718,2366,236,821,129,439,365,1260
355120,201903,667,1830,463,1489,51,187,151,456,202,643
355130,201903,759,1737,334,899,21,56,187,461,208,517
355140,201903,1590,3963,1375,3649,122,408,1077,2740,1199,3148
355150,201903,4168,11452,3313,9894,428,1394,1924,5518,2352,6912
355160,201903,1792,5149,1321,4296,335,1247,302,938,637,2185
355170,201903,9087,24102,7093,20668,1690,5221,3417,9714,5107,14935
355180,201903,2702,7547,1917,6160,448,1633,628,1778,1076,3411
355190,201903,1824,4912,1426,4268,352,1100,704,2196,1056,3296
355200,201903,800,2591,688,2405,214,847,228,717,442,1564
355210,201903,2857,8141,2326,7005,341,1181,1274,3597,1615,4778
355220,201903,43276,118476,33730,99759,8870,27747,12654,34434,21524,62181
355230,201903,1164,2938,610,1823,113,335,176,498,289,833
355240,201903,22028,59058,15188,45520,2362,7705,7407,21244,9769,28949
355250,201903,35114,96749,25490,77824,6577,21220,8995,26267,15572,47487
355255,201903,821,2146,427,1329,79,260,138,413,217,673
355260,201903,1388,3599,991,2907,121,425,588,1613,709,2038
355270,201903,1225,3688,932,3050,247,828,279,875,526,1703
355280,201903,27397,73108,19282,57084,3230,10251,8756,24534,11986,34785
355290,201903,854,2415,620,1953,128,382,254,763,382,1145
355300,201903,1217,3615,967,3118,175,603,322,999,497,1602
355310,201903,1019,2852,760,2401,103,337,410,1311,513,1648
355320,201903,532,1441,388,1157,69,235,145,357,214,592
355330,201903,2221,6115,1697,5144,151,550,1163,3350,1314,3900
355340,201903,3595,8076,2865,7067,381,880,1849,4612,2230,5492
355350,201903,1326,3960,971,3219,207,726,315,1032,522,1758
355360,201903,1292,3465,1011,3008,118,365,638,1876,756,2241
355365,201903,359,990,179,630,42,135,27,97,69,232
355370,201903,5844,14978,4377,12759,1063,3033,1870,5867,2933,8900
355380,201903,2913,8012,2161,6516,388,1291,706,1844,1094,3135
355385,201903,1369,3798,1121,3431,135,507,644,1780,779,2287
355390,201903,771,2171,549,1674,122,385,213,605,335,990
355395,201903,2060,5907,1414,4508,196,670,528,1523,724,2193
355400,201903,8902,27029,7121,23272,1992,7207,2234,6596,4226,13803
355410,201903,21451,59910,13935,45257,3339,11919,3229,10371,6568,22290
355420,201903,667,2226,545,1969,149,619,127,424,276,1043
355430,201903,3645,9439,2752,7875,718,2031,1170,3345,1888,5376
355440,201903,840,2352,491,1574,97,325,138,418,235,743
355450,201903,3397,9004,2099,6438,394,1285,790,2220,1184,3505
355460,201903,542,1360,335,999,46,159,160,434,206,593
355465,201903,385,1083,281,875,55,187,108,320,163,507
355470,201903,1156,3058,625,1944,179,606,174,496,353,1102
355475,201903,287,711,260,670,21,56,204,528,225,584
355480,201903,3591,10421,2948,9397,455,1661,1831,5648,2286,7309
355490,201903,953,2598,497,1586,44,148,232,702,276,850
355495,201903,795,2343,582,1938,82,307,202,633,284,940
355500,201903,6608,17699,3816,11919,600,2042,1138,3244,1738,5286
355510,201903,1299,3372,800,2409,111,387,294,778,405,1165
355520,201903,386,856,172,485,31,91,46,111,77,202
355530,201903,434,982,137,402,23,81,50,126,73,207
355535,201903,508,1424,387,1225,77,285,158,450,235,735
355540,201903,9484,25441,7776,22826,1480,4681,4466,12766,5946,17447
355550,201903,647,1968,530,1743,72,249,259,822,331,1071
355560,201903,1133,3003,596,1914,125,444,38,117,163,561
355570,201903,233,682,123,417,24,83,22,62,46,145
355580,201903,1215,3015,792,2314,110,368,391,1080,501,1448
355590,201903,182,459,139,393,16,46,86,230,102,276
355600,201903,1463,3715,970,2849,231,720,382,1084,613,1804
355610,201903,1716,4441,1142,3379,155,459,526,1487,681,1946
355620,201903,4483,12632,3345,10286,477,1739,1724,4819,2201,6558
355630,201903,2259,6416,1552,5006,287,960,724,2289,1011,3249
355635,201903,927,2798,700,2344,125,477,253,799,378,1276
355640,201903,2635,7813,1815,6109,430,1517,398,1321,828,2838
355645,201903,4268,12452,3246,10616,419,1514,1875,6020,2294,7534
355650,201903,6452,17910,5223,15627,1459,4544,2206,6103,3665,10647
355660,201903,1275,3465,872,2669,116,449,291,885,407,1334
355670,201903,3302,9421,2183,6768,325,1198,1030,2771,1355,3969
355680,201903,3266,9311,1254,4236,357,1246,124,439,481,1685
355690,201903,769,2361,493,1778,126,464,12,21,138,485
355695,201903,225,672,127,427,14,53,16,33,30,86
355700,201903,6670,19809,5386,16874,1098,3503,2504,7483,3602,10986
355710,201903,8181,19593,5015,13748,886,2613,2091,5185,2977,7798
355715,201903,473,1256,247,779,51,186,43,108,94,294
355720,201903,1429,4271,1114,3650,208,744,532,1587,740,2331
355730,201903,938,2726,733,2300,182,599,259,751,441,1350
410010,201903,1226,3441,922,2798,207,701,199,572,406,1273
410020,201903,988,3088,782,2597,280,870,204,690,484,1560
410030,201903,1414,4077,1196,3706,179,638,622,1904,801,2542
410040,201903,11006,31988,8254,26573,1822,6391,2658,7984,4480,14375
410045,201903,922,2439,611,1858,96,323,194,554,290,877
410050,201903,2489,6330,1556,4625,357,1156,365,974,722,2130
410060,201903,2044,6107,1573,5073,398,1334,432,1362,830,2696
410070,201903,1770,4681,1264,3700,222,704,463,1299,685,2003
410080,201903,1354,3669,962,2931,159,493,391,1225,550,1718
410090,201903,1010,2793,898,2599,105,295,500,1523,605,1818
410100,201903,1933,5766,1344,4315,183,699,258,785,441,1484
410105,201903,456,1224,243,757,41,149,51,146,92,295
410110,201903,3066,8113,2094,6120,318,985,839,2345,1157,3330
410115,201903,550,1421,385,1131,60,191,134,386,194,577
410120,201903,2367,7253,2063,6716,636,2236,708,2251,1344,4487
410130,201903,1114,3115,961,2823,247,805,416,1112,663,1917
410140,201903,14160,35007,8529,24761,1711,5368,1858,4898,3569,10266
410150,201903,16217,39205,7627,21770,1400,4304,1565,4195,2965,8499
410160,201903,2863,8179,2337,7237,478,1639,846,2604,1324,4243
410165,201903,713,2016,587,1733,58,195,345,953,403,1148
410170,201903,2539,6800,1627,4767,400,1265,142,423,542,1688
410180,201903,13835,40125,10834,33583,1683,5738,5610,16261,7293,21999
410185,201903,442,1224,315,962,50,165,101,281,151,446
410190,201903,2182,5635,1591,4549,347,1014,424,1180,771,2194
410200,201903,4787,11614,2574,7570,459,1579,548,1583,1007,3162
410210,201903,2826,7353,1767,5341,315,1102,568,1444,883,2546
410220,201903,511,1376,329,1001,44,157,54,160,98,317
410230,201903,1554,4379,1234,3740,180,645,663,1888,843,2533
410240,201903,4397,12225,3204,9876,857,2932,245,703,1102,3635
410250,201903,2512,6253,1811,5020,187,633,815,2171,1002,2804
410260,201903,1798,4648,1153,3414,232,725,462,1345,694,2070
410270,201903,459,1218,330,974,53,182,132,364,185,546
410275,201903,659,1936,430,1407,60,207,196,592,256,799
410280,201903,2205,6047,1409,4389,240,817,522,1511,762,2328
410290,201903,2909,8464,2114,6759,482,1558,675,2159,1157,3717
410300,201903,629,1605,497,1381,57,174,230,591,287,765
410302,201903,359,947,182,583,32,100,82,252,114,352
410304,201903,1118,3163,950,2815,127,383,527,1525,654,1908
410305,201903,1668,4173,1153,3396,189,587,628,1795,817,2382
410310,201903,2513,7454,1964,6276,408,1423,734,2313,1142,3736
410315,201903,706,1736,346,1122,116,386,77,241,193,627
410320,201903,1101,3122,709,2250,110,408,113,352,223,760
410322,201903,532,1496,272,872,23,87,115,346,138,433
410330,201903,1493,3783,1034,2878,166,503,289,799,455,1302
410335,201903,826,2350,662,2013,87,286,294,824,381,1110
410337,201903,808,2004,554,1501,53,153,247,629,300,782
410340,201903,490,1334,330,949,34,121,168,402,202,523
410345,201903,2230,5948,1118,3459,256,806,240,675,496,1481
410347,201903,689,1774,487,1394,56,201,137,382,193,583
410350,201903,1320,3492,915,2762,94,319,389,1105,483,1424
410360,201903,3997,9977,3140,8504,225,717,2024,5240,2249,5957
410370,201903,11478,31352,7621,22546,1021,3378,2923,7660,3944,11038
410380,201903,1373,3689,1010,2957,117,394,426,1165,543,1559
410390,201903,2506,6696,1606,4938,406,1372,379,1067,785,2439
410395,201903,860,2577,696,2220,140,484,305,957,445,1441
410400,201903,5149,14312,3834,11727,666,2160,1634,4815,2300,6975
410405,201903,795,1972,614,1707,151,462,245,626,396,1088
410410,201903,1180,3332,1123,3253,175,631,698,2074,873,2705
410420,201903,7801,22832,5996,19090,1145,4052,1897,5429,3042,9481
410425,201903,2874,8413,2063,6739,369,1298,701,2087,1070,3385
410430,201903,12725,32681,8596,24789,1477,4591,2828,7707,4305,12298
410440,201903,2374,7258,2008,6544,339,1235,1012,3236,1351,4471
410442,201903,2200,6962,1846,6140,544,1791,555,1861,1099,3652
410445,201903,2220,6694,1747,5758,371,1387,483,1656,854,3043
410450,201903,1452,3870,1046,3111,207,691,296,804,503,1495
410460,201903,1770,4585,1375,3969,192,594,626,1733,818,2327
410465,201903,2558,7718,1974,6455,408,1365,630,1974,1038,3339
410470,201903,1824,5385,1318,4340,330,1221,276,928,606,2149
410480,201903,34075,83359,18385,54896,3092,10350,3693,9507,6785,19857
410490,201903,10531,30105,7444,23458,1500,5130,2580,7624,4080,12754
410500,201903,1697,4747,1175,3660,258,920,300,797,558,1717
410510,201903,1984,5026,1273,3628,239,650,387,1127,626,1777
410520,201903,3000,9734,2704,9133,840,2869,1053,3622,1893,6491
410530,201903,1476,3937,727,2181,118,361,119,264,237,625
410540,201903,2499,6941,1787,5522,299,983,869,2662,1168,3645
410550,201903,6726,18447,4248,12794,756,2488,1100,2909,1856,5397
410560,201903,1431,3822,1077,3112,222,672,410,1038,632,1710
410570,201903,2485,7120,1869,5969,543,2009,146,498,689,2507
410580,201903,23276,62669,17279,51277,3647,11616,7169,19802,10816,31418
410590,201903,1411,4161,931,2928,166,544,247,685,413,1229
410600,201903,1775,4869,1329,3981,288,817,471,1457,759,2274
410610,201903,739,2012,526,1588,54,192,228,653,282,845
410620,201903,2047,6249,1316,4440,315,1140,223,683,538,1823
410630,201903,2328,6398,1492,4598,311,1051,252,630,563,1681
410640,201903,4500,11014,2891,8219,693,2241,400,1139,1093,3380
410645,201903,1019,3081,850,2837,295,1015,330,1119,625,2134
410650,201903,1989,5707,1396,4452,329,1115,410,1176,739,2291
410655,201903,891,2240,620,1744,34,122,307,808,341,930
410657,201903,626,1704,395,1214,67,246,161,423,228,669
410660,201903,3158,8381,1719,5147,323,1017,347,990,670,2007
410670,201903,1049,2625,594,1703,114,322,257,701,371,1023
410680,201903,2676,8249,1925,6378,476,1541,468,1591,944,3132
410685,201903,564,1481,441,1259,91,296,203,533,294,829
410690,201903,118115,302546,77458,224633,13607,44554,26221,66656,39828,111210
410700,201903,2338,6073,1984,5518,322,955,1005,2675,1327,3630
410710,201903,808,2095,529,1580,61,196,269,769,330,965
410712,201903,655,1984,553,1751,142,486,198,583,340,1069
410715,201903,870,2628,520,1785,101,352,157,526,258,878
410720,201903,3086,8246,2282,6592,339,1158,454,1192,793,2350
410725,201903,1107,2825,646,1933,126,405,116,299,242,704
410730,201903,596,1601,434,1301,86,295,98,278,184,573
410740,201903,909,2594,651,2099,105,364,256,803,361,1167
410750,201903,1660,4376,1349,3829,219,678,553,1511,772,2189
410752,201903,354,927,163,504,21,77,67,188,88,265
410753,201903,228,713,162,562,16,65,30,101,46,166
410754,201903,1120,2961,915,2644,66,165,602,1857,668,2022
410755,201903,585,1540,420,1208,56,185,193,484,249,669
410760,201903,3216,8528,2323,6926,670,2197,538,1526,1208,3723
410765,201903,12330,35846,9520,30139,1646,5709,1594,4687,3240,10396
410770,201903,965,2395,664,1873,71,223,322,881,393,1104
410773,201903,1266,3426,1105,3164,131,429,699,1926,830,2355
410775,201903,1430,3752,1249,3476,84,272,727,1969,811,2241
410780,201903,597,1504,370,1039,60,172,95,265,155,437
410785,201903,731,2094,582,1808,103,346,215,636,318,982
410790,201903,625,1835,504,1590,139,494,57,132,196,626
410800,201903,3192,7339,2545,6315,77,247,1578,3784,1655,4031
410810,201903,368,1030,282,864,42,143,121,347,163,490
410820,201903,769,2267,407,1274,90,293,77,207,167,500
410830,201903,29929,75959,20389,59464,4737,15617,6655,18301,11392,33918
410832,201903,985,2629,799,2295,105,354,443,1178,548,1532
410840,201903,7208,19199,4298,13374,924,3174,843,2299,1767,5473
410845,201903,1125,3046,896,2662,185,588,334,964,519,1552
410850,201903,2245,6702,1936,6120,350,1196,893,2773,1243,3969
410855,201903,722,1862,468,1364,38,116,212,572,250,688
410860,201903,3853,10057,3007,8490,534,1664,1189,3127,1723,4791
410865,201903,1363,4265,1196,3900,193,680,665,2220,858,2900
410870,201903,1269,3492,1071,3157,53,169,767,2234,820,2403
410880,201903,4136,11731,2973,9452,546,1972,438,1501,984,3473
410890,201903,950,2746,681,2176,163,565,186,583,349,1148
410895,201903,952,3184,787,2797,302,1149,124,426,426,1575
410900,201903,908,2483,591,1838,94,301,124,310,218,611
410910,201903,364,885,200,560,12,37,119,304,131,341
410920,201903,837,2047,564,1602,86,279,255,710,341,989
410930,201903,1437,3940,1064,3232,279,994,245,716,524,1710
410940,201903,21112,60279,15327,49370,3454,12116,4143,13278,7597,25394
410950,201903,1920,5702,1712,5370,69,271,1395,4279,1464,4550
410960,201903,6945,18335,4454,13835,1071,3701,1555,4708,2626,8409
410965,201903,961,2639,725,2183,111,338,382,1141,493,1479
410970,201903,3741,10353,2625,8184,638,2409,365,953,1003,3362
410975,201903,1286,3354,972,2801,157,518,359,1003,516,1521
410980,201903,6532,17062,4145,12557,556,1864,1655,4735,2211,6599
410990,201903,1242,3177,796,2418,247,876,180,451,427,1327
411000,201903,513,1438,361,1124,61,216,93,244,154,460
411005,201903,418,1163,261,813,56,184,49,143,105,327
411007,201903,2164,6328,1770,5585,398,1335,570,1801,968,3136
411010,201903,4169,12789,3267,10840,856,3051,312,926,1168,3977
411020,201903,2307,6742,1882,5986,559,1869,530,1629,1089,3498
411030,201903,715,1808,472,1299,44,145,230,564,274,709
411040,201903,876,2281,403,1195,48,147,121,320,169,467
411050,201903,1797,5851,1477,5073,406,1470,215,640,621,2110
411060,201903,1692,4557,1089,3336,222,817,187,520,409,1337
411065,201903,348,960,253,775,39,121,108,330,147,451
411070,201903,6349,16998,5025,14620,865,2771,2215,6228,3080,8999
411080,201903,2132,5848,1691,5033,421,1376,451,1280,872,2656
411090,201903,851,2234,520,1570,43,162,123,344,166,506
411095,201903,1536,3690,1052,2898,124,399,367,950,491,1349
411100,201903,1086,2869,725,2212,88,316,203,636,291,952
411110,201903,611,1614,259,819,36,101,19,41,55,142
411120,201903,1222,3563,962,3007,332,1161,194,494,526,1655
411125,201903,4987,14938,4433,13821,984,3154,2054,6590,3038,9744
411130,201903,695,1928,494,1510,92,288,188,591,280,879
411140,201903,2212,6951,1833,6074,503,1780,567,1871,1070,3651
411150,201903,3648,9718,2509,7333,533,1797,217,464,750,2261
411155,201903,950,2480,545,1672,49,152,250,716,299,868
411160,201903,338,797,216,607,27,84,48,137,75,221
411170,201903,695,2153,512,1713,108,356,174,566,282,922
411180,201903,5263,14403,4016,12099,691,2299,1713,4868,2404,7167
411190,201903,1461,3879,1071,3158,189,586,341,941,530,1527
411200,201903,4912,13555,3329,10448,938,3169,674,1951,1612,5120
411210,201903,2624,6064,1747,4697,373,1146,452,1136,825,2282
411220,201903,857,2322,632,1846,133,407,185,530,318,937
411230,201903,822,2274,561,1759,106,352,206,639,312,991
411240,201903,1565,3838,914,2557,94,305,441,1145,535,1450
411250,201903,2049,5616,1519,4639,345,1209,455,1373,800,2582
411260,201903,325,868,212,644,24,72,84,226,108,298
411270,201903,1883,5268,1448,4357,235,726,665,1901,900,2627
411275,201903,1318,3191,929,2527,149,466,397,1000,546,1466
411280,201903,1337,3676,858,2725,207,661,120,371,327,1032
411290,201903,717,1979,487,1523,57,162,241,768,298,930
411295,201903,1152,2931,850,2331,84,252,418,1103,502,1355
411300,201903,1007,2555,625,1776,71,219,229,563,300,782
411310,201903,862,2063,646,1745,49,133,282,748,331,881
411320,201903,5203,14036,3747,11293,791,2501,1353,3730,2144,6231
411325,201903,1465,4243,1223,3799,212,651,663,2113,875,2764
411330,201903,3200,8915,2347,7314,580,1978,655,2063,1235,4041
411340,201903,849,2399,510,1610,64,229,190,566,254,795
411342,201903,973,2414,580,1610,88,245,262,724,350,969
411345,201903,1077,2890,802,2427,90,303,530,1603,620,1906
411350,201903,2437,6872,1633,5197,460,1585,168,509,628,2094
411360,201903,638,1557,446,1258,52,155,155,428,207,583
411370,201903,48131,121481,34452,97922,3040,10368,19645,52136,22685,62504
411373,201903,1333,3524,1084,3124,114,376,551,1608,665,1984
411375,201903,1050,2707,752,2137,119,356,287,749,406,1105
411380,201903,1040,2466,714,1825,45,131,443,1046,488,1177
411390,201903,1596,4497,1222,3663,198,653,462,1222,660,1875
411400,201903,2153,5583,1641,4611,221,753,781,2077,1002,2830
411410,201903,2093,6001,1556,4777,361,1226,324,936,685,2162
411420,201903,3869,9877,2164,6530,338,1181,378,916,716,2097
411430,201903,3266,9113,2546,7745,556,1872,970,2696,1526,4568
411435,201903,411,1202,270,892,48,151,95,276,143,427
411440,201903,2501,7362,2042,6409,432,1499,716,2215,1148,3714
411450,201903,2557,6900,1928,5828,287,850,997,3036,1284,3886
411460,201903,3699,9929,2091,6603,401,1448,333,940,734,2388
411470,201903,705,1947,519,1559,90,293,166,452,256,745
411480,201903,4316,12065,3040,9566,641,2287,847,2445,1488,4732
411490,201903,1562,4153,1191,3501,175,588,435,1130,610,1718
411500,201903,1361,3711,884,2699,131,464,232,640,363,1104
411510,201903,2186,5867,1744,5048,366,1221,403,1193,769,2414
411520,201903,28513,70390,15827,45645,2157,7024,5459,14092,7616,21116
411530,201903,917,2484,564,1785,125,439,94,271,219,710
411535,201903,467,1385,229,784,20,73,37,96,57,169
411540,201903,2752,7109,1845,5268,266,860,744,2065,1010,2925
411545,201903,925,2758,770,2478,74,244,497,1610,571,1854
411550,201903,685,1791,482,1382,86,268,87,252,173,520
411560,201903,1878,5079,1075,3353,159,579,73,176,232,755
411570,201903,6726,16377,4490,12709,975,3052,1145,3200,2120,6252
411573,201903,772,2150,650,1940,74,249,365,1047,439,1296
411575,201903,1778,5046,1333,4112,291,970,328,964,619,1934
411580,201903,4221,10040,2355,7049,318,1139,353,922,671,2061
411585,201903,681,2025,287,968,77,267,44,120,121,387
411590,201903,381,1100,262,816,23,84,142,392,165,476
411600,201903,288,775,169,564,41,143,56,184,97,327
411605,201903,1515,3599,906,2533,122,425,458,1232,580,1657
411610,201903,2316,5916,1593,4449,125,409,940,2484,1065,2893
411620,201903,2819,7749,2405,7089,406,1318,1338,3858,1744,5176
411630,201903,730,1922,484,1435,82,291,152,387,234,678
411640,201903,532,1475,354,1055,48,154,125,325,173,479
411650,201903,208,598,137,443,26,83,32,101,58,184
411660,201903,904,2311,643,1815,46,133,330,895,376,1028
411670,201903,1203,3107,838,2322,110,312,341,873,451,1185
411680,201903,1528,4185,1184,3517,142,476,587,1733,729,2209
411690,201903,3470,9267,2625,7798,545,1699,788,2422,1333,4121
411695,201903,655,2050,438,1463,60,211,166,559,226,770
411700,201903,1580,4226,1041,3183,250,849,133,354,383,1203
411705,201903,1849,5934,1557,5401,327,1121,834,3083,1161,4204
411710,201903,1808,4730,1258,3696,343,1070,166,476,509,1546
411720,201903,1066,2590,734,1969,115,349,312,763,427,1112
411721,201903,877,2287,649,1862,126,372,150,436,276,808
411722,201903,728,2015,400,1217,63,222,157,414,220,636
411725,201903,1188,3503,796,2659,187,649,161,553,348,1202
411727,201903,1404,4022,918,2978,252,850,133,401,385,1251
411729,201903,685,1682,435,1191,55,187,152,366,207,553
411730,201903,5148,14243,3815,11503,1015,3184,1332,3919,2347,7103
411740,201903,536,1424,267,834,50,158,53,150,103,308
411745,201903,756,2217,481,1555,58,192,88,224,146,416
411750,201903,4874,13172,3462,10279,481,1555,1639,4587,2120,6142
411760,201903,6901,18802,5291,15902,1829,5690,1007,3334,2836,9024
411770,201903,3016,9017,2166,7062,561,1950,278,845,839,2795
411780,201903,2864,8315,2432,7422,669,2157,846,2580,1515,4737
411790,201903,2837,7098,1517,4579,359,1223,191,465,550,1688
411800,201903,974,2791,660,2052,114,361,126,373,240,734
411810,201903,1605,4191,1190,3393,187,576,587,1553,774,2129
411820,201903,10380,31417,8544,27841,2500,8617,3136,9970,5636,18587
411830,201903,595,1489,404,1148,82,247,89,278,171,525
411840,201903,11406,30942,7440,22455,1332,4382,1953,5414,3285,9796
411845,201903,446,1308,233,771,34,130,27,81,61,211
411850,201903,7236,19339,5113,15439,1458,4870,730,1973,2188,6843
411860,201903,718,2121,521,1682,103,372,133,381,236,753
411870,201903,646,1998,434,1466,87,326,92,280,179,606
411880,201903,2020,5326,1462,4361,282,898,367,1068,649,1966
411885,201903,1029,2698,729,2144,100,350,254,723,354,1073
411890,201903,1137,3135,770,2391,137,484,60,150,197,634
411900,201903,791,2307,477,1580,111,375,54,190,165,565
411910,201903,949,2953,689,2348,183,667,186,592,369,1259
411915,201903,15294,38500,9616,27939,1662,5316,3119,8090,4781,13406
411920,201903,1005,3117,839,2748,206,740,263,812,469,1552
411925,201903,486,1295,324,988,73,248,106,308,179,556
411930,201903,5039,16125,4269,14577,1936,7134,249,986,2185,8120
411940,201903,3171,9794,2423,8020,623,2161,660,1947,1283,4108
411950,201903,13098,36625,10677,32489,1964,6569,5496,16121,7460,22690
411960,201903,5550,15495,4519,13332,938,3047,1578,4353,2516,7400
411965,201903,429,1220,302,953,44,152,113,328,157,480
411970,201903,1000,2442,778,2124,162,428,340,1043,502,1471
411980,201903,1459,3828,1066,3118,264,821,391,1074,655,1895
411990,201903,34687,96215,23206,73530,4835,16876,7659,23059,12494,39935
411995,201903,2820,7393,2117,6258,611,2001,592,1618,1203,3619
412000,201903,2018,4706,1446,3730,54,174,968,2329,1022,2503
412010,201903,618,1947,426,1489,57,212,106,306,163,518
412015,201903,559,1605,461,1421,60,199,260,794,320,993
412020,201903,436,1241,259,850,32,122,104,326,136,448
412030,201903,631,1835,440,1451,84,291,122,394,206,685
412033,201903,839,2311,579,1736,77,224,200,569,277,793
412035,201903,778,2110,497,1600,66,247,247,744,313,991
412040,201903,563,1555,344,1086,69,235,53,149,122,384
412050,201903,1715,4437,1166,3409,219,732,278,799,497,1531
412060,201903,6992,21662,5894,19436,1776,6463,1466,4585,3242,11048
412065,201903,615,1735,432,1342,87,284,133,419,220,703
412070,201903,1137,2965,861,2386,121,353,361,957,482,1310
412080,201903,1892,5552,1176,3904,190,680,142,384,332,1064
412085,201903,284,743,95,313,14,44,12,29,26,73
412090,201903,5582,14841,4363,12569,1217,3570,1676,4944,2893,8514
412100,201903,1699,4758,1261,3946,379,1269,242,821,621,2090
412110,201903,847,2331,613,1822,105,323,200,574,305,897
412120,201903,1833,5610,1435,4770,311,1167,405,1169,716,2336
412125,201903,657,1939,475,1536,102,340,154,469,256,809
412130,201903,683,1814,476,1399,65,206,117,357,182,563
412135,201903,592,1598,266,803,44,128,87,241,131,369
412140,201903,1564,3980,1000,2940,219,745,159,408,378,1153
412150,201903,2837,7688,2360,6811,365,1172,1382,3805,1747,4977
412160,201903,1013,3198,604,2109,139,526,89,285,228,811
412170,201903,4178,12007,3510,10833,754,2495,1438,4145,2192,6640
412175,201903,1249,3855,1047,3464,261,874,406,1372,667,2246
412180,201903,1697,4772,1227,3872,174,665,518,1455,692,2120
412190,201903,3302,8441,2432,6866,331,1022,1077,3032,1408,4054
412200,201903,1742,5362,1249,4139,342,1226,204,630,546,1856
412210,201903,615,1567,337,1017,61,215,91,245,152,460
412215,201903,3539,9630,2842,8297,785,2247,1129,3743,1914,5990
412217,201903,994,2660,828,2378,67,209,550,1519,617,1728
412220,201903,5681,16246,4574,14115,1204,3724,1436,4665,2640,8389
412230,201903,2610,8055,2101,7004,411,1562,575,1620,986,3182
412240,201903,6586,17211,4153,12390,756,2491,1167,3206,1923,5697
412250,201903,1968,5194,1497,4309,375,1102,314,882,689,1984
412260,201903,1229,3373,862,2580,144,430,260,724,404,1154
412265,201903,795,2323,673,2080,135,450,292,859,427,1309
412270,201903,801,2291,526,1671,79,278,206,577,285,855
412280,201903,463,1362,364,1187,86,291,101,305,187,596
412290,201903,986,2548,656,1921,104,325,208,585,312,910
412300,201903,1425,3994,1126,3395,275,859,252,770,527,1629
412310,201903,769,2120,633,1877,53,224,336,950,389,1174
412320,201903,843,2184,561,1637,78,302,201,573,279,875
412330,201903,1445,4015,979,3060,181,604,350,1123,531,1727
412340,201903,1030,3002,637,2063,103,365,127,381,230,746
412350,201903,2709,7264,1749,5336,364,1112,357,1104,721,2216
412360,201903,256,726,158,503,13,47,72,215,85,262
412370,201903,780,2287,529,1745,105,391,35,125,140,516
412380,201903,1524,4245,1042,3207,291,939,155,519,446,1458
412382,201903,517,1329,339,1005,60,202,110,275,170,477
412385,201903,2131,6042,1736,5248,585,1708,501,1652,1086,3360
412390,201903,2399,6100,1920,5338,347,983,799,2209,1146,3192
412395,201903,704,2035,476,1508,62,196,200,603,262,799
412400,201903,884,2410,637,1912,142,446,161,513,303,959
412402,201903,1761,4501,1240,3617,316,994,139,410,455,1404
412405,201903,3083,8446,1976,6188,482,1765,54,154,536,1919
412410,201903,5314,14461,3823,11771,789,2771,1038,2980,1827,5751
412420,201903,488,1297,292,868,32,106,118,310,150,416
412430,201903,547,1420,357,1053,32,103,162,448,194,551
412440,201903,2687,7605,1793,5809,514,1775,270,887,784,2662
412450,201903,369,1133,243,801,54,171,21,45,75,216
412460,201903,987,2697,787,2351,143,478,325,956,468,1434
412470,201903,1558,5101,1261,4413,327,1194,318,1145,645,2339
412480,201903,933,2613,587,1810,109,365,144,387,253,752
412490,201903,1137,2956,930,2553,101,265,533,1399,634,1664
412500,201903,1812,4731,1367,3864,327,925,340,899,667,1824
412510,201903,1954,6086,1348,4493,320,1130,106,314,426,1444
412520,201903,1303,3453,689,2067,158,477,47,127,205,604
412530,201903,642,1758,464,1384,69,234,114,337,183,571
412535,201903,791,2144,538,1628,122,405,108,280,230,685
412540,201903,1222,3282,844,2501,97,343,268,823,365,1166
412545,201903,686,1799,461,1325,75,238,131,341,206,579
412550,201903,29371,81492,20175,62258,3862,12854,6977,19944,10839,32798
412555,201903,239,651,153,464,20,72,39,83,59,155
412560,201903,4753,14192,3501,11187,605,2098,1060,3376,1665,5474
412570,201903,4052,10696,2303,7159,538,1804,318,1079,856,2883
412575,201903,951,2521,771,2167,82,266,448,1168,530,1434
412580,201903,1356,3652,940,2829,135,467,436,1255,571,1722
412590,201903,401,1078,210,681,44,159,18,55,62,214
412600,201903,1365,3926,1011,3170,170,607,402,1204,572,1811
412610,201903,800,2199,518,1546,57,196,249,660,306,856
412620,201903,1260,3471,923,2856,192,671,278,800,470,1471
412625,201903,8274,22548,5179,16255,793,2803,310,905,1103,3708
412627,201903,1036,2958,678,2212,156,569,181,577,337,1146
412630,201903,2802,8306,2011,6522,398,1296,653,1913,1051,3209
412635,201903,346,933,231,673,38,125,68,172,106,297
412640,201903,1038,2880,576,1808,80,276,139,380,219,656
412650,201903,1553,4401,1220,3697,222,733,422,1109,644,1842
412660,201903,2488,6718,1739,5201,302,979,520,1407,822,2386
412665,201903,513,1283,297,875,56,165,112,309,168,474
412667,201903,1715,4597,1268,3698,180,580,498,1357,678,1937
412670,201903,781,1966,516,1487,101,341,164,438,265,779
412680,201903,1574,4404,1023,3263,132,485,414,1181,546,1666
412690,201903,868,2409,640,1921,112,354,222,634,334,988
412700,201903,2045,5541,1628,4865,253,915,776,2190,1029,3105
412710,201903,5795,17457,4488,14636,985,3541,1278,3877,2263,7418
412720,201903,1222,3645,913,2914,159,534,187,515,346,1049
412730,201903,2088,5796,1214,3897,252,869,242,740,494,1609
412740,201903,1729,4917,1136,3616,209,733,169,543,378,1276
412750,201903,3809,10508,3244,9641,406,1429,2048,5748,2454,7177
412760,201903,2840,7927,2353,7051,381,1260,1285,3680,1666,4940
412770,201903,9909,25640,5198,16094,762,2500,1059,2874,1821,5374
412780,201903,1207,3326,917,2788,204,663,348,1022,552,1685
412785,201903,1936,4978,1356,3915,206,623,739,2072,945,2695
412788,201903,1300,3798,1058,3314,261,822,451,1378,712,2200
412790,201903,1258,3367,679,2133,120,438,198,531,318,969
412795,201903,1329,3563,698,2179,126,419,127,377,253,796
412796,201903,2308,6908,1907,6050,395,1318,625,1850,1020,3168
412800,201903,3341,8412,2246,6310,292,926,934,2321,1226,3247
412810,201903,10546,27245,6358,18563,873,2893,2149,5497,3022,8390
412820,201903,6363,17931,4526,14194,1073,3530,1334,4212,2407,7742
412830,201903,349,1008,228,729,33,94,49,149,82,243
412840,201903,1801,4712,1283,3685,182,568,433,1172,615,1740
412850,201903,2846,7691,2081,6301,356,1164,755,2183,1111,3347
412853,201903,1641,4333,1355,3737,169,511,685,1718,854,2229
412855,201903,1195,3244,755,2268,158,533,195,553,353,1086
412860,201903,806,2113,553,1673,76,250,255,745,331,995
412862,201903,699,1686,456,1265,69,207,207,554,276,761
412863,201903,1194,3707,1109,3570,131,436,781,2515,912,2951
412865,201903,718,2037,524,1659,100,335,176,553,276,888
412870,201903,880,2390,660,2024,198,681,139,444,337,1125
412880,201903,841,2360,531,1694,100,336,75,215,175,551
420005,201903,458,1383,247,880,37,139,106,383,143,522
420010,201903,3402,8562,2243,6502,177,566,1581,4586,1758,5152
420020,201903,472,1476,289,1011,52,207,43,126,95,333
420030,201903,89,299,62,243,20,84,14,54,34,138
420040,201903,567,1781,336,1251,52,214,19,55,71,269
420050,201903,666,1636,412,1158,47,157,254,663,301,820
420055,201903,158,481,81,294,15,63,26,88,41,151
420060,201903,113,323,72,222,14,55,17,29,31,84
420070,201903,788,2546,586,2057,122,448,206,702,328,1150
420075,201903,81,222,38,123,8,26,8,14,16,40
420080,201903,356,1073,274,893,89,318,83,257,172,575
420090,201903,406,1326,251,922,63,241,55,207,118,448
420100,201903,1146,3168,984,2921,51,171,785,2311,836,2482
420110,201903,245,818,221,770,43,169,94,306,137,475
420120,201903,438,1284,288,931,60,221,112,317,172,538
420125,201903,316,1041,244,874,63,246,112,384,175,630
420127,201903,284,816,97,348,20,78,22,79,42,157
420130,201903,2235,6507,1663,5422,295,1155,776,2359,1071,3514
420140,201903,3305,9174,2379,7527,666,2409,301,921,967,3330
420150,201903,572,1494,352,1116,58,205,173,519,231,724
420160,201903,235,603,109,347,11,43,37,104,48,147
420165,201903,159,469,94,315,21,70,28,86,49,156
420170,201903,258,800,161,566,22,75,33,99,55,174
420180,201903,183,572,102,369,16,60,34,114,50,174
420190,201903,166,549,98,372,33,137,21,72,54,209
420195,201903,1283,3481,942,2918,282,985,125,328,407,1313
420200,201903,3395,8997,1957,6138,317,1233,689,1844,1006,3077
420205,201903,1376,3850,1002,3182,164,529,561,1808,725,2337
420207,201903,1555,4265,987,3155,206,758,365,1114,571,1872
420208,201903,375,1058,209,764,42,170,80,292,122,462
420209,201903,142,481,91,325,24,102,29,89,53,191
420210,201903,2369,6364,1546,5015,351,1279,657,2060,1008,3339
420213,201903,760,2439,630,2163,143,526,299,999,442,1525
420215,201903,215,657,149,513,44,153,22,63,66,216
420220,201903,227,694,138,489,30,127,56,173,86,300
420230,201903,4099,11625,3092,9731,452,1575,1637,4999,2089,6574
420240,201903,11464,31724,7207,22316,975,3519,3611,9902,4586,13421
420243,201903,383,1124,307,969,52,182,165,492,217,674
420245,201903,1230,3327,858,2654,95,378,475,1379,570,1757
420250,201903,421,1251,365,1143,75,274,183,524,258,798
420253,201903,501,1293,367,1088,33,105,193,560,226,665
420257,201903,183,482,106,335,20,69,54,165,74,234
420260,201903,1060,2965,775,2526,134,493,438,1402,572,1895
420270,201903,447,1204,202,614,27,91,71,203,98,294
420280,201903,1186,3434,818,2701,167,616,231,736,398,1352
420285,201903,89,242,50,163,6,27,7,16,13,43
420287,201903,448,1117,307,892,92,285,96,274,188,559
420290,201903,3908,11369,2964,9234,468,1700,1551,4383,2019,6083
420300,201903,6425,18524,3709,12146,740,2703,967,2789,1707,5492
420310,201903,831,2013,394,1124,70,201,174,450,244,651
420315,201903,828,2496,566,1959,134,496,207,718,341,1214
420320,201903,3962,11603,3090,9992,981,3498,685,2047,1666,5545
420325,201903,246,745,181,627,42,142,61,210,103,352
420330,201903,836,2563,546,1910,123,483,174,542,297,1025
420340,201903,926,2729,665,2196,163,571,65,205,228,776
420350,201903,1307,3548,920,2800,99,338,578,1720,677,2058
420360,201903,2461,7055,1316,4447,264,963,134,434,398,1397
420370,201903,1074,3014,863,2646,105,393,580,1701,685,2094
420380,201903,4640,12635,3009,9485,669,2275,988,2965,1657,5240
420390,201903,1063,2671,704,1903,115,376,319,635,434,1011
420395,201903,954,2829,625,2124,106,374,65,198,171,572
420400,201903,896,2652,587,1948,115,424,180,567,295,991
420410,201903,518,1466,381,1172,39,144,235,675,274,819
420415,201903,297,906,224,746,65,238,77,267,142,505
420417,201903,604,1871,492,1623,128,435,174,593,302,1028
420419,201903,151,546,119,458,44,181,10,32,54,213
420420,201903,10170,27633,6849,21446,2208,7585,1636,4712,3844,12297
420425,201903,669,1792,465,1398,45,165,209,610,254,775
420430,201903,2866,8152,1776,5640,457,1568,524,1481,981,3049
420435,201903,266,693,112,383,21,83,47,156,68,239
420440,201903,656,1940,383,1288,120,441,96,279,216,720
420445,201903,290,763,171,511,36,117,54,145,90,262
420450,201903,653,1979,474,1569,93,382,164,472,257,854
420455,201903,1927,4983,1418,4162,188,636,717,2010,905,2646
420460,201903,8448,23201,6285,19197,1055,3668,3000,8731,4055,12399
420470,201903,571,1562,320,1051,64,243,75,213,139,456
420475,201903,52,150,26,90,10,33,3,13,13,46
420480,201903,4923,12841,3166,9765,674,2255,968,2921,1642,5176
420490,201903,351,1053,235,800,57,223,72,237,129,460
420500,201903,1279,3808,895,3036,182,657,333,1114,515,1771
420510,201903,169,483,91,300,16,58,28,85,44,143
420515,201903,45,128,30,95,1,1,14,49,15,50
420517,201903,753,2108,651,1935,52,154,492,1458,544,1612
420519,201903,305,731,197,564,24,72,98,288,122,360
420520,201903,363,961,159,547,18,57,16,49,34,106
420530,201903,810,2415,565,1882,117,435,168,495,285,930
420535,201903,209,617,84,294,23,85,19,69,42,154
420540,201903,27019,66132,17008,48401,2972,9457,6011,14539,8983,23996
420543,201903,221,676,172,553,27,83,84,258,111,341
420545,201903,1055,3215,800,2635,173,615,302,941,475,1556
420550,201903,3360,9588,2165,7362,441,1649,875,3019,1316,4668
420555,201903,295,877,198,666,36,136,95,297,131,433
420560,201903,420,1091,291,886,69,209,147,440,216,649
420570,201903,2034,5909,1546,4942,321,1134,571,1712,892,2846
420580,201903,1689,4450,1205,3689,262,824,512,1589,774,2413
420590,201903,2799,7668,1631,5093,316,1140,387,927,703,2067
420600,201903,943,2852,720,2388,138,508,321,1012,459,1520
420610,201903,347,1022,188,651,45,156,50,174,95,330
420620,201903,521,1394,373,1130,106,332,133,399,239,731
420630,201903,885,2677,636,2032,128,457,301,855,429,1312
420640,201903,501,1435,237,839,63,228,20,59,83,287
420650,201903,2940,8163,1747,5528,297,1053,658,1787,955,2840
420660,201903,350,992,239,761,54,189,66,208,120,397
420665,201903,533,1439,333,1082,60,214,133,388,193,602
420670,201903,1373,3808,895,2879,144,592,350,986,494,1578
420675,201903,130,391,82,293,26,113,16,46,42,159
420680,201903,335,806,178,582,31,117,85,270,116,387
420690,201903,822,2566,498,1718,77,306,116,326,193,632
420700,201903,2675,7381,2050,6272,291,1024,1054,3078,1345,4102
420710,201903,708,2147,534,1745,80,331,290,844,370,1175
420720,201903,1298,3629,927,3014,223,712,408,1304,631,2016
420730,201903,2664,7246,2049,6255,342,1095,1149,3405,1491,4500
420740,201903,620,1891,381,1357,111,420,40,154,151,574
420750,201903,1764,5307,1173,3907,210,806,444,1353,654,2159
420757,201903,62,172,29,110,4,18,10,35,14,53
420760,201903,354,1066,150,488,39,140,25,67,64,207
420765,201903,363,1153,202,718,28,101,78,274,106,375
420768,201903,1191,3655,1023,3339,161,532,698,2253,859,2785
420770,201903,429,1161,187,673,31,122,79,267,110,389
420775,201903,372,1105,238,812,53,201,43,121,96,322
420780,201903,940,2699,550,1852,119,427,102,303,221,730
420785,201903,184,503,129,389,13,38,53,144,66,182
420790,201903,981,3153,731,2604,165,663,348,1172,513,1835
420800,201903,716,1846,333,1060,93,303,72,237,165,540
420810,201903,1439,4763,1177,4193,363,1452,325,997,688,2449
420820,201903,10021,25851,6914,20714,1426,4858,3029,8155,4455,13013
420830,201903,2975,8336,2237,6980,513,1723,868,2644,1381,4367
420840,201903,515,1574,237,872,60,220,45,163,105,383
420845,201903,1923,5152,1130,3697,225,837,392,1247,617,2084
420850,201903,1043,3462,635,2367,152,617,87,288,239,905
420860,201903,272,715,153,494,40,147,34,102,74,249
420870,201903,814,2239,636,1932,183,659,275,765,458,1424
420880,201903,899,2813,709,2416,152,568,241,756,393,1324
420890,201903,7438,20271,4201,13517,710,2534,1260,3455,1970,5989
420895,201903,158,475,94,305,24,75,28,95,52,170
420900,201903,1350,3481,809,2510,117,453,340,926,457,1379
420910,201903,25065,67864,15667,49423,2581,9170,5714,16237,8295,25407
420915,201903,521,1939,370,1489,66,268,165,679,231,947
420917,201903,340,911,178,523,25,83,79,218,104,301
420920,201903,79,223,29,107,3,12,4,14,7,26
420930,201903,16734,44681,11879,36048,2179,7278,5358,15459,7537,22737
420940,201903,2264,5798,1391,4255,331,1127,194,473,525,1600
420945,201903,128,373,100,310,24,87,39,106,63,193
420950,201903,311,928,170,583,29,119,43,119,72,238
420960,201903,956,2465,656,1922,119,415,264,679,383,1094
420970,201903,2408,7064,1614,5407,471,1618,257,894,728,2512
420980,201903,296,925,237,832,108,375,77,301,185,676
420985,201903,324,955,157,566,31,123,52,165,83,288
420990,201903,394,1219,203,749,44,168,32,99,76,267
421000,201903,471,1544,313,1149,75,300,76,240,151,540
421003,201903,454,1074,141,430,15,43,23,63,38,106
421005,201903,58,196,53,189,12,44,24,84,36,128
421010,201903,3349,9335,2390,7613,514,1816,570,1603,1084,3419
421020,201903,364,1126,284,985,39,152,163,554,202,706
421030,201903,720,2297,573,1987,177,675,160,505,337,1180
421040,201903,682,1639,414,1224,36,116,252,733,288,849
421050,201903,1071,3052,675,2155,132,458,228,660,360,1118
421055,201903,168,463,80,255,15,50,29,77,44,127
421060,201903,540,1648,340,1125,64,245,124,361,188,606
421070,201903,516,1603,286,1023,62,233,42,148,104,381
421080,201903,466,1370,410,1273,51,169,264,828,315,997
421085,201903,357,1079,136,517,26,106,22,63,48,169
421090,201903,283,765,164,515,21,68,51,160,72,228
421100,201903,913,2104,385,1153,86,278,59,164,145,442
421105,201903,1459,4120,1063,3355,167,511,531,1693,698,2204
421110,201903,1038,3016,871,2763,43,124,612,2025,655,2149
421120,201903,879,2831,617,2191,86,340,197,637,283,977
421125,201903,251,695,206,622,72,239,70,173,142,412
421130,201903,3876,11870,3251,10627,709,2578,1783,5618,2492,8196
421140,201903,283,790,184,585,37,125,64,177,101,302
421145,201903,428,1223,261,841,49,162,117,361,166,523
421150,201903,544,1481,283,934,58,213,92,290,150,503
421160,201903,559,1482,355,1118,50,169,205,632,255,801
421165,201903,194,599,130,445,29,99,51,175,80,274
421170,201903,1035,2850,823,2503,138,407,517,1605,655,2012
421175,201903,1036,2748,677,2163,137,506,268,776,405,1282
421180,201903,364,975,200,639,40,160,60,170,100,330
421185,201903,311,838,206,619,33,104,115,338,148,442
421187,201903,303,896,189,606,36,114,67,202,103,316
421189,201903,342,1027,260,856,41,135,94,300,135,435
421190,201903,9237,25471,5974,19418,1271,4519,1511,4646,2782,9165
421200,201903,627,1924,513,1689,89,312,265,846,354,1158
421205,201903,192,536,143,456,28,100,75,229,103,329
421210,201903,1062,2837,643,2074,160,523,204,650,364,1173
421220,201903,1310,4145,1033,3509,246,932,252,741,498,1673
421223,201903,370,1075,245,826,60,194,105,356,165,550
421225,201903,869,2695,751,2472,149,535,424,1409,573,1944
421227,201903,972,2578,559,1745,93,309,250,785,343,1094
421230,201903,585,1583,370,1176,100,343,105,327,205,670
421240,201903,300,917,119,449,13,70,16,57,29,127
421250,201903,1526,4021,1020,3178,170,592,438,1325,608,1917
421260,201903,177,513,44,164,11,44,9,35,20,79
421265,201903,611,1796,569,1733,17,59,521,1594,538,1653
421270,201903,392,1059,175,642,31,117,63,224,94,341
421280,201903,1523,4548,1150,3837,244,956,506,1559,750,2515
421290,201903,779,2165,409,1294,81,265,79,247,160,512
421300,201903,236,645,134,431,20,71,36,118,56,189
421310,201903,158,486,121,402,22,80,58,196,80,276
421315,201903,203,592,125,406,36,112,25,79,61,191
421320,201903,608,1801,305,1026,48,165,45,106,93,271
421330,201903,616,1824,435,1456,96,350,120,375,216,725
421335,201903,350,1087,285,971,50,186,115,382,165,568
421340,201903,1262,3708,940,3097,210,754,381,1236,591,1990
421350,201903,1153,3213,808,2581,162,617,346,1027,508,1644
421360,201903,2191,6147,1330,4376,281,1107,469,1360,750,2467
421370,201903,482,1604,293,1100,62,242,75,267,137,509
421380,201903,807,2235,689,2019,93,308,410,1167,503,1475
421390,201903,179,482,66,219,14,41,18,50,32,91
421400,201903,244,809,170,627,34,146,78,253,112,399
421410,201903,251,688,109,379,18,66,39,135,57,201
421415,201903,222,688,131,436,36,121,26,72,62,193
421420,201903,511,1491,431,1336,71,248,250,731,321,979
421430,201903,118,394,92,333,14,54,31,96,45,150
421440,201903,596,1597,378,1227,76,251,183,594,259,845
421450,201903,362,1117,230,786,37,157,35,128,72,285
421460,201903,326,941,203,691,42,153,51,147,93,300
421470,201903,243,746,140,503,30,127,52,187,82,314
421480,201903,2632,7231,1727,5510,399,1409,571,1637,970,3046
421490,201903,103,331,66,234,10,43,18,50,28,93
421500,201903,2030,6220,1414,4922,409,1604,294,938,703,2542
421505,201903,291,869,259,816,37,128,155,465,192,593
421507,201903,382,1156,226,786,67,247,69,223,136,470
421510,201903,263,767,153,493,33,104,69,208,102,312
421520,201903,515,1387,319,949,42,149,175,477,217,626
421530,201903,313,994,183,660,43,194,41,114,84,308
421535,201903,396,1103,251,826,38,144,128,392,166,536
421540,201903,240,590,123,393,19,70,41,114,60,184
421545,201903,664,2004,483,1649,98,383,228,737,326,1120
421550,201903,1857,5399,1536,4881,343,1168,751,2332,1094,3500
421555,201903,190,600,70,265,13,61,10,24,23,85
421560,201903,81,275,50,192,12,45,14,54,26,99
421565,201903,869,2351,620,1942,154,530,186,603,340,1133
421567,201903,451,1571,287,1077,125,484,51,171,176,655
421568,201903,354,1059,247,811,35,129,115,362,150,491
421569,201903,190,557,76,261,20,71,30,100,50,171
421570,201903,943,2683,663,2138,189,667,150,466,339,1133
421575,201903,284,862,226,704,45,163,89,222,134,385
421580,201903,2881,8384,1968,6455,395,1537,675,1875,1070,3412
421590,201903,135,441,106,364,36,131,27,78,63,209
421600,201903,506,1428,345,1085,85,283,90,239,175,522
421605,201903,725,1939,491,1537,102,306,179,577,281,883
421610,201903,1088,3012,667,2166,132,445,165,534,297,979
421620,201903,3710,10280,2133,7260,545,2011,516,1697,1061,3708
421625,201903,196,549,82,269,17,51,13,41,30,92
421630,201903,2365,6503,1372,4401,245,939,361,994,606,1933
421635,201903,227,635,151,459,17,54,82,227,99,281
421640,201903,661,1852,468,1530,106,364,137,450,243,814
421650,201903,2130,6066,1364,4570,349,1326,316,879,665,2205
421660,201903,7600,22138,5646,18379,966,3563,2235,6712,3201,10275
421670,201903,734,2172,515,1659,105,389,243,758,348,1147
421680,201903,919,2752,703,2314,196,690,278,842,474,1532
421690,201903,1165,3532,822,2759,165,629,257,859,422,1488
421700,201903,456,1423,243,877,43,172,68,227,111,399
421710,201903,211,677,91,312,25,92,20,63,45,155
421715,201903,105,301,76,235,19,56,48,143,67,199
421720,201903,1875,5275,1070,3540,282,1027,268,750,550,1777
421725,201903,208,510,106,331,21,70,39,98,60,168
421730,201903,369,1124,188,595,24,86,80,227,104,313
421740,201903,615,1839,429,1421,129,434,101,313,230,747
421750,201903,852,2076,410,1232,87,278,159,452,246,730
421755,201903,181,515,101,319,16,60,45,126,61,186
421760,201903,836,2348,510,1686,93,340,160,449,253,789
421770,201903,2140,5882,1565,4850,396,1248,551,1854,947,3102
421775,201903,235,627,145,444,22,76,66,182,88,258
421780,201903,763,2391,517,1837,102,396,205,686,307,1082
421790,201903,662,1759,390,1274,84,286,189,597,273,883
421795,201903,216,636,137,424,23,83,51,144,74,227
421800,201903,2355,6786,1743,5606,310,1105,869,2667,1179,3772
421810,201903,605,1677,420,1315,54,210,232,685,286,895
421820,201903,835,2498,448,1528,84,322,113,335,197,657
421825,201903,1293,3728,1167,3531,143,481,810,2379,953,2860
421830,201903,1892,6011,1611,5474,358,1321,657,2141,1015,3462
421835,201903,208,554,119,383,16,71,47,131,63,202
421840,201903,199,628,131,472,33,128,27,81,60,209
421850,201903,365,1082,204,728,42,173,62,161,104,334
421860,201903,285,845,182,618,23,93,63,177,86,270
421870,201903,3392,8864,2366,6888,461,1544,1072,2843,1533,4387
421875,201903,212,643,107,389,21,82,21,55,42,137
421880,201903,476,1365,347,1117,106,400,68,217,174,617
421885,201903,191,563,132,438,35,124,33,93,68,217
421890,201903,729,2351,577,2030,118,468,257,834,375,1302
421895,201903,367,1015,308,933,36,131,210,634,246,765
421900,201903,934,2447,648,1904,118,402,280,729,398,1131
421910,201903,312,956,217,743,50,199,42,120,92,319
421915,201903,375,1073,205,668,45,148,29,86,74,234
421917,201903,540,1370,320,1061,118,425,70,231,188,656
421920,201903,428,1340,310,1099,136,505,97,345,233,850
421930,201903,2266,6052,1054,3576,287,1058,167,541,454,1599
421935,201903,416,1367,324,1152,65,242,172,587,237,829
421940,201903,307,946,113,392,20,79,28,91,48,170
421950,201903,2933,7432,1447,4564,315,1113,323,889,638,2002
421960,201903,154,400,89,293,21,82,17,50,38,132
421970,201903,1825,4841,1019,3180,224,752,302,836,526,1588
421985,201903,244,639,140,428,12,46,43,136,55,182
422000,201903,1635,4480,1339,3970,167,579,849,2495,1016,3074
430003,201903,519,1495,348,1163,67,252,140,459,207,711
430005,201903,263,734,165,544,43,142,71,235,114,377
430010,201903,1632,4262,1309,3700,152,477,882,2398,1034,2875
430020,201903,574,1357,439,1171,65,207,267,668,332,875
430030,201903,995,2439,567,1667,163,490,162,450,325,940
430040,201903,9401,23536,5590,16513,1502,4860,452,1448,1954,6308
430045,201903,543,1420,365,1071,37,129,201,560,238,689
430047,201903,243,542,95,279,20,62,25,73,45,135
430050,201903,938,2456,526,1595,121,401,116,332,237,733
430055,201903,261,670,117,362,17,69,59,160,76,229
430057,201903,94,210,30,83,9,33,6,14,15,47
430060,201903,15801,44501,12387,38944,2978,10011,5291,16624,8269,26635
430063,201903,863,2441,681,2046,127,380,371,1098,498,1478
430064,201903,955,2758,725,2245,209,676,247,733,456,1409
430066,201903,108,246,76,195,4,11,56,131,60,142
430070,201903,699,1781,100,331,8,29,11,27,19,56
430080,201903,743,1926,451,1330,84,275,198,516,282,791
430085,201903,866,2037,513,1450,85,252,218,607,303,859
430087,201903,525,1440,424,1295,80,244,239,753,319,997
430090,201903,570,1501,185,604,19,82,56,170,75,252
430100,201903,614,1541,334,994,72,221,116,308,188,529
430105,201903,976,2668,611,2036,118,425,283,965,401,1390
430107,201903,176,524,116,379,20,70,29,78,49,148
430110,201903,2088,5252,1499,4359,243,740,827,2384,1070,3124
430120,201903,1335,4063,822,2723,161,558,360,1209,521,1767
430130,201903,3381,8214,2559,7042,1008,2780,523,1667,1531,4447
430140,201903,880,2571,599,1984,156,504,232,781,388,1285
430150,201903,532,1411,302,947,65,216,95,284,160,500
430155,201903,252,666,118,369,23,72,27,73,50,145
430160,201903,17352,43965,13902,38769,2691,7910,6570,18552,9261,26462
430163,201903,2442,6167,1713,5001,135,446,1138,3308,1273,3754
430165,201903,358,858,85,272,12,29,13,33,25,62
430170,201903,895,2405,323,1114,61,212,62,196,123,408
430175,201903,653,2035,535,1768,136,443,253,827,389,1270
430180,201903,645,1689,517,1456,74,226,350,953,424,1179
430185,201903,450,1081,271,762,49,134,105,270,154,404
430187,201903,636,1595,446,1321,75,242,219,663,294,905
430190,201903,1397,3883,1119,3421,257,835,486,1408,743,2243
430192,201903,128,373,54,164,9,32,14,39,23,71
430195,201903,393,1186,59,210,10,35,6,23,16,58
430200,201903,1066,3278,869,2915,292,1025,253,869,545,1894
430205,201903,491,1335,405,1161,17,60,331,913,348,973
430210,201903,4794,12255,3290,9226,665,2006,1153,2625,1818,4631
430215,201903,298,794,188,557,38,116,69,204,107,320
430220,201903,650,1609,170,573,34,140,37,102,71,242
430222,201903,178,517,141,443,20,73,60,177,80,250
430223,201903,243,683,202,603,30,94,114,331,144,425
430225,201903,15,35,12,30,1,2,9,15,10,17
430230,201903,1705,4898,1501,4598,161,467,1147,3574,1308,4041
430235,201903,256,767,183,598,43,153,58,168,101,321
430237,201903,524,1290,358,992,17,62,241,627,258,689
430240,201903,1099,2505,655,1802,72,242,382,1001,454,1243
430245,201903,666,2019,506,1690,159,529,229,774,388,1303
430250,201903,948,2531,741,2203,243,787,34,87,277,874
430258,201903,101,274,76,223,5,10,39,121,44,131
430260,201903,610,1662,442,1330,81,254,235,699,316,953
430265,201903,196,573,141,467,33,119,40,120,73,239
430270,201903,2692,7004,2172,6182,332,1041,1359,3744,1691,4785
430280,201903,4820,11883,3425,9361,744,2111,1419,3829,2163,5940
430290,201903,2094,5066,1811,4706,58,179,1540,3931,1598,4110
430300,201903,8637,23301,6791,19874,1220,3902,3381,9711,4601,13613
430310,201903,9678,25045,6422,18666,927,3107,3031,8152,3958,11259
430320,201903,938,2538,513,1619,73,205,271,884,344,1089
430330,201903,604,1552,397,1116,80,245,180,454,260,699
430340,201903,686,1564,362,1049,61,192,196,544,257,736
430350,201903,6207,17042,4668,14024,1033,3200,2081,6143,3114,9343
430355,201903,333,850,111,365,25,70,17,53,42,123
430360,201903,773,1933,533,1517,123,386,198,515,321,901
430367,201903,347,863,181,539,44,144,66,195,110,339
430370,201903,491,1365,223,723,45,157,55,153,100,310
430380,201903,680,1718,335,1068,76,274,71,229,147,503
430390,201903,2925,7323,1580,4747,301,982,123,286,424,1268
430400,201903,1087,2379,825,1995,81,211,585,1355,666,1566
430410,201903,557,1367,371,1057,58,186,211,577,269,763
430420,201903,2664,7461,2023,6018,590,1844,717,2016,1307,3860
430430,201903,658,1724,318,982,73,224,66,201,139,425
430435,201903,1483,3868,1113,3256,246,768,487,1421,733,2189
430440,201903,3594,10359,2695,8560,455,1599,1426,4469,1881,6068
430450,201903,6650,17343,5270,14840,654,2110,3028,8283,3682,10393
430460,201903,28244,74713,19954,60726,4175,14114,8633,24924,12808,39038
430461,201903,392,989,108,338,21,69,30,86,51,155
430462,201903,242,666,141,470,17,60,50,178,67,238
430463,201903,4619,13167,3595,11320,689,2364,1787,5530,2476,7894
430465,201903,463,1256,380,1089,61,189,228,631,289,820
430466,201903,3831,9867,3012,8469,798,2346,1353,3598,2151,5944
430467,201903,479,1218,331,967,52,183,162,441,214,624
430468,201903,1305,3301,1024,2879,129,389,610,1679,739,2068
430469,201903,646,1817,76,265,11,37,11,19,22,56
430470,201903,5377,14415,3704,11382,1176,3859,876,2600,2052,6459
430471,201903,509,1538,430,1377,78,251,197,607,275,858
430480,201903,831,2202,433,1351,66,218,88,240,154,458
430485,201903,159,435,60,202,12,34,9,33,21,67
430490,201903,407,1065,226,669,30,99,106,284,136,383
430495,201903,359,1014,209,702,38,137,75,226,113,363
430500,201903,1016,2692,711,2160,210,698,224,609,434,1307
430510,201903,22612,60673,15989,47268,3236,10726,6381,17235,9617,27961
430511,201903,320,946,122,428,14,50,15,44,29,94
430512,201903,897,2127,702,1825,178,464,236,631,414,1095
430513,201903,777,1988,364,1057,56,170,171,476,227,646
430515,201903,397,1124,277,872,41,115,138,440,179,555
430517,201903,922,2928,762,2576,142,471,385,1353,527,1824
430520,201903,1290,3434,664,2076,122,370,132,390,254,760
430530,201903,1038,2690,382,1192,89,278,86,257,175,535
430535,201903,2993,8031,2120,6365,344,1073,1024,3013,1368,4086
430537,201903,311,1126,282,1034,32,104,215,793,247,897
430540,201903,560,1369,336,1008,56,158,152,447,208,605
430543,201903,639,1250,385,949,60,135,212,545,272,680
430544,201903,632,1897,450,1469,97,341,210,664,307,1005
430545,201903,1882,5132,1407,4387,296,947,682,2197,978,3144
430550,201903,406,1158,252,814,45,146,73,221,118,367
430558,201903,112,254,49,134,8,21,16,41,24,62
430560,201903,322,718,134,403,11,43,43,120,54,163
430570,201903,790,1889,569,1537,83,254,349,883,432,1137
430580,201903,945,2337,636,1859,150,487,273,751,423,1238
430583,201903,191,471,38,120,4,12,7,20,11,32
430585,201903,222,534,117,312,17,45,54,117,71,162
430587,201903,194,572,136,437,23,77,61,198,84,275
430590,201903,1385,3385,1186,3081,54,161,1014,2595,1068,2756
430593,201903,19,70,13,48,2,8,6,21,8,29
430595,201903,400,944,85,281,7,28,16,36,23,64
430597,201903,332,917,204,621,22,72,73,171,95,243
430600,201903,1769,4686,809,2452,157,502,216,615,373,1117
430605,201903,1083,3075,799,2498,117,438,325,962,442,1400
430607,201903,580,1344,426,1100,33,90,297,775,330,865
430610,201903,5485,13640,3699,10824,1100,3474,624,1947,1724,5421
430613,201903,256,608,72,210,8,27,19,46,27,73
430620,201903,539,1432,415,1181,79,250,202,539,281,789
430630,201903,404,1138,123,401,18,64,24,63,42,127
430632,201903,519,1407,240,747,29,92,107,321,136,413
430635,201903,524,1368,388,1102,57,169,266,755,323,924
430637,201903,453,1166,357,1013,44,145,202,542,246,687
430640,201903,1065,2774,614,1846,99,320,207,571,306,891
430642,201903,337,929,254,740,47,138,134,373,181,511
430645,201903,227,505,81,222,17,49,13,36,30,85
430650,201903,1531,4668,1281,4231,353,1174,586,2006,939,3180
430655,201903,239,576,145,395,14,44,73,180,87,224
430660,201903,4689,12604,3578,10604,840,2677,1581,4594,2421,7271
430670,201903,599,1522,460,1272,35,110,310,861,345,971
430673,201903,561,1306,219,657,40,127,81,229,121,356
430675,201903,203,588,57,200,18,73,16,51,34,124
430676,201903,4287,11091,3349,9575,472,1452,1989,5525,2461,6977
430680,201903,941,2550,572,1784,159,509,142,429,301,938
430690,201903,3006,8388,2410,7269,798,2500,635,1869,1433,4369
430692,201903,209,649,159,563,13,48,112,400,125,448
430693,201903,1003,2672,574,1770,111,397,129,368,240,765
430695,201903,493,1246,289,841,32,89,160,439,192,528
430697,201903,382,991,288,838,61,177,146,439,207,616
430700,201903,6544,16596,3548,10951,881,2924,442,1338,1323,4262
430705,201903,390,968,186,568,31,101,70,200,101,301
430710,201903,1651,3703,1143,2954,171,489,634,1604,805,2093
430720,201903,719,1755,373,1144,57,163,168,514,225,677
430730,201903,1072,2933,732,2275,114,329,354,1120,468,1449
430740,201903,570,1577,297,986,48,171,84,290,132,461
430745,201903,442,1242,239,765,39,141,64,180,103,321
430750,201903,1323,3504,934,2808,194,612,480,1379,674,1991
430755,201903,460,1135,295,802,19,65,161,404,180,469
430760,201903,1948,4996,1505,4316,374,1120,637,1775,1011,2895
430770,201903,5816,14896,4450,12808,689,2236,2683,7468,3372,9704
430780,201903,2045,5115,1165,3588,237,758,356,1092,593,1850
430781,201903,393,1118,220,711,49,159,49,135,98,294
430783,201903,411,971,235,690,24,86,133,361,157,447
430786,201903,36,124,20,79,4,14,1,8,5,22
430790,201903,4389,11264,2991,8648,437,1452,1635,4371,2072,5823
430800,201903,730,1823,540,1485,46,145,349,937,395,1082
430805,201903,432,1175,258,779,24,81,153,423,177,504
430807,201903,341,761,216,573,13,47,127,303,140,350
430810,201903,810,1993,271,883,36,142,76,233,112,375
430820,201903,1307,3535,702,2312,152,517,156,531,308,1048
430825,201903,272,697,91,256,16,45,22,53,38,98
430830,201903,1627,4834,1338,4268,77,295,922,2929,999,3224
430840,201903,913,2482,710,2114,112,349,446,1317,558,1666
430843,201903,113,278,34,105,3,9,17,45,20,54
430845,201903,378,922,245,699,81,248,67,170,148,418
430850,201903,2229,6026,1642,4880,296,929,761,2252,1057,3181
430860,201903,786,1858,437,1243,69,234,203,503,272,737
430865,201903,513,1339,403,1143,73,220,205,555,278,775
430870,201903,633,1692,269,863,41,148,92,262,133,410
430880,201903,1218,2915,821,2293,175,510,385,1035,560,1545
430885,201903,200,488,91,293,8,35,49,147,57,182
430890,201903,992,2664,677,2085,55,259,114,320,169,579
430900,201903,2923,6699,1992,5299,177,561,1234,3065,1411,3626
430905,201903,748,1978,471,1431,90,300,168,492,258,792
430910,201903,1398,3820,943,2883,164,559,396,1088,560,1647
430912,201903,472,1320,320,1031,29,86,205,676,234,762
430915,201903,483,1510,359,1271,92,331,122,438,214,769
430920,201903,22374,58071,17042,49161,2519,8054,9878,27629,12397,35683
430925,201903,137,308,51,147,10,31,18,54,28,85
430930,201903,9491,22808,5785,17012,1287,4027,2111,6435,3398,10462
430940,201903,1109,3119,617,1940,197,651,77,185,274,836
430950,201903,695,1734,434,1242,49,173,258,667,307,840
430955,201903,223,586,63,198,12,34,13,33,25,67
430957,201903,179,627,167,598,30,112,93,328,123,440
430960,201903,1292,3100,780,2198,170,534,349,955,519,1489
430965,201903,1686,4164,1282,3520,75,230,959,2612,1034,2842
430970,201903,382,978,195,595,32,106,89,256,121,362
430975,201903,482,1502,366,1215,94,328,152,493,246,821
430980,201903,396,967,216,651,45,147,87,243,132,390
430990,201903,550,1628,331,1064,44,160,168,533,212,693
430995,201903,568,1488,409,1226,64,197,188,558,252,755
431000,201903,1324,3143,523,1538,85,273,33,79,118,352
431010,201903,2049,5453,1223,3962,225,811,138,383,363,1194
431020,201903,8058,18144,4893,13183,1161,3456,1594,3864,2755,7320
431030,201903,314,867,139,483,27,98,21,70,48,168
431033,201903,3047,7571,1921,5770,511,1604,587,1827,1098,3431
431036,201903,351,778,74,224,9,21,17,44,26,65
431040,201903,909,2406,593,1804,94,324,258,725,352,1049
431041,201903,457,1080,343,910,33,92,200,515,233,607
431043,201903,395,971,209,652,62,208,69,209,131,417
431046,201903,107,288,46,147,4,14,11,34,15,48
431050,201903,1371,3457,987,2844,175,529,524,1509,699,2038
431053,201903,528,1501,315,1033,66,230,102,316,168,546
431055,201903,589,1477,497,1339,40,97,372,994,412,1091
431057,201903,265,771,128,439,16,57,36,110,52,167
431060,201903,4965,13622,3494,10974,991,3351,700,2251,1691,5602
431065,201903,458,1223,309,956,66,205,105,323,171,528
431070,201903,439,1299,247,835,67,254,38,109,105,363
431075,201903,221,667,142,478,25,82,40,137,65,219
431080,201903,602,1693,413,1296,97,336,120,351,217,687
431085,201903,701,1911,496,1440,75,215,262,736,337,951
431087,201903,455,1310,360,1100,26,77,242,753,268,830
431090,201903,394,940,147,470,29,99,35,110,64,209
431100,201903,3085,7149,2227,5980,365,1034,1078,2901,1443,3935
431110,201903,1355,3240,940,2494,245,644,405,1036,650,1680
431112,201903,510,1562,426,1393,85,310,221,690,306,1000
431113,201903,334,963,295,883,65,213,158,464,223,677
431115,201903,1045,3024,825,2615,134,465,460,1395,594,1860
431120,201903,2294,6603,1593,5144,533,1920,369,1077,902,2997
431123,201903,383,1093,235,771,50,136,119,417,169,553
431125,201903,1039,3136,772,2551,302,978,226,807,528,1785
431127,201903,255,677,60,197,8,24,8,19,16,43
431130,201903,2992,8065,2147,6515,425,1418,963,2847,1388,4265
431140,201903,4846,11699,2715,7630,377,1142,1132,2841,1509,3983
431142,201903,486,1345,365,1119,56,169,212,653,268,822
431150,201903,996,2741,697,2145,150,475,283,864,433,1339
431160,201903,670,1926,473,1506,88,292,161,511,249,803
431162,201903,490,1212,228,703,23,93,100,278,123,371
431164,201903,198,461,40,124,8,24,5,15,13,39
431170,201903,526,1466,357,1119,102,300,97,304,199,604
431171,201903,632,1578,522,1434,78,200,329,909,407,1109
431173,201903,384,1041,286,879,96,322,93,276,189,598
431175,201903,1021,2562,634,1883,139,409,169,500,308,909
431177,201903,678,1994,511,1708,151,549,235,770,386,1319
431179,201903,303,649,66,200,15,50,13,29,28,79
431180,201903,2211,5795,1362,4119,376,1140,287,873,663,2013
431190,201903,454,1251,238,763,28,88,56,158,84,246
431198,201903,307,954,266,879,104,357,67,245,171,602
431200,201903,376,976,85,268,13,35,2,6,15,41
431205,201903,184,533,81,287,20,77,28,96,48,173
431210,201903,611,1595,490,1413,121,326,239,731,360,1057
431213,201903,246,716,188,611,16,62,93,305,109,367
431215,201903,525,1277,239,716,31,102,96,257,127,359
431217,201903,157,446,105,339,8,29,62,184,70,213
431220,201903,596,1577,342,1072,33,127,179,512,212,639
431225,201903,1487,3684,1125,3064,124,372,721,1944,845,2316
431230,201903,674,1985,491,1524,72,240,277,817,349,1057
431235,201903,145,366,25,77,3,8,3,9,6,17
431237,201903,346,1056,273,912,46,177,146,463,192,640
431238,201903,24,63,19,51,6,14,6,15,12,29
431240,201903,3775,9829,2961,8502,618,1962,1361,3750,1979,5712
431242,201903,291,817,239,717,62,197,111,335,173,532
431244,201903,324,782,149,420,25,96,49,100,74,196
431245,201903,1303,3116,808,2214,104,301,397,1031,501,1332
431247,201903,225,630,117,381,26,93,27,67,53,160
431250,201903,1540,4199,1166,3642,265,813,549,1801,814,2614
431260,201903,221,624,124,427,22,96,39,117,61,213
431261,201903,242,772,194,677,22,84,96,315,118,399
431262,201903,382,1088,168,566,15,52,104,347,119,399
431265,201903,1420,3382,557,1640,78,267,185,456,263,723
431267,201903,249,698,145,441,4,15,97,266,101,281
431270,201903,2562,6020,1367,3939,358,1117,380,1098,738,2215
431275,201903,140,401,72,234,18,60,8,18,26,78
431280,201903,240,659,66,227,7,22,6,17,13,39
431290,201903,293,844,201,640,33,115,62,164,95,279
431295,201903,73,195,26,78,2,5,6,15,8,20
431300,201903,373,935,57,194,5,22,12,34,17,56
431301,201903,239,712,62,216,9,22,4,11,13,33
431303,201903,567,1531,325,1001,33,123,123,348,156,471
431306,201903,2105,5094,1231,3556,193,622,459,1162,652,1784
431308,201903,24,76,21,66,13,44,5,12,18,56
431310,201903,532,1544,350,1108,45,158,155,462,200,620
431320,201903,581,1585,265,883,48,159,41,121,89,280
431330,201903,1645,3973,756,2306,201,665,207,572,408,1237
431333,201903,224,625,115,341,20,52,39,110,59,162
431335,201903,39,111,22,75,5,12,4,8,9,20
431337,201903,2520,6927,1767,5598,449,1586,648,1961,1097,3547
431339,201903,406,1073,302,879,67,198,143,411,210,609
431340,201903,19418,48871,13393,38375,2710,8473,5099,13761,7809,22234
431342,201903,450,1021,328,838,19,54,281,710,300,764
431344,201903,387,1000,225,667,12,39,146,421,158,460
431346,201903,263,673,103,342,15,48,30,98,45,146
431349,201903,643,1716,340,1029,71,228,123,347,194,575
431350,201903,3883,10452,2838,8617,441,1468,1372,4106,1813,5574
431360,201903,554,1343,311,888,75,233,103,281,178,514
431365,201903,1714,4378,1435,3970,149,480,1058,2890,1207,3370
431370,201903,4054,10524,2987,8677,782,2453,1254,3722,2036,6175
431380,201903,750,2127,634,1921,39,142,419,1254,458,1396
431390,201903,2451,6138,1409,4200,228,782,544,1414,772,2196
431395,201903,1194,3206,853,2664,218,703,343,1098,561,1801
431400,201903,337,971,178,572,30,97,43,124,73,221
431402,201903,834,1981,591,1569,79,228,373,928,452,1156
431403,201903,176,492,140,427,23,87,78,199,101,286
431405,201903,4324,11667,3407,10225,486,1725,1886,5381,2372,7106
431406,201903,448,1375,352,1166,90,280,165,562,255,842
431407,201903,452,1261,291,905,60,200,135,404,195,604
431410,201903,15144,39887,9701,29704,1772,6206,4051,11484,5823,17690
431413,201903,199,511,55,177,6,18,6,17,12,35
431415,201903,675,1721,413,1272,65,234,170,472,235,706
431417,201903,562,1287,384,1019,65,184,202,518,267,702
431420,201903,1430,3450,1106,2980,196,552,544,1479,740,2031
431430,201903,519,1357,252,814,42,151,66,185,108,336
431440,201903,25370,62463,18274,50889,3743,11133,6406,17309,10149,28442
431442,201903,101,290,47,165,7,25,7,20,14,45
431445,201903,424,1207,136,473,15,46,16,57,31,103
431446,201903,303,853,206,652,49,167,81,244,130,411
431447,201903,613,1703,404,1254,90,294,153,485,243,779
431449,201903,711,1892,425,1255,72,207,180,519,252,726
431450,201903,2064,4509,1684,3968,109,287,1287,2905,1396,3192
431454,201903,41,127,38,121,8,28,14,45,22,73
431455,201903,568,1396,297,824,43,138,146,361,189,499
431460,201903,2834,7236,2082,5841,560,1653,621,1763,1181,3416
431470,201903,1435,4083,1030,3225,197,632,441,1393,638,2025
431475,201903,247,716,31,126,2,9,2,10,4,19
431477,201903,416,1081,255,749,39,112,116,306,155,418
431478,201903,257,659,64,198,17,52,5,14,22,66
431480,201903,3024,7739,2341,6655,441,1313,1277,3605,1718,4918
431490,201903,100189,246713,80312,215916,7114,22250,58228,151177,65342,173427
431500,201903,477,1267,352,1019,65,184,184,516,249,700
431505,201903,344,824,220,631,21,58,136,390,157,448
431507,201903,342,815,143,413,34,112,49,123,83,235
431510,201903,1483,3949,1045,3088,244,770,395,1160,639,1930
431513,201903,231,543,121,345,9,22,81,234,90,256
431514,201903,82,218,45,140,6,18,24,71,30,89
431515,201903,486,1262,329,965,67,207,163,453,230,660
431517,201903,71,202,54,161,11,28,17,51,28,79
431520,201903,428,1063,163,529,31,113,56,161,87,274
431530,201903,3899,8451,2338,6249,649,1773,414,1140,1063,2913
431531,201903,196,537,128,396,13,36,56,173,69,209
431532,201903,541,1302,338,939,73,217,135,369,208,586
431535,201903,248,671,102,330,22,76,14,42,36,118
431540,201903,1718,5634,1606,5455,64,262,1291,4380,1355,4642
431545,201903,349,920,59,188,8,27,13,35,21,62
431550,201903,1895,5112,1535,4407,280,875,741,2029,1021,2904
431555,201903,673,1576,416,1132,29,94,256,682,285,776
431560,201903,20320,52170,13425,40859,2908,9512,3940,12697,6848,22209
431570,201903,4684,11551,3658,10087,523,1613,2307,6122,2830,7735
431575,201903,218,625,163,514,29,86,34,96,63,182
431580,201903,533,1434,304,946,48,183,145,409,193,592
431590,201903,672,1825,479,1432,93,274,188,577,281,851
431595,201903,329,936,220,693,44,146,87,253,131,399
431600,201903,1275,3167,926,2658,267,801,333,996,600,1797
431610,201903,1321,3530,903,2707,144,402,446,1385,590,1787
431620,201903,552,1501,235,721,42,136,100,288,142,424
431630,201903,1258,3246,581,1815,123,422,192,532,315,954
431640,201903,5824,15113,5145,14156,623,1795,3663,10122,4286,11917
431642,201903,483,1189,317,868,30,74,172,449,202,523
431643,201903,332,824,141,420,16,46,48,142,64,188
431645,201903,1706,4173,1360,3645,114,365,1001,2641,1115,3006
431647,201903,211,544,100,290,12,39,23,57,35,96
431650,201903,161,460,110,361,17,63,41,121,58,184
431660,201903,840,2282,434,1435,76,286,95,289,171,575
431670,201903,1157,2850,761,2143,108,326,401,1077,509,1403
431673,201903,237,622,86,296,16,48,12,40,28,88
431675,201903,565,1397,116,366,11,40,29,70,40,110
431680,201903,7067,18906,5219,15313,1372,4172,1993,5822,3365,9994
431690,201903,20471,52533,14010,40813,3325,10294,4978,14602,8303,24896
431695,201903,154,403,97,297,18,66,43,103,61,169
431697,201903,467,1130,351,940,58,149,190,521,248,670
431700,201903,1392,3709,1180,3316,164,454,677,1886,841,2340
431710,201903,11023,28707,8311,24638,1910,5933,3555,11013,5465,16946
431720,201903,5563,14564,3463,10293,951,3021,548,1465,1499,4486
431725,201903,26,73,18,55,5,14,4,11,9,25
431730,201903,3561,9073,2293,6914,583,1880,698,2221,1281,4101
431740,201903,4851,12114,3234,9269,951,3055,664,1627,1615,4682
431750,201903,6845,18528,5716,16740,1126,3551,2889,8495,4015,12046
431755,201903,309,836,66,237,9,34,11,40,20,74
431760,201903,5436,12576,3512,9460,366,1211,2105,5250,2471,6461
431770,201903,1741,4346,1410,3898,112,347,1018,2769,1130,3116
431775,201903,205,547,97,303,22,74,18,47,40,121
431780,201903,1872,4843,1234,3644,230,704,451,1315,681,2019
431790,201903,875,2380,617,1867,121,370,265,768,386,1138
431795,201903,225,586,105,319,25,80,29,84,54,164
431800,201903,7120,18612,4912,14843,1496,5026,618,1936,2114,6962
431805,201903,296,698,84,281,6,23,32,97,38,120
431810,201903,3250,7952,2044,5687,383,1164,848,2212,1231,3376
431820,201903,2111,6025,1711,5343,455,1464,651,2113,1106,3577
431830,201903,8655,19761,6415,16536,1581,4578,2237,5800,3818,10378
431840,201903,2403,6646,1974,5905,360,1100,1153,3462,1513,4562
431842,201903,661,1644,223,699,31,105,66,193,97,298
431843,201903,310,849,236,693,32,101,116,321,148,422
431844,201903,198,532,66,219,18,71,20,54,38,125
431845,201903,515,1367,355,1035,28,87,216,618,244,705
431846,201903,255,717,227,676,18,51,185,552,203,603
431848,201903,150,379,79,244,9,30,12,27,21,57
431849,201903,401,946,60,167,8,18,6,12,14,30
431850,201903,3902,10859,3057,9138,761,2455,933,2727,1694,5182
431860,201903,656,1668,396,1139,75,224,199,543,274,767
431861,201903,109,285,47,144,7,23,16,40,23,63
431862,201903,423,1341,344,1203,76,283,172,589,248,872
431870,201903,16378,44361,13366,39232,2115,6985,7234,20388,9349,27373
431880,201903,3963,10466,2798,8357,511,1721,1187,3402,1698,5123
431890,201903,4016,10559,2495,7463,780,2532,346,1121,1126,3653
431900,201903,981,2564,616,1850,105,361,307,849,412,1210
431910,201903,781,1913,278,799,52,158,73,161,125,319
431912,201903,447,1305,360,1136,72,241,208,652,280,893
431915,201903,948,2511,773,2208,48,148,548,1530,596,1678
431920,201903,1132,2906,963,2650,46,156,811,2185,857,2341
431930,201903,680,1906,482,1539,128,377,231,762,359,1139
431935,201903,79,232,48,167,15,48,7,29,22,77
431936,201903,285,861,157,532,37,127,46,149,83,276
431937,201903,184,468,111,309,24,81,45,101,69,182
431940,201903,2773,6774,1590,4562,225,757,725,1947,950,2704
431950,201903,1742,4814,1443,4320,427,1295,590,1781,1017,3076
431960,201903,2696,6921,2007,5630,584,1714,536,1497,1120,3211
431970,201903,417,1087,154,488,36,105,36,99,72,204
431971,201903,59,150,32,102,4,16,5,10,9,26
431973,201903,447,1469,363,1301,42,146,255,924,297,1070
431975,201903,96,197,16,54,3,10,4,11,7,21
431980,201903,1068,2861,815,2424,189,613,353,996,542,1609
431990,201903,5606,14002,3671,11012,613,2057,1499,4324,2112,6381
432000,201903,10101,25417,7396,21054,1831,5397,3152,9008,4983,14405
432010,201903,1892,4970,1410,4068,215,682,797,2201,1012,2883
432020,201903,1771,4428,1208,3423,282,848,526,1403,808,2251
432023,201903,495,1229,258,755,46,149,120,319,166,468
432026,201903,1011,2928,734,2368,173,547,286,926,459,1473
432030,201903,317,848,199,618,33,108,106,321,139,429
432032,201903,394,1058,271,814,34,119,139,378,173,497
432035,201903,674,1953,596,1823,216,699,206,628,422,1327
432040,201903,1082,2513,373,1171,69,248,116,318,185,566
432045,201903,183,510,109,355,25,81,36,119,61,200
432050,201903,494,1317,373,1090,94,268,140,415,234,683
432055,201903,673,1815,424,1317,138,456,108,308,246,764
432057,201903,236,626,173,475,33,82,74,182,107,264
432060,201903,443,1068,140,442,29,107,48,127,77,234
432065,201903,225,639,157,486,31,90,54,162,85,252
432067,201903,709,2123,606,1880,67,227,396,1187,463,1414
432070,201903,1767,4765,1099,3402,221,758,293,802,514,1560
432080,201903,3895,10006,3024,8503,647,2081,1278,3441,1925,5522
432085,201903,399,1037,260,822,89,276,90,309,179,585
432090,201903,1256,3330,902,2667,199,635,422,1180,621,1815
432100,201903,971,2610,431,1414,81,285,48,127,129,412
432110,201903,2089,5798,1395,4482,359,1303,95,313,454,1616
432120,201903,2656,7580,2144,6653,601,2003,592,1802,1193,3805
432130,201903,2440,6564,2082,6039,706,2133,815,2408,1521,4541
432132,201903,180,527,107,364,22,75,40,117,62,192
432135,201903,939,2359,613,1728,46,161,430,1180,476,1341
432140,201903,1508,4661,1125,3884,196,705,613,2153,809,2858
432143,201903,1319,3570,1034,3118,91,325,667,1984,758,2309
432145,201903,1329,3638,756,2366,126,445,194,520,320,965
432146,201903,108,313,71,239,23,83,14,41,37,124
432147,201903,445,1350,284,998,86,317,59,189,145,506
432149,201903,414,1078,222,669,19,52,105,310,124,362
432150,201903,2838,7707,2091,6284,507,1712,652,1887,1159,3599
432160,201903,4667,13097,3564,11217,1024,3501,1157,3551,2181,7052
432162,201903,273,614,38,111,7,19,4,13,11,32
432163,201903,144,373,28,83,0,0,3,6,3,6
432166,201903,534,1565,412,1296,69,230,159,453,228,683
432170,201903,1292,3610,818,2673,179,636,237,733,416,1369
432180,201903,2567,6532,1372,4131,283,915,399,1065,682,1980
432183,201903,333,985,216,702,61,230,57,167,118,397
432185,201903,780,2062,454,1404,32,113,250,736,282,849
432190,201903,1981,5008,1224,3643,276,941,469,1289,745,2230
432195,201903,937,2351,593,1747,176,488,216,666,392,1154
432200,201903,3019,8250,2179,6781,430,1369,1036,3294,1466,4663
432210,201903,322,906,219,703,44,165,97,286,141,451
432215,201903,630,1877,558,1765,52,150,395,1266,447,1416
432218,201903,256,644,119,338,19,56,54,143,73,199
432220,201903,3699,9001,2742,7446,395,1197,1625,4257,2020,5454
432225,201903,88,261,67,215,15,50,32,105,47,155
432230,201903,711,1765,387,1130,54,159,166,452,220,611
432232,201903,488,1235,317,925,64,205,124,350,188,555
432234,201903,296,773,130,391,30,82,22,54,52,136
432235,201903,88,248,31,99,8,24,8,28,16,52
432237,201903,355,909,304,819,19,53,226,582,245,635
432240,201903,13289,36235,10297,31872,870,3074,6434,20689,7304,23763
432250,201903,4182,13181,3551,11943,1107,3791,1262,4379,2369,8170
432252,201903,434,1108,269,772,40,125,120,325,160,450
432253,201903,1025,3189,596,2068,165,620,29,83,194,703
432254,201903,844,2092,161,522,34,109,16,46,50,155
432255,201903,119,295,54,166,5,18,21,55,26,73
432260,201903,4728,12450,3477,10092,982,2951,1004,2890,1986,5841
432270,201903,1856,5400,1500,4675,467,1552,257,781,724,2333
432280,201903,1086,2850,600,1855,104,356,236,646,340,1002
432285,201903,189,586,22,78,0,0,2,5,2,5
432290,201903,353,1036,190,641,59,202,40,110,99,312
432300,201903,24984,66271,19214,56604,2911,9510,11184,31906,14095,41416
432310,201903,720,2035,530,1673,67,222,333,1051,400,1273
432320,201903,212,501,68,199,9,36,26,62,35,98
432330,201903,228,579,85,272,14,40,19,59,33,99
432335,201903,178,514,57,213,6,23,15,59,21,82
432340,201903,315,762,134,419,23,89,37,97,60,186
432345,201903,586,1427,521,1347,25,85,406,1032,431,1117
432350,201903,320,869,163,542,30,102,52,170,82,272
432360,201903,216,635,39,124,3,14,13,37,16,51
432370,201903,314,795,205,603,16,42,126,360,142,402
432375,201903,493,1254,373,1028,66,160,197,548,263,708
432377,201903,206,653,36,125,7,23,3,5,10,28
432380,201903,1484,4218,948,3160,192,730,426,1340,618,2070
500020,201903,2253,6092,1585,4936,287,985,794,2411,1081,3396
500025,201903,1177,2715,739,1998,66,192,432,1132,498,1324
500060,201903,6196,17791,4610,15070,666,2254,2705,9237,3371,11491
500070,201903,3859,10269,2728,8348,548,1705,1181,3745,1729,5450
500080,201903,1236,3273,844,2577,156,559,381,1069,537,1628
500085,201903,1987,4987,1325,3918,302,956,646,1826,948,2782
500090,201903,1875,5150,1284,4097,243,805,501,1654,744,2459
500100,201903,3389,8846,2593,7532,353,1140,1421,3988,1774,5128
500110,201903,6977,18931,4500,14826,986,3541,1332,5116,2318,8657
500124,201903,1909,5902,1567,5281,302,1010,855,3022,1157,4032
500150,201903,1191,2764,743,2082,190,567,231,600,421,1167
500190,201903,4254,10469,3001,8587,738,2193,1110,3234,1848,5427
500200,201903,2140,5177,1565,4217,187,531,937,2418,1124,2949
500210,201903,4365,11637,3299,10094,875,2742,1429,4469,2304,7211
500215,201903,1336,3826,940,3061,93,348,480,1554,573,1902
500220,201903,2603,7393,1822,6003,322,1164,668,2165,990,3329
500230,201903,2062,5049,1549,4285,206,566,982,2670,1188,3236
500240,201903,3473,10708,2407,8432,423,1647,780,2804,1203,4451
500260,201903,3000,6582,1825,4930,249,661,935,2460,1184,3121
500270,201903,128225,310331,74823,216082,14306,45018,25102,68647,39408,113665
500280,201903,1210,3109,839,2522,104,345,512,1491,616,1836
500290,201903,3568,8301,1961,5775,345,1121,731,2026,1076,3147
500295,201903,2917,7347,1728,5084,314,992,656,1722,970,2714
500310,201903,870,1975,619,1654,107,253,325,894,432,1147
500315,201903,3229,9567,2640,8625,276,905,1813,6103,2089,7008
500320,201903,17235,49554,12175,40865,3278,11713,3930,14009,7208,25722
500325,201903,4055,9463,2755,7582,294,877,1651,4543,1945,5420
500330,201903,6577,15381,4190,11694,360,1133,2333,6629,2693,7762
500345,201903,1945,4840,1248,3728,317,980,428,1257,745,2237
500348,201903,2511,6473,1897,5450,248,752,1104,3237,1352,3989
500350,201903,1251,3442,663,2153,83,279,256,831,339,1110
500370,201903,22483,60191,15279,47957,2450,8702,7218,22655,9668,31357
500375,201903,2324,6417,1612,4885,346,1162,544,1563,890,2725
500380,201903,3442,8717,2361,6922,674,2094,775,2305,1449,4399
500390,201903,504,1081,301,814,56,163,152,412,208,575
500400,201903,1144,3070,765,2294,153,518,261,705,414,1223
500410,201903,2309,6012,1682,5025,222,659,969,2971,1191,3630
500430,201903,2455,6394,1685,5216,264,937,664,2157,928,3094
500440,201903,1106,2709,694,2037,111,325,263,823,374,1148
500450,201903,1341,3440,736,2277,146,468,139,406,285,874
500460,201903,3388,9446,2113,6931,422,1546,587,1950,1009,3496
500470,201903,2279,6344,1423,4545,454,1575,280,785,734,2360
500480,201903,2159,6446,1856,5994,177,618,1252,4221,1429,4839
500490,201903,961,2334,557,1705,141,506,161,491,302,997
500500,201903,4118,11429,2702,9090,920,3552,563,1945,1483,5497
500510,201903,653,1663,434,1272,24,81,258,726,282,807
500515,201903,1876,4753,1473,4144,145,414,961,2652,1106,3066
500520,201903,2966,9910,2393,8756,694,2645,947,3565,1641,6210
500525,201903,864,2621,706,2369,75,279,428,1460,503,1739
500540,201903,4213,11191,2522,8156,749,2906,228,609,977,3515
500560,201903,5051,14864,4183,13649,333,1208,3148,10391,3481,11599
500568,201903,4123,9256,2487,6842,610,1850,801,2188,1411,4038
500570,201903,7190,17393,4144,12033,901,2876,1108,2985,2009,5861
500580,201903,3037,8278,2299,7018,487,1581,1123,3384,1610,4965
500600,201903,3000,7639,2104,6282,407,1267,904,2755,1311,4022
500620,201903,7114,19484,4850,15059,1088,3489,1784,5508,2872,8997
500625,201903,483,1356,269,874,54,192,102,319,156,511
500627,201903,719,1865,430,1321,61,183,145,449,206,632
500630,201903,5900,14371,3499,10276,790,2506,1082,3227,1872,5733
500635,201903,2693,8901,2110,8082,153,635,1537,6261,1690,6896
500640,201903,1632,3730,1103,2974,42,137,755,1959,797,2096
500660,201903,15736,44257,11137,36897,3966,14536,2494,8377,6460,22913
500690,201903,2145,6075,1502,5057,615,2329,87,209,702,2538
500710,201903,2858,8041,2174,6778,633,2102,642,1864,1275,3966
500720,201903,4820,12556,3020,9501,707,2411,790,2536,1497,4947
500730,201903,874,2294,562,1719,84,240,222,690,306,930
500740,201903,4510,11011,3146,8750,321,946,1824,5089,2145,6035
500750,201903,937,2471,644,1949,100,320,242,663,342,983
500755,201903,833,2316,479,1618,98,340,67,212,165,552
500769,201903,4796,12168,2497,7575,486,1673,356,819,842,2492
500770,201903,1466,4075,915,3039,165,614,290,960,455,1574
500780,201903,1262,3164,805,2376,187,597,215,583,402,1180
500790,201903,7526,20014,5967,17493,1153,3673,3198,9402,4351,13075
500793,201903,1792,4705,1223,3731,414,1285,247,679,661,1964
500795,201903,2414,6491,1996,5921,127,357,1655,5066,1782,5423
500797,201903,702,1874,462,1417,105,328,172,521,277,849
500800,201903,2691,6475,1765,5106,598,1970,260,834,858,2804
500830,201903,17173,43921,11790,34105,2103,6647,5113,13947,7216,20594
500840,201903,1366,3450,778,2291,91,283,314,881,405,1164
510010,201903,1847,4402,1215,3523,157,440,742,2190,899,2630
510020,201903,3525,9243,1835,5724,436,1410,358,1004,794,2414
510025,201903,6587,17077,4056,12575,695,2409,1432,4224,2127,6633
510030,201903,2184,5027,1425,3952,344,983,499,1426,843,2409
510035,201903,1206,3097,714,2309,90,304,416,1414,506,1718
510040,201903,2154,5039,1562,4224,154,429,980,2660,1134,3089
510050,201903,1945,4545,1302,3611,212,672,786,2052,998,2724
510060,201903,1354,3478,1006,2941,202,655,369,1031,571,1686
510080,201903,1185,3252,782,2536,232,811,228,652,460,1463
510100,201903,633,1534,414,1160,51,146,217,581,268,727
510120,201903,255,471,143,339,8,25,106,249,114,274
510125,201903,2147,5427,1668,4701,219,811,778,1987,997,2798
510130,201903,1443,3684,1010,2978,219,729,301,879,520,1608
510140,201903,2834,7735,1967,6604,757,2906,639,1984,1396,4890
510160,201903,1676,4430,1232,3841,212,647,837,2640,1049,3287
510170,201903,4513,12321,3316,10345,797,2582,1333,4235,2130,6817
510180,201903,13096,31464,7976,23259,1968,6217,2266,7438,4234,13655
510185,201903,1636,4442,1085,3628,424,1398,334,1358,758,2756
510190,201903,2014,5834,1360,4676,436,1615,297,1067,733,2682
510250,201903,13969,37656,11437,34097,2230,6903,6453,19894,8683,26797
510260,201903,2051,8428,1661,7711,279,1368,976,4989,1255,6357
510263,201903,2864,8227,1779,5987,349,1269,220,675,569,1944
510267,201903,4625,13515,2809,9439,630,2205,426,1424,1056,3629
510268,201903,1361,3450,956,2749,132,387,535,1481,667,1868
510269,201903,1039,2905,663,2191,160,561,231,733,391,1294
510270,201903,2814,8406,2020,6960,390,1449,781,2654,1171,4103
510279,201903,1709,4633,1149,3628,216,759,530,1590,746,2349
510285,201903,1067,2962,752,2413,224,797,174,532,398,1329
510300,201903,3526,9169,2617,7906,375,1078,1540,4926,1915,6004
510305,201903,1444,4093,885,2991,190,705,237,872,427,1577
510310,201903,928,2416,654,1945,198,617,202,625,400,1242
510320,201903,3598,9457,2586,7679,592,1888,711,2159,1303,4047
510325,201903,4445,13432,3465,11778,979,3402,1330,4704,2309,8106
510330,201903,2837,8662,1915,7002,386,1441,689,2847,1075,4288
510335,201903,4557,13157,3404,11473,443,1618,1946,6854,2389,8472
510336,201903,463,1372,341,1170,67,229,153,560,220,789
510337,201903,1588,4783,1070,3821,423,1631,174,636,597,2267
510340,201903,85076,194855,51160,143624,14014,45958,12955,33581,26969,79539
510343,201903,1005,2849,686,2222,127,465,269,826,396,1291
510345,201903,1228,3618,914,2997,168,571,398,1262,566,1833
510350,201903,2821,7573,1826,5886,431,1439,714,2283,1145,3722
510360,201903,1829,3950,1170,3149,63,169,841,2359,904,2528
510370,201903,1651,5011,1189,4149,203,789,625,2211,828,3000
510380,201903,489,1255,264,828,70,251,77,234,147,485
510385,201903,1027,3671,766,3134,85,395,475,2042,560,2437
510390,201903,1026,3114,776,2753,203,705,361,1421,564,2126
510395,201903,736,1669,482,1288,33,103,271,764,304,867
510410,201903,4317,12637,3233,10613,712,2417,1694,5737,2406,8154
510420,201903,2114,4747,1481,3871,133,406,904,2347,1037,2753
510450,201903,499,1256,285,848,73,211,47,165,120,376
510452,201903,631,1791,409,1364,86,288,185,620,271,908
510454,201903,886,2540,671,2150,77,219,408,1398,485,1617
510455,201903,894,2575,635,2005,103,390,241,697,344,1087
510460,201903,1833,4641,1313,3860,128,448,810,2270,938,2718
510480,201903,4571,11469,2996,8401,611,1874,1156,3100,1767,4974
510490,201903,1607,4517,1205,3951,246,834,631,2101,877,2935
510500,201903,1567,4072,933,2975,188,647,316,1000,504,1647
510510,201903,3192,9824,2422,8332,718,2699,642,2361,1360,5060
510515,201903,5228,14064,3376,10523,757,2621,901,2548,1658,5169
510517,201903,1093,3224,837,2769,246,911,150,437,396,1348
510520,201903,2039,4199,1169,3135,72,207,649,1854,721,2061
510523,201903,988,2643,737,2208,150,427,411,1241,561,1668
510525,201903,5812,16603,4330,13596,749,2640,1894,5530,2643,8170
510530,201903,548,1410,404,1198,31,117,265,757,296,874
510550,201903,2505,7595,1824,6362,475,1717,708,2505,1183,4222
510558,201903,2028,5593,1557,4872,167,578,812,2703,979,3281
510560,201903,1541,4544,890,3264,210,846,237,920,447,1766
510562,201903,5064,13824,3614,11063,950,3146,1089,3367,2039,6513
510590,201903,2990,7730,2165,6659,269,856,1391,4350,1660,5206
510600,201903,1491,3508,952,2670,180,499,382,1086,562,1585
510610,201903,2723,6698,1842,5463,175,609,1109,3275,1284,3884
510615,201903,2090,5838,1509,4771,276,873,830,2689,1106,3562
510617,201903,936,2733,681,2302,113,422,391,1375,504,1797
510618,201903,1213,3345,847,2681,174,614,432,1326,606,1940
510619,201903,705,1840,417,1307,72,258,87,254,159,512
510620,201903,1385,3183,630,1990,159,585,43,102,202,687
510621,201903,1383,3860,862,2846,191,684,256,810,447,1494
510622,201903,4016,11685,2780,8885,1038,3555,406,1154,1444,4709
510623,201903,2597,6800,1834,5540,428,1524,505,1453,933,2977
510624,201903,1498,3969,658,2263,92,342,126,368,218,710
510625,201903,2533,6290,1399,4239,299,1026,288,861,587,1887
510626,201903,1514,3597,899,2656,271,922,195,575,466,1497
510627,201903,589,1551,345,1066,90,283,76,255,166,538
510628,201903,1524,3525,1026,2867,157,425,581,1714,738,2139
510629,201903,1540,4602,1155,3859,284,1024,372,1246,656,2270
510630,201903,3171,9161,1839,6508,427,1617,292,1135,719,2752
510631,201903,539,1336,388,1116,20,56,292,847,312,903
510637,201903,3250,8199,2361,6804,682,2171,637,1773,1319,3944
510642,201903,5026,15097,4011,13546,1086,3934,1631,5702,2717,9636
510645,201903,846,1860,494,1377,117,337,194,515,311,852
510650,201903,6821,18481,5506,17040,691,1996,3920,13002,4611,14998
510665,201903,1784,4134,1039,2899,168,504,418,1216,586,1720
510670,201903,407,871,231,609,27,83,129,336,156,419
510675,201903,5621,16148,3992,13049,1220,4324,699,2255,1919,6579
510677,201903,2098,5536,1453,4534,204,668,749,2317,953,2985
510680,201903,662,1785,387,1257,95,337,50,150,145,487
510682,201903,1560,4837,1156,4097,386,1492,244,869,630,2361
510685,201903,644,1886,471,1537,72,241,220,701,292,942
510700,201903,3735,9491,2581,7780,397,1272,1620,4912,2017,6184
510704,201903,9684,23819,6362,17945,1275,3929,1842,4947,3117,8876
510706,201903,1826,5577,1301,4731,237,897,681,2676,918,3573
510710,201903,2478,6608,1685,5054,365,1156,587,1671,952,2827
510715,201903,635,1467,458,1213,50,133,213,587,263,720
510718,201903,2395,5384,1339,4089,577,1785,262,1064,839,2849
510719,201903,397,856,238,648,36,103,127,327,163,430
510720,201903,939,2328,620,1822,133,419,232,641,365,1060
510724,201903,741,2048,494,1593,83,294,222,678,305,972
510726,201903,1188,2159,599,1415,74,186,301,703,375,889
510729,201903,618,1476,275,838,39,138,68,208,107,346
510730,201903,2908,7254,1962,5751,377,1205,813,2347,1190,3552
510735,201903,1011,3027,755,2651,81,317,531,1879,612,2196
510740,201903,908,2307,582,1698,86,248,293,876,379,1124
510757,201903,566,1828,460,1651,167,666,154,516,321,1182
510760,201903,39732,88715,22916,63047,5430,17178,6529,16383,11959,33561
510770,201903,4023,9491,2914,8113,304,788,1952,5678,2256,6466
510774,201903,328,928,224,721,35,115,114,386,149,501
510775,201903,597,1644,407,1335,93,351,86,261,179,612
510776,201903,457,1201,306,896,80,245,96,281,176,526
510777,201903,1589,4366,1161,3779,149,620,749,2356,898,2976
510779,201903,572,1591,449,1382,61,174,261,849,322,1023
510780,201903,3556,9662,2647,8280,659,2075,1071,3735,1730,5810
510785,201903,2050,5470,1153,3784,302,1060,162,602,464,1662
510787,201903,2442,7119,1626,5367,670,2343,83,248,753,2591
510788,201903,684,1647,472,1322,77,213,187,607,264,820
510790,201903,14829,39879,9010,28575,2141,7718,1446,4002,3587,11720
510792,201903,8210,22434,5221,16785,1113,3994,1117,3388,2230,7382
510794,201903,1188,3288,775,2543,255,922,157,444,412,1366
510795,201903,7322,20164,4934,15783,1216,4254,1224,3938,2440,8192
510800,201903,1666,4382,1097,3424,336,1071,194,550,530,1621
510805,201903,1586,4411,1039,3361,230,816,317,894,547,1710
510810,201903,644,1387,422,1079,111,309,196,491,307,800
510820,201903,778,1525,427,1080,42,133,201,506,243,639
510830,201903,804,2017,560,1670,72,222,356,1102,428,1324
510835,201903,515,1313,348,1064,51,174,179,535,230,709
510840,201903,47041,105839,33319,88564,6224,15894,17406,50227,23630,66121
510850,201903,1853,4545,1040,3220,332,1170,120,283,452,1453
510860,201903,2454,6735,1588,5254,513,1987,169,538,682,2525
510880,201903,647,1929,490,1622,127,436,203,684,330,1120
510885,201903,559,1427,388,1171,68,231,135,400,203,631
510890,201903,647,1950,491,1684,108,393,223,772,331,1165
510895,201903,1184,3138,793,2460,202,710,304,855,506,1565
520005,201903,2128,5718,1687,5169,453,1323,778,2694,1231,4017
520010,201903,2161,6418,1546,5142,411,1526,395,1136,806,2662
520013,201903,2575,6922,1788,5422,425,1346,448,1459,873,2805
520015,201903,530,1367,397,1180,99,311,134,429,233,740
520017,201903,1081,2926,821,2512,123,399,498,1495,621,1894
520020,201903,379,923,295,807,43,150,182,461,225,611
520025,201903,32079,91404,28055,85756,3118,10268,19950,60719,23068,70987
520030,201903,5091,13762,4127,12347,461,1494,2637,7880,3098,9374
520050,201903,404,955,256,696,18,42,151,433,169,475
520055,201903,1299,3399,920,2651,57,172,516,1433,573,1605
520060,201903,1382,4006,1039,3363,284,999,263,854,547,1853
520080,201903,1821,4789,1371,4167,253,772,631,2103,884,2875
520082,201903,912,2347,740,2044,79,192,422,1227,501,1419
520085,201903,764,2121,584,1828,122,403,230,678,352,1081
520090,201903,822,1671,557,1375,98,197,377,993,475,1190
520110,201903,37522,104075,26532,85934,8886,32406,1917,5693,10803,38099
520120,201903,197,486,110,335,14,50,36,108,50,158
520130,201903,3658,9363,2923,8167,572,1655,1330,3758,1902,5413
520140,201903,36825,103680,26943,86491,10110,35114,3036,10210,13146,45324
520145,201903,526,1271,355,1012,71,215,157,411,228,626
520150,201903,576,1381,421,1176,74,210,226,646,300,856
520160,201903,805,1889,581,1544,98,239,285,781,383,1020
520170,201903,4989,10428,3521,8714,196,544,2751,6676,2947,7220
520180,201903,1973,5587,1627,5042,393,1295,734,2248,1127,3543
520215,201903,1895,4569,1359,3722,311,918,532,1400,843,2318
520235,201903,594,1434,365,1078,39,126,144,412,183,538
520250,201903,1477,3899,1083,3270,330,1106,200,616,530,1722
520260,201903,833,1974,507,1413,104,304,201,562,305,866
520280,201903,661,1730,521,1486,131,372,215,664,346,1036
520310,201903,1165,2661,763,2049,191,552,289,805,480,1357
520320,201903,1692,4745,1324,4134,151,514,704,2170,855,2684
520330,201903,3530,10041,2565,8375,473,1825,1137,3610,1610,5435
520340,201903,2244,5137,1470,4044,168,427,904,2565,1072,2992
520350,201903,2822,7088,2065,5862,681,2046,659,1847,1340,3893
520355,201903,1766,4963,1317,4093,338,1162,454,1336,792,2498
520357,201903,761,1938,594,1669,39,107,433,1230,472,1337
520360,201903,689,1842,516,1540,162,499,136,439,298,938
520380,201903,1267,3240,767,2289,73,264,398,1096,471,1360
520390,201903,959,2158,544,1628,177,565,140,448,317,1013
520393,201903,547,1310,373,1039,47,161,177,444,224,605
520396,201903,786,2161,662,1936,70,232,419,1186,489,1418
520400,201903,1556,4031,1227,3570,222,689,760,2211,982,2900
520410,201903,1781,3921,1052,2848,146,398,539,1426,685,1824
520420,201903,376,901,285,732,28,83,203,493,231,576
520425,201903,1410,3468,916,2626,224,646,312,897,536,1543
520430,201903,2173,5084,1179,3530,224,773,40,109,264,882
520440,201903,3046,7482,1914,5498,478,1469,498,1391,976,2860
520450,201903,11310,28013,7441,21843,2448,7769,873,2686,3321,10455
520455,201903,645,1817,470,1541,127,444,137,455,264,899
520460,201903,890,2287,754,2099,96,221,565,1623,661,1844
520465,201903,800,2094,640,1858,107,329,406,1140,513,1469
520470,201903,1921,5461,1594,5028,381,1185,802,2697,1183,3882
520480,201903,872,2475,584,1965,177,618,127,452,304,1070
520485,201903,1537,4374,1297,4039,211,652,824,2568,1035,3220
520490,201903,3895,11026,2987,9608,867,2805,1297,4342,2164,7147
520495,201903,1484,3382,1145,2925,61,171,894,2289,955,2460
520500,201903,1377,3692,954,2893,219,727,349,1050,568,1777
520505,201903,730,1753,523,1474,82,240,287,795,369,1035
520510,201903,7328,19038,4923,15238,1164,4028,1299,4287,2463,8315
520520,201903,1116,2926,839,2479,199,613,266,800,465,1413
520530,201903,1954,5928,1465,5060,490,1739,410,1620,900,3359
520540,201903,2892,7796,1786,5523,353,1140,411,1231,764,2371
520545,201903,896,2475,701,2159,145,445,263,819,408,1264
520547,201903,752,2122,595,1830,157,492,258,794,415,1286
520549,201903,11781,33361,9765,30128,1769,5694,5806,17831,7575,23525
520551,201903,4268,12010,3619,11062,434,1579,2491,7412,2925,8991
520552,201903,816,2191,698,2042,119,328,461,1414,580,1742
520570,201903,604,1431,396,1123,109,294,137,414,246,708
520580,201903,2407,5548,1788,4792,149,432,1219,3252,1368,3684
520590,201903,1195,3231,843,2590,241,748,152,468,393,1216
520620,201903,8039,22227,6423,19847,1629,5134,2953,9353,4582,14487
520630,201903,793,2072,501,1562,94,305,126,399,220,704
520640,201903,2450,6143,1863,5136,470,1291,738,2128,1208,3419
520650,201903,900,2196,637,1794,115,332,303,882,418,1214
520660,201903,527,1277,251,771,49,165,56,181,105,346
520670,201903,928,2633,788,2432,71,225,522,1555,593,1780
520680,201903,701,1750,517,1466,99,273,246,716,345,989
520690,201903,352,828,239,671,82,220,72,222,154,442
520710,201903,485,1160,317,878,9,22,212,571,221,593
520725,201903,1574,3823,1121,3071,131,389,704,1861,835,2250
520735,201903,719,1822,502,1453,105,282,185,570,290,852
520740,201903,1963,4679,1524,4118,270,724,865,2426,1135,3150
520750,201903,645,1612,458,1305,91,251,215,642,306,893
520753,201903,1367,3662,1058,3071,202,612,444,1221,646,1833
520760,201903,1162,2548,1044,2395,72,133,876,2085,948,2218
520780,201903,1534,3737,1133,3164,126,367,572,1552,698,1919
520790,201903,3342,8004,2336,6444,251,703,1370,4004,1621,4707
520800,201903,14636,39141,11732,35011,2219,6752,6698,20713,8917,27465
520810,201903,1291,2754,927,2339,172,460,525,1381,697,1841
520815,201903,602,1801,434,1461,94,324,94,336,188,660
520830,201903,1828,4026,1288,3406,54,134,1018,2648,1072,2782
520840,201903,2291,6364,1876,5825,805,2629,534,1776,1339,4405
520850,201903,649,1769,459,1470,170,621,95,308,265,929
520860,201903,5959,16626,4554,14357,1115,3805,1757,5515,2872,9320
520870,201903,90742,218191,62531,176069,16311,49872,19666,54130,35977,104002
520880,201903,6106,17786,4796,15522,1363,4635,1488,4835,2851,9470
520890,201903,3739,9464,2597,7651,575,1811,1071,3146,1646,4957
520910,201903,4368,11286,2781,8473,745,2490,508,1559,1253,4049
520915,201903,611,1724,391,1252,70,263,132,395,202,658
520920,201903,4414,10383,2998,8446,409,1222,1564,4436,1973,5658
520929,201903,726,1780,506,1410,81,203,244,725,325,928
520940,201903,997,2706,792,2412,49,175,584,1730,633,1905
520945,201903,487,1121,387,967,32,78,264,641,296,719
520960,201903,1021,2647,811,2300,110,333,508,1385,618,1718
520970,201903,2405,6920,1962,6174,554,1897,484,1606,1038,3503
520980,201903,788,1977,590,1693,131,408,226,614,357,1022
520990,201903,2963,8369,2438,7635,294,959,1594,5040,1888,5999
520993,201903,1037,2464,684,1898,51,164,460,1247,511,1411
520995,201903,2209,5724,1692,5019,310,934,675,2024,985,2958
521000,201903,8147,21990,5647,17541,1320,4296,1582,4923,2902,9219
521010,201903,3714,9776,2794,8191,333,1009,1578,4598,1911,5607
521015,201903,699,1776,527,1485,63,197,316,853,379,1050
521020,201903,2880,7591,1751,5388,532,1738,160,517,692,2255
521030,201903,489,1081,334,866,44,93,164,469,208,562
521040,201903,7560,18553,5585,15495,1356,3938,2231,6305,3587,10243
521056,201903,864,2360,670,2063,209,649,195,652,404,1301
521060,201903,1021,2654,758,2214,59,182,373,1101,432,1283
521080,201903,1072,2407,555,1561,71,210,207,500,278,710
521090,201903,3356,8881,2285,6898,668,2130,295,931,963,3061
521100,201903,1776,4177,1276,3477,219,596,714,1976,933,2572
521120,201903,4745,11148,3302,9332,281,741,1608,5192,1889,5933
521130,201903,929,2179,586,1596,32,113,324,890,356,1003
521140,201903,1252,3316,905,2709,162,517,380,1125,542,1642
521150,201903,11735,26550,7562,20702,1515,4721,3297,9164,4812,13885
521160,201903,610,1357,437,1085,60,148,254,601,314,749
521170,201903,1070,2555,766,2081,74,210,513,1352,587,1562
521180,201903,6615,19343,5538,17381,1081,3667,2512,7612,3593,11279
521190,201903,10328,26867,5967,19050,1497,5081,1157,3891,2654,8972
521200,201903,725,1824,499,1434,52,148,280,800,332,948
521205,201903,607,1555,455,1303,20,50,333,929,353,979
521210,201903,710,1832,404,1223,108,351,55,123,163,474
521220,201903,3868,9626,2521,7420,565,1818,666,1795,1231,3613
521225,201903,318,732,245,646,43,117,150,389,193,506
521230,201903,1276,3575,1178,3438,429,1232,594,1841,1023,3073
521250,201903,29931,83381,23826,74593,9319,30409,7128,23860,16447,54269
521260,201903,584,1368,424,1107,62,166,241,616,303,782
521270,201903,1805,4656,1548,4342,94,238,1187,3359,1281,3597
521280,201903,1872,5132,1410,4321,376,1237,513,1601,889,2838
521290,201903,468,1166,328,976,54,182,176,509,230,691
521295,201903,1101,2402,861,2145,80,180,661,1742,741,1922
521300,201903,1881,4781,1502,4258,300,800,888,2595,1188,3395
521305,201903,716,1815,501,1462,66,179,281,823,347,1002
521308,201903,4634,12720,3354,10236,446,1375,1814,5461,2260,6836
521310,201903,8056,21133,5423,16520,1286,4242,1887,5521,3173,9763
521340,201903,417,974,298,800,19,54,220,578,239,632
521350,201903,2042,5252,1576,4546,164,534,1054,2935,1218,3469
521370,201903,1189,3081,714,2265,173,632,124,410,297,1042
521375,201903,1387,3538,984,2959,239,710,326,1052,565,1762
521377,201903,1478,3221,1091,2741,77,152,895,2314,972,2466
521380,201903,5868,15982,3907,12259,434,1527,955,3155,1389,4682
521385,201903,624,1536,479,1350,78,212,261,788,339,1000
521390,201903,682,1728,485,1429,155,484,165,515,320,999
521400,201903,2504,5789,1942,5120,191,503,1431,3908,1622,4411
521405,201903,1282,3314,948,2752,193,568,422,1218,615,1786
521410,201903,754,2040,600,1792,118,339,299,959,417,1298
521440,201903,1311,3407,953,2828,289,923,263,770,552,1693
521450,201903,3819,11626,2863,9687,675,2267,820,2943,1495,5210
521460,201903,5744,15562,4208,12817,1531,4867,863,2608,2394,7475
521470,201903,649,1807,398,1266,60,190,116,344,176,534
521480,201903,351,921,200,617,37,119,49,134,86,253
521483,201903,2481,6018,1722,4817,431,1295,589,1590,1020,2885
521486,201903,1676,4032,1270,3458,72,206,958,2576,1030,2782
521487,201903,451,1132,322,939,59,176,147,443,206,619
521490,201903,839,2312,617,1938,39,164,441,1338,480,1502
521500,201903,1989,5105,1445,4194,90,337,1009,2847,1099,3184
521520,201903,765,1745,519,1380,91,246,211,574,302,820
521523,201903,11095,36089,9487,33402,3195,12001,2529,9172,5724,21173
521525,201903,1044,2431,764,2029,83,229,538,1413,621,1642
521530,201903,2260,5890,1298,3908,270,861,320,1017,590,1878
521540,201903,843,2161,544,1644,90,319,227,702,317,1021
521550,201903,1267,3289,766,2284,157,507,226,718,383,1225
521560,201903,4100,11320,2896,9671,562,2219,1407,4869,1969,7088
521565,201903,623,1560,499,1383,93,236,293,810,386,1046
521570,201903,3591,9671,2398,7411,498,1729,317,1056,815,2785
521580,201903,518,1287,289,870,41,135,65,167,106,302
521590,201903,602,1509,456,1285,105,331,224,599,329,930
521600,201903,392,1094,240,757,46,121,60,197,106,318
521630,201903,1640,3713,990,2707,209,594,313,829,522,1423
521640,201903,1892,4552,1360,3783,321,967,464,1230,785,2197
521645,201903,553,1468,357,1113,81,235,104,332,185,567
521680,201903,1124,3491,883,2999,261,946,105,396,366,1342
521690,201903,508,1348,440,1233,59,182,266,720,325,902
521710,201903,2952,7702,1963,5987,389,1353,433,1249,822,2602
521720,201903,2116,5126,1465,4145,173,540,832,2290,1005,2830
521730,201903,3594,10562,2804,9132,890,3230,540,1497,1430,4727
521740,201903,3895,10457,2981,9106,873,2893,1003,3207,1876,6100
521760,201903,14134,40694,11281,36199,3409,11995,3775,12510,7184,24505
521770,201903,2877,7207,2004,5766,629,1945,452,1288,1081,3233
521800,201903,5911,16639,4595,14433,1224,3945,1571,5400,2795,9345
521805,201903,536,1277,385,1062,128,339,156,440,284,779
521810,201903,691,1630,470,1307,78,220,230,652,308,872
521830,201903,5167,14757,4206,13307,372,1380,2873,8933,3245,10313
521839,201903,672,1725,480,1386,99,302,209,554,308,856
521850,201903,5065,12897,3398,10129,630,2094,338,896,968,2990
521860,201903,1733,4560,1180,3601,196,644,377,1128,573,1772
521870,201903,682,1950,470,1538,113,381,124,380,237,761
521878,201903,631,1684,466,1378,73,246,214,558,287,804
521880,201903,17972,44075,12197,35318,3198,9779,3940,11729,7138,21508
521890,201903,3051,8316,2038,6382,548,1810,287,856,835,2666
521900,201903,1591,3828,953,2870,273,798,195,625,468,1423
521910,201903,1153,2614,782,2159,79,214,447,1288,526,1502
521920,201903,427,1220,311,990,59,207,115,376,174,583
521925,201903,739,2031,553,1723,111,344,225,681,336,1025
521930,201903,4641,11868,3286,9828,935,2689,1172,3856,2107,6545
521935,201903,881,2190,614,1718,66,193,355,945,421,1138
521940,201903,1296,2989,851,2376,190,577,341,921,531,1498
521945,201903,516,1454,409,1259,89,276,195,627,284,903
521950,201903,689,1668,508,1417,128,390,240,617,368,1007
521960,201903,714,1961,472,1462,67,218,223,657,290,875
521970,201903,2484,6358,2085,5879,136,382,1643,4691,1779,5073
521971,201903,757,1851,529,1503,144,412,129,368,273,780
521973,201903,1184,3229,929,2826,65,249,623,1845,688,2094
521975,201903,11782,31801,9931,29252,1634,5010,6160,18154,7794,23164
521980,201903,2538,6160,1959,5390,184,474,1436,3993,1620,4467
521990,201903,1135,3167,907,2786,145,446,419,1313,564,1759
522000,201903,2827,7816,2205,7036,253,794,1450,4816,1703,5610
522005,201903,343,842,257,725,51,129,122,356,173,485
522010,201903,3790,9524,2713,7778,760,2331,737,2043,1497,4374
522015,201903,937,2529,673,2098,147,478,266,831,413,1309
522020,201903,5119,12435,3424,9757,776,2316,1400,4099,2176,6415
522026,201903,645,1836,485,1543,95,322,172,536,267,858
522028,201903,472,1274,341,1009,66,195,136,375,202,570
522040,201903,2961,6781,2081,5611,264,781,1368,3607,1632,4388
522045,201903,16469,47508,12315,39731,3021,10384,3069,9599,6090,19983
522050,201903,1005,2695,687,2151,144,483,273,817,417,1300
522060,201903,2494,6959,1977,6135,241,786,1137,3623,1378,4409
522068,201903,1765,4753,1398,4297,173,483,988,3127,1161,3610
522070,201903,599,1566,489,1397,34,120,372,1016,406,1136
522100,201903,620,1665,442,1372,60,197,232,713,292,910
522108,201903,888,2443,698,2148,46,205,555,1640,601,1845
522119,201903,1533,4002,1190,3535,193,603,624,1906,817,2509
522130,201903,366,920,264,785,54,167,143,444,197,611
522140,201903,15938,43340,11676,35812,3428,11221,2504,7425,5932,18646
522145,201903,826,2050,584,1691,146,383,260,808,406,1191
522150,201903,973,2440,706,1995,200,565,216,641,416,1206
522155,201903,875,2327,685,2011,132,385,345,1011,477,1396
522157,201903,531,1361,453,1253,30,108,350,951,380,1059
522160,201903,5707,15261,3827,11754,1094,3649,295,978,1389,4627
522170,201903,2595,6804,1903,5721,432,1323,881,2698,1313,4021
522180,201903,445,1107,281,826,63,187,28,102,91,289
522185,201903,16100,41327,12064,35966,5206,16600,2760,9029,7966,25629
522190,201903,749,1842,534,1463,101,272,204,566,305,838
522200,201903,1662,4951,1062,3625,202,736,79,246,281,982
522205,201903,1591,3801,1215,3279,120,355,840,2253,960,2608
522220,201903,1289,3370,972,2882,142,414,519,1567,661,1981
522230,201903,1145,3048,953,2769,223,756,495,1354,718,2110
530010,201903,156259,443765,130423,403028,24567,83664,69815,211960,94382,295624
110001,201904,3588,10507,2494,8412,665,2372,948,3200,1613,5572
110002,201904,11104,30003,7925,24488,2288,7463,2430,7656,4718,15119
110003,201904,607,1848,433,1470,119,433,96,315,215,748
110004,201904,9300,25903,6389,20378,1585,5397,1700,5636,3285,11033
110005,201904,2406,6429,1508,4759,358,1219,431,1459,789,2678
110006,201904,1761,5026,1077,3566,232,861,178,560,410,1421
110007,201904,1034,2950,790,2542,283,942,222,818,505,1760
110008,201904,3073,8909,2268,7649,269,885,1530,5421,1799,6306
110009,201904,3985,11524,2576,8912,670,2398,920,3293,1590,5691
110010,201904,6298,21610,4882,18849,1128,4254,2294,9828,3422,14082
110011,201904,6124,17026,4375,13791,1564,5073,736,2455,2300,7528
110012,201904,13466,35162,8386,26047,2185,7143,973,3264,3158,10407
110013,201904,4994,15088,3831,12691,1661,5608,576,2166,2237,7774
110014,201904,3580,9795,2475,7693,675,2133,928,2864,1603,4997
110015,201904,4738,12845,2675,8621,729,2541,399,1180,1128,3721
110018,201904,3311,8698,1983,6339,419,1509,548,1705,967,3214
110020,201904,70612,175731,48979,145086,10842,33204,19890,63385,30732,96589
110025,201904,4780,11996,3121,9055,668,2055,1414,4026,2082,6081
110026,201904,449,1244,339,1076,99,341,133,414,232,755
110028,201904,5890,15840,3799,11938,1077,3598,555,1733,1632,5331
110029,201904,1327,3298,769,2351,185,576,303,967,488,1543
110030,201904,11995,28739,7774,22627,1634,5507,2137,6553,3771,12060
110032,201904,2783,8295,1886,6373,629,2128,455,1588,1084,3716
110033,201904,3600,11750,2880,10366,1081,3954,675,2726,1756,6680
110034,201904,3261,8021,2176,6497,652,2083,882,2750,1534,4833
110037,201904,1561,4926,1239,4306,290,1008,566,2005,856,3013
110040,201904,2843,8235,2064,6769,654,2283,516,1634,1170,3917
110045,201904,4775,14240,3753,12397,1010,3616,1417,4710,2427,8326
110050,201904,1666,4839,1216,3976,519,1788,226,754,745,2542
110060,201904,758,2312,524,1788,211,756,63,228,274,984
110070,201904,1642,5296,1271,4459,433,1610,260,840,693,2450
110080,201904,5830,13995,4227,12102,463,1209,2940,8947,3403,10156
110090,201904,566,1554,403,1263,104,361,159,478,263,839
110092,201904,1149,3485,841,2876,149,532,432,1556,581,2088
110094,201904,2686,8186,2061,7047,790,2807,504,1840,1294,4647
110100,201904,1656,5121,1363,4492,337,1162,636,2090,973,3252
110110,201904,1681,4838,1172,3907,402,1402,247,883,649,2285
110120,201904,1228,3743,928,3138,249,873,279,937,528,1810
110130,201904,2472,6490,1564,4812,347,1161,554,1705,901,2866
110140,201904,1993,6179,1418,4978,379,1361,356,1285,735,2646
110143,201904,1290,3560,880,2747,302,947,194,618,496,1565
110145,201904,848,2330,548,1766,139,466,183,616,322,1082
110146,201904,422,1153,290,946,53,170,146,506,199,676
110147,201904,742,1967,469,1408,69,217,188,488,257,705
110148,201904,763,2255,467,1606,117,445,54,185,171,630
110149,201904,2864,8163,2038,6844,789,2687,438,1632,1227,4319
110150,201904,2469,6376,1689,5285,543,1851,483,1654,1026,3505
110155,201904,636,1963,480,1600,121,421,159,506,280,927
110160,201904,1464,4658,1091,3826,355,1244,255,939,610,2183
110170,201904,2127,5651,1314,4028,257,820,660,1964,917,2784
110175,201904,1490,4385,1073,3651,187,675,502,1789,689,2464
110180,201904,1289,3650,878,2803,172,564,409,1290,581,1854
120001,201904,3064,9709,2614,9062,411,1382,1738,6267,2149,7649
120005,201904,1902,7360,1720,7077,157,714,1338,5609,1495,6323
120010,201904,5136,16003,4387,14784,530,1739,3075,10663,3605,12402
120013,201904,2120,7910,1978,7706,482,1793,1197,4962,1679,6755
120017,201904,2111,7101,1888,6751,320,1201,1184,4387,1504,5588
120020,201904,14100,58279,13203,56443,1240,5903,10156,43920,11396,49823
120025,201904,2867,8610,2368,7966,443,1502,1545,5323,1988,6825
120030,201904,6458,25761,6115,25137,407,2205,4873,20069,5280,22274
120032,201904,1632,7521,1565,7365,100,630,1288,5990,1388,6620
120033,201904,4031,15091,3772,14628,132,741,3251,12512,3383,13253
120034,201904,2564,9510,2185,8799,114,689,1762,6944,1876,7633
120035,201904,3453,14497,3291,14185,286,1384,2670,11602,2956,12986
120038,201904,2677,8814,2313,8204,550,2069,1215,4358,1765,6427
120039,201904,1944,8620,1819,8354,139,869,1435,6536,1574,7405
120040,201904,40548,133713,35823,125767,5890,21799,21954,78137,27844,99936
120042,201904,3312,12634,3020,12032,167,887,2419,9605,2586,10492
120043,201904,1377,5575,1254,5362,44,258,1115,4772,1159,5030
120045,201904,5846,15900,5153,15122,136,553,4719,13704,4855,14257
120050,201904,9051,33163,8301,31994,473,2406,6760,26119,7233,28525
120060,201904,9176,36431,8517,35393,421,2432,7304,30301,7725,32733
120070,201904,3026,9992,2655,9482,274,1010,1851,6886,2125,7896
120080,201904,4208,14219,3776,13524,568,2213,2550,9262,3118,11475
130002,201904,3067,12332,2760,11905,177,841,2364,10291,2541,11132
130006,201904,2331,8947,1916,8194,167,784,1430,6099,1597,6883
130008,201904,2546,9075,2291,8683,80,421,1943,7345,2023,7766
130010,201904,3874,11326,3294,10664,60,203,3079,10061,3139,10264
130014,201904,2947,9079,2328,8022,439,1527,1409,4966,1848,6493
130020,201904,2636,10600,2400,10215,156,920,1880,7970,2036,8890
130030,201904,9536,31955,8738,31013,226,963,7882,28237,8108,29200
130040,201904,3686,11205,3125,10440,156,547,2550,8583,2706,9130
130050,201904,7384,27438,6186,25888,193,981,5576,23536,5769,24517
130060,201904,7367,29736,6365,28385,540,3091,5057,22414,5597,25505
130063,201904,6079,20392,5434,19675,134,633,5022,18258,5156,18891
130068,201904,3445,13059,2990,12272,249,1398,2173,8740,2422,10138
130070,201904,7503,21852,6279,20487,281,943,5324,17703,5605,18646
130080,201904,6739,25709,5993,24792,308,1802,4987,20782,5295,22584
130083,201904,2621,8937,2382,8638,180,763,2006,7239,2186,8002
130090,201904,3407,10802,3043,10325,66,298,2629,9087,2695,9385
130100,201904,7630,23479,6566,22353,73,193,6134,21462,6207,21655
130110,201904,8208,23862,6845,22160,874,2328,5198,17871,6072,20199
130115,201904,5358,17062,4688,16266,104,428,4141,14546,4245,14974
130120,201904,14060,51319,12796,49658,1197,5114,10397,40667,11594,45781
130130,201904,5113,16929,4035,15511,449,1910,3022,11649,3471,13559
130140,201904,6856,24875,6299,24248,211,1147,5590,21561,5801,22708
130150,201904,3590,13666,3369,13398,100,639,3050,12108,3150,12747
130160,201904,4988,18272,4334,17417,314,1455,3606,14677,3920,16132
130165,201904,3164,12251,2999,12018,115,580,2686,10785,2801,11365
130170,201904,11493,34809,9376,32253,740,2958,7559,26074,8299,29032
130180,201904,4455,14180,4211,13907,40,228,4062,13365,4102,13593
130185,201904,17991,44905,14676,41347,847,1554,12631,37270,13478,38824
130190,201904,18697,62513,15331,57484,1836,7099,10797,41668,12633,48767
130195,201904,2364,8803,1915,8218,75,414,1693,7268,1768,7682
130200,201904,2448,7227,2044,6669,122,505,1656,5371,1778,5876
130210,201904,1288,4939,1161,4790,98,589,945,3802,1043,4391
130220,201904,2206,8032,1975,7695,81,431,1698,6609,1779,7040
130230,201904,4270,18374,3774,17646,284,1709,3144,14695,3428,16404
130240,201904,11339,35314,9279,32486,204,1216,8194,28585,8398,29801
130250,201904,25405,77947,22193,74304,1667,5316,18079,62711,19746,68027
130255,201904,4230,14566,3748,13697,187,879,3006,10972,3193,11851
130260,201904,246370,718000,205142,656165,57485,195956,92869,302099,150354,498055
130270,201904,8612,32218,7402,30304,1107,4630,5064,21437,6171,26067
130280,201904,3466,14075,3196,13774,109,535,2948,12863,3057,13398
130290,201904,12804,43652,11341,41852,573,2342,9873,36952,10446,39294
130300,201904,4630,16648,4250,16090,165,911,3640,13686,3805,14597
130310,201904,5824,20634,5162,19712,363,1577,4232,16309,4595,17886
130320,201904,3366,11162,2904,10595,315,1117,2229,8385,2544,9502
130330,201904,4520,14663,3715,13682,200,923,3170,11649,3370,12572
130340,201904,22203,73095,19436,69856,1510,5166,16139,59731,17649,64897
130350,201904,3907,14418,3537,13932,153,889,3070,11968,3223,12857
130353,201904,6620,18993,5474,17513,906,2807,3683,12232,4589,15039
130356,201904,4910,16391,4215,15264,614,2247,2753,10358,3367,12605
130360,201904,3105,9474,2663,8969,59,193,2490,8460,2549,8653
130370,201904,5646,22301,5013,21434,299,1527,4177,17839,4476,19366
130380,201904,7096,30072,6709,29469,414,2393,5665,24622,6079,27015
130390,201904,5925,24918,5234,23698,559,2990,3834,17319,4393,20309
130395,201904,2312,7550,2002,7023,212,798,1480,5154,1692,5952
130400,201904,2642,8602,2298,8137,113,417,2026,7262,2139,7679
130406,201904,10666,38974,9235,37122,1726,7089,6245,25855,7971,32944
130410,201904,3993,14557,3477,13695,1096,4475,1615,6618,2711,11093
130420,201904,13142,47389,11154,44947,1010,5185,8753,35211,9763,40396
130423,201904,4172,13460,3682,12893,180,891,3232,11140,3412,12031
130426,201904,2810,11116,2678,10922,87,476,2467,10086,2554,10562
130430,201904,4113,12143,3605,11440,333,1213,2859,8917,3192,10130
130440,201904,4720,15026,4135,14330,105,452,3814,13264,3919,13716
140002,201904,2169,6518,1901,6167,97,373,1582,5098,1679,5471
140005,201904,3125,8834,2838,8515,151,416,2466,7516,2617,7932
140010,201904,53869,144450,42566,127559,10930,34371,16999,52465,27929,86836
140015,201904,3367,10582,2919,10029,214,772,2490,8668,2704,9440
140017,201904,3890,11530,3434,10933,312,995,2645,8669,2957,9664
140020,201904,5075,15263,4343,14263,279,1210,3429,11192,3708,12402
140023,201904,2297,7030,1873,6420,225,817,1331,4633,1556,5450
140028,201904,2084,5429,1777,5025,119,381,1389,3890,1508,4271
140030,201904,4857,12992,4336,12364,329,750,3668,10773,3997,11523
140040,201904,2241,9318,2058,9042,116,737,1798,7740,1914,8477
140045,201904,2605,9588,2206,9023,401,1536,1467,6370,1868,7906
140047,201904,5678,16801,4846,15532,744,2545,3251,10534,3995,13079
140050,201904,1371,4119,1172,3821,134,461,841,2783,975,3244
140060,201904,1612,4347,1356,3967,126,343,1056,3162,1182,3505
140070,201904,1761,9459,1703,9308,142,955,1351,7303,1493,8258
150010,201904,44667,112518,40653,107342,947,2636,36228,95089,37175,97725
150013,201904,1901,5073,1580,4712,148,340,1215,3827,1363,4167
150020,201904,14013,42948,13114,41771,1118,2813,11105,36423,12223,39236
150030,201904,8569,32703,7865,31835,382,1828,6928,28122,7310,29950
150034,201904,4222,10851,3513,9930,251,685,2879,8280,3130,8965
150040,201904,15912,41578,13954,39380,1351,2309,11365,34967,12716,37276
150050,201904,6725,24088,6202,23341,142,675,5667,21477,5809,22152
150060,201904,20619,57798,17012,52379,2903,9018,10564,33411,13467,42429
150070,201904,6527,25131,5802,24248,192,1043,5236,22095,5428,23138
150080,201904,90153,208213,76840,190209,18078,47891,25993,77383,44071,125274
150085,201904,6867,21014,6310,20320,165,551,5856,18967,6021,19518
150090,201904,9900,37237,9331,36139,646,2837,7567,29342,8213,32179
150095,201904,5457,16602,4852,15814,275,712,4038,13676,4313,14388
150100,201904,2978,10596,2641,10001,200,780,2045,7794,2245,8574
150110,201904,4138,17901,3946,17660,221,1064,3571,16066,3792,17130
150120,201904,7638,24806,7391,24477,305,826,6561,22451,6866,23277
150125,201904,733,2026,558,1785,107,394,319,1003,426,1397
150130,201904,22600,66283,19805,62088,2667,7474,14170,46172,16837,53646
150140,201904,226891,544085,196266,501698,31752,79510,114589,306985,146341,386495
150145,201904,4435,13493,3801,12587,811,2408,2419,8620,3230,11028
150150,201904,15118,40201,13465,38100,751,2252,11064,31379,11815,33631
150157,201904,3296,9316,2739,8592,277,915,1965,6379,2242,7294
150160,201904,2918,8978,2734,8682,624,1952,1578,5189,2202,7141
150170,201904,24090,80305,21079,75187,3961,13390,12759,48405,16720,61795
150172,201904,4479,12711,3642,11518,267,754,2728,8925,2995,9679
150175,201904,1625,5137,1379,4677,243,874,840,2885,1083,3759
150178,201904,10244,28799,8578,26829,309,949,7434,23603,7743,24552
150180,201904,20937,77511,19477,75705,994,3866,17055,67454,18049,71320
150190,201904,6753,23046,6349,22510,285,1254,5558,19626,5843,20880
150195,201904,5194,16984,4977,16661,89,470,4621,15313,4710,15783
150200,201904,5553,16669,5101,16175,60,167,4790,15332,4850,15499
150210,201904,25212,90155,23742,88062,1971,7234,19312,73446,21283,80680
150215,201904,6946,20543,6010,19155,1399,4386,3206,10795,4605,15181
150220,201904,11524,33950,10280,32133,1317,4052,6790,21646,8107,25698
150230,201904,12210,35424,10658,33355,1213,3530,7398,24137,8611,27667
150240,201904,31692,89825,26320,80508,8025,24895,8183,25796,16208,50691
150250,201904,4087,16402,3899,16145,550,2267,2995,12658,3545,14925
150260,201904,2570,8780,2377,8465,193,683,1831,6614,2024,7297
150270,201904,8600,25114,6144,20980,2010,7167,1940,7021,3950,14188
150275,201904,6644,21716,6154,20986,240,927,5313,18039,5553,18966
150276,201904,2230,6132,1918,5756,247,673,1333,4360,1580,5033
150277,201904,5161,13807,4214,12707,356,995,3238,10382,3594,11377
150280,201904,6501,27020,6309,26661,532,2244,5251,22439,5783,24683
150285,201904,3195,11432,2823,10853,300,1195,1983,7784,2283,8979
150290,201904,10593,29011,9726,28066,345,791,8759,25847,9104,26638
150293,201904,9377,23662,6979,20448,1264,3656,3848,12058,5112,15714
150295,201904,7840,21420,5710,18534,2009,7095,1916,6820,3925,13915
150300,201904,2241,6946,2015,6639,53,232,1793,5905,1846,6137
150304,201904,4012,12327,3339,11213,614,1954,2047,7169,2661,9123
150307,201904,6194,20149,5787,19499,408,1325,4719,16122,5127,17447
150309,201904,6102,18980,4928,16898,996,3312,2620,9406,3616,12718
150310,201904,7159,28369,6824,27961,230,1330,6027,24874,6257,26204
150320,201904,9350,25570,8536,24437,457,1420,6635,18948,7092,20368
150330,201904,13697,45157,12705,43476,1485,4918,9382,32941,10867,37859
150340,201904,2546,7509,2288,7133,332,960,1616,5161,1948,6121
150345,201904,7656,23144,6985,22255,397,1372,5983,19149,6380,20521
150350,201904,8767,23420,8112,22559,819,1643,6588,19042,7407,20685
150360,201904,23301,66475,18869,60740,2166,6241,12909,43775,15075,50016
150370,201904,10076,32322,8501,30135,950,3126,6244,23369,7194,26495
150375,201904,3323,13824,3010,13349,247,1241,2476,11028,2723,12269
150380,201904,10676,28261,8899,25865,216,774,7731,22502,7947,23276
150390,201904,7754,31953,7045,30765,1136,4585,4884,22481,6020,27066
150400,201904,6273,23053,6026,22571,279,1142,5211,19538,5490,20680
150405,201904,9041,24491,8072,23293,499,1130,6538,19548,7037,20678
150410,201904,1878,6140,1609,5660,212,720,1034,3729,1246,4449
150420,201904,39547,114038,30591,100254,9362,32178,9532,36159,18894,68337
150430,201904,8246,24805,7632,23986,800,2023,6007,19610,6807,21633
150440,201904,5503,18190,5160,17658,611,1904,3870,13626,4481,15530
150442,201904,24656,61893,20594,56507,2280,6091,13973,39293,16253,45384
150445,201904,6086,19240,5438,18227,243,865,4602,15463,4845,16328
150450,201904,4940,21746,4659,21353,384,1903,3936,18118,4320,20021
150460,201904,8319,27626,7724,26858,249,1045,6683,23998,6932,25043
150470,201904,20768,54763,18494,52158,591,1517,17022,48250,17613,49767
150475,201904,4575,15001,4062,14199,181,688,3378,11947,3559,12635
150480,201904,13525,45047,12191,42988,2118,6947,8270,30777,10388,37724
150490,201904,8023,28606,7525,27959,236,1118,6715,25024,6951,26142
150495,201904,5115,18193,4974,17984,115,574,4571,16438,4686,17012
150497,201904,2760,9095,2246,8173,558,2102,1122,4308,1680,6410
150500,201904,3248,8537,2901,8028,271,697,2252,6256,2523,6953
150503,201904,4409,12152,3150,10420,975,3435,1018,3794,1993,7229
150506,201904,9924,31161,8572,29229,1841,5563,5426,20207,7267,25770
150510,201904,9740,36022,8528,33681,1162,4440,5791,23915,6953,28355
150520,201904,7257,27640,6943,27239,204,1174,6348,24817,6552,25991
150530,201904,12130,41801,10656,39673,1542,4734,7693,30333,9235,35067
150540,201904,4896,13733,4204,12693,147,452,3614,10893,3761,11345
150543,201904,7035,19293,5784,17674,654,2069,4174,13309,4828,15378
150548,201904,9752,31014,8842,29784,301,1058,7801,26443,8102,27501
150549,201904,2018,6177,1747,5813,49,214,1516,5040,1565,5254
150550,201904,19391,58408,16566,53714,3973,13141,7466,25818,11439,38959
150553,201904,23520,72637,18693,63858,6095,21349,5817,21806,11912,43155
150555,201904,1832,5014,1448,4399,134,344,1009,3158,1143,3502
150560,201904,1807,5634,1606,5234,283,877,916,3104,1199,3981
150563,201904,2462,7768,2115,7137,446,1616,1167,3908,1613,5524
150565,201904,4213,13818,3745,13050,114,549,3078,10777,3192,11326
150570,201904,6111,20310,5848,19912,267,1076,5076,17175,5343,18251
150580,201904,10067,41170,9122,40103,647,3239,7546,33952,8193,37191
150590,201904,7344,26728,6666,25863,213,1199,6014,23213,6227,24412
150600,201904,9172,31433,8574,30672,220,933,7884,28302,8104,29235
150610,201904,2686,8199,2417,7724,118,458,1968,6205,2086,6663
150611,201904,3038,8959,2742,8520,100,413,2398,7370,2498,7783
150613,201904,12849,36096,9791,30840,1861,6253,4783,15160,6644,21413
150616,201904,3253,9113,2396,7679,606,2030,912,2887,1518,4917
150618,201904,6798,20195,5512,18159,645,2080,3431,11837,4076,13917
150619,201904,6057,17785,5066,16295,201,785,4115,13250,4316,14035
150620,201904,6466,21668,5639,20329,789,2759,3895,14454,4684,17213
150630,201904,6058,16897,5593,16318,447,1206,4628,13761,5075,14967
150635,201904,4505,12841,3864,11782,591,1777,2421,7542,3012,9319
150640,201904,2197,6424,2015,6209,33,110,1881,5871,1914,5981
150650,201904,11219,32121,9965,29988,3078,8702,4401,14368,7479,23070
150655,201904,5751,16709,5231,15928,225,707,4466,13577,4691,14284
150658,201904,4397,12598,3502,11268,593,1995,2106,7111,2699,9106
150660,201904,5633,16468,5078,15665,539,1595,3504,11016,4043,12611
150670,201904,8067,19261,6385,17333,641,1456,5009,14248,5650,15704
150680,201904,64058,195054,49393,171462,12472,42715,22094,85732,34566,128447
150690,201904,2739,7630,2470,7283,123,315,2163,6493,2286,6808
150700,201904,6110,18470,5505,17686,388,1150,4358,14322,4746,15472
150710,201904,3717,12555,3414,12060,235,863,2649,9478,2884,10341
150715,201904,4995,14861,4200,13604,359,1117,3266,10763,3625,11880
150720,201904,6658,24669,6237,23945,435,1896,5137,19768,5572,21664
150730,201904,11215,35483,9888,33468,1099,3892,7485,25795,8584,29687
150740,201904,3812,10967,3379,10238,356,964,2477,7644,2833,8608
150745,201904,5074,14742,4110,13300,840,2857,2600,8446,3440,11303
150746,201904,1591,5035,1458,4824,84,267,1190,3959,1274,4226
150747,201904,4779,15678,4274,14828,769,2363,2783,10192,3552,12555
150750,201904,3611,11517,3057,10638,222,822,2334,8318,2556,9140
150760,201904,11762,34903,10746,33568,1393,4047,7793,24964,9186,29011
150770,201904,6187,22775,5922,22446,200,653,5428,21135,5628,21788
150775,201904,876,2592,702,2332,131,487,381,1272,512,1759
150780,201904,4502,13648,4076,13128,117,346,3722,12179,3839,12525
150790,201904,5468,16085,4790,15348,213,543,3992,13847,4205,14390
150795,201904,13092,42444,11891,40427,3114,10027,6693,24258,9807,34285
150796,201904,3609,9325,3145,8766,167,444,2659,7479,2826,7923
150797,201904,3844,12200,3334,11428,142,440,2773,9642,2915,10082
150800,201904,12896,41480,11965,40300,1510,4659,9169,31930,10679,36589
150803,201904,6767,22693,6392,22111,371,1322,5443,18911,5814,20233
150805,201904,3364,10651,2873,9886,265,945,2174,7558,2439,8503
150808,201904,5915,17329,4359,14665,1662,6099,609,2289,2271,8388
150810,201904,20364,55800,15631,49960,3078,9830,8407,29182,11485,39012
150812,201904,5344,15420,4744,14353,453,1461,3473,10304,3926,11765
150815,201904,8985,27746,7716,26134,700,2373,6152,21173,6852,23546
150820,201904,11810,32702,9985,30468,975,2624,7731,24406,8706,27030
150830,201904,11303,42957,10762,42270,394,2044,9399,37438,9793,39482
150835,201904,2135,7335,1889,6886,390,1397,958,3559,1348,4956
150840,201904,7046,20821,5649,18349,1101,3794,2877,9267,3978,13061
160005,201904,1169,3229,1058,3073,33,135,963,2779,996,2914
160010,201904,2434,6266,2317,6145,17,92,2253,5902,2270,5994
160015,201904,2388,7496,2186,7225,78,277,1994,6607,2072,6884
160020,201904,2001,6754,1782,6457,219,814,1363,4992,1582,5806
160021,201904,1087,4284,1013,4178,77,447,813,3273,890,3720
160023,201904,1228,4420,1090,4187,105,368,788,3180,893,3548
160025,201904,1956,5559,1895,5486,12,39,1864,5399,1876,5438
160027,201904,8648,24409,7842,23406,563,1612,6432,19510,6995,21122
160030,201904,62860,185535,51695,170612,11487,35868,27638,100470,39125,136338
160040,201904,5248,18657,4802,18058,104,525,4411,16639,4515,17164
160050,201904,4406,14190,3577,12975,1450,4975,1250,5584,2700,10559
160053,201904,3619,11761,3349,11416,284,924,2740,9555,3024,10479
160055,201904,782,2502,763,2482,27,96,711,2307,738,2403
160060,201904,23056,64006,19275,59631,1073,3340,15421,49778,16494,53118
160070,201904,2871,10944,2600,10502,194,779,2061,8558,2255,9337
160080,201904,3045,10267,2807,9986,67,340,2525,9031,2592,9371
170025,201904,607,1656,448,1419,86,264,237,762,323,1026
170030,201904,1196,3725,941,3230,157,510,468,1667,625,2177
170035,201904,1459,3818,1053,3144,107,362,615,1817,722,2179
170040,201904,1788,5279,1436,4793,115,441,836,2917,951,3358
170070,201904,1751,4180,1235,3524,94,309,737,2131,831,2440
170100,201904,2413,7025,1990,6294,184,538,1299,4174,1483,4712
170105,201904,728,2148,498,1646,130,404,169,564,299,968
170110,201904,921,2913,709,2496,113,431,311,1088,424,1519
170130,201904,1302,4012,927,3251,168,606,443,1612,611,2218
170190,201904,1365,3942,933,3220,327,1128,170,789,497,1917
170200,201904,1774,4453,1085,3276,256,827,296,905,552,1732
170210,201904,23732,66276,18127,56600,6465,21729,1892,7066,8357,28795
170215,201904,1304,3587,1089,3294,52,223,829,2484,881,2707
170220,201904,5822,18262,4918,16553,1225,3904,2242,8162,3467,12066
170230,201904,1268,3835,953,3189,261,890,195,693,456,1583
170240,201904,2629,7460,2018,6466,168,658,1357,4227,1525,4885
170255,201904,3982,11756,2788,9453,509,1783,1253,4383,1762,6166
170270,201904,999,2455,647,1959,23,79,414,1242,437,1321
170290,201904,2925,8603,2495,8079,119,366,2000,6720,2119,7086
170300,201904,1883,5344,1545,4819,174,572,1030,3250,1204,3822
170305,201904,698,1997,550,1725,66,234,266,811,332,1045
170307,201904,919,3227,740,2853,106,429,404,1581,510,2010
170310,201904,1598,4129,1100,3286,190,625,496,1483,686,2108
170320,201904,1030,2713,765,2295,67,214,488,1469,555,1683
170330,201904,892,2788,799,2638,51,230,639,2045,690,2275
170360,201904,466,1299,329,1064,37,135,194,587,231,722
170370,201904,1275,3445,909,2825,221,681,324,1082,545,1763
170380,201904,1759,5212,1311,4498,117,445,715,2538,832,2983
170382,201904,544,1673,440,1486,47,201,298,967,345,1168
170384,201904,1525,5651,1255,5106,297,1266,566,2336,863,3602
170386,201904,855,2367,529,1721,79,300,164,488,243,788
170388,201904,626,1805,446,1481,62,235,202,671,264,906
170389,201904,1031,3361,880,3100,45,195,688,2452,733,2647
170390,201904,1622,3840,1195,3307,68,164,940,2687,1008,2851
170410,201904,552,1665,397,1364,21,98,260,874,281,972
170460,201904,372,997,291,855,44,128,176,527,220,655
170510,201904,874,2643,641,2187,52,231,384,1264,436,1495
170550,201904,6451,17625,4650,14580,1302,4373,994,3329,2296,7702
170555,201904,1329,3747,1043,3283,60,205,555,1813,615,2018
170560,201904,1021,2958,762,2579,81,316,444,1628,525,1944
170600,201904,1327,3674,1067,3282,231,576,604,2026,835,2602
170610,201904,1740,4768,1259,3999,72,278,777,2424,849,2702
170625,201904,433,1200,268,838,27,74,90,276,117,350
170650,201904,1275,3855,991,3362,164,562,495,1755,659,2317
170700,201904,3312,9873,2477,8292,504,1734,1071,3672,1575,5406
170710,201904,1495,4056,1134,3427,179,598,642,1916,821,2514
170720,201904,1826,4662,1450,4101,74,159,1127,3317,1201,3476
170730,201904,1007,2838,741,2399,163,500,320,1107,483,1607
170740,201904,2031,6919,1733,6329,223,863,1151,4196,1374,5059
170755,201904,862,2483,601,1984,60,222,290,922,350,1144
170765,201904,1224,3218,832,2588,180,570,338,1103,518,1673
170770,201904,1781,5341,1492,4869,199,592,957,3234,1156,3826
170820,201904,3361,10668,2788,9581,470,1699,1406,4955,1876,6654
170825,201904,930,2256,752,2002,84,220,516,1386,600,1606
170830,201904,1367,3767,1133,3391,26,99,909,2715,935,2814
170900,201904,2622,8646,2241,8052,189,754,1729,6288,1918,7042
170930,201904,3645,10247,2827,8760,631,2073,1107,3421,1738,5494
170950,201904,10968,30967,7568,24766,2228,8258,988,3478,3216,11736
170980,201904,415,1175,337,1048,16,81,240,699,256,780
171050,201904,1564,5081,1361,4696,52,253,1107,3791,1159,4044
171070,201904,1322,3932,1128,3642,242,767,605,2151,847,2918
171090,201904,1027,2572,832,2289,72,188,582,1612,654,1800
171110,201904,564,1578,402,1269,65,226,187,528,252,754
171150,201904,1054,2695,638,1967,80,276,385,1173,465,1449
171180,201904,754,2120,491,1605,86,265,195,659,281,924
171190,201904,1646,5803,1458,5463,242,945,866,3318,1108,4263
171195,201904,821,2696,681,2432,105,436,408,1423,513,1859
171200,201904,518,1523,388,1288,76,270,171,561,247,831
171215,201904,377,1083,292,928,47,164,170,527,217,691
171240,201904,750,2589,618,2316,40,205,394,1470,434,1675
171245,201904,618,1913,480,1612,55,209,266,865,321,1074
171250,201904,1056,2811,766,2351,144,473,374,1150,518,1623
171270,201904,370,1460,315,1317,73,319,127,573,200,892
171280,201904,842,2585,655,2242,95,310,347,1257,442,1567
171320,201904,3931,11239,3059,9707,585,1874,1275,4236,1860,6110
171330,201904,2663,7372,2047,6315,432,1294,963,3069,1395,4363
171360,201904,1408,4197,1147,3820,79,300,834,2809,913,3109
171370,201904,659,1727,515,1528,59,183,351,1057,410,1240
171380,201904,1491,4171,1239,3790,107,338,870,2685,977,3023
171395,201904,937,2747,637,2141,67,254,348,1144,415,1398
171420,201904,1884,5724,1367,4664,238,900,597,2039,835,2939
171430,201904,1008,3049,836,2702,71,275,560,1748,631,2023
171488,201904,2320,6946,1789,6041,306,1077,880,3051,1186,4128
171500,201904,956,2446,729,2087,42,122,538,1543,580,1665
171510,201904,742,2581,657,2403,45,203,454,1658,499,1861
171515,201904,460,1256,336,1047,36,155,195,566,231,721
171525,201904,648,1934,518,1703,36,165,311,948,347,1113
171550,201904,336,1005,239,833,35,149,131,438,166,587
171570,201904,1099,3401,920,3067,161,514,521,1817,682,2331
171575,201904,1812,4866,1133,3610,159,541,481,1503,640,2044
171610,201904,5622,16063,4205,13635,955,3408,1168,4017,2123,7425
171620,201904,2649,7604,2234,6991,127,496,1760,5502,1887,5998
171630,201904,923,2570,751,2322,117,363,486,1553,603,1916
171650,201904,2047,6016,1533,5071,394,1385,483,1707,877,3092
171660,201904,2300,6001,1587,4765,249,727,812,2474,1061,3201
171665,201904,1329,3789,999,3239,163,613,474,1559,637,2172
171670,201904,1809,4954,1396,4277,207,711,777,2337,984,3048
171700,201904,1194,3477,874,2906,111,368,491,1625,602,1993
171720,201904,792,2103,609,1799,60,197,422,1241,482,1438
171750,201904,1232,3537,869,2863,212,719,121,483,333,1202
171780,201904,1198,3141,876,2663,68,243,609,1813,677,2056
171790,201904,1412,4783,1140,4194,241,871,498,1936,739,2807
171800,201904,739,2076,548,1777,67,257,306,989,373,1246
171820,201904,10755,30821,8061,26053,1931,6506,2668,9183,4599,15689
171830,201904,1469,4989,1238,4547,119,549,794,2861,913,3410
171840,201904,738,2013,581,1763,27,83,397,1206,424,1289
171845,201904,626,1618,456,1368,58,222,261,779,319,1001
171850,201904,847,2942,726,2662,64,302,523,1855,587,2157
171855,201904,1051,3274,901,2996,78,259,563,1843,641,2102
171865,201904,372,1216,308,1101,49,181,149,508,198,689
171870,201904,768,2198,542,1758,54,178,285,959,339,1137
171875,201904,1239,3739,996,3338,54,240,733,2424,787,2664
171880,201904,1097,3472,979,3308,35,146,792,2713,827,2859
171884,201904,813,2260,595,1914,115,428,224,777,339,1205
171886,201904,1407,4031,990,3297,298,1068,199,688,497,1756
171888,201904,736,2083,495,1618,39,142,304,978,343,1120
171889,201904,413,1302,351,1189,71,259,151,513,222,772
171890,201904,1140,3209,845,2731,173,505,467,1571,640,2076
171900,201904,508,1793,357,1397,82,318,132,547,214,865
172000,201904,566,1760,473,1573,47,193,283,901,330,1094
172010,201904,1021,3603,875,3297,79,379,540,1956,619,2335
172015,201904,356,1271,266,1079,63,239,111,489,174,728
172020,201904,2423,7278,2178,6949,172,660,1633,5263,1805,5923
172025,201904,744,2070,538,1723,42,163,351,1108,393,1271
172030,201904,1228,3695,1055,3426,31,140,854,2754,885,2894
172049,201904,1259,3133,866,2562,216,635,439,1367,655,2002
172065,201904,1458,3662,1149,3287,96,203,949,2870,1045,3073
172080,201904,2255,6896,1842,6129,130,497,1225,4078,1355,4575
172085,201904,476,1332,310,970,58,172,109,324,167,496
172090,201904,3929,10191,3016,8960,134,468,2283,6782,2417,7250
172093,201904,482,1452,350,1209,35,143,185,619,220,762
172097,201904,580,1578,414,1294,56,179,202,647,258,826
172100,201904,47979,121617,32480,96021,6526,21229,10538,31962,17064,53191
172110,201904,1584,5931,1373,5586,159,666,992,4238,1151,4904
172120,201904,4750,14444,3771,12819,557,1911,2047,7224,2604,9135
172125,201904,296,834,218,700,24,83,118,371,142,454
172130,201904,693,1878,572,1682,25,91,415,1178,440,1269
172208,201904,2449,6230,1975,5591,201,511,1365,3956,1566,4467
172210,201904,2711,7242,2064,6397,422,1360,1079,3446,1501,4806
210005,201904,19103,56498,15012,49749,4422,15220,5762,19910,10184,35130
210010,201904,1878,5911,1699,5659,55,254,1460,4895,1515,5149
210015,201904,3337,10067,2970,9565,119,326,2564,8396,2683,8722
210020,201904,7435,17136,6492,16042,85,226,6030,14910,6115,15136
210030,201904,4692,15816,4413,15403,198,955,3838,13295,4036,14250
210040,201904,1890,4687,1712,4472,28,49,1595,4217,1623,4266
210043,201904,6368,17956,5254,16508,575,1754,3861,12514,4436,14268
210047,201904,6554,21274,5538,19819,182,912,4784,17028,4966,17940
210050,201904,2231,7691,1756,6802,194,851,1167,4497,1361,5348
210055,201904,1826,6019,1674,5761,68,286,1398,4777,1466,5063
210060,201904,6979,26272,6218,24844,785,3257,4303,17710,5088,20967
210070,201904,7207,20600,6805,20113,38,138,6512,19351,6550,19489
210080,201904,4035,13975,3873,13786,41,249,3648,13038,3689,13287
210083,201904,5515,16161,4620,15206,64,344,4354,14268,4418,14612
210087,201904,2953,8242,2602,7776,116,295,2214,6791,2330,7086
210090,201904,9398,29599,8832,28608,350,1184,7721,24946,8071,26130
210095,201904,6255,20614,5796,20053,246,1050,4862,17326,5108,18376
210100,201904,6751,20541,6128,19566,288,1048,5073,16167,5361,17215
210110,201904,2920,9923,2721,9665,42,257,2526,8953,2568,9210
210120,201904,22557,63202,19045,58604,2195,5756,12821,41795,15016,47551
210125,201904,4176,11739,3734,11177,763,1836,2645,8470,3408,10306
210130,201904,4273,11563,3574,10656,150,378,3039,9118,3189,9496
210135,201904,1442,4420,1262,4127,59,207,1030,3397,1089,3604
210140,201904,17284,48111,13563,43206,2672,8329,7587,25287,10259,33616
210150,201904,4468,10953,3972,10252,113,317,3476,8857,3589,9174
210160,201904,16242,48752,14321,46183,1331,4480,10199,33914,11530,38394
210170,201904,14628,47036,13675,45756,657,2253,12065,40424,12722,42677
210173,201904,2289,8645,2101,8308,61,394,1890,7450,1951,7844
210177,201904,3320,9377,2990,8967,109,204,2693,8352,2802,8556
210180,201904,1443,3986,1287,3783,34,97,1152,3371,1186,3468
210190,201904,4967,14336,4377,13447,99,505,3702,11104,3801,11609
210193,201904,1241,3772,1111,3566,42,154,884,2890,926,3044
210197,201904,1965,6466,1833,6271,154,536,1477,5149,1631,5685
210200,201904,7453,24519,6799,23449,581,2102,5394,18723,5975,20825
210203,201904,6923,20913,6092,19766,518,1714,4873,16061,5391,17775
210207,201904,3359,9335,2961,8842,146,364,2457,7520,2603,7884
210210,201904,8154,26724,7595,25970,125,738,6963,23713,7088,24451
210215,201904,2206,7318,2005,7018,63,322,1775,6183,1838,6505
210220,201904,6085,21208,5779,20722,224,1363,5012,17538,5236,18901
210230,201904,5117,15809,4654,15118,301,805,3998,13233,4299,14038
210232,201904,11340,36404,9448,33575,1520,5477,6061,22870,7581,28347
210235,201904,3443,10321,3017,9743,70,337,2677,8623,2747,8960
210237,201904,2525,8822,2305,8537,29,167,2143,7947,2172,8114
210240,201904,2647,8453,2439,8089,86,359,2114,6937,2200,7296
210250,201904,5503,17059,5049,16484,79,449,4509,14690,4588,15139
210255,201904,2524,7861,2156,7171,239,821,1450,4778,1689,5599
210260,201904,5368,16519,4763,15608,250,966,4009,13076,4259,14042
210270,201904,4726,13386,4247,12753,95,486,3807,11313,3902,11799
210275,201904,3566,9028,3182,8554,50,116,2926,7963,2976,8079
210280,201904,5447,15980,4402,14320,280,1256,3156,10001,3436,11257
210290,201904,6845,19428,6222,18642,148,469,5634,16882,5782,17351
210300,201904,33034,90905,27402,83165,1785,5547,20412,64313,22197,69860
210310,201904,3015,7904,2673,7405,126,299,2309,6459,2435,6758
210312,201904,2605,6883,2304,6540,47,195,2117,5931,2164,6126
210315,201904,2988,8399,2544,7882,75,199,2294,7273,2369,7472
210317,201904,4096,13125,3757,12729,122,621,3374,11347,3496,11968
210320,201904,18687,58118,17185,56105,473,2303,15147,49129,15620,51432
210325,201904,3404,10095,3008,9565,90,314,2687,8649,2777,8963
210330,201904,23783,70763,20474,66107,5754,17038,10241,37451,15995,54489
210340,201904,9816,30158,8917,28803,760,2520,6836,22524,7596,25044
210350,201904,9312,27242,8210,25869,180,693,7213,22835,7393,23528
210355,201904,4291,14972,3801,14193,127,660,3242,12172,3369,12832
210360,201904,13420,42214,12093,40294,490,2335,9759,32031,10249,34366
210370,201904,10386,23869,8212,21555,249,468,7480,20057,7729,20525
210375,201904,3217,8706,2438,7663,607,1912,1170,4056,1777,5968
210380,201904,5462,14337,4804,13529,234,591,4083,11575,4317,12166
210390,201904,2531,9252,2374,8952,129,623,1956,7320,2085,7943
210400,201904,4393,13883,3971,13351,152,486,3510,11915,3662,12401
210405,201904,6959,19098,5622,17172,1043,3007,3177,10286,4220,13293
210407,201904,1953,6581,1627,5954,95,442,1298,4659,1393,5101
210408,201904,2427,9308,2286,9083,146,736,1837,7324,1983,8060
210409,201904,3732,13093,3437,12686,112,624,2836,10479,2948,11103
210410,201904,3463,10809,2950,9940,223,852,2143,7180,2366,8032
210420,201904,3928,12671,3549,12009,197,607,2985,10210,3182,10817
210430,201904,2242,6594,2029,6326,85,248,1783,5590,1868,5838
210440,201904,4135,11643,3768,11139,70,287,3500,10282,3570,10569
210450,201904,2458,7468,2164,7013,102,375,1794,5783,1896,6158
210455,201904,4114,11007,3154,9780,916,2809,1557,5040,2473,7849
210460,201904,3495,10385,3050,9796,84,362,2661,8496,2745,8858
210462,201904,1540,4921,1348,4597,41,193,1087,3683,1128,3876
210465,201904,2580,7704,2270,7266,73,287,1963,6271,2036,6558
210467,201904,5558,18702,5065,18036,285,1204,4348,15550,4633,16754
210470,201904,2092,5496,1435,4547,85,202,1071,3527,1156,3729
210480,201904,15580,47255,13147,44186,1234,3852,9674,34513,10908,38365
210490,201904,3705,9493,3027,8527,79,234,2624,7385,2703,7619
210500,201904,6108,24350,5738,23682,373,1970,4671,19040,5044,21010
210510,201904,6017,20394,5400,19705,123,601,4820,17795,4943,18396
210515,201904,3711,10929,3245,10412,115,416,2852,9216,2967,9632
210520,201904,2452,7140,2229,6855,83,297,1968,6006,2051,6303
210530,201904,53661,131642,42431,115016,6802,23280,11468,39854,18270,63134
210535,201904,3086,10570,2875,10240,110,435,2421,8706,2531,9141
210540,201904,14179,42049,11941,38972,1421,4408,8459,28692,9880,33100
210542,201904,6248,15270,5159,14046,387,685,4309,12465,4696,13150
210545,201904,2217,7000,2091,6784,51,216,1841,5887,1892,6103
210547,201904,3523,12706,3117,11900,293,1107,2266,8901,2559,10008
210550,201904,6108,18612,4960,16844,341,1295,3736,12981,4077,14276
210560,201904,3444,10737,3118,10200,118,411,2634,8567,2752,8978
210565,201904,1458,4971,1224,4608,67,344,956,3651,1023,3995
210570,201904,10677,29520,9562,28175,295,867,8556,25572,8851,26439
210580,201904,2952,8182,2539,7687,192,366,2053,6526,2245,6892
210590,201904,4234,12922,3720,12226,88,469,3288,10735,3376,11204
210592,201904,2562,7645,2402,7387,35,166,2140,6526,2175,6692
210594,201904,2546,6924,1980,6054,86,237,1493,4703,1579,4940
210596,201904,2413,8744,2189,8284,139,599,1740,6626,1879,7225
210598,201904,1864,5386,1714,5169,33,146,1561,4671,1594,4817
210600,201904,2977,8155,2414,7333,75,206,1973,6095,2048,6301
210610,201904,2556,7501,2233,7100,68,332,1916,6028,1984,6360
210620,201904,2555,7225,2188,6779,46,144,2003,6317,2049,6461
210630,201904,3034,10433,2766,10006,145,749,2263,8031,2408,8780
210632,201904,4276,14104,3835,13458,276,1197,2986,10359,3262,11556
210635,201904,1776,6336,1679,6163,136,483,1373,5153,1509,5636
210637,201904,2278,7861,2048,7515,163,732,1537,5661,1700,6393
210640,201904,4495,16154,4269,15886,48,273,4036,14974,4084,15247
210650,201904,7243,20854,6652,20091,82,362,6171,18645,6253,19007
210660,201904,8203,24208,7278,22737,303,1155,6262,19342,6565,20497
210663,201904,2545,7676,2388,7495,110,275,2086,6720,2196,6995
210667,201904,1877,6201,1754,6017,53,217,1581,5465,1634,5682
210670,201904,4447,15410,4112,14862,137,686,3540,12691,3677,13377
210675,201904,4961,13694,4318,12826,254,651,3584,10896,3838,11547
210680,201904,4131,10678,3512,9909,129,243,3106,8981,3235,9224
210690,201904,7354,23633,6536,22685,266,1240,5722,19896,5988,21136
210700,201904,2685,7406,2203,6776,137,381,1719,5578,1856,5959
210710,201904,5010,15744,4421,14879,121,635,3855,12833,3976,13468
210720,201904,2802,9440,2621,9213,55,309,2366,8266,2421,8575
210725,201904,1329,4544,1143,4249,42,195,800,3070,842,3265
210730,201904,1198,3235,1005,2968,72,186,794,2371,866,2557
210735,201904,4577,13868,3940,12987,271,914,3288,11030,3559,11944
210740,201904,5243,14355,4624,13668,127,455,3830,11246,3957,11701
210745,201904,4464,12415,4147,11993,141,391,3750,10876,3891,11267
210750,201904,22107,56638,19388,53272,1494,3990,13632,39358,15126,43348
210760,201904,5749,15521,5043,14761,23,88,4807,14148,4830,14236
210770,201904,6007,15766,5211,14854,51,216,4880,13870,4931,14086
210780,201904,7039,23258,6314,22003,579,1871,4932,17539,5511,19410
210790,201904,4364,13850,4026,13418,227,670,3204,11283,3431,11953
210800,201904,4923,13245,4244,12332,60,258,3829,10967,3889,11225
210805,201904,3880,14404,3740,14195,113,626,3334,12572,3447,13198
210810,201904,4890,14568,4482,14037,213,503,3844,12388,4057,12891
210820,201904,6938,20084,5876,18356,756,2385,3641,11615,4397,14000
210825,201904,6627,20799,6115,20127,234,824,5317,17693,5551,18517
210830,201904,7504,21744,7043,21178,433,999,6066,18772,6499,19771
210840,201904,3181,8554,2878,8137,91,287,2514,7015,2605,7302
210845,201904,6354,17491,5802,16876,27,87,5635,16437,5662,16524
210850,201904,5779,20059,4994,18854,280,1383,3899,14698,4179,16081
210860,201904,19556,52528,16613,48761,721,2030,13655,41553,14376,43583
210870,201904,6733,18661,5770,17521,228,693,5026,15293,5254,15986
210880,201904,4372,13504,3960,13031,233,890,3261,10729,3494,11619
210890,201904,3961,12014,3609,11591,222,581,2985,9874,3207,10455
210900,201904,4498,13333,3472,11453,1398,4900,581,2140,1979,7040
210905,201904,1914,5418,1622,5024,49,106,1462,4622,1511,4728
210910,201904,7144,22007,6101,20324,810,2777,4075,13639,4885,16416
210920,201904,3233,10719,2827,10173,82,449,2513,8959,2595,9408
210923,201904,1420,4468,1267,4218,62,239,963,3202,1025,3441
210927,201904,5173,16391,4581,15720,176,658,3958,13799,4134,14457
210930,201904,2427,8557,2200,8146,149,690,1713,6279,1862,6969
210940,201904,3941,11391,3714,11109,125,506,3371,9943,3496,10449
210945,201904,6042,18043,5560,17464,237,735,4807,15305,5044,16040
210950,201904,5037,14700,3937,13084,597,1663,2622,9293,3219,10956
210955,201904,1532,4983,1364,4698,137,456,982,3445,1119,3901
210960,201904,8739,26717,7700,25161,1290,3865,4967,17132,6257,20997
210970,201904,1248,3953,1014,3551,62,278,766,2611,828,2889
210975,201904,1656,5375,1493,5093,102,365,1179,4032,1281,4397
210980,201904,10097,23223,8879,21970,103,213,8425,20976,8528,21189
210990,201904,15793,45682,12652,41507,942,3332,9280,30952,10222,34284
211000,201904,14068,42853,12147,40614,600,2423,9982,34054,10582,36477
211003,201904,5375,16746,4600,15790,141,546,3977,13959,4118,14505
211010,201904,6249,22726,5682,22003,74,451,5153,20139,5227,20590
211020,201904,7609,23772,7029,23071,263,1081,6082,20024,6345,21105
211023,201904,1978,6613,1887,6484,94,395,1593,5415,1687,5810
211027,201904,2884,9525,2790,9369,176,651,2430,8085,2606,8736
211030,201904,3812,10727,3435,10266,239,544,2813,8661,3052,9205
211040,201904,4495,16492,4209,16006,133,784,3726,14033,3859,14817
211050,201904,9159,23760,8365,22754,153,414,7709,20982,7862,21396
211060,201904,6779,21242,6289,20577,155,625,5776,18892,5931,19517
211065,201904,2102,6032,1780,5601,84,276,1471,4710,1555,4986
211070,201904,7228,24097,6330,22665,502,1838,4953,17903,5455,19741
211080,201904,1270,3612,1022,3222,39,229,785,2324,824,2553
211085,201904,1950,5769,1705,5430,93,252,1479,4804,1572,5056
211090,201904,3203,8921,2885,8514,39,204,2631,7691,2670,7895
211100,201904,6596,16994,6144,16429,42,141,5642,15147,5684,15288
211102,201904,2923,10434,2711,10114,153,750,2323,8566,2476,9316
211105,201904,2321,7517,1942,6790,188,687,1362,4724,1550,5411
211107,201904,4449,14262,3857,13379,145,606,3152,11179,3297,11785
211110,201904,5827,16406,4550,14443,453,1323,3238,10519,3691,11842
211120,201904,40840,105449,36477,100389,4757,12145,23715,69870,28472,82015
211125,201904,1998,6089,1698,5620,49,200,1419,4704,1468,4904
211130,201904,191546,465093,174230,443199,25325,65021,75200,219881,100525,284902
211140,201904,4873,14802,4316,14039,195,607,3679,12000,3874,12607
211150,201904,9228,25857,7962,24184,325,1014,6700,20470,7025,21484
211153,201904,2511,7425,2033,6830,286,1023,1350,4721,1636,5744
211157,201904,1072,3441,898,3130,37,201,651,2236,688,2437
211160,201904,3852,11433,3105,10273,163,697,2316,7515,2479,8212
211163,201904,1715,5491,1577,5292,24,111,1440,4905,1464,5016
211167,201904,1545,4980,1446,4821,31,154,1327,4382,1358,4536
211170,201904,6270,15661,5919,15251,45,158,5636,14455,5681,14613
211172,201904,2397,6743,2072,6236,91,308,1697,4972,1788,5280
211174,201904,2775,8337,2559,8072,62,318,2318,7257,2380,7575
211176,201904,4208,12305,3288,10955,189,771,2573,8533,2762,9304
211178,201904,4627,10844,4004,10145,38,152,3762,9434,3800,9586
211180,201904,3941,13318,3666,12900,190,780,3132,11009,3322,11789
211190,201904,3010,9067,2605,8438,45,244,2248,7201,2293,7445
211195,201904,1326,3883,1143,3603,54,144,963,3107,1017,3251
211200,201904,2078,6162,1697,5655,192,660,1183,4017,1375,4677
211210,201904,6395,19658,5822,18899,266,1007,5024,16262,5290,17269
211220,201904,34919,91270,29110,84074,2822,7924,21430,63440,24252,71364
211223,201904,4836,13429,4241,12583,452,1310,3127,9383,3579,10693
211227,201904,1733,5873,1582,5649,41,209,1386,4997,1427,5206
211230,201904,7025,21486,6301,20347,393,1189,5082,16608,5475,17797
211240,201904,8089,26217,7623,25602,157,859,6960,23110,7117,23969
211245,201904,6576,17093,6180,16687,77,221,6007,16220,6084,16441
211250,201904,13196,40344,12045,38938,467,2045,10236,32639,10703,34684
211260,201904,7640,25355,7021,24501,202,948,6321,22122,6523,23070
211270,201904,10182,33253,8952,31548,387,1820,7383,26052,7770,27872
211280,201904,12737,36158,11419,34491,954,2363,9153,28858,10107,31221
211285,201904,1690,5842,1495,5539,185,735,947,3591,1132,4326
211290,201904,7178,22408,6654,21659,174,802,5742,18536,5916,19338
211300,201904,7895,22640,7159,21649,150,515,6526,19687,6676,20202
211400,201904,11062,32778,9178,30098,1256,4151,5951,20495,7207,24646
220005,201904,1795,4871,1638,4637,40,159,1355,3758,1395,3917
220010,201904,1468,4198,1230,3774,34,142,956,2889,990,3031
220020,201904,3353,9854,2965,9243,223,783,2315,7113,2538,7896
220025,201904,2169,5019,1856,4536,23,70,1568,3724,1591,3794
220027,201904,1230,3200,1064,2980,28,96,878,2405,906,2501
220030,201904,3251,8477,3087,8243,93,272,2712,7129,2805,7401
220040,201904,6792,20929,6086,19589,1236,3728,3600,11986,4836,15714
220045,201904,1443,4495,1211,4088,36,186,977,3232,1013,3418
220050,201904,4508,12744,3855,11806,93,441,3467,10462,3560,10903
220060,201904,2363,5057,1995,4630,23,57,1864,4307,1887,4364
220070,201904,2462,6349,2117,5846,76,167,1747,4833,1823,5000
220080,201904,690,1968,595,1826,29,121,510,1527,539,1648
220090,201904,1762,4328,1462,3912,20,78,1233,3378,1253,3456
220095,201904,628,1637,596,1601,15,27,545,1468,560,1495
220100,201904,1358,3823,1105,3402,49,189,873,2604,922,2793
220105,201904,1993,6299,1741,5768,144,473,1309,4366,1453,4839
220110,201904,3374,9407,3160,9010,48,230,2812,7896,2860,8126
220115,201904,2634,7937,2442,7647,66,283,2201,6767,2267,7050
220117,201904,1338,3279,1037,2851,15,60,882,2378,897,2438
220120,201904,12046,33818,11097,32626,101,401,10398,30532,10499,30933
220130,201904,1080,3017,905,2770,12,85,810,2424,822,2509
220140,201904,1963,4273,1695,3946,137,367,1442,3291,1579,3658
220150,201904,6356,19082,5934,18397,135,665,5035,15272,5170,15937
220155,201904,1092,3216,869,2796,27,104,617,1949,644,2053
220157,201904,1025,2555,868,2308,16,73,700,1792,716,1865
220160,201904,2701,7730,2339,7070,44,228,1935,5700,1979,5928
220170,201904,1462,3937,1244,3610,12,64,1098,3144,1110,3208
220173,201904,1993,5702,1641,5054,37,165,1314,3961,1351,4126
220177,201904,1925,5565,1849,5474,15,52,1809,5359,1824,5411
220180,201904,1102,2812,892,2437,5,27,666,1706,671,1733
220190,201904,6178,16541,5241,15219,396,1296,3912,11287,4308,12583
220191,201904,1393,4429,1281,4227,80,310,936,3021,1016,3331
220192,201904,1826,4976,1433,4276,27,101,1159,3385,1186,3486
220194,201904,1667,4841,1491,4551,67,280,1232,3666,1299,3946
220196,201904,1897,5156,1723,4873,31,148,1462,4026,1493,4174
220198,201904,1278,3525,1062,3246,9,28,981,3028,990,3056
220200,201904,4783,14328,4287,13666,204,760,3545,11294,3749,12054
220202,201904,2176,6165,1864,5635,28,150,1581,4687,1609,4837
220205,201904,2503,7130,2249,6709,52,230,1902,5546,1954,5776
220207,201904,764,2326,641,2104,56,207,417,1369,473,1576
220208,201904,1654,5214,1350,4611,222,813,705,2355,927,3168
220209,201904,1561,4527,1361,4177,25,127,1102,3333,1127,3460
220210,201904,1564,4074,1369,3752,16,72,1133,3022,1149,3094
220211,201904,1548,4058,1431,3896,17,65,1261,3452,1278,3517
220213,201904,1734,4712,1503,4279,29,109,1206,3325,1235,3434
220217,201904,2039,6233,1930,6114,33,117,1804,5765,1837,5882
220220,201904,10083,26938,8426,24316,531,1410,5960,17679,6491,19089
220225,201904,1062,2808,864,2553,8,38,783,2288,791,2326
220230,201904,5720,14264,4942,13190,196,506,4223,11279,4419,11785
220240,201904,2844,8459,2621,8027,97,332,2134,6519,2231,6851
220245,201904,1613,4002,1294,3596,10,52,1176,3296,1186,3348
220250,201904,2878,8217,2519,7749,21,120,2311,7067,2332,7187
220253,201904,1617,4455,1392,4058,82,270,1146,3239,1228,3509
220255,201904,1796,4483,1539,4094,42,191,1261,3198,1303,3389
220260,201904,4151,13040,3666,12196,165,627,2926,9692,3091,10319
220265,201904,1171,3915,1086,3778,54,227,887,3040,941,3267
220270,201904,6323,20050,5936,19330,251,1151,4944,15550,5195,16701
220271,201904,1439,3740,1253,3480,30,108,1105,3057,1135,3165
220272,201904,1706,4922,1519,4576,66,212,1134,3318,1200,3530
220273,201904,1210,3474,1002,3088,40,159,762,2288,802,2447
220275,201904,2205,5401,1741,4757,33,115,1514,4135,1547,4250
220277,201904,2098,5434,1827,5013,37,129,1547,4149,1584,4278
220280,201904,1576,3842,1306,3467,26,89,1119,2901,1145,2990
220285,201904,1429,3729,1207,3448,15,75,1077,3035,1092,3110
220290,201904,5930,17612,4793,16001,361,1348,3510,11882,3871,13230
220300,201904,1951,5822,1609,5354,42,249,1326,4330,1368,4579
220310,201904,2956,8149,2334,7431,51,250,1937,6103,1988,6353
220320,201904,2996,8963,2322,7656,109,489,1753,5595,1862,6084
220323,201904,1602,4895,1287,4364,61,260,1056,3509,1117,3769
220325,201904,1268,3745,1086,3433,29,125,897,2780,926,2905
220327,201904,1444,4238,1284,3966,44,199,1046,3156,1090,3355
220330,201904,4206,10399,3485,9492,90,281,3042,8180,3132,8461
220335,201904,1731,5208,1546,4983,24,88,1399,4506,1423,4594
220340,201904,1813,4820,1424,4170,44,146,997,2804,1041,2950
220342,201904,1161,3462,1029,3256,49,231,800,2477,849,2708
220345,201904,3070,7046,2444,6138,17,47,2228,5579,2245,5626
220350,201904,3246,8482,2617,7510,130,404,1915,5466,2045,5870
220360,201904,1220,3141,970,2743,21,68,783,2197,804,2265
220370,201904,8701,25102,7923,23924,181,769,6945,20713,7126,21482
220375,201904,1535,4494,1379,4297,8,36,1311,4103,1319,4139
220380,201904,1498,3635,1235,3254,22,55,1064,2764,1086,2819
220385,201904,823,2005,657,1708,10,35,562,1437,572,1472
220390,201904,8309,23493,6795,20958,1778,5361,2908,9618,4686,14979
220400,201904,1479,3607,1121,3061,24,85,853,2262,877,2347
220410,201904,1127,3130,923,2792,48,145,741,2204,789,2349
220415,201904,806,2123,677,1913,16,50,527,1466,543,1516
220420,201904,1959,5462,1598,4783,53,165,1235,3636,1288,3801
220430,201904,2481,6755,2359,6575,84,274,2050,5619,2134,5893
220435,201904,1673,4470,1463,4150,54,180,1172,3245,1226,3425
220440,201904,2348,7539,2051,7052,100,422,1686,5720,1786,6142
220450,201904,2347,6321,1938,5798,120,429,1560,4655,1680,5084
220455,201904,1294,4004,1228,3916,23,113,1092,3471,1115,3584
220460,201904,922,2325,859,2251,24,81,747,1919,771,2000
220465,201904,2308,7259,2044,6840,162,573,1520,5160,1682,5733
220470,201904,3382,9617,3034,9047,76,249,2460,7221,2536,7470
220480,201904,2513,6680,2007,5837,157,406,1418,4084,1575,4490
220490,201904,2353,6176,2119,5866,39,175,1876,5118,1915,5293
220500,201904,2537,6799,2321,6456,43,171,1935,5200,1978,5371
220510,201904,2475,7123,1987,6255,85,251,1557,4903,1642,5154
220515,201904,1619,3955,1483,3766,32,71,1297,3277,1329,3348
220520,201904,4876,12746,4381,12035,99,305,3840,10467,3939,10772
220525,201904,1275,3324,1140,3144,19,85,1026,2777,1045,2862
220527,201904,1309,3678,1134,3407,17,57,967,2951,984,3008
220530,201904,1343,3474,1169,3245,26,100,1079,2944,1105,3044
220535,201904,793,2237,735,2163,40,157,596,1720,636,1877
220540,201904,3248,10380,3058,10025,106,415,2618,8508,2724,8923
220545,201904,1341,4217,1248,4058,77,314,1032,3289,1109,3603
220550,201904,8524,26369,7663,24924,555,1999,5763,18524,6318,20523
220551,201904,1408,4110,1234,3803,35,140,986,2984,1021,3124
220552,201904,1581,4621,1289,4076,41,194,1015,3099,1056,3293
220553,201904,1543,4256,1364,4005,53,126,1091,3299,1144,3425
220554,201904,856,2290,623,1894,43,106,415,1250,458,1356
220555,201904,2069,6543,1928,6307,51,241,1556,5208,1607,5449
220556,201904,1200,3556,1036,3216,54,223,738,2180,792,2403
220557,201904,1585,4839,1342,4357,69,269,974,3062,1043,3331
220558,201904,1392,3658,1084,3220,22,100,914,2686,936,2786
220559,201904,1586,4132,1340,3743,5,29,1084,3066,1089,3095
220560,201904,1747,3997,1404,3546,32,69,1259,3181,1291,3250
220570,201904,7038,21412,6433,20541,432,1445,5119,16304,5551,17749
220580,201904,6804,19112,6287,18258,112,419,5646,16217,5758,16636
220585,201904,1881,6147,1658,5726,49,187,1355,4695,1404,4882
220590,201904,1279,3567,1062,3232,94,284,746,2275,840,2559
220595,201904,2450,6774,2235,6478,19,92,2012,5769,2031,5861
220600,201904,1383,3116,1159,2832,109,165,945,2386,1054,2551
220605,201904,1639,4777,1391,4344,22,121,1103,3344,1125,3465
220610,201904,2768,8553,2595,8310,32,139,2401,7691,2433,7830
220620,201904,7817,24530,7239,23746,209,1053,6517,21100,6726,22153
220630,201904,355,1072,278,934,24,81,173,593,197,674
220635,201904,1609,5156,1429,4758,57,238,1084,3536,1141,3774
220640,201904,2550,7045,2189,6511,90,352,1766,5178,1856,5530
220650,201904,2005,5620,1734,5185,37,143,1374,4092,1411,4235
220660,201904,2590,8200,2267,7645,93,459,1842,6044,1935,6503
220665,201904,1261,3879,1082,3584,32,170,882,2857,914,3027
220667,201904,1595,5055,1423,4729,72,282,1129,3725,1201,4007
220669,201904,1647,5099,1584,4991,75,348,1351,4141,1426,4489
220670,201904,2177,5769,1748,5167,32,108,1494,4405,1526,4513
220672,201904,3108,7698,2516,6982,136,388,2173,5996,2309,6384
220675,201904,1202,3315,1100,3128,42,131,889,2506,931,2637
220680,201904,2634,7319,2511,7139,99,246,2273,6482,2372,6728
220690,201904,1445,3910,1289,3675,94,241,998,2873,1092,3114
220695,201904,846,2407,793,2304,18,66,684,1974,702,2040
220700,201904,9321,23592,7413,20887,355,1074,5666,15800,6021,16874
220710,201904,875,2464,664,2059,28,99,493,1493,521,1592
220720,201904,2095,5013,1881,4714,20,78,1606,3963,1626,4041
220730,201904,1245,3558,1071,3277,20,104,909,2709,929,2813
220735,201904,953,2264,732,1907,21,69,609,1525,630,1594
220740,201904,1357,3727,1094,3380,36,109,919,2867,955,2976
220750,201904,3703,9719,3284,9114,222,516,2820,7895,3042,8411
220755,201904,1206,3064,1007,2748,31,114,796,2083,827,2197
220760,201904,2971,8626,2623,8139,110,354,2255,7101,2365,7455
220770,201904,20738,64062,17717,58719,5881,20200,6278,21585,12159,41785
220775,201904,1096,2900,1021,2806,13,54,983,2686,996,2740
220777,201904,1649,4208,1250,3568,32,80,932,2644,964,2724
220779,201904,1320,3267,1163,3046,27,81,1009,2621,1036,2702
220780,201904,5444,14053,4776,12981,189,626,3944,10422,4133,11048
220785,201904,1453,3235,1291,3015,8,13,1244,2901,1252,2914
220790,201904,9866,28636,8949,27301,269,1283,7515,22509,7784,23792
220793,201904,865,2328,708,2051,17,42,571,1671,588,1713
220795,201904,1361,3612,1225,3440,27,108,1063,2953,1090,3061
220800,201904,16655,39412,14034,35679,722,1855,10490,26393,11212,28248
220810,201904,2924,8302,2505,7539,51,193,2075,6129,2126,6322
220820,201904,5049,13139,4334,12143,387,942,3194,9017,3581,9959
220830,201904,7096,19176,6410,18187,252,840,5379,15077,5631,15917
220840,201904,11878,36838,10065,33074,2405,7515,4767,16342,7172,23857
220850,201904,3102,9655,2767,9230,68,355,2410,7989,2478,8344
220855,201904,620,1662,546,1540,11,50,479,1327,490,1377
220860,201904,1005,2521,864,2293,19,76,771,2016,790,2092
220865,201904,2514,6684,1957,5723,66,239,1502,4279,1568,4518
220870,201904,2844,8189,2371,7545,35,175,2154,6812,2189,6987
220880,201904,5164,12438,4516,11639,83,289,4148,10561,4231,10850
220885,201904,1341,4247,1119,3871,52,240,896,3101,948,3341
220887,201904,1484,3299,1236,2975,8,26,1150,2736,1158,2762
220890,201904,1420,4483,1226,4146,67,248,979,3311,1046,3559
220900,201904,1982,4835,1668,4408,35,84,1444,3779,1479,3863
220910,201904,1466,4130,1248,3801,41,144,1047,3173,1088,3317
220915,201904,942,2567,752,2191,8,32,585,1654,593,1686
220920,201904,1333,4444,1157,4196,72,314,928,3358,1000,3672
220930,201904,1607,4522,1405,4207,27,102,1279,3787,1306,3889
220935,201904,1054,3036,852,2615,26,99,572,1666,598,1765
220937,201904,1340,3647,1167,3375,21,87,954,2700,975,2787
220940,201904,1456,4196,1170,3654,40,157,878,2682,918,2839
220945,201904,426,1480,373,1366,20,112,276,977,296,1089
220950,201904,1403,3285,911,2498,14,48,710,1884,724,1932
220955,201904,1555,4067,1331,3677,38,116,1105,3024,1143,3140
220960,201904,825,2100,628,1781,10,44,473,1284,483,1328
220965,201904,1756,4852,1533,4526,21,131,1318,3796,1339,3927
220970,201904,1839,4628,1377,3906,39,113,1119,3137,1158,3250
220975,201904,689,2093,604,1991,23,147,528,1653,551,1800
220980,201904,1137,3259,1013,3086,33,150,849,2540,882,2690
220985,201904,1176,3229,1050,3047,40,155,833,2306,873,2461
220987,201904,1466,4386,1265,4032,54,238,1019,3182,1073,3420
220990,201904,1691,4722,1478,4398,26,142,1220,3545,1246,3687
220995,201904,1119,3375,894,2970,49,192,643,2120,692,2312
220997,201904,2408,7107,2217,6823,46,221,1993,6046,2039,6267
221000,201904,4118,11638,3781,11156,90,452,3245,9384,3335,9836
221005,201904,1437,3871,1316,3666,39,169,1123,2999,1162,3168
221010,201904,1170,2796,954,2517,32,86,819,2113,851,2199
221020,201904,1509,4649,1394,4425,25,107,1049,3288,1074,3395
221030,201904,1578,4100,1360,3816,30,112,1185,3318,1215,3430
221035,201904,1425,3761,1242,3508,23,41,1087,3159,1110,3200
221037,201904,622,1794,522,1616,9,53,351,1032,360,1085
221038,201904,504,1453,408,1267,17,61,281,863,298,924
221039,201904,859,2358,751,2171,19,81,613,1696,632,1777
221040,201904,3975,12062,3516,11234,161,592,2784,8863,2945,9455
221050,201904,3752,10065,3333,9515,53,216,3020,8543,3073,8759
221060,201904,8295,23155,6858,20924,230,691,5537,16962,5767,17653
221062,201904,1153,3801,981,3489,44,218,788,2756,832,2974
221063,201904,1064,3054,901,2818,64,232,660,2006,724,2238
221065,201904,2585,6748,2274,6195,23,104,1993,5319,2016,5423
221070,201904,3248,10346,2746,9312,301,1026,1740,6001,2041,7027
221080,201904,3459,8507,2815,7550,50,199,2326,6138,2376,6337
221090,201904,1384,3655,1131,3213,13,52,965,2667,978,2719
221093,201904,1318,3757,1218,3539,120,351,841,2405,961,2756
221095,201904,885,2328,740,2103,7,20,609,1705,616,1725
221097,201904,812,2147,624,1803,20,69,461,1267,481,1336
221100,201904,103232,281634,88343,257160,11587,35466,56304,160226,67891,195692
221110,201904,9736,29323,8985,28355,186,986,8010,24884,8196,25870
221120,201904,4532,12909,4091,12164,186,621,3478,10249,3664,10870
221130,201904,4952,13217,3694,10716,817,2284,1727,5044,2544,7328
221135,201904,1568,4302,1410,4085,41,154,1241,3566,1282,3720
221140,201904,1285,3118,1096,2859,10,42,965,2453,975,2495
221150,201904,1082,2690,853,2290,24,108,662,1659,686,1767
221160,201904,757,1902,665,1777,19,35,541,1449,560,1484
221170,201904,968,2846,894,2719,22,71,762,2310,784,2381
230010,201904,3144,8347,2524,7256,80,286,1942,5422,2022,5708
230015,201904,2914,9631,2611,9030,202,831,1816,6196,2018,7027
230020,201904,12911,41035,12206,39900,396,1692,10261,33126,10657,34818
230030,201904,12462,32104,10745,29751,196,633,9450,26082,9646,26715
230040,201904,4416,11585,3705,10405,78,338,3049,8414,3127,8752
230050,201904,2769,8750,2040,6971,350,1158,847,2828,1197,3986
230060,201904,2292,6315,1851,5483,40,187,1485,4285,1525,4472
230070,201904,3791,10450,3122,9102,156,512,2147,6191,2303,6703
230075,201904,9019,29368,8313,28117,359,1850,6780,22328,7139,24178
230080,201904,2951,6266,2263,5405,10,40,2035,4854,2045,4894
230090,201904,4110,10481,3530,9524,151,446,2777,7422,2928,7868
230100,201904,17288,46448,15451,43837,1362,4038,10730,30503,12092,34541
230110,201904,12039,36352,10403,33057,1688,5333,5714,18225,7402,23558
230120,201904,7204,19942,6373,18533,538,1427,4649,13717,5187,15144
230125,201904,3074,8296,2527,7391,80,299,1929,5567,2009,5866
230130,201904,5591,17583,4590,15352,349,1307,3016,9885,3365,11192
230140,201904,3364,10266,2886,9269,114,490,2177,6783,2291,7273
230150,201904,1576,4757,1329,4205,210,582,765,2513,975,3095
230160,201904,6398,16995,5546,15656,144,564,4619,12762,4763,13326
230170,201904,5928,17266,5022,15435,297,945,3649,10991,3946,11936
230180,201904,1623,4552,1382,4071,26,116,1095,3118,1121,3234
230185,201904,4156,12241,3564,11239,272,954,2612,8228,2884,9182
230190,201904,12744,37849,10933,34410,1653,5328,5975,18797,7628,24125
230195,201904,5033,15076,4589,14230,309,1020,3538,10872,3847,11892
230200,201904,4944,13720,4227,12319,144,485,3245,9239,3389,9724
230205,201904,3869,12031,3491,11402,145,632,2684,8575,2829,9207
230210,201904,10096,24981,8603,22863,400,1290,6644,17337,7044,18627
230220,201904,13221,34191,11827,32109,517,1496,9842,26393,10359,27889
230230,201904,6800,20757,6118,19327,410,1327,4471,14017,4881,15344
230240,201904,12320,33457,10970,31258,314,1152,9095,25514,9409,26666
230250,201904,8824,25557,8483,25007,275,1023,6679,19120,6954,20143
230260,201904,14176,43675,12508,40614,1571,5215,7321,24073,8892,29288
230270,201904,7342,20256,5732,17218,500,1480,3800,11449,4300,12929
230280,201904,20188,54629,16581,48501,559,2326,13010,36676,13569,39002
230290,201904,4714,13314,4003,11916,334,889,2965,8877,3299,9766
230300,201904,4592,12662,4247,12169,72,289,3739,10546,3811,10835
230310,201904,4616,13255,3935,12067,136,599,2818,8395,2954,8994
230320,201904,7578,22055,6557,20113,301,1176,5015,15051,5316,16227
230330,201904,4608,12766,3776,11159,172,561,2779,8048,2951,8609
230340,201904,3539,11268,3030,10209,295,1006,1994,6690,2289,7696
230350,201904,17751,50054,15777,46837,1012,3486,10204,30494,11216,33980
230360,201904,2768,7717,2240,6723,144,458,1501,4459,1645,4917
230365,201904,3024,7585,2535,6823,48,243,2136,5643,2184,5886
230370,201904,53726,155374,46164,143606,7988,25112,25430,81142,33418,106254
230380,201904,6373,17859,5061,15390,156,587,3696,11037,3852,11624
230390,201904,3233,9759,2845,9123,114,473,2181,6927,2295,7400
230393,201904,3021,9271,2491,8196,98,546,1916,6021,2014,6567
230395,201904,5713,15646,4983,14390,386,1076,3411,9881,3797,10957
230400,201904,5660,15903,5038,14873,142,698,3924,11181,4066,11879
230410,201904,14140,42523,11647,37726,1076,3750,7667,24772,8743,28522
230420,201904,26922,76467,22453,68222,2803,8831,12742,38482,15545,47313
230423,201904,4730,14137,4122,12880,98,450,3303,10093,3401,10543
230425,201904,5453,17079,4974,16073,429,1454,3520,11313,3949,12767
230426,201904,2615,7041,1948,5710,38,153,1471,4207,1509,4360
230427,201904,1851,5266,1306,4052,70,236,877,2631,947,2867
230428,201904,9395,25919,8259,24135,1130,3349,4929,14294,6059,17643
230430,201904,4662,13433,3790,11942,160,614,2852,8792,3012,9406
230435,201904,5487,14962,4705,13615,550,1599,3003,8658,3553,10257
230440,201904,389372,996667,326379,900926,40444,117810,197605,540313,238049,658123
230445,201904,4228,11333,3474,10009,193,551,2398,6759,2591,7310
230450,201904,3582,10514,3115,9777,244,962,2255,6883,2499,7845
230460,201904,2080,5911,1834,5511,80,299,1500,4479,1580,4778
230465,201904,3922,11177,3370,10145,99,443,2481,7144,2580,7587
230470,201904,11017,37003,9975,35018,838,3602,7253,24981,8091,28583
230480,201904,1395,4099,1187,3720,97,380,845,2539,942,2919
230490,201904,2403,6841,2052,6169,185,624,1286,3653,1471,4277
230495,201904,5751,17355,5077,16084,381,1517,3329,10342,3710,11859
230500,201904,8923,29478,8207,28101,319,1315,6589,22464,6908,23779
230510,201904,1622,5087,1208,4122,208,754,542,1835,750,2589
230520,201904,4415,12794,3883,11805,301,944,2750,8292,3051,9236
230523,201904,14240,42857,11747,37433,2756,8726,3153,10620,5909,19346
230526,201904,3839,11062,3248,9995,153,550,2401,7294,2554,7844
230530,201904,5246,16476,4472,14983,353,1290,3162,10532,3515,11822
230533,201904,4116,10476,3534,9470,93,264,2897,7677,2990,7941
230535,201904,5205,14670,4444,13355,221,685,3167,9594,3388,10279
230540,201904,15776,43826,13864,40929,257,1104,11619,33829,11876,34933
230550,201904,19833,54139,16270,47886,1648,5047,10062,29433,11710,34480
230560,201904,7742,19611,6402,17377,73,294,5403,14521,5476,14815
230565,201904,3003,8450,2524,7557,81,352,1911,5614,1992,5966
230570,201904,3474,8867,3007,8253,66,205,2557,6976,2623,7181
230580,201904,10248,27563,8975,25739,329,1070,7502,21322,7831,22392
230590,201904,8769,25529,7307,22775,465,1677,5231,15761,5696,17438
230600,201904,3636,9611,2793,8028,88,279,1884,5457,1972,5736
230610,201904,6508,18249,5779,17065,473,1361,4445,13117,4918,14478
230620,201904,2057,5657,1573,4685,134,445,948,2732,1082,3177
230625,201904,7666,22369,6544,20255,2022,6467,1737,5745,3759,12212
230630,201904,10352,31513,9060,28777,1889,5660,4534,15074,6423,20734
230640,201904,27412,83931,24804,79625,1507,5896,19276,60958,20783,66854
230650,201904,5051,14041,4281,12632,160,674,3379,9682,3539,10356
230655,201904,9182,31888,8743,31076,691,2677,6820,24343,7511,27020
230660,201904,6077,18180,4966,16154,174,911,4005,12717,4179,13628
230670,201904,6022,14688,4467,12113,149,459,3525,9350,3674,9809
230680,201904,2531,7147,2184,6520,154,479,1532,4565,1686,5044
230690,201904,6797,20493,5986,18846,432,1531,3755,11545,4187,13076
230700,201904,9453,24812,8028,22188,338,1048,6038,16238,6376,17286
230710,201904,6693,21234,5820,19377,555,1999,4053,13222,4608,15221
230720,201904,1939,5760,1582,5010,122,374,1044,3231,1166,3605
230725,201904,3788,11733,3364,10889,458,1628,1730,5491,2188,7119
230730,201904,53723,149769,43640,133571,10283,33866,14637,47133,24920,80999
230740,201904,5970,16971,5166,15623,133,555,4130,12365,4263,12920
230750,201904,8274,22538,6966,20335,187,729,5438,15404,5625,16133
230760,201904,10867,29537,9651,27600,625,2090,7136,19885,7761,21975
230763,201904,4422,12611,3801,11432,136,574,3017,8792,3153,9366
230765,201904,40156,112451,33805,101738,5986,18724,15325,46096,21311,64820
230770,201904,24807,63421,21081,58290,2448,7041,13547,37444,15995,44485
230780,201904,5954,21388,5579,20572,827,3085,3314,12508,4141,15593
230790,201904,2909,8560,2593,8021,121,523,1931,5785,2052,6308
230800,201904,7686,25056,6902,23411,788,2978,4170,13844,4958,16822
230810,201904,11618,35173,10371,33080,436,1663,7941,24793,8377,26456
230820,201904,3236,10714,2730,9540,273,1138,1662,5540,1935,6678
230830,201904,7563,20917,6453,18950,156,672,5249,15007,5405,15679
230835,201904,4098,9966,3186,8524,81,264,2566,6735,2647,6999
230837,201904,3053,9576,2643,8811,110,540,2082,6735,2192,7275
230840,201904,8793,26344,7683,24504,595,1988,5668,18135,6263,20123
230850,201904,9246,27409,7956,24824,418,1519,5670,17466,6088,18985
230860,201904,5030,13258,4262,12105,88,327,3668,10311,3756,10638
230870,201904,16155,40330,14046,36846,429,1228,11366,29490,11795,30718
230880,201904,2068,6375,1881,6045,54,293,1467,4580,1521,4873
230890,201904,4368,14315,4058,13705,339,1289,2964,9829,3303,11118
230900,201904,2955,8765,2552,7958,213,754,1685,5106,1898,5860
230910,201904,2877,8029,2390,7191,74,367,1908,5622,1982,5989
230920,201904,4429,12820,3787,11753,163,653,2855,8649,3018,9302
230930,201904,6366,18247,5374,16346,354,1114,3718,11268,4072,12382
230940,201904,7591,20084,6690,18685,193,552,5645,15624,5838,16176
230945,201904,6473,18853,5584,17063,366,1282,3859,11692,4225,12974
230950,201904,6144,15689,5570,14954,133,323,4933,13398,5066,13721
230960,201904,12766,37939,11478,35499,1797,5650,5894,18435,7691,24085
230970,201904,12918,35461,10990,32421,1957,5867,5705,16996,7662,22863
230980,201904,2688,8001,2349,7362,435,1311,1372,4429,1807,5740
230990,201904,1668,4788,1402,4241,75,312,947,2718,1022,3030
231000,201904,2423,6558,2028,5784,77,219,1454,4045,1531,4264
231010,201904,3313,8027,2678,6922,73,245,2249,5622,2322,5867
231020,201904,7800,25185,7031,23575,1245,3923,4093,14212,5338,18135
231025,201904,7266,20720,6402,19290,815,2434,4313,13087,5128,15521
231030,201904,7006,21330,5613,18330,935,3016,2957,9687,3892,12703
231040,201904,2987,8822,2601,8086,99,369,2022,6147,2121,6516
231050,201904,11695,30707,9500,26729,656,1822,6943,19150,7599,20972
231060,201904,2680,7783,2389,7291,79,293,1916,5805,1995,6098
231070,201904,7937,23499,6729,21309,871,2809,4019,12664,4890,15473
231080,201904,3922,11410,3435,10593,145,667,2590,7763,2735,8430
231085,201904,6265,15951,5097,14506,226,653,3905,11136,4131,11789
231090,201904,4306,11448,3243,9333,104,404,2259,6289,2363,6693
231095,201904,2136,6540,1732,5628,137,470,1180,3828,1317,4298
231100,201904,2909,8653,2456,7794,122,446,1864,5841,1986,6287
231110,201904,3454,10517,3209,10039,134,528,2399,7377,2533,7905
231120,201904,2140,6431,1824,5877,90,341,1249,3967,1339,4308
231123,201904,1896,5020,1586,4475,79,212,1144,3195,1223,3407
231126,201904,5524,15522,4456,13417,230,726,3220,9519,3450,10245
231130,201904,20055,53509,16881,49327,1176,4308,12080,34544,13256,38852
231135,201904,4126,11684,3464,10431,154,556,2490,7335,2644,7891
231140,201904,16314,46966,13293,41519,715,3041,9172,27743,9887,30784
231150,201904,5390,15335,4315,13119,768,2344,1928,5984,2696,8328
231160,201904,5832,18106,5242,16966,997,3051,2877,9608,3874,12659
231170,201904,4351,13015,3579,11451,213,802,2419,7479,2632,8281
231180,201904,13779,40049,11516,35093,2995,9004,4245,13157,7240,22161
231190,201904,3764,10823,3220,9788,108,466,2507,7402,2615,7868
231195,201904,4649,14511,3941,12995,217,869,2907,9367,3124,10236
231200,201904,7757,24726,6786,22664,257,1312,5169,16710,5426,18022
231210,201904,4711,14156,4056,13002,190,740,3042,9510,3232,10250
231220,201904,11820,31663,9359,26878,487,1540,6689,18456,7176,19996
231230,201904,8917,28779,7981,27147,470,1913,5935,20166,6405,22079
231240,201904,11353,33933,10037,31331,1619,5053,5753,18103,7372,23156
231250,201904,2049,5379,1329,3745,105,289,787,2173,892,2462
231260,201904,3179,9228,2787,8596,288,870,1850,5845,2138,6715
231270,201904,6334,16759,5262,14985,139,558,3976,11022,4115,11580
231280,201904,1639,5239,1539,5043,114,386,1134,3689,1248,4075
231290,201904,36698,111698,31333,100599,5504,17826,14403,46018,19907,63844
231300,201904,3952,11146,3133,9455,258,810,2000,5938,2258,6748
231310,201904,7108,18943,5766,16378,518,1457,3850,10772,4368,12229
231320,201904,7611,21295,6035,18387,101,465,4671,14029,4772,14494
231325,201904,2459,6710,2030,6008,211,564,1309,3958,1520,4522
231330,201904,9478,29071,7946,25986,1490,4727,4181,14115,5671,18842
231335,201904,5635,14958,4754,13499,83,393,4137,11534,4220,11927
231340,201904,17369,54648,15587,51487,1300,4421,11238,37475,12538,41896
231350,201904,15510,42606,14097,40614,352,1210,12548,35798,12900,37008
231355,201904,4355,13238,3909,12427,209,769,3015,9496,3224,10265
231360,201904,7287,22457,6372,20804,385,1396,4827,15711,5212,17107
231370,201904,2214,6066,1773,5262,38,130,1364,4005,1402,4135
231375,201904,4347,13736,3969,13080,149,691,3247,10542,3396,11233
231380,201904,5818,15970,5352,15363,207,571,4364,12719,4571,13290
231390,201904,3326,9823,3001,9282,157,595,2179,6527,2336,7122
231395,201904,3939,11852,3311,10822,537,1723,1819,6079,2356,7802
231400,201904,9122,26736,7906,24445,324,1311,6020,18240,6344,19551
231410,201904,14470,45703,13092,43398,744,2843,10252,33492,10996,36335
240010,201904,2467,6733,1916,5691,210,663,1144,3307,1354,3970
240020,201904,11486,33259,9938,30500,768,2850,6518,19631,7286,22481
240030,201904,2686,6902,2478,6583,100,288,2172,5703,2272,5991
240040,201904,814,2341,674,2089,16,73,503,1511,519,1584
240050,201904,3102,8394,2594,7466,49,144,2048,5800,2097,5944
240060,201904,1362,3707,1156,3331,38,124,925,2623,963,2747
240070,201904,2068,6176,1936,5907,205,678,1435,4291,1640,4969
240080,201904,2777,7645,2356,6856,61,250,1814,5147,1875,5397
240090,201904,2207,5534,1799,4831,19,62,1499,3970,1518,4032
240100,201904,9317,23755,7640,20589,295,921,5925,15412,6220,16333
240110,201904,4217,12389,3677,11391,195,737,2679,8132,2874,8869
240120,201904,3494,9515,2588,8467,204,800,1729,5791,1933,6591
240130,201904,3524,7527,2985,6800,40,117,2715,6081,2755,6198
240140,201904,1881,5669,1619,5173,187,675,1063,3308,1250,3983
240145,201904,6370,18215,5297,16290,761,2395,3115,9655,3876,12050
240150,201904,863,2553,790,2406,47,167,617,1819,664,1986
240160,201904,1427,4343,1218,3926,57,265,878,2811,935,3076
240165,201904,917,2548,784,2291,53,175,601,1720,654,1895
240170,201904,2295,6472,1963,5869,210,707,1281,3697,1491,4404
240180,201904,3010,8972,2419,7782,525,1644,1169,3922,1694,5566
240185,201904,1221,3952,1107,3764,63,264,898,3013,961,3277
240190,201904,1011,3023,892,2819,28,128,729,2273,757,2401
240200,201904,10464,27686,8645,24508,997,3042,4762,13254,5759,16296
240210,201904,2918,7480,2543,6911,30,142,2149,5651,2179,5793
240220,201904,7290,22283,6548,21105,414,1841,5004,15733,5418,17574
240230,201904,5721,14772,4668,12965,233,664,3676,10154,3909,10818
240240,201904,1923,5872,1219,4107,123,410,476,1572,599,1982
240250,201904,2792,7606,2517,7190,141,353,2050,5914,2191,6267
240260,201904,13353,40205,11657,37226,1664,5135,7191,24000,8855,29135
240270,201904,2208,6605,1956,6209,110,334,1489,4824,1599,5158
240280,201904,1651,4283,1410,3899,49,151,1132,3075,1181,3226
240290,201904,1191,3509,984,3050,33,148,677,1956,710,2104
240300,201904,2138,5578,1549,4437,77,235,991,2753,1068,2988
240310,201904,8529,22997,6874,20032,880,2657,3678,10602,4558,13259
240320,201904,2030,5554,1486,4474,28,135,1124,3238,1152,3373
240325,201904,29056,80291,22807,69086,4982,15760,8371,25991,13353,41751
240330,201904,1661,4576,1306,3888,44,158,916,2613,960,2771
240340,201904,1901,4533,1563,3995,49,126,1270,3165,1319,3291
240350,201904,2019,5392,1887,5237,25,114,1688,4676,1713,4790
240360,201904,7906,22667,7112,21408,962,2869,4606,14277,5568,17146
240370,201904,1913,5162,1505,4313,75,211,1023,2869,1098,3080
240375,201904,887,2280,746,2003,28,111,597,1521,625,1632
240380,201904,2229,6370,1643,5054,156,468,973,2947,1129,3415
240390,201904,968,2457,674,1863,26,73,434,1125,460,1198
240400,201904,1362,3455,1077,2935,35,131,746,1914,781,2045
240410,201904,552,1743,465,1548,55,236,281,883,336,1119
240420,201904,4556,16373,4028,15159,530,2389,2225,8177,2755,10566
240430,201904,3290,8904,2791,7927,222,705,1990,5456,2212,6161
240440,201904,2515,5685,2123,5124,128,296,1693,4034,1821,4330
240450,201904,4196,11816,3417,10380,325,1152,2069,6036,2394,7188
240460,201904,2871,8333,2637,7955,265,864,2049,6143,2314,7007
240470,201904,3503,10709,2742,9124,385,1291,1510,5046,1895,6337
240480,201904,541,1516,382,1172,30,103,169,500,199,603
240485,201904,2049,5958,1695,5258,159,499,1120,3477,1279,3976
240490,201904,1707,4329,1351,3683,63,159,1071,2924,1134,3083
240500,201904,2101,5698,1858,5336,53,178,1581,4492,1634,4670
240510,201904,1640,4392,1472,4154,77,259,1221,3355,1298,3614
240520,201904,1293,3344,1060,3017,44,163,844,2357,888,2520
240530,201904,1980,6029,1830,5765,111,383,1449,4526,1560,4909
240540,201904,2212,5598,1933,5166,82,198,1645,4378,1727,4576
240550,201904,668,1895,614,1797,26,102,480,1353,506,1455
240560,201904,3224,8579,2764,7950,266,699,2043,5961,2309,6660
240570,201904,2819,7464,1902,5398,264,790,814,2115,1078,2905
240580,201904,7671,22679,6951,21372,546,1698,5567,17137,6113,18835
240590,201904,685,1844,602,1700,12,48,461,1278,473,1326
240600,201904,1758,4800,1295,3824,52,181,860,2446,912,2627
240610,201904,4173,11486,3521,10267,145,511,2651,7563,2796,8074
240615,201904,1105,3060,879,2612,59,221,599,1680,658,1901
240620,201904,1808,5141,1550,4675,87,259,1238,3704,1325,3963
240630,201904,2014,5871,1822,5527,128,332,1280,4006,1408,4338
240640,201904,905,2450,725,2147,31,138,530,1523,561,1661
240650,201904,3853,10781,3408,9981,207,630,2625,7627,2832,8257
240660,201904,2890,7640,2595,7247,52,193,2363,6539,2415,6732
240670,201904,2377,6745,1966,5906,135,412,1275,3748,1410,4160
240680,201904,1592,4318,1282,3772,59,203,946,2694,1005,2897
240690,201904,927,2394,738,2068,11,48,596,1609,607,1657
240700,201904,2303,6752,1946,6103,65,267,1528,4691,1593,4958
240710,201904,15809,41657,13341,37297,2154,5837,7724,21850,9878,27687
240720,201904,5026,12991,4380,11989,518,1507,2976,7995,3494,9502
240725,201904,1077,3118,837,2614,34,120,565,1710,599,1830
240730,201904,2084,5964,1771,5343,79,259,1350,4002,1429,4261
240740,201904,1799,4882,1485,4297,57,235,1090,2981,1147,3216
240750,201904,2198,7375,1844,6603,264,1062,1009,3614,1273,4676
240760,201904,1501,3699,1090,3071,52,116,844,2420,896,2536
240770,201904,3132,8770,2672,8112,152,595,2083,6181,2235,6776
240780,201904,5098,14072,4073,12348,516,1565,2468,7644,2984,9209
240790,201904,840,2424,708,2168,16,60,526,1581,542,1641
240800,201904,43346,108889,34580,95212,4859,13970,17144,47181,22003,61151
240810,201904,80267,215766,70030,198398,11609,33196,41204,116236,52813,149432
240820,201904,5622,17145,4853,15737,743,2452,2871,9434,3614,11886
240830,201904,8536,25125,7783,23917,296,1331,6336,19052,6632,20383
240840,201904,1127,2860,893,2457,45,119,620,1645,665,1764
240850,201904,1228,3459,901,2750,44,149,523,1559,567,1708
240860,201904,1216,3342,913,2777,17,83,683,1975,700,2058
240870,201904,1118,2847,871,2420,94,302,559,1500,653,1802
240880,201904,1267,4004,1149,3777,77,310,921,2963,998,3273
240890,201904,4478,12347,3416,10286,513,1674,1691,4887,2204,6561
240895,201904,2627,8416,2388,8048,160,581,2009,6747,2169,7328
240910,201904,3126,8805,2721,8011,64,233,2217,6421,2281,6654
240920,201904,804,2332,689,2122,66,190,391,1250,457,1440
240930,201904,3639,8438,3036,7697,193,279,2349,6184,2542,6463
240933,201904,1753,4241,1436,3761,47,184,1228,3153,1275,3337
240940,201904,6019,14980,4822,12929,273,774,3456,8941,3729,9715
240950,201904,942,2870,826,2640,27,116,682,2140,709,2256
240960,201904,684,2104,611,1952,34,131,469,1456,503,1587
240970,201904,1828,4796,1501,4229,50,190,1254,3436,1304,3626
240980,201904,2959,9216,2699,8723,157,649,2101,6615,2258,7264
240990,201904,2505,7226,2282,6768,269,862,1620,4656,1889,5518
241000,201904,933,2486,752,2134,43,101,528,1510,571,1611
241010,201904,2761,8888,2543,8399,182,734,1868,6031,2050,6765
241020,201904,2037,5499,1507,4407,141,415,955,2711,1096,3126
241025,201904,1735,4998,1391,4328,64,253,960,2942,1024,3195
241030,201904,2470,7850,2035,6919,212,753,1335,4515,1547,5268
241040,201904,2231,7122,2001,6729,93,432,1610,5358,1703,5790
241050,201904,1256,3519,1030,3086,36,126,785,2297,821,2423
241060,201904,700,2023,633,1880,35,114,445,1267,480,1381
241070,201904,636,1763,562,1633,19,62,434,1209,453,1271
241080,201904,1105,3174,856,2670,11,44,631,1948,642,1992
241090,201904,2007,5860,1617,5198,57,285,1266,3998,1323,4283
241100,201904,1134,3220,897,2695,54,166,617,1796,671,1962
241105,201904,1013,3086,826,2720,265,868,259,894,524,1762
241110,201904,903,2618,682,2129,39,144,454,1353,493,1497
241120,201904,7417,21400,6366,19515,1042,3133,3560,11278,4602,14411
241140,201904,3191,8582,2591,7362,142,422,1905,5267,2047,5689
241142,201904,755,2056,555,1658,30,108,315,867,345,975
241150,201904,5725,15357,5102,14299,168,617,4167,11379,4335,11996
241160,201904,1267,3574,1065,3211,133,378,709,2129,842,2507
241170,201904,1286,3305,1118,3023,37,149,929,2383,966,2532
241180,201904,1001,2614,726,2077,73,201,423,1185,496,1386
241190,201904,1069,2859,894,2507,23,88,651,1742,674,1830
241200,201904,18220,48741,15851,45107,2673,7740,9030,25781,11703,33521
241210,201904,1348,3743,998,3031,108,359,593,1753,701,2112
241220,201904,8510,25846,7489,24061,1903,6059,3365,11322,5268,17381
241230,201904,2865,7736,2553,7230,112,391,2115,5861,2227,6252
241240,201904,1166,3329,707,2257,45,156,340,1088,385,1244
241250,201904,5143,15437,4300,13807,184,853,3187,9806,3371,10659
241255,201904,2006,6550,1768,6028,133,560,1282,4247,1415,4807
241260,201904,4778,12697,3749,10932,101,447,2915,8265,3016,8712
241270,201904,1762,5141,1464,4552,131,454,1014,3095,1145,3549
241280,201904,2099,5377,1829,4890,67,196,1535,4039,1602,4235
241290,201904,3387,8392,2584,7058,75,293,2008,5288,2083,5581
241300,201904,1429,3897,1143,3379,42,152,762,2186,804,2338
241310,201904,2010,5211,1719,4805,20,95,1445,4031,1465,4126
241320,201904,983,3208,820,2873,94,392,502,1742,596,2134
241330,201904,1758,4551,1371,4063,27,115,1165,3453,1192,3568
241335,201904,3031,8625,2726,8066,92,335,2285,6667,2377,7002
241340,201904,1616,4682,1264,3936,265,843,531,1626,796,2469
241350,201904,1942,5743,1736,5361,110,388,1312,3969,1422,4357
241355,201904,1284,3526,1070,3114,21,80,827,2370,848,2450
241360,201904,2031,5319,1565,4372,59,178,1117,2995,1176,3173
241370,201904,1339,3732,1045,3142,61,212,695,1987,756,2199
241380,201904,623,1759,494,1500,77,224,264,818,341,1042
241390,201904,2679,8120,2424,7708,187,585,1869,5978,2056,6563
241400,201904,3451,9697,3117,9201,177,584,2529,7393,2706,7977
241410,201904,2310,6958,1878,6073,359,1194,974,3145,1333,4339
241415,201904,1608,4808,1324,4244,68,270,950,2958,1018,3228
241420,201904,2136,7090,1830,6523,458,1765,793,2804,1251,4569
241430,201904,561,1617,393,1208,25,84,242,721,267,805
241440,201904,7147,22892,6445,21602,407,1636,5054,16652,5461,18288
241445,201904,1060,2750,969,2638,23,66,879,2437,902,2503
241450,201904,2651,6736,2320,6195,255,604,1702,4580,1957,5184
241460,201904,3552,9811,2995,8619,166,526,2130,5959,2296,6485
241470,201904,1394,3694,1118,3284,29,113,914,2654,943,2767
241475,201904,1184,3393,928,2903,31,165,674,2002,705,2167
241480,201904,2762,8776,2338,7879,809,2687,666,2579,1475,5266
241490,201904,662,1609,529,1418,27,74,353,923,380,997
241500,201904,805,2324,705,2192,8,32,627,1959,635,1991
250010,201904,2572,7733,2135,6812,59,242,1545,4792,1604,5034
250020,201904,1587,4335,1136,3443,55,155,814,2431,869,2586
250030,201904,6677,18624,6013,17587,471,1452,4590,13198,5061,14650
250040,201904,4012,12480,3483,11492,225,911,2482,8005,2707,8916
250050,201904,3432,9476,3149,9062,132,472,2567,7292,2699,7764
250053,201904,1147,3329,1038,3151,72,237,766,2334,838,2571
250057,201904,640,2305,604,2249,3,18,546,2067,549,2085
250060,201904,5241,14164,4799,13607,385,1023,3796,10913,4181,11936
250070,201904,3893,11145,3423,10297,56,263,2725,7971,2781,8234
250073,201904,731,1996,603,1792,6,24,498,1426,504,1450
250077,201904,2180,5975,1643,5064,72,251,1197,3660,1269,3911
250080,201904,4491,11761,3981,11074,96,367,3427,9375,3523,9742
250090,201904,3067,7757,2710,7271,61,201,2330,6125,2391,6326
250100,201904,3626,11274,3356,10763,162,643,2683,8363,2845,9006
250110,201904,4774,13528,4331,12879,338,1226,3338,9652,3676,10878
250115,201904,546,1584,467,1453,11,63,348,1047,359,1110
250120,201904,1843,5416,1539,4906,39,175,1208,3822,1247,3997
250130,201904,5413,15228,4615,14059,81,456,3817,11396,3898,11852
250135,201904,1158,3175,1037,2984,13,53,933,2678,946,2731
250140,201904,2109,6443,2002,6291,112,525,1715,5258,1827,5783
250150,201904,4738,15040,4284,14221,162,735,3430,11146,3592,11881
250153,201904,1427,3701,1192,3350,26,92,974,2690,1000,2782
250157,201904,1701,5156,1526,4804,85,319,1191,3670,1276,3989
250160,201904,3828,9748,3100,8751,33,134,2774,7798,2807,7932
250170,201904,1759,4550,1581,4291,36,132,1366,3651,1402,3783
250180,201904,18302,46354,16030,43358,853,2658,12363,32717,13216,35375
250190,201904,3975,10935,3388,10013,401,1130,2238,6596,2639,7726
250200,201904,1848,5087,1590,4682,49,173,1358,3977,1407,4150
250205,201904,806,2586,701,2408,26,134,577,1956,603,2090
250210,201904,1548,4733,1403,4488,52,268,1112,3469,1164,3737
250215,201904,1538,4381,1276,3934,71,242,781,2387,852,2629
250220,201904,666,1893,543,1700,28,116,365,1085,393,1201
250230,201904,1573,3652,1144,2995,24,76,907,2296,931,2372
250240,201904,2195,6716,1967,6313,42,185,1674,5303,1716,5488
250250,201904,4498,12605,3913,11737,91,302,3295,9867,3386,10169
250260,201904,1695,4736,1426,4277,41,129,1140,3385,1181,3514
250270,201904,1194,3645,1074,3495,75,241,798,2700,873,2941
250280,201904,3165,9099,2797,8515,102,335,2215,6715,2317,7050
250290,201904,1593,4237,1358,3910,27,76,1087,3149,1114,3225
250300,201904,5371,14667,4949,14169,199,875,4109,11331,4308,12206
250310,201904,1133,3180,965,2893,40,128,738,2180,778,2308
250320,201904,10404,25034,9179,23563,351,1029,7913,20032,8264,21061
250330,201904,2266,6540,1927,6092,126,449,1529,4769,1655,5218
250340,201904,1087,2806,958,2628,6,21,855,2320,861,2341
250350,201904,3972,11142,3597,10556,137,360,2932,8828,3069,9188
250355,201904,1943,5990,1739,5707,27,155,1569,5108,1596,5263
250360,201904,1746,4945,1582,4701,35,124,1296,3829,1331,3953
250370,201904,12162,32698,10328,29910,341,1326,8487,24082,8828,25408
250375,201904,1141,3000,943,2751,7,22,877,2583,884,2605
250380,201904,1580,4177,1455,4010,38,158,1234,3278,1272,3436
250390,201904,1738,4540,1484,4129,123,331,1108,3079,1231,3410
250400,201904,68695,170136,49639,140670,13640,40619,15387,45572,29027,86191
250403,201904,1641,4710,1498,4521,80,388,1178,3386,1258,3774
250407,201904,1207,3084,993,2772,61,144,725,2049,786,2193
250410,201904,591,1626,520,1510,3,13,433,1234,436,1247
250415,201904,1802,5181,1603,4849,40,173,1354,4048,1394,4221
250420,201904,1210,3465,1097,3312,14,64,1025,3090,1039,3154
250430,201904,6073,15238,5247,14091,156,503,4348,11456,4504,11959
250435,201904,1492,4182,1230,3726,24,107,928,2752,952,2859
250440,201904,4458,11994,3860,11253,78,277,3358,9756,3436,10033
250450,201904,1796,4890,1511,4498,33,128,1257,3722,1290,3850
250460,201904,7144,19480,6421,18442,343,1023,5250,15038,5593,16061
250470,201904,1540,3990,1280,3606,55,188,985,2698,1040,2886
250480,201904,3994,10952,3484,10342,14,66,3150,9452,3164,9518
250485,201904,721,1646,533,1383,33,68,389,976,422,1044
250490,201904,4820,12031,4342,11460,197,637,3756,9737,3953,10374
250500,201904,1922,5352,1713,5001,72,237,1402,4079,1474,4316
250510,201904,5361,13578,4659,12663,91,291,4096,11140,4187,11431
250520,201904,1756,4867,1525,4536,141,452,1067,3150,1208,3602
250523,201904,2178,5394,1958,5117,81,351,1640,4132,1721,4483
250527,201904,1640,4305,1499,4137,27,77,1320,3665,1347,3742
250530,201904,604,1629,521,1513,8,25,458,1323,466,1348
250535,201904,1325,3921,1218,3715,32,139,989,2933,1021,3072
250540,201904,2887,6788,2394,6228,68,148,2088,5502,2156,5650
250550,201904,766,2487,675,2307,20,89,523,1742,543,1831
250560,201904,1624,4575,1460,4343,47,182,1212,3507,1259,3689
250570,201904,2607,7864,2246,7205,81,335,1780,5586,1861,5921
250580,201904,1028,2710,935,2574,54,178,763,2073,817,2251
250590,201904,813,2300,721,2164,15,80,597,1778,612,1858
250600,201904,8069,20905,6763,19188,309,937,5575,15739,5884,16676
250610,201904,2961,8326,2678,7915,109,422,2218,6452,2327,6874
250620,201904,717,1942,605,1741,11,49,463,1297,474,1346
250625,201904,2506,7325,2251,6910,49,255,1868,5563,1917,5818
250630,201904,9378,26742,7869,23975,850,2722,5181,15355,6031,18077
250640,201904,3247,9308,2993,8950,82,398,2532,7357,2614,7755
250650,201904,902,2243,756,2043,19,56,641,1688,660,1744
250660,201904,1565,3970,1350,3669,37,108,1130,3003,1167,3111
250670,201904,2301,7225,2134,6946,53,249,1836,5842,1889,6091
250680,201904,5812,13468,5166,12724,101,365,4668,11238,4769,11603
250690,201904,6573,15258,5744,14192,103,282,5140,12523,5243,12805
250700,201904,4255,12097,3740,11301,311,952,2783,8315,3094,9267
250710,201904,4399,12726,3807,11913,286,1007,2779,8666,3065,9673
250720,201904,2722,7254,2470,6893,41,189,2182,5997,2223,6186
250730,201904,4013,10822,3543,10187,127,467,2930,8161,3057,8628
250740,201904,1939,4963,1588,4484,104,307,1232,3435,1336,3742
250750,201904,95992,245848,83456,228020,7425,22024,59578,159516,67003,181540
250760,201904,2314,6044,2034,5592,108,328,1573,4192,1681,4520
250770,201904,3818,11823,3479,11355,341,1153,2512,8179,2853,9332
250780,201904,1701,4673,1427,4156,78,268,1056,3000,1134,3268
250790,201904,2409,7257,2099,6805,215,834,1370,4343,1585,5177
250800,201904,2432,6518,2100,5984,82,186,1732,4953,1814,5139
250810,201904,1240,3381,1023,3062,25,69,875,2639,900,2708
250820,201904,1868,5530,1782,5429,45,202,1619,4896,1664,5098
250830,201904,5587,16928,4732,15213,323,1227,3248,10149,3571,11376
250840,201904,789,2507,671,2261,22,95,482,1623,504,1718
250850,201904,1790,5451,1622,5160,43,223,1343,4162,1386,4385
250855,201904,937,2747,814,2540,63,219,604,1863,667,2082
250860,201904,2951,9112,2502,8291,434,1518,1392,4591,1826,6109
250870,201904,1030,2835,876,2574,32,110,711,2066,743,2176
250880,201904,1542,4044,1269,3640,136,387,890,2555,1026,2942
250890,201904,9588,26239,8756,25063,432,1869,7084,19305,7516,21174
250900,201904,2730,7896,2353,7183,71,272,1968,5887,2039,6159
250905,201904,2295,6614,2104,6329,53,208,1880,5638,1933,5846
250910,201904,5792,14622,4767,13416,103,383,4022,11364,4125,11747
250915,201904,1943,4706,1444,4167,12,30,1313,3832,1325,3862
250920,201904,3416,8863,3004,8223,317,825,2164,5839,2481,6664
250930,201904,2108,5793,1931,5550,56,217,1659,4667,1715,4884
250933,201904,1125,3432,1001,3200,20,112,752,2332,772,2444
250937,201904,706,1937,592,1743,23,82,433,1291,456,1373
250939,201904,1684,4629,1482,4330,56,190,1180,3394,1236,3584
250940,201904,3788,10386,3378,9815,57,246,2905,8364,2962,8610
250950,201904,1663,4284,1347,3879,24,101,1146,3263,1170,3364
250960,201904,1079,3204,953,2998,24,127,782,2368,806,2495
250970,201904,8137,21546,7123,19882,305,1014,5688,15528,5993,16542
250980,201904,2446,6597,2203,6206,44,171,1857,5100,1901,5271
250990,201904,1916,6043,1657,5543,80,351,1223,4028,1303,4379
251000,201904,2079,5845,1707,5224,33,136,1416,4299,1449,4435
251010,201904,2576,7336,2339,6958,29,124,2115,6269,2144,6393
251020,201904,1652,4450,1503,4234,32,130,1321,3658,1353,3788
251030,201904,981,2657,829,2370,27,77,581,1624,608,1701
251040,201904,1830,5323,1559,4857,48,224,1222,3765,1270,3989
251050,201904,1076,2952,898,2613,43,146,654,1836,697,1982
251060,201904,1033,2240,777,1925,9,40,641,1547,650,1587
251065,201904,439,1217,354,1073,13,37,255,745,268,782
251070,201904,731,1993,636,1863,7,22,538,1564,545,1586
251080,201904,18299,47625,15111,42861,1854,5573,9822,27820,11676,33393
251090,201904,2601,7612,2229,6936,50,197,1826,5638,1876,5835
251100,201904,790,2481,709,2338,25,100,546,1737,571,1837
251110,201904,1667,4554,1444,4149,51,150,1114,3175,1165,3325
251120,201904,6927,20212,5917,18894,241,1032,4678,14765,4919,15797
251130,201904,3840,8925,3436,8468,164,426,2998,7342,3162,7768
251140,201904,4166,11809,3782,11260,85,342,3132,9218,3217,9560
251150,201904,2636,7718,2372,7298,115,504,1897,5633,2012,6137
251160,201904,1997,6034,1763,5694,109,391,1424,4562,1533,4953
251170,201904,1482,4148,1331,3968,39,165,1163,3434,1202,3599
251180,201904,2549,7037,2130,6453,180,559,1420,4258,1600,4817
251190,201904,4266,11320,3973,10979,52,249,3612,9797,3664,10046
251200,201904,4073,12315,3708,11839,92,387,3208,10280,3300,10667
251203,201904,918,3031,862,2910,32,140,650,2135,682,2275
251207,201904,1055,2986,831,2594,19,89,585,1778,604,1867
251210,201904,7268,19086,5954,17368,268,723,4575,13471,4843,14194
251220,201904,1158,2869,897,2509,48,119,701,1983,749,2102
251230,201904,4563,12666,3976,11692,130,514,3167,9029,3297,9543
251240,201904,3559,9932,2973,8976,150,493,2215,6527,2365,7020
251250,201904,9664,26604,8610,24850,777,2376,6307,17630,7084,20006
251260,201904,463,1383,425,1310,11,57,327,971,338,1028
251270,201904,4060,12798,3671,12289,106,453,3086,10472,3192,10925
251272,201904,1319,3625,1205,3461,38,167,1036,2877,1074,3044
251274,201904,877,2497,721,2226,48,179,490,1435,538,1614
251275,201904,1221,3414,1046,3141,47,220,779,2226,826,2446
251276,201904,1324,3559,1165,3353,35,180,950,2635,985,2815
251278,201904,558,1590,497,1489,37,102,374,1123,411,1225
251280,201904,2203,6163,1978,5794,48,197,1639,4708,1687,4905
251290,201904,5661,13870,5259,13353,184,664,4550,11089,4734,11753
251300,201904,802,2425,745,2342,10,41,635,1985,645,2026
251310,201904,2742,7925,2402,7370,60,307,1897,5649,1957,5956
251315,201904,1674,5313,1541,5074,62,231,1170,3784,1232,4015
251320,201904,1625,4316,1143,3480,32,116,830,2504,862,2620
251330,201904,1992,4708,1660,4311,25,90,1503,3921,1528,4011
251335,201904,990,3077,904,2950,27,110,767,2452,794,2562
251340,201904,3580,8919,2871,7938,122,381,2127,5784,2249,6165
251350,201904,1062,3146,948,2956,29,135,790,2398,819,2533
251360,201904,1786,5084,1481,4665,23,105,1278,4028,1301,4133
251365,201904,692,1978,556,1685,10,35,427,1287,437,1322
251370,201904,21576,59777,19211,56467,2258,6901,12748,37648,15006,44549
251380,201904,1160,3390,1040,3183,21,119,870,2553,891,2672
251385,201904,709,1862,562,1597,16,48,420,1144,436,1192
251390,201904,6255,18817,5487,17529,615,2120,3401,10763,4016,12883
251392,201904,954,2640,795,2390,25,125,619,1808,644,1933
251394,201904,593,1779,488,1588,24,101,363,1158,387,1259
251396,201904,690,1867,588,1695,20,50,403,1144,423,1194
251398,201904,908,2378,660,1925,17,75,503,1423,520,1498
251400,201904,1155,2951,944,2651,29,114,729,1963,758,2077
251410,201904,1520,3630,1269,3270,21,96,1086,2700,1107,2796
251420,201904,1881,5111,1565,4748,49,195,1218,3647,1267,3842
251430,201904,1522,4738,1360,4467,32,158,1179,3836,1211,3994
251440,201904,1101,3114,901,2730,33,107,712,2159,745,2266
251445,201904,1485,4282,1381,4126,47,204,1146,3299,1193,3503
251450,201904,4320,12985,3910,12359,88,379,3276,10257,3364,10636
251455,201904,896,2713,811,2560,27,105,617,1923,644,2028
251460,201904,886,2565,788,2405,25,94,648,1978,673,2072
251465,201904,436,1294,372,1156,6,27,281,857,287,884
251470,201904,1153,3224,859,2605,69,221,521,1512,590,1733
251480,201904,967,2585,808,2310,20,88,616,1686,636,1774
251490,201904,1859,5040,1482,4515,56,192,1082,3277,1138,3469
251500,201904,1881,5457,1741,5243,51,207,1521,4520,1572,4727
251510,201904,2632,8084,2209,7212,139,517,1467,4694,1606,5211
251520,201904,935,2504,714,2077,70,192,466,1330,536,1522
251530,201904,13945,34106,11509,31039,123,693,10165,26859,10288,27552
251540,201904,2766,8252,2545,7843,111,443,2038,6124,2149,6567
251550,201904,3617,8779,2898,7857,81,224,2431,6571,2512,6795
251560,201904,569,1721,506,1617,77,260,332,1010,409,1270
251570,201904,885,2573,740,2270,19,92,564,1667,583,1759
251580,201904,1878,4556,1681,4270,66,218,1440,3534,1506,3752
251590,201904,1576,4069,1341,3792,60,197,1073,2926,1133,3123
251593,201904,881,2654,820,2552,88,294,530,1596,618,1890
251597,201904,2063,5798,1881,5554,26,110,1648,4794,1674,4904
251600,201904,6263,17179,5576,16122,165,548,4685,13338,4850,13886
251610,201904,3241,9276,2771,8401,304,906,1880,5745,2184,6651
251615,201904,1210,3077,984,2707,21,69,776,2082,797,2151
251620,201904,17842,42221,14159,37790,204,703,11841,32051,12045,32754
251630,201904,4620,11064,3750,9865,195,561,2897,7527,3092,8088
251640,201904,2028,5804,1845,5470,42,204,1571,4526,1613,4730
251650,201904,4023,10719,3526,10101,130,444,3025,8621,3155,9065
251660,201904,3381,10184,2984,9468,84,409,2470,7657,2554,8066
251670,201904,4033,11505,3558,10849,55,281,3147,9495,3202,9776
251675,201904,644,1888,584,1812,79,271,385,1184,464,1455
251680,201904,2521,6853,2114,6298,44,164,1699,5047,1743,5211
251690,201904,3140,8964,2665,8102,79,258,1994,5951,2073,6209
251700,201904,1885,5691,1704,5455,51,244,1438,4491,1489,4735
251710,201904,784,2069,542,1558,49,169,306,864,355,1033
251720,201904,1309,3754,1085,3350,27,117,826,2468,853,2585
251740,201904,618,1740,498,1514,34,132,355,1034,389,1166
260005,201904,28675,61313,23557,54755,1759,4186,17839,40606,19598,44792
260010,201904,9699,25923,8084,23344,488,1519,4895,14233,5383,15752
260020,201904,6663,15942,5735,14575,127,563,4770,11879,4897,12442
260030,201904,6347,16834,5421,15424,179,630,4328,12177,4507,12807
260040,201904,7672,20900,6358,18824,574,1683,4166,12573,4740,14256
260050,201904,13050,35042,11300,33074,238,883,10142,29862,10380,30745
260060,201904,3860,9969,3343,9122,189,519,2635,7144,2824,7663
260070,201904,10203,26343,8761,24195,462,1569,6804,18337,7266,19906
260080,201904,6391,14880,5602,13777,132,436,4651,11152,4783,11588
260090,201904,4777,12457,4283,11802,631,1707,2868,8002,3499,9709
260100,201904,2995,8205,2562,7551,83,340,2068,5984,2151,6324
260105,201904,5077,13745,4506,12940,151,557,3698,10431,3849,10988
260110,201904,22191,60759,19935,57544,1105,3662,16297,46281,17402,49943
260120,201904,14097,38575,11880,35149,1570,4644,7308,22025,8878,26669
260130,201904,2953,7849,2660,7392,205,621,1969,5363,2174,5984
260140,201904,12929,29853,11105,27593,605,1714,9195,22479,9800,24193
260150,201904,3473,8319,2984,7711,117,396,2536,6427,2653,6823
260160,201904,6513,17335,5524,16070,114,471,4845,14170,4959,14641
260170,201904,18238,45476,15583,41723,1367,3539,11751,31339,13118,34878
260180,201904,3268,9109,2881,8580,102,370,2409,7036,2511,7406
260190,201904,18148,37208,15294,33850,171,503,13421,29046,13592,29549
260200,201904,10844,26537,9410,24715,448,1122,7946,20935,8394,22057
260210,201904,11727,33666,9948,30768,349,1415,7916,24266,8265,25681
260220,201904,10141,24951,9392,23996,189,645,8216,20624,8405,21269
260230,201904,10402,26291,9087,24479,233,724,7535,19988,7768,20712
260240,201904,2684,8081,2346,7443,159,562,1782,5609,1941,6171
260250,201904,2146,5762,1883,5371,109,286,1429,4045,1538,4331
260260,201904,12635,33623,11189,31320,463,1627,8777,24012,9240,25639
260270,201904,3936,10053,3452,9434,144,605,2780,7368,2924,7973
260280,201904,12714,38881,11439,37097,534,2263,9622,30791,10156,33054
260290,201904,38078,100016,33089,92455,3892,11116,21758,60308,25650,71424
260300,201904,9609,25974,8352,24203,247,1059,6897,19796,7144,20855
260310,201904,4653,12465,4218,11889,315,863,3271,9314,3586,10177
260320,201904,7377,21653,6437,20036,270,847,5228,16300,5498,17147
260330,201904,2504,7752,2231,7179,64,240,1819,5729,1883,5969
260340,201904,2009,5444,1744,5035,37,179,1449,4055,1486,4234
260345,201904,24076,64805,20386,59273,3325,10369,10253,29134,13578,39503
260350,201904,5048,12445,4479,11743,100,307,3938,10245,4038,10552
260360,201904,2471,6555,2251,6143,41,188,1571,4204,1612,4392
260370,201904,5399,15785,4703,14573,236,845,3601,11061,3837,11906
260380,201904,4844,14640,4177,13529,188,681,3090,9860,3278,10541
260390,201904,4275,13022,3630,11702,212,723,2498,7890,2710,8613
260392,201904,3422,10932,3034,10437,135,795,2397,8198,2532,8993
260400,201904,16330,39366,14290,36656,590,1782,11126,27465,11716,29247
260410,201904,69471,171932,53707,149697,10186,29909,24059,68747,34245,98656
260415,201904,4359,12230,3746,11136,83,371,2953,8557,3036,8928
260420,201904,12593,26741,10683,24578,159,447,9676,21997,9835,22444
260430,201904,2791,8683,2392,7908,139,535,1650,5409,1789,5944
260440,201904,3612,9721,3159,8949,98,355,2554,7057,2652,7412
260450,201904,5576,14340,5046,13678,287,660,4143,11403,4430,12063
260460,201904,5064,15574,4374,14255,494,1828,2580,8190,3074,10018
260470,201904,4917,12957,4180,12100,105,258,3751,11048,3856,11306
260480,201904,4043,10803,3380,9850,241,883,2308,6725,2549,7608
260490,201904,5191,12212,4596,11292,58,230,4100,9837,4158,10067
260500,201904,6013,15489,5158,14236,471,1270,3566,9916,4037,11186
260510,201904,9411,23484,7958,21450,155,568,6944,18446,7099,19014
260515,201904,4187,11782,3263,9967,152,496,2140,6371,2292,6867
260520,201904,17038,40194,14978,37475,912,2353,11989,29609,12901,31962
260530,201904,9586,27829,8273,25747,187,860,7002,21489,7189,22349
260540,201904,6942,15398,6218,14448,357,786,5319,12333,5676,13119
260545,201904,38,126,15,73,3,11,4,18,7,29
260550,201904,2920,8366,2424,7477,144,607,1571,4719,1715,5326
260560,201904,5858,15194,5027,13989,143,602,4196,11381,4339,11983
260570,201904,7482,20937,6633,19747,440,1447,5149,15272,5589,16719
260580,201904,4356,10521,3889,9887,32,143,3545,8943,3577,9086
260590,201904,6619,15700,5586,14517,243,629,4593,12050,4836,12679
260600,201904,29704,78793,24419,70480,1325,4221,18091,51386,19416,55607
260610,201904,6924,18602,6300,17753,409,1285,4687,13041,5096,14326
260620,201904,15252,41371,13501,38777,1495,4714,9261,26091,10756,30805
260630,201904,2310,6356,1918,5718,40,176,1541,4488,1581,4664
260640,201904,20320,47707,17310,44174,900,2420,13721,34677,14621,37097
260650,201904,5658,15705,4729,14466,175,737,3965,12011,4140,12748
260660,201904,7141,19099,6148,17746,170,755,5166,14541,5336,15296
260670,201904,2159,5693,1791,5135,80,203,1343,3810,1423,4013
260680,201904,25781,63387,21725,57363,1825,5143,14488,37445,16313,42588
260690,201904,3600,9318,2937,8316,113,417,2323,6481,2436,6898
260700,201904,5877,17253,5579,16906,21,65,5407,16516,5428,16581
260710,201904,1307,3508,1169,3325,44,158,887,2518,931,2676
260720,201904,21205,56459,18668,52766,2468,7195,12142,33956,14610,41151
260730,201904,7225,21564,6427,20396,327,1239,5272,16440,5599,17679
260740,201904,1336,3743,1116,3385,12,67,888,2715,900,2782
260750,201904,6803,19267,5874,18037,130,447,5231,16257,5361,16704
260760,201904,5499,13292,4767,12374,217,638,3831,9968,4048,10606
260765,201904,7586,22671,6669,21354,515,2164,4572,14202,5087,16366
260770,201904,3777,9830,3240,8915,84,289,2583,6996,2667,7285
260775,201904,5170,13976,4601,13100,226,852,3502,9623,3728,10475
260780,201904,3592,10850,3204,10212,304,1168,2046,6308,2350,7476
260790,201904,113442,260717,95013,236036,14816,36059,58174,144195,72990,180254
260795,201904,2988,7980,2581,7410,118,394,1946,5591,2064,5985
260800,201904,5317,12513,4799,11786,175,549,4169,9886,4344,10435
260805,201904,3530,10278,2982,9294,174,658,2154,6569,2328,7227
260810,201904,6505,17817,5766,16394,564,1587,4092,11396,4656,12983
260820,201904,4350,10478,3837,9810,143,501,3128,7785,3271,8286
260825,201904,2861,8705,2484,8024,117,455,1842,5880,1959,6335
260830,201904,4240,12452,3541,11180,455,1315,2270,7347,2725,8662
260840,201904,4071,10869,3640,10233,198,562,3017,8457,3215,9019
260845,201904,4064,11056,3666,10334,254,711,2713,7567,2967,8278
260850,201904,4740,13631,4062,12305,386,1279,2586,7598,2972,8877
260860,201904,3395,9748,2921,8916,88,331,2360,7019,2448,7350
260870,201904,4404,10725,3822,9993,99,381,3375,8637,3474,9018
260875,201904,6610,17079,5493,15368,619,1744,3660,10220,4279,11964
260880,201904,9542,27056,8349,24941,456,1368,6601,19766,7057,21134
260890,201904,12998,34145,11475,31849,768,2380,8215,22249,8983,24629
260900,201904,5138,14956,4334,13710,303,1117,2905,9040,3208,10157
260910,201904,3136,8698,2722,8057,107,372,2125,6217,2232,6589
260915,201904,5105,15098,4507,14392,59,288,4071,13036,4130,13324
260920,201904,3273,8463,2814,7938,101,316,2394,6747,2495,7063
260930,201904,3470,11306,3072,10593,171,735,2319,7842,2490,8577
260940,201904,14312,34963,12485,32279,818,2325,9418,23805,10236,26130
260950,201904,6476,17986,5263,15747,457,1589,3147,8954,3604,10543
260960,201904,64682,150697,52360,134186,6590,17686,31798,80131,38388,97817
260970,201904,5209,14075,4659,13328,161,437,3605,10330,3766,10767
260980,201904,4407,13076,3987,12533,69,266,3589,11351,3658,11617
260990,201904,17568,49666,14993,46185,860,3096,11549,35189,12409,38285
261000,201904,15868,38510,13449,35246,467,1732,10556,26973,11023,28705
261010,201904,2405,6302,2105,5896,72,184,1830,5130,1902,5314
261020,201904,6046,16774,5190,15225,257,921,4110,11589,4367,12510
261030,201904,4051,11583,3516,10683,163,588,2768,8189,2931,8777
261040,201904,5122,15327,4183,13438,202,813,3044,9591,3246,10404
261050,201904,7560,20300,6873,19148,537,1245,4918,13794,5455,15039
261060,201904,13489,34685,11897,32662,407,1323,9725,26415,10132,27738
261070,201904,58840,131308,48973,118073,3075,7300,36478,86336,39553,93636
261080,201904,6182,15595,5705,14962,163,434,5198,13606,5361,14040
261090,201904,17939,44106,16041,41648,367,1292,13744,35081,14111,36373
261100,201904,8008,22891,6978,21337,562,1878,5046,15419,5608,17297
261110,201904,59246,169703,50117,153705,8806,28319,26846,82376,35652,110695
261120,201904,3749,9401,3224,8695,87,266,2776,7462,2863,7728
261130,201904,7328,17894,6468,16764,121,362,5714,14712,5835,15074
261140,201904,3489,8268,3129,7782,181,502,2502,6096,2683,6598
261150,201904,5211,14000,4616,13071,101,401,3945,11006,4046,11407
261153,201904,1854,5577,1631,5170,66,269,1124,3533,1190,3802
261160,201904,202474,482654,166437,432236,41560,111039,67557,178515,109117,289554
261170,201904,5849,15004,5237,14064,364,950,4115,10979,4479,11929
261180,201904,9646,24722,8501,23207,510,1518,6085,16484,6595,18002
261190,201904,4599,13808,4134,12998,246,1022,3087,9390,3333,10412
261200,201904,3318,7738,2966,7267,143,359,2465,5927,2608,6286
261210,201904,1909,4672,1619,4266,64,204,1351,3504,1415,3708
261220,201904,13528,39134,11271,34770,1451,4876,6340,19244,7791,24120
261230,201904,4117,11942,3434,10991,67,288,2821,9106,2888,9394
261240,201904,5025,13098,4438,12166,254,730,3632,9841,3886,10571
261245,201904,3517,10111,3001,9197,95,442,2354,6951,2449,7393
261247,201904,2897,8770,2440,7921,143,532,1685,5398,1828,5930
261250,201904,20825,48626,17958,45226,1782,4156,13404,34581,15186,38737
261255,201904,3944,11820,3330,10625,150,676,2450,7506,2600,8182
261260,201904,12826,34641,11075,32387,419,1711,9260,26693,9679,28404
261270,201904,3915,10340,3477,9734,185,651,2864,7836,3049,8487
261280,201904,2536,7235,2241,6714,80,328,1752,5106,1832,5434
261290,201904,2922,7755,2492,7247,86,343,2008,5857,2094,6200
261300,201904,11687,33596,9962,30582,580,2207,7154,21467,7734,23674
261310,201904,8414,22059,7192,20294,791,2462,5015,13772,5806,16234
261320,201904,5897,16840,5149,15550,89,409,4293,12714,4382,13123
261330,201904,5904,14745,5365,14012,152,545,4647,11901,4799,12446
261340,201904,4096,12012,3569,11282,178,722,2801,8728,2979,9450
261350,201904,8564,25346,7649,23790,132,660,6203,18873,6335,19533
261360,201904,8138,20091,6926,18364,254,797,5470,14028,5724,14825
261370,201904,21495,55533,18217,50960,2422,6840,11319,31833,13741,38673
261380,201904,3913,12188,3522,11474,459,1640,2317,7416,2776,9056
261390,201904,15728,45808,13395,41992,1226,4180,8713,27156,9939,31336
261400,201904,4564,14717,3972,13463,167,784,2954,9721,3121,10505
261410,201904,9247,23821,7740,21413,512,1446,6018,16386,6530,17832
261420,201904,7059,21882,6441,21093,827,3075,4385,14249,5212,17324
261430,201904,3387,9662,2853,8825,80,321,2339,7117,2419,7438
261440,201904,1432,4346,1219,3928,41,194,848,2628,889,2822
261450,201904,14790,40343,13213,37822,244,993,10950,31096,11194,32089
261460,201904,7277,20213,6510,19075,182,680,5461,15851,5643,16531
261470,201904,4169,10486,3692,9861,41,200,3117,8311,3158,8511
261480,201904,4813,15118,4188,14048,231,978,3178,10420,3409,11398
261485,201904,4918,14126,4236,13030,389,1335,2892,8726,3281,10061
261500,201904,5548,14667,4896,13766,450,1130,3351,9779,3801,10909
261510,201904,1836,5583,1590,5148,65,244,1173,3846,1238,4090
261520,201904,2373,7331,2177,6929,95,349,1514,4820,1609,5169
261530,201904,11179,33800,9221,30008,1150,4337,4395,13939,5545,18276
261540,201904,7844,22894,7058,21697,1093,3296,4023,12898,5116,16194
261550,201904,3558,9590,3122,8893,223,734,2226,6181,2449,6915
261560,201904,7597,22935,6620,21462,370,1431,4893,15845,5263,17276
261570,201904,3428,9356,2771,8284,202,731,1900,5541,2102,6272
261580,201904,6517,17398,5754,16365,118,543,5137,14410,5255,14953
261590,201904,2654,6908,2122,6129,75,248,1575,4513,1650,4761
261600,201904,5053,13135,4243,11908,422,1077,2809,8187,3231,9264
261610,201904,2329,6455,1942,5806,98,371,1401,4137,1499,4508
261618,201904,2542,6476,2229,6021,74,225,1769,4719,1843,4944
261620,201904,3973,11585,3692,11159,849,2318,2242,7141,3091,9459
261630,201904,6327,17905,5416,16180,394,1462,3569,10140,3963,11602
261640,201904,35894,82275,31010,76115,1673,3486,23938,60009,25611,63495
261650,201904,4100,10352,3580,9672,144,511,2674,7123,2818,7634
270010,201904,4198,14467,3687,13546,171,959,2857,10218,3028,11177
270020,201904,3813,9794,3378,9225,189,604,2798,7480,2987,8084
270030,201904,32854,91502,28295,84241,4057,11895,18369,55051,22426,66946
270040,201904,11010,29898,9507,28102,413,1690,7791,22695,8204,24385
270050,201904,5432,12631,4626,11733,179,452,4093,10415,4272,10867
270060,201904,2008,5260,1709,4904,125,337,1355,3936,1480,4273
270070,201904,4562,13049,4004,12254,147,604,3352,10053,3499,10657
270080,201904,1409,3926,1171,3517,47,169,884,2531,931,2700
270090,201904,1853,5687,1636,5271,73,331,1295,4034,1368,4365
270100,201904,5478,14945,4785,13903,206,818,3858,10911,4064,11729
270110,201904,3194,7842,2569,7095,132,344,2016,5777,2148,6121
270120,201904,2917,7967,2543,7483,78,312,2183,6359,2261,6671
270130,201904,5082,13467,4415,12678,163,543,3723,10719,3886,11262
270135,201904,2002,4871,1700,4525,53,167,1521,4025,1574,4192
270140,201904,9529,22367,7851,20063,356,1327,6335,15325,6691,16652
270150,201904,2691,8067,2513,7808,6,29,2406,7465,2412,7494
270160,201904,5683,16174,5003,15357,74,447,4594,13923,4668,14370
270170,201904,3413,10107,2910,9407,225,1007,2135,6630,2360,7637
270180,201904,2223,6940,2032,6683,46,223,1788,5801,1834,6024
270190,201904,1654,4981,1488,4768,51,250,1281,4037,1332,4287
270200,201904,2389,7342,2075,6899,125,498,1508,4915,1633,5413
270210,201904,5587,13569,4849,12731,132,485,4383,11334,4515,11819
270220,201904,1417,3861,1151,3479,217,668,632,1914,849,2582
270230,201904,9064,26026,7561,23658,695,2520,5192,15950,5887,18470
270235,201904,5784,18019,5047,16803,167,738,4050,13342,4217,14080
270240,201904,10332,28486,8453,26072,947,3223,6035,18539,6982,21762
270250,201904,2817,7298,2485,6838,227,600,1892,5247,2119,5847
270255,201904,4539,13132,3506,11201,142,579,2565,8010,2707,8589
270260,201904,5550,16602,5065,15802,115,593,4356,13190,4471,13783
270270,201904,1039,2753,888,2557,120,344,618,1762,738,2106
270280,201904,3875,9420,3089,8422,479,832,2129,6246,2608,7078
270290,201904,7643,24473,6891,23210,247,1110,5836,19413,6083,20523
270300,201904,4103,11017,3239,10067,179,569,2453,7755,2632,8324
270310,201904,7009,19750,6084,18384,145,749,5156,15156,5301,15905
270320,201904,5478,16134,4799,14844,528,1702,3335,10053,3863,11755
270330,201904,3793,12634,3404,12026,257,1103,2624,9167,2881,10270
270340,201904,1634,4559,1404,4249,63,194,1147,3452,1210,3646
270350,201904,1837,4504,1529,4130,179,540,1041,2825,1220,3365
270360,201904,2424,6335,2170,6040,68,185,1966,5490,2034,5675
270370,201904,1401,4386,1270,4132,48,216,1017,3252,1065,3468
270375,201904,3027,7241,2583,6725,16,56,2415,6286,2431,6342
270380,201904,5574,16250,4726,15096,519,1634,3175,10492,3694,12126
270390,201904,1189,3060,974,2797,27,140,790,2235,817,2375
270400,201904,6137,16609,5214,15160,219,714,4049,11537,4268,12251
270410,201904,4504,13353,3936,12414,187,691,3183,9930,3370,10621
270420,201904,5442,16408,4974,15719,175,810,4197,12963,4372,13773
270430,201904,135571,334108,108316,298930,22201,63861,50010,140252,72211,204113
270440,201904,4727,12991,4070,12180,98,447,3466,10220,3564,10667
270450,201904,6715,18666,6017,17821,265,1003,5034,14796,5299,15799
270460,201904,3751,8405,3276,7853,94,238,3005,7123,3099,7361
270470,201904,10806,31093,9479,29133,852,2814,6989,21512,7841,24326
270480,201904,2816,7724,2434,7158,137,539,1936,5499,2073,6038
270490,201904,946,2706,830,2562,45,169,653,1975,698,2144
270500,201904,4839,14998,4359,14281,234,959,3482,11236,3716,12195
270510,201904,5465,15106,4699,14056,398,1543,3437,9812,3835,11355
270520,201904,3883,11357,3084,9942,685,2256,1195,4043,1880,6299
270530,201904,1186,3526,1037,3285,59,184,757,2416,816,2600
270540,201904,2131,6374,1876,6040,64,308,1612,5084,1676,5392
270550,201904,6625,17681,5448,16373,535,1385,4129,12842,4664,14227
270560,201904,3037,8178,2676,7680,167,517,2082,5886,2249,6403
270570,201904,4026,11480,3432,10554,104,418,2814,8516,2918,8934
270580,201904,2280,6521,2078,6219,98,304,1779,5287,1877,5591
270590,201904,1601,4779,1476,4610,15,78,1395,4338,1410,4416
270600,201904,2727,8526,2465,8106,60,313,2163,6994,2223,7307
270610,201904,3688,9743,3142,9015,89,339,2776,7862,2865,8201
270620,201904,1221,3807,1123,3626,43,188,947,2958,990,3146
270630,201904,16274,41680,14240,38807,697,2321,11734,31330,12431,33651
270640,201904,5359,15598,4689,14549,191,782,3755,11321,3946,12103
270642,201904,2445,7980,2183,7553,149,727,1668,5559,1817,6286
270644,201904,3518,8870,2883,8044,243,670,2173,6156,2416,6826
270650,201904,3114,9335,2765,8823,415,1489,1850,5713,2265,7202
270660,201904,2084,5234,1697,4684,81,308,1278,3447,1359,3755
270670,201904,15365,36918,12928,33948,529,1656,10742,27650,11271,29306
270680,201904,5231,13166,4695,12560,135,216,4370,11858,4505,12074
270690,201904,8903,22513,7430,20675,927,2419,5307,14914,6234,17333
270700,201904,533,1618,467,1501,27,117,347,1105,374,1222
270710,201904,5537,16848,5036,16109,254,1116,4128,12876,4382,13992
270720,201904,3371,10258,3004,9633,71,417,2624,8210,2695,8627
270730,201904,7875,18185,7051,17270,281,682,5615,14908,5896,15590
270740,201904,2318,6208,2064,5896,99,360,1701,4739,1800,5099
270750,201904,5478,14940,4837,14088,146,608,4150,11974,4296,12582
270760,201904,3293,9385,2866,8793,64,328,2419,7309,2483,7637
270770,201904,20791,51097,16395,45697,2979,7600,9456,28095,12435,35695
270780,201904,1735,5115,1627,4965,91,325,1356,4073,1447,4398
270790,201904,1532,4465,1304,4125,111,373,845,2631,956,3004
270800,201904,10579,29523,9498,27997,376,1505,8095,23282,8471,24787
270810,201904,3233,9399,2546,8204,186,768,1757,5521,1943,6289
270820,201904,1660,5030,1401,4597,66,291,1091,3482,1157,3773
270830,201904,5234,12834,4270,11639,192,660,3400,9148,3592,9808
270840,201904,8120,24304,7292,23129,192,1057,6361,19617,6553,20674
270850,201904,8725,21465,7842,20361,555,1750,6536,16524,7091,18274
270860,201904,12007,29165,10089,26849,429,1425,8323,21628,8752,23053
270870,201904,2068,6016,1771,5502,208,687,1221,3820,1429,4507
270880,201904,8044,24217,7217,22989,247,1102,5941,18539,6188,19641
270890,201904,2618,7264,2270,6787,184,636,1599,4695,1783,5331
270895,201904,2917,9447,2706,9159,77,427,2383,7884,2460,8311
270900,201904,1805,4718,1377,4045,50,178,1080,3119,1130,3297
270910,201904,3820,11306,3291,10415,119,480,2583,8048,2702,8528
270915,201904,9022,26875,7435,24145,738,2826,4929,15579,5667,18405
270920,201904,5243,16531,4781,15742,224,1064,3857,12245,4081,13309
270930,201904,16940,40483,13309,36177,1826,4481,9067,25529,10893,30010
270940,201904,6145,17170,5391,16227,247,1181,4265,12387,4512,13568
280010,201904,680,1879,553,1611,17,74,387,1015,404,1089
280020,201904,4675,12274,4020,11232,535,1405,2644,7457,3179,8862
280030,201904,71866,172635,56416,150650,13318,35862,23374,65119,36692,100981
280040,201904,3004,8490,2625,7916,277,883,1743,5175,2020,6058
280050,201904,3891,11180,3352,10285,536,1742,1981,6067,2517,7809
280060,201904,5349,14590,4315,12995,767,2386,2141,6694,2908,9080
280067,201904,6854,17409,5833,15830,356,1021,4193,11096,4549,12117
280070,201904,1887,5761,1772,5558,81,305,1483,4562,1564,4867
280100,201904,3794,10468,3208,9506,333,1032,2224,6558,2557,7590
280110,201904,1339,3712,1169,3444,19,98,1007,2900,1026,2998
280120,201904,7461,22073,6730,20867,715,2029,4988,15748,5703,17777
280130,201904,8842,21281,7768,19736,536,1456,6076,15311,6612,16767
280140,201904,5463,13405,4829,12545,251,715,4028,10356,4279,11071
280150,201904,3873,9974,3392,9345,207,572,2753,7541,2960,8113
280160,201904,1234,3595,1024,3233,118,398,651,2000,769,2398
280170,201904,5093,13599,4546,12869,242,721,3630,10213,3872,10934
280190,201904,1184,2716,1024,2490,62,162,811,1925,873,2087
280200,201904,1314,3485,1064,3080,105,377,723,2022,828,2399
280210,201904,15683,40613,13694,37786,1751,5141,8439,23214,10190,28355
280220,201904,1738,4724,1493,4389,38,205,1208,3521,1246,3726
280230,201904,3917,10108,3447,9420,271,671,2491,6786,2762,7457
280240,201904,3369,9051,3027,8535,59,306,2560,7004,2619,7310
280250,201904,829,2117,669,1859,75,230,394,1052,469,1282
280260,201904,2110,5194,1894,4927,40,106,1741,4535,1781,4641
280270,201904,2278,6508,2022,6103,128,474,1679,4927,1807,5401
280280,201904,4023,12454,3602,11855,454,1393,2502,8533,2956,9926
280290,201904,16993,46466,14808,43289,1463,4660,9924,29132,11387,33792
280300,201904,11231,28220,9742,26593,264,893,7584,21942,7848,22835
280310,201904,1324,3486,1105,3118,33,125,821,2238,854,2363
280320,201904,8507,23548,7375,21797,860,2591,4850,14148,5710,16739
280330,201904,4710,11839,3962,10733,267,753,2920,7841,3187,8594
280340,201904,5453,11355,4630,10459,245,438,3976,9129,4221,9567
280350,201904,24275,59150,21254,54980,1330,3747,16304,41393,17634,45140
280360,201904,5848,16543,5120,15277,857,2593,2867,8630,3724,11223
280370,201904,2212,5455,1804,4739,67,189,1419,3638,1486,3827
280380,201904,969,2713,835,2527,93,303,528,1598,621,1901
280390,201904,3531,9028,2917,8016,136,394,2272,6161,2408,6555
280400,201904,3927,10251,3378,9436,476,1239,2102,6074,2578,7313
280410,201904,2156,6176,1734,5422,187,626,1035,3147,1222,3773
280420,201904,4284,11604,3900,11082,93,342,3518,9930,3611,10272
280430,201904,2026,5059,1773,4712,81,319,1414,3630,1495,3949
280440,201904,4308,11757,3773,10932,203,696,3069,8650,3272,9346
280445,201904,2289,5863,2022,5385,56,186,1508,3830,1564,4016
280450,201904,10212,23526,8968,21879,436,846,7386,18188,7822,19034
280460,201904,6671,16274,6050,15385,466,1111,4930,12481,5396,13592
280470,201904,1734,4953,1489,4505,63,241,1089,3210,1152,3451
280480,201904,38997,97101,34039,90187,2800,8111,24413,63479,27213,71590
280490,201904,3736,10773,3230,9914,93,421,2461,7296,2554,7717
280500,201904,962,2353,816,2149,37,134,672,1741,709,1875
280510,201904,2537,6712,2190,6197,88,344,1661,4586,1749,4930
280520,201904,1598,4119,1404,3859,75,217,1117,3022,1192,3239
280530,201904,2632,6482,2255,6004,314,724,1574,4295,1888,5019
280540,201904,8881,24090,8099,22942,236,899,7038,19547,7274,20446
280550,201904,6655,15740,5389,13898,245,803,4269,10621,4514,11424
280560,201904,7033,20057,6591,19394,149,583,5733,16629,5882,17212
280570,201904,6331,15863,5136,14319,215,799,3768,10341,3983,11140
280580,201904,5486,15142,4725,13944,542,1473,3262,9761,3804,11234
280590,201904,2955,6856,2473,6271,129,503,1864,4461,1993,4964
280600,201904,3425,9415,3035,8832,169,556,2176,6298,2345,6854
280610,201904,2494,6260,2255,5922,164,415,1810,4715,1974,5130
280620,201904,5272,13317,4490,12240,419,982,3172,8944,3591,9926
280630,201904,3733,10855,3401,10359,175,635,2740,8286,2915,8921
280640,201904,2405,6523,2152,6240,65,200,1905,5534,1970,5734
280650,201904,1235,3245,969,2841,95,305,673,1902,768,2207
280660,201904,3180,7472,2799,7012,95,259,2457,6093,2552,6352
280670,201904,19187,43940,16635,40663,965,2565,13145,31856,14110,34421
280680,201904,2708,6688,2314,6095,189,392,1670,4402,1859,4794
280690,201904,947,2429,788,2201,30,96,594,1616,624,1712
280700,201904,1111,2875,952,2621,21,92,743,1999,764,2091
280710,201904,14895,33788,12665,31231,494,988,10900,27316,11394,28304
280720,201904,2678,6014,2176,5427,91,269,1465,3853,1556,4122
280730,201904,1057,2719,942,2526,55,169,709,1837,764,2006
280740,201904,13975,34638,11929,31496,941,2621,8288,21402,9229,24023
280750,201904,3521,10048,3095,9290,178,634,2224,6541,2402,7175
280760,201904,6129,17018,5421,15900,559,1609,3646,10918,4205,12527
290010,201904,3092,6597,2074,4992,8,28,1695,3889,1703,3917
290020,201904,5362,14379,4911,13773,370,755,4099,11828,4469,12583
290030,201904,4235,10275,3534,9480,172,430,2957,7987,3129,8417
290035,201904,5149,11474,4195,10222,339,576,3310,8403,3649,8979
290040,201904,4244,10425,3613,9652,129,372,2830,7813,2959,8185
290050,201904,2084,6661,1737,5912,128,530,1173,3875,1301,4405
290060,201904,1300,3198,960,2631,85,304,642,1683,727,1987
290070,201904,34751,79259,29975,73148,2010,5149,22286,53802,24296,58951
290080,201904,5321,15877,4534,14687,481,1667,3102,10149,3583,11816
290090,201904,2141,4162,1543,3518,31,89,1387,3124,1418,3213
290100,201904,9728,26061,8012,23459,1107,3056,4643,14014,5750,17070
290110,201904,5036,13708,4531,12827,402,1177,3194,8952,3596,10129
290115,201904,4093,12030,3490,10976,225,787,2608,8139,2833,8926
290120,201904,6486,16184,5434,14828,133,489,4688,12545,4821,13034
290130,201904,4567,11257,3623,10077,137,470,2870,7880,3007,8350
290135,201904,4235,10071,3438,8758,226,583,2580,6389,2806,6972
290140,201904,4544,12232,3609,10968,106,406,3061,9239,3167,9645
290150,201904,2424,6508,2114,6109,160,505,1585,4540,1745,5045
290160,201904,3070,7440,2774,7056,284,657,2134,5449,2418,6106
290170,201904,3240,8499,2885,8091,105,324,2570,7223,2675,7547
290180,201904,2952,8042,2427,7209,83,299,1946,5717,2029,6016
290190,201904,4088,11898,3614,11245,161,676,2940,8991,3101,9667
290195,201904,2321,5891,1851,5220,37,182,1522,4249,1559,4431
290200,201904,3969,11241,3304,10133,225,770,2516,7635,2741,8405
290205,201904,3378,8776,2979,8184,139,533,2343,6207,2482,6740
290210,201904,13043,36912,11608,34765,943,2555,8866,27205,9809,29760
290220,201904,2736,7039,2445,6673,164,495,1955,5261,2119,5756
290225,201904,3374,7211,2672,6459,225,525,2207,5347,2432,5872
290230,201904,2467,6646,2243,6382,38,147,1997,5650,2035,5797
290240,201904,3600,9216,2945,8373,105,353,2436,6879,2541,7232
290250,201904,4005,11729,3446,10925,137,463,2801,9050,2938,9513
290260,201904,5345,13453,4393,12071,203,727,3529,9436,3732,10163
290265,201904,3499,10360,2838,9056,141,542,2097,6590,2238,7132
290270,201904,11144,38234,10532,37166,578,2591,8415,29241,8993,31832
290280,201904,5963,17982,5166,16419,331,1228,3718,11631,4049,12859
290290,201904,9922,29343,8164,26027,816,2855,5440,17105,6256,19960
290300,201904,4163,11491,3132,9520,186,634,2199,6675,2385,7309
290310,201904,1508,3895,1258,3570,83,326,941,2575,1024,2901
290320,201904,23577,63422,19168,56570,4343,12753,9163,28309,13506,41062
290323,201904,3705,10164,3246,9474,72,258,2636,7628,2708,7886
290327,201904,4215,12235,3573,10978,280,821,2494,7626,2774,8447
290330,201904,2051,4444,1639,3990,47,102,1447,3524,1494,3626
290340,201904,5555,14598,4391,13121,497,1558,3140,9486,3637,11044
290350,201904,4633,13052,3844,11701,297,981,2747,8340,3044,9321
290360,201904,4959,13255,4364,12464,127,394,3757,10718,3884,11112
290370,201904,5278,12893,3919,11145,189,475,2907,8417,3096,8892
290380,201904,5505,14852,4700,13734,128,372,4078,12020,4206,12392
290390,201904,14090,40329,11965,37134,1232,3799,8109,25534,9341,29333
290395,201904,2725,8150,2291,7390,65,333,1782,5650,1847,5983
290400,201904,3581,9847,2911,8750,90,388,2211,6470,2301,6858
290405,201904,4536,13493,3867,12297,256,876,2746,8841,3002,9717
290410,201904,5628,15714,4445,13740,118,562,3387,10115,3505,10677
290420,201904,2970,8415,2443,7566,91,332,1883,5805,1974,6137
290430,201904,3070,8672,2538,7821,271,870,1662,5103,1933,5973
290440,201904,2747,7055,1994,5850,44,138,1436,4270,1480,4408
290450,201904,3271,8738,2663,7837,150,506,2022,5880,2172,6386
290460,201904,11453,32466,9889,29504,2099,6314,4622,13744,6721,20058
290470,201904,4373,11132,3260,9566,325,1077,1900,5608,2225,6685
290475,201904,6377,18673,5420,16934,102,537,4401,13412,4503,13949
290480,201904,1728,4511,1465,4120,115,353,977,2626,1092,2979
290485,201904,4452,13282,3962,12539,122,633,3350,10359,3472,10992
290490,201904,8960,21434,7994,20113,505,1233,6277,15902,6782,17135
290500,201904,3849,11807,3014,9962,519,1800,1392,4476,1911,6276
290510,201904,3326,8558,2808,7878,81,285,2404,6648,2485,6933
290515,201904,3665,10023,3162,9375,67,198,2776,8401,2843,8599
290520,201904,11036,32179,8634,27480,499,1836,5479,17100,5978,18936
290530,201904,4939,14170,4237,13015,152,543,3518,10790,3670,11333
290540,201904,3437,9208,3084,8777,69,246,2804,7932,2873,8178
290550,201904,4283,11238,3745,10604,23,88,3456,9907,3479,9995
290560,201904,6496,17052,5015,14831,454,1636,3294,9411,3748,11047
290570,201904,41662,105321,37776,100314,2567,7088,30259,79730,32826,86818
290580,201904,7702,23125,6749,21725,621,1993,4920,16200,5541,18193
290590,201904,6981,21795,5967,19973,150,639,4855,16244,5005,16883
290600,201904,18255,51586,16357,48589,645,2119,13088,38752,13733,40871
290610,201904,2501,7991,1990,6938,103,439,1375,4717,1478,5156
290620,201904,6545,18363,5658,16882,203,619,4711,13980,4914,14599
290630,201904,8923,22022,7159,19713,590,1602,5510,15254,6100,16856
290640,201904,2717,7149,2076,6174,73,237,1537,4563,1610,4800
290650,201904,12177,31848,11010,30408,2831,7359,6159,18121,8990,25480
290660,201904,3648,9428,3063,8573,52,121,2288,6671,2340,6792
290670,201904,6555,18648,5658,17170,431,1271,4309,13218,4740,14489
290680,201904,10484,29640,8973,27398,224,1190,7320,21740,7544,22930
290682,201904,4569,12171,4035,11414,135,331,3410,9680,3545,10011
290685,201904,3350,7759,2379,6360,174,450,1519,4299,1693,4749
290687,201904,6489,17987,5295,16001,707,2057,3357,10430,4064,12487
290689,201904,2741,7896,2243,7005,129,423,1652,5176,1781,5599
290690,201904,5614,14638,4559,13153,383,1131,3234,9246,3617,10377
290700,201904,2589,7189,2306,6813,84,283,1879,5572,1963,5855
290710,201904,8448,23904,7207,22178,182,761,6091,18620,6273,19381
290720,201904,18734,51417,17092,48931,951,3120,13632,38504,14583,41624
290730,201904,7131,17403,6118,16199,283,654,4760,12662,5043,13316
290740,201904,1055,2897,803,2458,39,158,617,1884,656,2042
290750,201904,10750,27739,9335,25308,803,2310,6617,17406,7420,19716
290755,201904,2070,5880,1683,5160,95,316,1192,3651,1287,3967
290760,201904,3793,11180,3030,9691,250,739,1938,6405,2188,7144
290770,201904,2590,8435,2351,8139,57,297,1961,6838,2018,7135
290780,201904,8270,20638,7152,19130,318,718,5658,15343,5976,16061
290790,201904,4576,12661,3998,11874,141,453,3370,10079,3511,10532
290800,201904,7174,14965,5155,12607,330,767,3813,9435,4143,10202
290810,201904,5536,14883,4459,13248,114,408,3313,9923,3427,10331
290820,201904,4908,13348,4412,12573,217,666,3255,9366,3472,10032
290830,201904,4521,10406,4072,9816,55,162,3523,8354,3578,8516
290840,201904,16406,44868,14423,41737,1791,4424,9463,28726,11254,33150
290850,201904,6309,15860,5707,15187,326,784,4770,12917,5096,13701
290860,201904,5846,17434,5116,16552,222,787,4310,14152,4532,14939
290870,201904,4739,13231,3666,11239,116,417,2606,7894,2722,8311
290880,201904,1369,3488,1096,3125,76,204,759,2224,835,2428
290890,201904,8704,18260,7827,17241,160,383,7282,15935,7442,16318
290900,201904,2312,6182,1770,5253,101,287,1134,3308,1235,3595
290910,201904,4995,12383,3872,10663,51,204,3184,8661,3235,8865
290920,201904,5077,12659,4648,12147,56,129,4365,11446,4421,11575
290930,201904,7798,22015,6315,19410,203,938,4957,14755,5160,15693
290940,201904,3659,10357,3052,9488,165,630,2414,7495,2579,8125
290950,201904,1478,3787,1226,3419,65,183,881,2469,946,2652
290960,201904,5355,14436,4818,13763,134,417,4070,11587,4204,12004
290970,201904,3469,10141,2838,9041,143,491,2138,6783,2281,7274
290980,201904,11487,28400,9726,25640,888,2500,5913,15181,6801,17681
290990,201904,9193,25095,8064,23221,305,1209,6627,18424,6932,19633
291000,201904,3393,9047,2698,8170,181,508,2124,6554,2305,7062
291005,201904,14712,36467,13040,34299,836,2268,10578,27632,11414,29900
291010,201904,2954,9020,2413,7871,132,471,1601,5109,1733,5580
291020,201904,1276,3202,1013,2705,28,96,719,1823,747,1919
291030,201904,2399,5997,1671,4693,95,260,1089,2958,1184,3218
291040,201904,5240,14853,4499,13787,195,829,3548,10700,3743,11529
291050,201904,7266,19845,6296,18435,812,2599,4278,12312,5090,14911
291060,201904,5748,18544,5002,17461,393,1709,3684,12695,4077,14404
291070,201904,15472,42540,13101,38811,526,1897,10547,30916,11073,32813
291072,201904,23591,62442,17213,50839,3417,10457,7031,20986,10448,31443
291075,201904,5171,13420,4614,12503,131,393,3757,9959,3888,10352
291077,201904,1564,4132,1240,3545,52,152,874,2479,926,2631
291080,201904,86520,231288,70456,207458,24577,74124,15585,49013,40162,123137
291085,201904,5614,14369,4711,13021,192,621,3925,10731,4117,11352
291090,201904,1929,3694,1422,3132,28,82,1200,2595,1228,2677
291100,201904,3088,6925,2163,5800,115,358,1651,4350,1766,4708
291110,201904,5851,17758,4991,16247,340,1387,3727,11667,4067,13054
291120,201904,7663,19083,6569,17636,386,1102,4925,13185,5311,14287
291125,201904,2158,3821,1577,3171,124,177,1189,2495,1313,2672
291130,201904,3132,9166,2360,7635,90,402,1675,5241,1765,5643
291140,201904,4721,13033,3499,10736,413,1117,2232,6913,2645,8030
291150,201904,2246,5164,1873,4737,13,40,1750,4406,1763,4446
291160,201904,4995,14080,4205,12900,398,1331,2784,8437,3182,9768
291165,201904,2138,5951,1663,5045,47,202,1198,3492,1245,3694
291170,201904,20430,52421,17287,47122,1010,2997,11259,30321,12269,33318
291180,201904,5789,13955,4461,12080,411,1073,3284,8947,3695,10020
291185,201904,3143,8628,2740,7945,84,271,2110,6065,2194,6336
291190,201904,7533,18858,6261,17149,343,1040,4880,13334,5223,14374
291200,201904,2823,7894,2107,6532,81,282,1300,3936,1381,4218
291210,201904,6817,15121,5247,13282,162,528,3912,9895,4074,10423
291220,201904,3971,11560,3602,10979,234,849,2781,8362,3015,9211
291230,201904,4361,9602,3387,8520,58,129,3023,7695,3081,7824
291240,201904,4161,10875,3614,9951,65,229,3091,8374,3156,8603
291250,201904,3399,10099,2672,8769,171,565,1730,5704,1901,6269
291260,201904,1397,3292,1200,3038,34,104,975,2487,1009,2591
291270,201904,5013,13740,4057,12250,651,1930,2575,7915,3226,9845
291280,201904,2439,6328,1851,5393,154,526,1126,3153,1280,3679
291290,201904,5791,15557,4595,13669,396,1275,3112,9193,3508,10468
291300,201904,3902,10606,2949,9007,134,452,2176,6558,2310,7010
291310,201904,5048,13693,4334,12347,123,430,3613,10081,3736,10511
291320,201904,5985,17222,4696,14729,1070,3109,2284,7561,3354,10670
291330,201904,1818,4619,1531,4132,76,195,1128,2971,1204,3166
291340,201904,4139,10852,3461,9717,81,278,2680,7377,2761,7655
291345,201904,2941,9038,2701,8658,124,450,2214,7090,2338,7540
291350,201904,6708,17090,5251,15219,83,262,4472,13162,4555,13424
291360,201904,34723,83290,27986,74837,3309,9094,17296,47162,20605,56256
291370,201904,7783,21657,7024,20531,519,1663,5244,15155,5763,16818
291380,201904,3294,9434,2959,8924,97,452,2441,7205,2538,7657
291390,201904,12754,28370,10069,25371,401,1053,8296,20833,8697,21886
291400,201904,13401,35663,11281,32445,1573,4106,6749,20765,8322,24871
291410,201904,2831,7557,2184,6462,49,225,1607,4630,1656,4855
291420,201904,1921,4800,1529,4309,40,162,1301,3632,1341,3794
291430,201904,2880,8154,2493,7522,101,446,1972,5774,2073,6220
291440,201904,6238,18244,5387,16811,314,1085,4245,13252,4559,14337
291450,201904,8723,22604,7329,20970,121,236,6410,18907,6531,19143
291460,201904,14949,40641,13223,38041,710,2298,9899,28250,10609,30548
291465,201904,8797,22659,7068,20633,197,883,5931,17140,6128,18023
291470,201904,15215,36062,12996,33553,644,1580,9698,25746,10342,27326
291480,201904,39784,90320,29356,75953,3755,10227,15307,39502,19062,49729
291490,201904,5363,13843,4715,13041,183,606,4175,11473,4358,12079
291500,201904,4967,12293,4156,11190,60,259,3751,10035,3811,10294
291510,201904,3863,10194,2997,9033,82,390,2404,7203,2486,7593
291520,201904,4427,10310,3413,8970,158,452,2606,6820,2764,7272
291530,201904,2197,5187,1588,4369,285,708,938,2794,1223,3502
291535,201904,3103,9477,2884,9100,164,496,2244,7180,2408,7676
291540,201904,2249,5163,1587,4353,51,203,1315,3496,1366,3699
291550,201904,5429,12754,4273,11227,399,932,2891,7713,3290,8645
291560,201904,18997,44034,13424,37069,1019,2754,8812,25247,9831,28001
291570,201904,2355,5644,1890,5060,66,161,1550,4266,1616,4427
291580,201904,6116,16356,4836,14603,260,918,3547,10530,3807,11448
291590,201904,1880,5069,1683,4799,127,417,1381,3860,1508,4277
291600,201904,4995,12536,3780,10604,463,1422,2348,6380,2811,7802
291610,201904,5572,15263,5187,14831,87,312,4789,13678,4876,13990
291620,201904,3134,7013,2295,6071,117,316,1759,4738,1876,5054
291630,201904,3187,7356,2373,6295,200,607,1783,4646,1983,5253
291640,201904,15129,38652,11594,33381,1881,5263,4949,15047,6830,20310
291650,201904,9068,23619,8024,22324,472,1047,6761,19144,7233,20191
291660,201904,2037,5018,1487,4145,128,430,973,2560,1101,2990
291670,201904,2044,5392,1738,4967,107,266,1341,3877,1448,4143
291680,201904,3994,10123,3253,8985,280,807,2346,6399,2626,7206
291685,201904,4631,11234,3705,10036,228,479,2819,7932,3047,8411
291690,201904,4209,9414,2853,7458,183,427,2203,5727,2386,6154
291700,201904,8425,24802,7560,23272,417,1485,6134,18580,6551,20065
291710,201904,5121,12634,3845,10804,268,845,2713,7470,2981,8315
291720,201904,4304,13439,3619,12033,409,1477,2373,7674,2782,9151
291730,201904,6279,16526,5441,15412,246,786,4481,12640,4727,13426
291733,201904,2895,7470,2445,6857,63,204,1808,5283,1871,5487
291735,201904,2900,7571,2350,6648,71,204,1854,5200,1925,5404
291740,201904,3812,9957,2915,8382,96,287,2152,6063,2248,6350
291750,201904,19280,46977,15708,41618,1557,4219,10469,27791,12026,32010
291760,201904,10169,30109,8057,26548,2540,9478,2101,6920,4641,16398
291770,201904,6924,19161,5798,17141,437,1366,4184,12086,4621,13452
291780,201904,5008,13571,4522,12852,96,375,3930,11022,4026,11397
291790,201904,2615,7504,2406,7224,259,676,1780,5478,2039,6154
291800,201904,28496,73541,21829,63373,3321,9328,11515,34496,14836,43824
291810,201904,10413,25430,8750,23349,236,735,7560,19999,7796,20734
291820,201904,3784,10133,3305,9468,108,351,2605,7491,2713,7842
291830,201904,4188,10327,3561,9451,212,556,2844,7567,3056,8123
291835,201904,6344,19075,4935,16292,717,2458,2884,9695,3601,12153
291840,201904,45863,127304,39829,118397,4589,14315,27369,81477,31958,95792
291845,201904,2360,6403,1928,5866,95,309,1576,4834,1671,5143
291850,201904,3898,11250,3251,10149,266,762,2331,7479,2597,8241
291855,201904,2159,4367,1709,3843,52,135,1525,3404,1577,3539
291860,201904,2237,5899,1552,4564,38,130,1057,2986,1095,3116
291870,201904,1303,3318,872,2560,55,169,578,1651,633,1820
291875,201904,2667,8104,2345,7454,84,318,1782,5499,1866,5817
291880,201904,5524,16051,4768,14726,274,874,3503,10794,3777,11668
291890,201904,1547,3316,1009,2672,137,335,662,1746,799,2081
291900,201904,1168,2979,908,2556,24,94,716,1952,740,2046
291905,201904,2625,6616,2058,5690,85,289,1539,4124,1624,4413
291910,201904,2820,7306,2401,6799,74,272,2065,5831,2139,6103
291915,201904,7242,20908,5988,18750,232,871,4495,14060,4727,14931
291920,201904,24649,66850,21391,62284,2460,7695,14330,41059,16790,48754
291930,201904,2420,6774,2068,6223,244,785,1351,4026,1595,4811
291940,201904,3817,9976,2550,7793,217,653,1480,4448,1697,5101
291950,201904,9016,27540,7758,25083,430,1615,5244,16786,5674,18401
291955,201904,14339,36804,12935,34975,1205,3315,10003,27261,11208,30576
291960,201904,3068,8292,2514,7506,136,454,1924,5828,2060,6282
291970,201904,4216,11215,3640,10427,174,614,2727,7804,2901,8418
291980,201904,9926,28309,7904,25048,675,2058,5293,16997,5968,19055
291990,201904,2145,5681,1866,5366,24,111,1772,5083,1796,5194
291992,201904,3975,9799,3070,8568,242,572,2411,6850,2653,7422
291995,201904,2139,5776,1727,5165,56,266,1345,3902,1401,4168
292000,201904,2592,6298,2108,5687,116,430,1610,4269,1726,4699
292010,201904,5875,13737,4826,12250,206,603,3964,9874,4170,10477
292020,201904,4508,13259,3772,11938,227,840,2732,8383,2959,9223
292030,201904,1739,5486,1646,5325,76,306,1060,3331,1136,3637
292040,201904,4249,11191,3413,9955,254,690,2625,7829,2879,8519
292045,201904,3972,10567,2942,9029,47,127,2581,8077,2628,8204
292050,201904,6445,18409,5177,16050,286,1011,3253,9924,3539,10935
292060,201904,11771,27410,10928,26368,573,1308,9404,22447,9977,23755
292070,201904,5674,14992,4988,14145,266,808,4289,12093,4555,12901
292080,201904,3190,8047,2642,7357,82,269,2333,6479,2415,6748
292090,201904,4514,9867,3275,8403,257,667,2492,6479,2749,7146
292100,201904,10114,25525,8624,23591,1030,2992,5604,15199,6634,18191
292105,201904,3343,8700,2948,8121,86,246,2397,6577,2483,6823
292110,201904,6020,15149,4286,12252,966,2809,1974,5641,2940,8450
292120,201904,6785,17739,5556,15594,396,1183,4130,11380,4526,12563
292130,201904,3343,8144,2744,7405,116,359,2135,5684,2251,6043
292140,201904,5096,12080,4216,10800,277,680,3357,8581,3634,9261
292145,201904,2331,6885,1961,6213,78,255,1472,4695,1550,4950
292150,201904,13325,37335,11881,35056,277,1211,9882,28658,10159,29869
292160,201904,2871,7221,2225,6385,60,185,1830,5371,1890,5556
292170,201904,8062,21929,6773,19753,458,1480,4875,13998,5333,15478
292180,201904,2784,7668,2038,6336,222,667,1238,3799,1460,4466
292190,201904,2844,7627,2442,7021,143,441,1820,5229,1963,5670
292200,201904,7741,20225,5889,17494,1069,3266,3101,9397,4170,12663
292205,201904,3839,10672,3324,9908,63,313,2907,8553,2970,8866
292210,201904,6252,14995,5107,13514,95,429,4531,11787,4626,12216
292220,201904,2050,5088,1811,4728,65,199,1404,3557,1469,3756
292225,201904,3168,9364,2805,8808,78,351,2363,7294,2441,7645
292230,201904,8329,20119,7460,18981,190,678,6330,15741,6520,16419
292240,201904,4711,13798,4065,12593,344,1043,2748,8526,3092,9569
292250,201904,5115,14075,4630,13310,535,1467,3140,9147,3675,10614
292260,201904,3296,8828,2963,8405,124,331,2552,7279,2676,7610
292265,201904,3305,9235,2801,8450,74,366,2187,6424,2261,6790
292270,201904,4262,9926,3418,8912,174,487,2765,7205,2939,7692
292273,201904,2617,5721,2086,5071,58,111,1573,4007,1631,4118
292275,201904,1635,4334,1307,3870,51,125,998,3004,1049,3129
292280,201904,2561,6171,2077,5609,98,218,1726,4812,1824,5030
292285,201904,2530,6221,1996,5473,88,214,1582,4388,1670,4602
292290,201904,7058,19384,5756,17457,183,690,4683,14162,4866,14852
292300,201904,9873,25714,7820,23015,804,2561,5245,15393,6049,17954
292303,201904,2857,8266,2516,7731,75,198,2132,6599,2207,6797
292305,201904,2453,6579,2271,6321,45,212,2011,5475,2056,5687
292310,201904,6611,17137,5701,16014,180,601,4856,13527,5036,14128
292320,201904,6116,16796,4941,14610,265,859,3643,10500,3908,11359
292330,201904,2743,6090,2156,5432,110,265,1666,4297,1776,4562
292335,201904,4666,12198,4172,11490,253,632,3494,9707,3747,10339
292340,201904,5709,15986,4806,14253,218,711,3590,10484,3808,11195
292350,201904,2529,6802,2074,6187,84,320,1685,5011,1769,5331
292360,201904,4824,12999,4037,11631,300,983,2816,7861,3116,8844
292370,201904,10700,24666,9248,22718,132,491,8500,20440,8632,20931
292380,201904,6793,19179,6082,17911,416,1256,4569,13346,4985,14602
292390,201904,4393,8610,3199,7220,104,239,2793,6284,2897,6523
292400,201904,21512,62701,18810,58251,1842,6029,12979,40095,14821,46124
292405,201904,4131,10372,3509,9428,135,349,2850,7615,2985,7964
292410,201904,2126,5127,1826,4757,59,176,1599,4150,1658,4326
292420,201904,3608,10977,3281,10437,150,705,2730,8474,2880,9179
292430,201904,4748,14489,3665,12535,299,1104,2417,8266,2716,9370
292440,201904,8354,26800,7724,25824,124,643,6938,23132,7062,23775
292450,201904,3794,11140,3072,9701,108,413,2373,7467,2481,7880
292460,201904,4804,13448,3964,12004,366,1051,2796,8487,3162,9538
292465,201904,2551,6773,2131,6200,89,230,1471,4552,1560,4782
292467,201904,1816,5213,1630,4962,228,631,1124,3547,1352,4178
292470,201904,2945,7550,2306,6526,68,151,1791,5078,1859,5229
292480,201904,6388,15227,5106,13673,79,300,4558,12024,4637,12324
292490,201904,2081,5536,1737,5025,104,297,1310,3829,1414,4126
292500,201904,6319,17700,5216,15672,557,1721,3400,10120,3957,11841
292510,201904,12348,33785,9868,30025,516,1923,7215,21848,7731,23771
292520,201904,6731,16972,5972,15866,560,1518,4465,11828,5025,13346
292525,201904,5642,13621,4714,12550,117,319,4099,10979,4216,11298
292530,201904,26289,71299,20572,61590,5502,16705,7412,22965,12914,39670
292540,201904,4130,8016,3282,7096,121,221,2884,6247,3005,6468
292550,201904,7732,21193,6028,19060,415,1412,4457,14508,4872,15920
292560,201904,4201,10776,3640,10011,81,274,3001,8227,3082,8501
292570,201904,3749,9771,3184,8856,73,273,2754,7496,2827,7769
292575,201904,6832,19922,6314,19225,287,938,5187,15795,5474,16733
292580,201904,7358,18877,6215,17178,148,491,5210,14241,5358,14732
292590,201904,7324,19469,6367,17901,271,865,5348,14702,5619,15567
292593,201904,2816,7013,2345,6231,81,194,1933,5116,2014,5310
292595,201904,5359,14223,4622,13316,170,577,3831,10882,4001,11459
292600,201904,10908,29858,9407,27590,393,1086,7382,21723,7775,22809
292610,201904,4111,10907,3489,9792,200,485,2536,7234,2736,7719
292620,201904,6289,17540,5317,16395,85,220,4975,15526,5060,15746
292630,201904,8360,20692,6886,18327,567,1521,4687,12469,5254,13990
292640,201904,8075,24199,7073,22523,213,938,5064,16117,5277,17055
292650,201904,4557,11227,4095,10623,132,398,3680,9386,3812,9784
292660,201904,11050,30348,9522,28099,480,1574,7405,21751,7885,23325
292665,201904,2171,6482,1936,6187,78,252,1641,5328,1719,5580
292670,201904,3526,9596,2729,8097,119,390,1879,5481,1998,5871
292680,201904,3940,10660,3163,9214,194,557,2290,6517,2484,7074
292690,201904,2616,6904,1845,5623,186,536,1114,3562,1300,4098
292700,201904,9699,26710,8479,24810,777,2177,5797,17414,6574,19591
292710,201904,2441,7714,2260,7467,50,197,2024,6732,2074,6929
292720,201904,8967,21775,7630,20253,275,765,6097,16368,6372,17133
292730,201904,4373,10377,4107,10050,196,314,3588,8924,3784,9238
292740,201904,313638,782591,277953,729678,42771,113532,169492,442013,212263,555545
292750,201904,6152,16563,5380,15411,268,792,4070,11764,4338,12556
292760,201904,3822,11166,3354,10325,244,814,2427,7411,2671,8225
292770,201904,5917,16077,4787,14436,756,2386,2909,9074,3665,11460
292780,201904,1972,4136,1479,3494,40,139,1178,2647,1218,2786
292790,201904,4061,8720,3143,7725,149,413,2674,6541,2823,6954
292800,201904,10888,27622,9433,25389,336,953,7800,20734,8136,21687
292805,201904,3424,8482,2693,7505,144,409,2058,5717,2202,6126
292810,201904,10453,28113,8295,24752,244,995,6165,17937,6409,18932
292820,201904,7426,20532,5366,17180,496,1721,3619,11392,4115,13113
292830,201904,2878,6774,2454,6243,84,279,2109,5311,2193,5590
292840,201904,8687,22947,7496,21318,174,684,6450,17886,6624,18570
292850,201904,2496,6754,2100,6148,142,475,1464,4180,1606,4655
292860,201904,16536,37654,14797,35495,657,1631,12295,29177,12952,30808
292870,201904,16886,43348,14739,40315,1064,3221,9791,26380,10855,29601
292880,201904,11012,30165,9522,27925,317,1349,7448,21082,7765,22431
292890,201904,6544,18728,5799,17572,251,985,4868,14551,5119,15536
292895,201904,2935,6432,2156,5245,90,221,1706,4088,1796,4309
292900,201904,2582,7139,2377,6812,53,227,1928,5352,1981,5579
292905,201904,4299,11496,3380,10108,182,629,2426,7167,2608,7796
292910,201904,4867,13489,4450,12852,250,802,3364,9616,3614,10418
292920,201904,9627,26679,9047,25861,258,1026,7869,22053,8127,23079
292925,201904,5355,15243,4609,13936,227,708,3390,10077,3617,10785
292930,201904,6409,19270,5507,17501,492,1805,3423,10546,3915,12351
292935,201904,2320,5993,1815,5423,38,195,1612,4811,1650,5006
292937,201904,2998,7343,2644,6913,70,220,2354,6143,2424,6363
292940,201904,2884,7492,2358,6665,193,449,1684,4925,1877,5374
292950,201904,9573,24746,8402,22945,467,1245,6340,17133,6807,18378
292960,201904,5202,12647,4423,11564,124,349,3536,9089,3660,9438
292970,201904,3805,11198,3340,10488,115,521,2767,8676,2882,9197
292975,201904,4396,9645,3904,9084,162,320,3493,8205,3655,8525
292980,201904,3276,8019,2648,7061,97,307,2119,5539,2216,5846
292990,201904,11232,30960,9473,27832,671,2157,6999,20281,7670,22438
293000,201904,2532,6163,2202,5685,38,146,1728,4474,1766,4620
293010,201904,17943,46548,14558,41079,1935,5649,8890,24952,10825,30601
293015,201904,7905,24757,6289,21547,449,1838,4260,14537,4709,16375
293020,201904,9739,28679,8819,27367,139,658,7822,24519,7961,25177
293030,201904,5313,14381,4062,12439,109,381,2783,8727,2892,9108
293040,201904,3860,10815,3352,10118,83,311,2904,8726,2987,9037
293050,201904,21415,53706,19104,50369,1176,3277,14205,37048,15381,40325
293060,201904,3447,9135,2830,8060,235,703,1989,5545,2224,6248
293070,201904,24351,60428,20780,55650,2529,7015,13785,37160,16314,44175
293075,201904,3329,10712,2950,10083,204,855,2305,7839,2509,8694
293076,201904,3558,8855,3194,8396,89,236,2741,7262,2830,7498
293077,201904,5996,16909,4843,15110,459,1467,3103,9982,3562,11449
293080,201904,4751,14083,4115,13009,116,517,3274,10130,3390,10647
293090,201904,3167,9309,2440,8102,239,855,1575,5207,1814,6062
293100,201904,5609,15270,4584,13396,257,804,3550,10256,3807,11060
293105,201904,3609,11507,3195,10660,198,720,2339,7682,2537,8402
293110,201904,2414,6062,2051,5546,73,294,1689,4411,1762,4705
293120,201904,4304,11873,3846,11135,118,316,3193,9248,3311,9564
293130,201904,3745,10399,3316,9836,85,353,2840,8336,2925,8689
293135,201904,28607,69218,21313,59097,3684,11162,9606,26844,13290,38006
293140,201904,2331,5343,2014,4942,78,198,1671,4069,1749,4267
293150,201904,5315,16127,4446,14498,391,1358,3025,9853,3416,11211
293160,201904,3843,9414,3277,8762,256,458,2682,7519,2938,7977
293170,201904,4467,9899,3900,9149,119,291,3329,7716,3448,8007
293180,201904,4462,12403,3683,11057,116,484,2927,8533,3043,9017
293190,201904,13988,38569,12241,36069,213,939,10661,31178,10874,32117
293200,201904,8019,20208,6523,17833,224,862,5183,13820,5407,14682
293210,201904,5218,13826,4404,12529,310,850,3354,9592,3664,10442
293220,201904,4955,13266,3725,11090,859,2593,1496,4599,2355,7192
293230,201904,3850,10082,2888,8669,241,813,1953,5916,2194,6729
293240,201904,4428,11756,3566,10332,88,255,2722,8091,2810,8346
293245,201904,3833,10387,3452,9848,165,505,2903,8193,3068,8698
293250,201904,5518,13485,4710,12382,227,591,3842,10091,4069,10682
293260,201904,4352,12136,3605,10967,114,361,2534,7670,2648,8031
293270,201904,6889,15772,5547,14317,459,777,4309,11856,4768,12633
293280,201904,4665,12420,4080,11592,254,633,3152,9019,3406,9652
293290,201904,13505,41113,12078,38816,2180,7023,7150,23577,9330,30600
293300,201904,5647,13852,4918,12762,294,726,3625,9468,3919,10194
293305,201904,3922,9801,3462,9197,39,120,3082,8145,3121,8265
293310,201904,2137,5481,1760,4844,61,177,1366,3695,1427,3872
293315,201904,4047,9861,3305,8710,160,398,2684,7036,2844,7434
293317,201904,2501,6215,2206,5783,148,329,1715,4525,1863,4854
293320,201904,10856,27768,9991,26755,343,949,8790,23455,9133,24404
293325,201904,1676,4329,1333,3836,189,544,855,2486,1044,3030
293330,201904,44279,135973,37689,124089,8355,27832,16622,56175,24977,84007
293340,201904,2280,6458,1894,5787,115,407,1289,3880,1404,4287
293345,201904,3260,9159,2660,8263,311,753,1843,6115,2154,6868
293350,201904,6637,18964,5847,18075,54,211,5391,16927,5445,17138
293360,201904,15074,38695,12902,35894,407,1580,11213,30654,11620,32234
310010,201904,825,1960,566,1588,57,193,261,676,318,869
310020,201904,2272,6478,1644,5309,346,1229,278,845,624,2074
310030,201904,1959,5731,1527,4942,232,832,928,2890,1160,3722
310040,201904,932,2456,756,2164,40,160,513,1385,553,1545
310050,201904,1498,4673,1320,4382,179,724,788,2521,967,3245
310060,201904,3180,9132,2780,8612,118,496,2273,6957,2391,7453
310070,201904,349,788,241,626,7,17,181,465,188,482
310080,201904,793,2173,532,1637,79,275,208,594,287,869
310090,201904,4463,12236,3657,10894,287,950,2639,7698,2926,8648
310100,201904,3245,9300,2758,8486,96,440,2210,6572,2306,7012
310110,201904,4619,12473,3649,10750,771,2477,1574,4451,2345,6928
310120,201904,635,1591,398,1187,56,197,221,589,277,786
310130,201904,361,991,306,904,40,146,196,540,236,686
310140,201904,232,708,169,591,37,145,52,157,89,302
310150,201904,4799,13258,3648,11106,608,2097,1558,4533,2166,6630
310160,201904,7037,18504,5181,15425,1154,3767,1657,4881,2811,8648
310163,201904,983,2917,779,2535,221,806,228,670,449,1476
310170,201904,8811,23145,7159,20547,673,1984,5042,14453,5715,16437
310180,201904,1678,4310,1264,3627,109,388,845,2319,954,2707
310190,201904,2830,8648,2261,7537,533,1974,321,1013,854,2987
310200,201904,1740,5300,1281,4344,231,874,521,1732,752,2606
310205,201904,1067,2986,798,2552,156,568,316,1003,472,1571
310210,201904,2641,7051,2162,6246,103,299,1629,4639,1732,4938
310220,201904,1110,3070,869,2647,87,294,597,1770,684,2064
310230,201904,2228,6388,1820,5589,222,775,1089,3127,1311,3902
310240,201904,879,2825,751,2596,51,212,518,1764,569,1976
310250,201904,1007,2741,819,2442,27,115,582,1701,609,1816
310260,201904,2730,7367,1704,5534,506,1898,374,897,880,2795
310270,201904,2660,6753,2089,5954,111,430,1691,4737,1802,5167
310280,201904,2287,5479,1775,4731,297,858,970,2451,1267,3309
310285,201904,1848,6066,1590,5616,177,742,945,3292,1122,4034
310290,201904,1128,3020,944,2692,203,665,503,1296,706,1961
310300,201904,1425,4360,1251,4051,175,703,670,1982,845,2685
310310,201904,300,775,199,587,32,97,106,313,138,410
310320,201904,504,1309,326,997,28,114,166,479,194,593
310330,201904,475,1124,280,767,36,115,122,301,158,416
310340,201904,7498,20940,6035,18415,943,2815,2989,9365,3932,12180
310350,201904,12070,29931,8180,23485,1816,5533,3017,8400,4833,13933
310360,201904,472,1129,358,981,12,39,264,705,276,744
310370,201904,1263,4030,1057,3622,220,814,321,1122,541,1936
310375,201904,828,2176,560,1759,100,336,241,747,341,1083
310380,201904,384,896,204,585,30,77,82,222,112,299
310390,201904,438,1339,346,1161,93,334,88,230,181,564
310400,201904,9232,22980,6463,18705,849,2834,3555,9988,4404,12822
310410,201904,796,2338,499,1780,101,387,148,484,249,871
310420,201904,3927,10281,2561,7574,422,1414,869,2303,1291,3717
310430,201904,1450,4032,941,3067,193,707,309,904,502,1611
310440,201904,565,1462,393,1159,26,112,233,663,259,775
310445,201904,1319,3867,993,3234,51,193,704,2236,755,2429
310450,201904,4653,11922,3498,10062,198,738,2592,7202,2790,7940
310460,201904,1579,4294,1096,3380,212,698,322,961,534,1659
310470,201904,3783,8328,2996,7295,291,774,2230,5391,2521,6165
310480,201904,961,2580,727,2152,103,332,454,1307,557,1639
310490,201904,2804,7888,2191,6798,299,1113,1121,3228,1420,4341
310500,201904,1371,3950,1000,3266,190,695,478,1522,668,2217
310510,201904,1899,5114,1204,3785,242,834,407,1287,649,2121
310520,201904,1260,3228,904,2614,132,362,501,1434,633,1796
310530,201904,748,1949,425,1303,63,227,119,285,182,512
310540,201904,3178,9235,2623,8245,609,2018,1109,3342,1718,5360
310550,201904,1240,3226,850,2550,73,282,498,1407,571,1689
310560,201904,13641,36892,9969,30391,1928,6634,3644,10021,5572,16655
310570,201904,1074,2898,856,2582,75,283,573,1672,648,1955
310590,201904,4033,10961,3248,9534,250,846,1870,5188,2120,6034
310600,201904,1367,4106,1102,3571,172,627,544,1631,716,2258
310610,201904,478,1286,300,983,55,202,156,469,211,671
310620,201904,159958,421160,117135,343067,21028,70222,50528,132606,71556,202828
310630,201904,4307,12052,3505,10512,269,940,2279,6603,2548,7543
310640,201904,979,3011,822,2688,190,695,302,922,492,1617
310650,201904,2380,7037,1754,5825,201,733,979,3136,1180,3869
310660,201904,1222,3372,1031,3131,39,139,862,2584,901,2723
310665,201904,1341,3527,1055,3109,40,158,866,2517,906,2675
310670,201904,50405,134509,42470,120488,4772,15653,27625,74231,32397,89884
310680,201904,675,1673,568,1519,24,80,451,1167,475,1247
310690,201904,1701,4655,1237,3849,126,451,681,2028,807,2479
310700,201904,484,1105,373,974,37,125,263,650,300,775
310710,201904,5263,15436,3762,13231,895,3664,495,1621,1390,5285
310720,201904,911,2282,721,2033,43,145,524,1430,567,1575
310730,201904,9309,26017,8024,23875,455,1722,5756,16724,6211,18446
310740,201904,5412,15379,3623,11522,642,2185,1119,3312,1761,5497
310750,201904,1192,2939,855,2451,125,419,374,977,499,1396
310760,201904,559,1496,406,1250,28,96,206,651,234,747
310770,201904,1068,3006,729,2464,97,380,350,1118,447,1498
310780,201904,3994,10082,3316,9021,108,340,2490,6681,2598,7021
310790,201904,1775,5669,1544,5174,421,1507,423,1375,844,2882
310800,201904,2179,6625,1580,5394,390,1558,98,302,488,1860
310810,201904,1120,2918,903,2517,47,155,623,1674,670,1829
310820,201904,1162,3058,698,2220,148,497,154,480,302,977
310825,201904,2421,7761,1974,6972,91,504,1543,5223,1634,5727
310830,201904,1528,4506,1042,3471,212,782,423,1321,635,2103
310840,201904,1850,5150,1303,4180,357,1247,308,876,665,2123
310850,201904,1488,4131,1264,3821,61,295,972,2795,1033,3090
310855,201904,3140,8513,2436,7372,202,726,1673,4919,1875,5645
310860,201904,6815,20012,5453,17257,523,1790,3327,10549,3850,12339
310870,201904,1036,2494,787,2127,79,217,558,1522,637,1739
310880,201904,1011,3047,780,2578,93,317,459,1472,552,1789
310890,201904,2230,6386,1435,4839,295,1078,191,550,486,1628
310900,201904,4064,11517,3056,9580,468,1565,1374,3976,1842,5541
310910,201904,1811,4664,1196,3595,124,447,202,534,326,981
310920,201904,1826,4908,1394,4216,251,790,716,2155,967,2945
310925,201904,934,2673,772,2384,95,330,502,1480,597,1810
310930,201904,5670,15342,4078,12733,787,2548,1968,6307,2755,8855
310940,201904,6196,15611,4982,13783,251,924,3618,9654,3869,10578
310945,201904,1234,3260,1002,2912,122,413,566,1572,688,1985
310950,201904,1832,5518,1230,4152,246,910,418,1268,664,2178
310960,201904,699,1838,420,1319,60,203,144,453,204,656
310970,201904,1153,3487,798,2716,197,731,154,462,351,1193
310980,201904,314,761,210,599,25,75,128,352,153,427
310990,201904,1236,3555,936,2991,204,668,406,1253,610,1921
311000,201904,3942,11319,2941,9604,769,2684,1122,3511,1891,6195
311010,201904,781,2424,629,2088,245,878,194,608,439,1486
311020,201904,963,2561,641,1966,66,225,306,909,372,1134
311030,201904,1489,3900,1009,3034,229,784,403,1096,632,1880
311040,201904,323,1043,255,873,69,246,74,234,143,480
311050,201904,2468,6446,1876,5542,407,1339,843,2378,1250,3717
311060,201904,2820,7580,1946,5804,311,1078,762,2067,1073,3145
311070,201904,2063,5434,1490,4496,188,691,738,2107,926,2798
311080,201904,1011,2467,834,2162,44,172,624,1506,668,1678
311090,201904,2019,6565,1577,5740,365,1491,475,1681,840,3172
311100,201904,2025,5921,1236,4323,284,1117,186,594,470,1711
311110,201904,3583,7563,1987,5270,409,1165,732,1967,1141,3132
311115,201904,1264,3070,1031,2738,57,170,821,2132,878,2302
311120,201904,6367,17116,4735,14043,775,2621,1665,4370,2440,6991
311130,201904,1843,4966,1416,4357,135,550,766,2249,901,2799
311140,201904,1369,3424,1015,2915,74,245,642,1820,716,2065
311150,201904,1506,4816,1195,4203,202,802,621,2098,823,2900
311160,201904,3606,10613,2504,8537,669,2552,703,2337,1372,4889
311170,201904,858,2292,686,2044,44,132,430,1332,474,1464
311180,201904,1293,2973,821,2278,170,502,355,983,525,1485
311190,201904,978,2715,712,2180,111,387,279,765,390,1152
311200,201904,1786,4917,1241,3856,285,963,363,1009,648,1972
311205,201904,851,2633,700,2323,47,218,417,1324,464,1542
311210,201904,980,2926,856,2765,111,334,634,2098,745,2432
311220,201904,719,2062,598,1846,69,242,331,947,400,1189
311230,201904,7523,22997,5635,19186,989,3563,2070,7225,3059,10788
311240,201904,964,2631,742,2320,178,607,343,1050,521,1657
311250,201904,847,2485,659,2148,154,515,283,893,437,1408
311260,201904,2413,6093,1526,4548,269,850,579,1624,848,2474
311265,201904,1221,3259,922,2764,45,168,656,1899,701,2067
311270,201904,2935,8954,2576,8346,175,787,1901,5860,2076,6647
311280,201904,1157,3090,526,1730,97,349,80,240,177,589
311290,201904,1854,5765,1712,5447,167,550,1157,3658,1324,4208
311300,201904,4579,13270,3793,11907,226,993,2918,8896,3144,9889
311310,201904,564,1615,477,1453,58,192,250,723,308,915
311320,201904,3038,9498,2568,8427,430,1606,1159,3505,1589,5111
311330,201904,4704,12882,3859,11467,448,1481,2139,6402,2587,7883
311340,201904,9859,28656,7818,24894,2293,7843,1968,6078,4261,13921
311350,201904,2198,5656,1534,4419,150,521,825,2126,975,2647
311360,201904,1091,2714,687,2072,214,726,188,522,402,1248
311370,201904,4348,11000,3220,9120,164,669,2022,5417,2186,6086
311380,201904,363,1117,286,966,74,262,97,338,171,600
311390,201904,1657,5225,1318,4763,554,2293,334,1047,888,3340
311400,201904,1372,3927,1000,3198,138,495,412,1171,550,1666
311410,201904,1574,4748,1295,4353,211,796,698,2386,909,3182
311420,201904,1501,4488,1011,3445,187,684,177,497,364,1181
311430,201904,3379,9289,2204,6885,436,1394,646,2045,1082,3439
311440,201904,2434,7136,1715,5849,369,1436,579,1936,948,3372
311450,201904,1680,5229,1235,4367,314,1243,298,895,612,2138
311455,201904,931,2192,641,1750,174,478,234,657,408,1135
311460,201904,478,1537,326,1221,69,332,93,309,162,641
311470,201904,434,1393,307,1091,76,313,55,181,131,494
311480,201904,1145,3206,984,2976,40,112,803,2467,843,2579
311490,201904,235,708,184,600,44,165,81,232,125,397
311500,201904,400,1040,298,878,29,97,179,516,208,613
311510,201904,2900,7873,1919,6037,326,1193,719,2058,1045,3251
311520,201904,557,1651,504,1541,96,336,276,803,372,1139
311530,201904,8441,20236,5292,15029,1310,4128,1326,3684,2636,7812
311535,201904,732,2025,490,1545,77,279,155,452,232,731
311540,201904,500,1589,438,1478,87,310,263,882,350,1192
311545,201904,2000,5783,1739,5417,96,385,1322,4038,1418,4423
311547,201904,1435,3739,1264,3471,41,126,902,2515,943,2641
311550,201904,2650,7604,2097,6539,331,1183,846,2513,1177,3696
311560,201904,278,629,190,508,29,87,104,249,133,336
311570,201904,1765,4169,1266,3473,53,157,977,2735,1030,2892
311580,201904,2146,4027,1380,3130,157,322,893,2074,1050,2396
311590,201904,476,1320,387,1189,65,221,203,603,268,824
311600,201904,1687,3866,1420,3539,56,158,1211,2956,1267,3114
311610,201904,2279,7712,1907,6854,288,1096,955,3396,1243,4492
311615,201904,2913,8725,2405,7856,154,578,1810,5814,1964,6392
311620,201904,409,1128,351,1053,22,84,276,814,298,898
311630,201904,1333,3706,1078,3205,89,289,709,2018,798,2307
311640,201904,520,1525,405,1305,76,292,192,571,268,863
311650,201904,1854,4923,1555,4443,131,452,1053,2879,1184,3331
311660,201904,2688,7801,1963,6445,374,1326,458,1296,832,2622
311670,201904,1510,3999,1110,3303,169,574,495,1488,664,2062
311680,201904,2093,6168,1581,5231,261,893,934,3077,1195,3970
311690,201904,550,1218,420,1053,46,111,297,787,343,898
311700,201904,2229,5441,1747,4757,33,141,1444,3818,1477,3959
311710,201904,1455,4302,1014,3446,251,936,365,1214,616,2150
311720,201904,407,1252,323,1091,33,143,178,579,211,722
311730,201904,4006,10280,2533,7585,779,2534,418,1269,1197,3803
311740,201904,786,2264,674,2118,30,84,597,1907,627,1991
311750,201904,3765,11685,3083,10495,471,1754,1617,5255,2088,7009
311760,201904,589,1732,489,1550,81,326,214,569,295,895
311770,201904,1936,5765,1504,4939,279,1011,614,1908,893,2919
311780,201904,1241,3697,836,2834,165,637,225,664,390,1301
311783,201904,2146,6108,1764,5421,59,273,1394,4128,1453,4401
311787,201904,684,1999,496,1580,79,289,184,501,263,790
311790,201904,1393,3714,917,2873,224,780,276,825,500,1605
311800,201904,4706,14437,3825,12509,740,2639,662,1952,1402,4591
311810,201904,950,2969,745,2585,59,244,453,1553,512,1797
311820,201904,749,1916,562,1608,81,259,315,851,396,1110
311830,201904,8076,23859,5568,18291,1546,5425,656,2068,2202,7493
311840,201904,3154,8475,2676,7784,274,874,1945,5584,2219,6458
311850,201904,314,867,256,763,15,46,164,478,179,524
311860,201904,54202,141102,41583,119515,6563,20067,22725,63072,29288,83139
311870,201904,1928,5189,1261,3961,201,704,459,1288,660,1992
311880,201904,6078,16160,5123,14811,301,826,3893,11383,4194,12209
311890,201904,1519,3853,1181,3362,107,362,785,2132,892,2494
311900,201904,707,1875,538,1637,62,216,348,1028,410,1244
311910,201904,4063,10590,3059,9258,573,1697,1592,4967,2165,6664
311920,201904,1966,5548,1578,4941,151,464,941,2980,1092,3444
311930,201904,3143,7890,2396,6804,865,2645,711,1892,1576,4537
311940,201904,13702,37275,10135,30432,1501,4976,4597,12947,6098,17923
311950,201904,2105,5956,1569,5023,89,411,1059,3287,1148,3698
311960,201904,524,1321,425,1167,28,124,268,629,296,753
311970,201904,430,1414,287,1049,59,244,61,187,120,431
311980,201904,417,1177,220,761,32,126,61,205,93,331
311990,201904,530,1297,345,1034,74,268,143,389,217,657
311995,201904,978,2756,516,1686,19,64,61,135,80,199
312000,201904,565,1527,471,1389,33,117,325,958,358,1075
312010,201904,874,2498,670,2144,65,243,395,1209,460,1452
312015,201904,1295,3918,1156,3675,62,279,891,2750,953,3029
312020,201904,1136,3579,916,3156,231,854,297,970,528,1824
312030,201904,1988,4957,1741,4669,24,103,1603,4267,1627,4370
312040,201904,773,2474,585,2042,57,209,255,868,312,1077
312050,201904,1217,3933,950,3376,222,921,258,809,480,1730
312060,201904,833,2128,548,1752,136,447,250,795,386,1242
312070,201904,867,2562,619,2062,63,240,310,985,373,1225
312080,201904,2683,6750,2003,5728,132,440,1269,3459,1401,3899
312083,201904,849,2292,640,1962,65,233,407,1197,472,1430
312087,201904,2314,6293,1931,5696,69,234,1489,4408,1558,4642
312090,201904,9238,25260,7083,21676,1238,4212,3276,9788,4514,14000
312100,201904,1536,4658,1138,3912,124,557,547,1797,671,2354
312110,201904,995,3165,835,2836,215,843,258,783,473,1626
312120,201904,720,2029,499,1632,157,590,150,411,307,1001
312125,201904,1567,4224,1320,3852,126,405,938,2640,1064,3045
312130,201904,907,2293,667,1886,61,191,271,720,332,911
312140,201904,732,2182,605,1917,131,453,243,696,374,1149
312150,201904,450,1283,383,1134,11,55,277,752,288,807
312160,201904,7769,22452,5914,19066,845,3130,2669,8102,3514,11232
312170,201904,882,2404,665,1997,38,141,458,1330,496,1471
312180,201904,1338,3735,1062,3181,155,499,534,1526,689,2025
312190,201904,567,1685,400,1344,84,295,93,310,177,605
312200,201904,4643,12604,3668,11034,996,3060,1489,4571,2485,7631
312210,201904,1312,3105,941,2551,48,165,661,1736,709,1901
312220,201904,1789,5593,1534,5109,120,436,948,3153,1068,3589
312230,201904,11623,31344,7650,23924,2064,7103,1329,3670,3393,10773
312235,201904,1797,4876,1455,4328,96,348,1021,2970,1117,3318
312240,201904,646,2154,493,1819,104,409,143,519,247,928
312245,201904,2487,6708,2067,6055,83,298,1647,4784,1730,5082
312247,201904,884,2251,628,1856,129,392,305,911,434,1303
312250,201904,949,2522,613,1855,99,309,241,714,340,1023
312260,201904,859,2472,696,2203,45,195,491,1484,536,1679
312270,201904,693,1946,528,1620,29,128,285,793,314,921
312280,201904,410,1210,317,1037,100,329,35,105,135,434
312290,201904,710,2163,567,1880,119,444,192,614,311,1058
312300,201904,897,2716,620,2067,164,587,114,309,278,896
312310,201904,768,2535,638,2266,100,403,277,946,377,1349
312320,201904,1728,4600,1268,3791,349,1104,251,701,600,1805
312330,201904,853,2559,683,2220,63,221,447,1411,510,1632
312340,201904,251,664,179,543,40,135,62,170,102,305
312350,201904,261,552,195,479,19,53,129,304,148,357
312352,201904,1603,4824,1413,4485,110,371,863,2891,973,3262
312360,201904,2465,7397,1809,6029,388,1394,462,1482,850,2876
312370,201904,1690,4706,1414,4213,231,791,727,2052,958,2843
312380,201904,2133,4945,1771,4483,10,34,1576,3958,1586,3992
312385,201904,1246,3518,965,2993,140,506,470,1362,610,1868
312390,201904,1836,5456,1379,4588,220,800,478,1454,698,2254
312400,201904,2743,8278,2215,7255,719,2460,649,2180,1368,4640
312410,201904,11150,31953,9155,28461,1756,5682,4645,14259,6401,19941
312420,201904,3536,10042,2984,9077,552,1793,1566,4662,2118,6455
312430,201904,7858,21020,6278,18213,523,1724,4195,11895,4718,13619
312440,201904,886,2889,679,2393,344,1281,69,204,413,1485
312450,201904,1134,3440,860,2923,250,896,284,993,534,1889
312460,201904,422,1119,285,899,35,134,159,512,194,646
312470,201904,460,1153,306,890,47,167,119,293,166,460
312480,201904,1107,2825,770,2339,114,363,375,1094,489,1457
312490,201904,2009,4993,1513,4229,211,602,786,2123,997,2725
312500,201904,876,2220,696,1953,49,175,470,1295,519,1470
312510,201904,3455,9446,2579,7797,670,1942,754,2331,1424,4273
312520,201904,146,464,132,437,36,116,62,202,98,318
312530,201904,545,1416,475,1327,20,67,416,1160,436,1227
312540,201904,1485,4344,981,3239,170,615,484,1542,654,2157
312550,201904,747,2037,554,1632,39,127,362,985,401,1112
312560,201904,1928,5038,1576,4516,65,245,1236,3517,1301,3762
312570,201904,2068,5405,1603,4787,485,1527,604,1824,1089,3351
312580,201904,586,1700,439,1381,64,229,192,560,256,789
312590,201904,1615,4840,1310,4240,117,497,755,2276,872,2773
312595,201904,1642,5100,1441,4737,299,927,840,2906,1139,3833
312600,201904,990,2470,519,1673,79,302,177,578,256,880
312610,201904,6134,16129,3927,11903,584,1930,1264,3613,1848,5543
312620,201904,2450,6373,1783,5452,54,245,1406,4354,1460,4599
312630,201904,262,827,197,702,39,166,77,268,116,434
312640,201904,549,1529,370,1219,50,165,125,432,175,597
312650,201904,2049,5400,1394,4122,79,253,942,2640,1021,2893
312660,201904,1331,3320,1009,2776,91,327,665,1724,756,2051
312670,201904,4871,13334,4020,11957,227,977,2814,7948,3041,8925
312675,201904,1193,3307,974,2952,62,255,762,2239,824,2494
312680,201904,1351,3887,1135,3565,64,288,893,2721,957,3009
312690,201904,2454,5682,1939,5023,95,282,1591,4041,1686,4323
312695,201904,922,2673,783,2430,46,125,593,1866,639,1991
312700,201904,2016,5423,1446,4362,155,537,805,2316,960,2853
312705,201904,1285,3331,1082,3008,23,88,926,2538,949,2626
312707,201904,1342,4047,1039,3476,69,359,642,2003,711,2362
312710,201904,6305,14631,3654,10425,1032,3190,949,2787,1981,5977
312720,201904,1000,2848,752,2431,96,344,423,1310,519,1654
312730,201904,1615,3928,1176,3322,92,295,694,1886,786,2181
312733,201904,1437,3822,1089,3175,36,136,728,2025,764,2161
312735,201904,622,1731,528,1548,70,240,341,899,411,1139
312737,201904,817,1931,553,1531,77,246,311,779,388,1025
312738,201904,579,1541,404,1222,58,197,194,550,252,747
312740,201904,424,1069,240,752,56,187,56,140,112,327
312750,201904,1347,4285,1076,3749,190,722,418,1374,608,2096
312760,201904,1795,5451,1301,4426,247,891,427,1391,674,2282
312770,201904,42560,103902,26382,76333,5968,18267,8177,23315,14145,41582
312780,201904,2398,7421,2025,6782,221,858,1283,4257,1504,5115
312790,201904,262,652,160,507,9,46,56,147,65,193
312800,201904,4735,13922,3693,11852,848,2949,1369,4262,2217,7211
312810,201904,1619,4406,1052,3443,260,963,330,943,590,1906
312820,201904,1752,4835,1433,4232,56,221,1034,2951,1090,3172
312825,201904,1305,3133,1121,2880,27,95,938,2365,965,2460
312830,201904,2331,6739,1460,5007,335,1287,358,1195,693,2482
312840,201904,1187,3439,914,2937,127,515,415,1232,542,1747
312850,201904,852,2163,597,1762,43,176,321,859,364,1035
312860,201904,1289,3299,850,2604,231,744,218,651,449,1395
312870,201904,6258,17390,3760,12298,639,2268,858,2666,1497,4934
312880,201904,1370,3517,1083,3054,49,193,590,1655,639,1848
312890,201904,2064,5465,1437,4341,139,437,655,1999,794,2436
312900,201904,1159,3090,933,2789,83,275,541,1710,624,1985
312910,201904,1596,2984,815,1951,140,293,305,690,445,983
312920,201904,1007,2795,681,2207,152,564,253,747,405,1311
312930,201904,2114,5526,1689,4879,353,1065,737,2095,1090,3160
312940,201904,894,2564,706,2263,91,343,344,1064,435,1407
312950,201904,3064,7760,1996,5992,514,1682,670,1917,1184,3599
312960,201904,1870,4989,1558,4520,110,307,1166,3478,1276,3785
312965,201904,1657,4849,1389,4378,138,442,896,2799,1034,3241
312970,201904,1142,3336,883,2890,166,644,428,1292,594,1936
312980,201904,21603,61851,17645,54575,2993,10305,9158,26766,12151,37071
312990,201904,440,1160,267,861,58,222,117,360,175,582
313000,201904,434,1286,330,1097,36,154,175,547,211,701
313005,201904,2503,7308,2123,6668,134,459,1554,4764,1688,5223
313010,201904,4555,13149,3713,11704,677,2407,2141,6498,2818,8905
313020,201904,902,2788,603,2092,110,417,101,298,211,715
313030,201904,1145,2794,767,2192,84,307,465,1249,549,1556
313040,201904,753,2399,608,2068,52,216,342,1096,394,1312
313050,201904,1734,4981,1216,4196,209,875,354,1074,563,1949
313055,201904,1824,5094,1646,4817,49,164,1391,4035,1440,4199
313060,201904,933,2381,625,1872,210,702,129,332,339,1034
313065,201904,1600,4994,1422,4687,74,330,1059,3366,1133,3696
313070,201904,953,2522,711,2083,70,220,416,1195,486,1415
313080,201904,359,999,259,811,63,225,83,209,146,434
313090,201904,4616,12931,3973,11802,532,1763,2413,7004,2945,8767
313100,201904,1341,3552,1029,3093,46,182,744,2202,790,2384
313110,201904,1451,3938,1031,3154,89,336,577,1625,666,1961
313115,201904,2400,7290,2002,6513,288,1036,1000,3040,1288,4076
313120,201904,3573,8626,2658,7406,304,909,1604,4468,1908,5377
313130,201904,27721,75024,21484,63082,2742,9110,11514,31854,14256,40964
313140,201904,553,1264,342,944,26,87,224,605,250,692
313150,201904,1328,3852,973,3143,272,931,269,813,541,1744
313160,201904,966,2552,740,2160,43,156,533,1508,576,1664
313170,201904,11097,32981,7821,26518,1425,5192,2881,9215,4306,14407
313180,201904,2168,5896,1522,4585,200,654,793,2316,993,2970
313190,201904,4198,12391,3052,9991,552,1919,1029,3147,1581,5066
313200,201904,1056,3041,915,2789,24,104,761,2227,785,2331
313210,201904,3659,10967,3029,9793,396,1417,1764,5508,2160,6925
313220,201904,1699,4580,1137,3499,183,648,403,1082,586,1730
313230,201904,2917,8240,2442,7666,80,293,2010,6372,2090,6665
313240,201904,8776,22293,5445,16814,1015,3556,2217,6342,3232,9898
313250,201904,5749,17313,4568,15035,651,2254,2303,7450,2954,9704
313260,201904,591,1569,409,1222,49,178,198,554,247,732
313270,201904,5429,14785,4357,13082,646,2014,2660,8044,3306,10058
313280,201904,426,1229,286,935,38,131,111,349,149,480
313290,201904,854,2748,658,2428,229,915,202,719,431,1634
313300,201904,1531,4372,1122,3596,302,1031,226,628,528,1659
313310,201904,1020,3108,811,2654,139,522,210,574,349,1096
313320,201904,2083,5597,1456,4577,290,1028,632,1976,922,3004
313330,201904,3860,10683,2975,9299,199,836,1924,5838,2123,6674
313340,201904,1272,2945,906,2414,98,266,633,1679,731,1945
313350,201904,2139,6143,1439,4605,219,796,542,1553,761,2349
313360,201904,1272,3259,868,2593,148,531,442,1220,590,1751
313370,201904,1281,3809,1123,3504,142,519,656,1918,798,2437
313375,201904,1642,4360,1017,3216,203,723,230,686,433,1409
313380,201904,5603,14627,3950,11509,795,2526,1668,4394,2463,6920
313390,201904,850,2781,746,2609,53,254,475,1574,528,1828
313400,201904,3593,9217,2826,8167,187,617,2153,6061,2340,6678
313410,201904,1264,3391,966,2857,67,222,700,2038,767,2260
313420,201904,14842,33782,7419,21059,1643,5113,982,2844,2625,7957
313430,201904,822,2446,628,2060,105,408,261,776,366,1184
313440,201904,5797,12814,3809,10172,292,830,2462,6543,2754,7373
313450,201904,603,1734,438,1397,93,328,139,382,232,710
313460,201904,2063,6171,1654,5515,340,1325,759,2389,1099,3714
313470,201904,2926,7517,2316,6648,243,671,1500,4379,1743,5050
313480,201904,875,2554,497,1693,81,293,129,392,210,685
313490,201904,1651,3888,791,2512,268,971,78,260,346,1231
313500,201904,415,1253,328,1048,41,136,122,361,163,497
313505,201904,9416,25509,8045,23676,304,1109,6590,19296,6894,20405
313507,201904,1455,3852,1200,3462,33,135,963,2723,996,2858
313510,201904,12233,34551,10045,30452,1270,4142,5086,14981,6356,19123
313520,201904,13261,38785,10803,34453,721,2727,7758,24236,8479,26963
313530,201904,511,1479,396,1261,19,70,193,582,212,652
313535,201904,2316,6411,2000,5823,138,356,1419,4083,1557,4439
313540,201904,775,2419,595,1956,112,363,230,719,342,1082
313545,201904,1171,3973,998,3614,167,628,537,1876,704,2504
313550,201904,1694,5240,1408,4573,348,1256,649,1993,997,3249
313560,201904,2542,5172,1882,4368,70,138,1588,3675,1658,3813
313570,201904,929,2834,752,2499,187,664,292,923,479,1587
313580,201904,5375,14536,4094,12370,514,1662,2277,7001,2791,8663
313590,201904,918,2703,725,2412,227,808,296,1015,523,1823
313600,201904,3703,10323,3102,9351,100,412,2557,7563,2657,7975
313610,201904,970,2521,778,2176,103,299,467,1248,570,1547
313620,201904,5240,14319,4197,12430,647,2102,2261,6459,2908,8561
313630,201904,8087,20370,5620,16557,666,2288,3097,8937,3763,11225
313640,201904,989,2403,613,1890,192,615,182,572,374,1187
313650,201904,1720,5266,1420,4762,97,392,936,3146,1033,3538
313652,201904,763,2522,697,2368,122,465,411,1345,533,1810
313655,201904,1076,2884,867,2597,47,159,674,2002,721,2161
313657,201904,1230,3344,960,2899,46,204,696,1989,742,2193
313660,201904,848,2432,689,2132,94,360,390,1110,484,1470
313665,201904,4447,12282,3446,10514,510,1751,1955,5708,2465,7459
313670,201904,44120,112321,28357,84879,4816,15836,11529,32668,16345,48504
313680,201904,987,2704,828,2454,65,222,533,1520,598,1742
313690,201904,813,2637,631,2264,151,576,184,622,335,1198
313695,201904,1690,4781,1316,4160,92,322,901,2831,993,3153
313700,201904,2969,9786,2608,9317,242,912,1977,7058,2219,7970
313710,201904,1320,3202,937,2644,82,243,632,1787,714,2030
313720,201904,5126,14521,3744,11716,553,1951,1622,4687,2175,6638
313730,201904,1260,2984,965,2588,83,197,636,1687,719,1884
313740,201904,1627,5851,1323,5067,333,1442,215,708,548,2150
313750,201904,1862,5213,1442,4382,310,1041,592,1672,902,2713
313753,201904,2098,5109,1399,3982,148,460,794,2166,942,2626
313760,201904,4901,13847,3617,11317,831,2773,1374,4074,2205,6847
313770,201904,3692,10634,2967,9469,212,748,2112,6756,2324,7504
313780,201904,3935,10813,2891,8986,287,1045,778,2462,1065,3507
313790,201904,470,1498,416,1391,58,216,220,703,278,919
313800,201904,1293,3115,972,2629,139,430,514,1300,653,1730
313810,201904,1571,4124,1237,3636,66,251,907,2613,973,2864
313820,201904,14151,34495,9337,25816,1534,4617,3319,8868,4853,13485
313830,201904,350,1008,259,815,54,182,105,298,159,480
313835,201904,894,2708,729,2388,72,277,368,1139,440,1416
313840,201904,6371,17126,4590,14011,1196,3845,960,3012,2156,6857
313850,201904,909,2285,733,2033,116,394,388,964,504,1358
313860,201904,2542,7094,1885,5771,301,1015,722,2052,1023,3067
313862,201904,1460,3261,712,2093,57,184,347,969,404,1153
313865,201904,2225,6174,1916,5671,127,396,1438,4165,1565,4561
313867,201904,1088,3452,918,3121,239,867,467,1563,706,2430
313868,201904,1682,5269,1401,4697,64,310,1053,3400,1117,3710
313870,201904,771,2148,567,1773,116,387,187,523,303,910
313880,201904,1434,3873,1043,3212,181,616,457,1276,638,1892
313890,201904,1951,4469,1436,3798,81,255,995,2591,1076,2846
313900,201904,3711,11240,2754,9283,725,2697,662,2079,1387,4776
313910,201904,583,1779,427,1476,97,363,86,286,183,649
313920,201904,2861,9162,2405,8211,503,1709,1184,4068,1687,5777
313925,201904,1555,4088,1251,3526,210,569,758,2135,968,2704
313930,201904,4734,14532,3847,12926,317,1236,2501,8249,2818,9485
313940,201904,8022,24011,5766,19965,1061,4344,1363,5132,2424,9476
313950,201904,4770,11048,3456,9349,465,1599,2057,5422,2522,7021
313960,201904,5224,13325,3578,10460,780,2527,1165,3162,1945,5689
313970,201904,1333,3792,1164,3501,28,102,737,2204,765,2306
313980,201904,1292,3447,847,2720,125,463,309,938,434,1401
313990,201904,1751,5824,1280,4687,342,1379,371,1213,713,2592
314000,201904,9219,24826,7758,22287,515,1904,5266,14829,5781,16733
314010,201904,1337,3375,1075,3010,48,172,803,2173,851,2345
314015,201904,1959,5511,1503,4786,216,832,784,2394,1000,3226
314020,201904,485,1352,290,966,59,243,51,178,110,421
314030,201904,741,2196,592,1907,72,246,295,931,367,1177
314040,201904,633,1735,513,1502,92,298,259,727,351,1025
314050,201904,1647,4501,1184,3638,161,584,590,1675,751,2259
314053,201904,1770,5369,1419,4648,266,847,714,2455,980,3302
314055,201904,2269,6245,1945,5756,52,212,1578,4676,1630,4888
314060,201904,1189,3247,898,2775,42,157,613,1871,655,2028
314070,201904,4399,12414,3445,10669,740,2332,1443,4376,2183,6708
314080,201904,2112,5714,1350,4285,201,765,493,1375,694,2140
314085,201904,2025,6061,1674,5503,310,1078,846,2815,1156,3893
314090,201904,4011,11585,3414,10624,246,1003,2251,6901,2497,7904
314100,201904,3074,7365,2406,6435,73,198,1853,4966,1926,5164
314110,201904,4115,12136,3397,10714,444,1628,1833,5384,2277,7012
314120,201904,789,1830,301,921,70,251,53,161,123,412
314130,201904,658,1765,377,1198,32,120,194,602,226,722
314140,201904,4520,13214,3488,11131,539,1843,1618,5012,2157,6855
314150,201904,1431,3679,1065,3036,97,301,697,1898,794,2199
314160,201904,2173,5918,1563,4808,240,790,633,1976,873,2766
314170,201904,956,2730,763,2339,64,220,459,1309,523,1529
314180,201904,5287,15167,4339,13601,395,1399,2522,7859,2917,9258
314190,201904,586,1542,415,1285,86,301,179,501,265,802
314200,201904,2797,8072,2291,7182,131,526,1634,4952,1765,5478
314210,201904,1936,5180,1531,4440,145,436,825,2330,970,2766
314220,201904,1264,3598,901,2939,214,816,305,909,519,1725
314225,201904,1076,3141,910,2883,76,238,651,2080,727,2318
314230,201904,747,1990,613,1821,81,261,376,1147,457,1408
314240,201904,1011,2762,782,2431,181,593,311,985,492,1578
314250,201904,513,1449,325,1059,48,176,121,357,169,533
314260,201904,903,2665,727,2380,164,609,372,1152,536,1761
314270,201904,3141,9088,2556,8160,99,404,1873,5891,1972,6295
314280,201904,3207,7539,2054,5711,280,857,964,2506,1244,3363
314290,201904,4327,11478,3625,10250,347,1004,2455,6818,2802,7822
314300,201904,1687,5027,1170,3853,258,925,362,1139,620,2064
314310,201904,4292,11643,2985,9343,926,3095,536,1573,1462,4668
314315,201904,894,3185,769,2907,58,286,524,1904,582,2190
314320,201904,2682,7401,1739,5635,336,1157,650,2074,986,3231
314330,201904,46031,130666,34745,110908,9970,33196,7696,25609,17666,58805
314340,201904,2209,5609,1213,3759,266,972,279,694,545,1666
314345,201904,1354,4133,1123,3717,159,546,656,2131,815,2677
314350,201904,877,2478,590,1947,128,464,146,448,274,912
314360,201904,563,1634,347,1168,59,214,98,300,157,514
314370,201904,675,1878,527,1640,28,121,379,1129,407,1250
314380,201904,1077,3074,739,2420,180,673,148,470,328,1143
314390,201904,11781,31338,7589,23358,1618,5332,2148,5914,3766,11246
314400,201904,3863,11626,3021,10078,818,2870,1075,3669,1893,6539
314410,201904,2692,7606,1822,5922,272,1003,638,2171,910,3174
314420,201904,776,1920,590,1670,16,79,438,1182,454,1261
314430,201904,6825,17724,4857,14240,830,2550,2020,5703,2850,8253
314435,201904,1531,4281,1234,3775,45,182,909,2739,954,2921
314437,201904,929,2428,651,1956,57,209,318,936,375,1145
314440,201904,580,1690,419,1375,111,392,92,261,203,653
314450,201904,1298,3592,1082,3243,105,362,658,1904,763,2266
314460,201904,3238,10128,2335,8088,591,2172,441,1489,1032,3661
314465,201904,2156,6381,1867,5805,52,237,1426,4249,1478,4486
314467,201904,806,2245,697,2055,28,90,559,1616,587,1706
314470,201904,2140,6316,1714,5392,325,1132,741,2160,1066,3292
314480,201904,5858,17445,4218,13857,751,2705,1290,3811,2041,6516
314490,201904,951,2679,706,2150,80,280,410,1202,490,1482
314500,201904,1575,4048,1146,3368,219,659,477,1391,696,2050
314505,201904,1893,4782,1561,4313,104,307,1135,3078,1239,3385
314510,201904,1803,4808,1238,3923,259,907,543,1672,802,2579
314520,201904,4244,13396,3003,10598,592,2275,360,1123,952,3398
314530,201904,5366,17789,4823,16719,415,1714,3371,11440,3786,13154
314535,201904,2536,6761,2066,6053,124,479,1544,4431,1668,4910
314537,201904,1081,3151,837,2723,57,224,582,1851,639,2075
314540,201904,411,1078,283,835,23,85,135,374,158,459
314545,201904,1707,4390,1512,4137,44,124,1260,3570,1304,3694
314550,201904,635,1595,478,1363,37,148,250,631,287,779
314560,201904,3914,12209,2941,9997,498,1805,941,2989,1439,4794
314570,201904,285,799,220,681,28,104,98,304,126,408
314580,201904,431,1317,324,1099,92,318,79,278,171,596
314585,201904,644,2063,488,1701,61,272,238,775,299,1047
314587,201904,1973,5525,1499,4765,199,569,831,2713,1030,3282
314590,201904,3487,9887,2426,7791,381,1355,913,2749,1294,4104
314600,201904,1791,5096,1053,3626,224,838,114,343,338,1181
314610,201904,8422,22222,5872,18420,1149,4159,2354,7220,3503,11379
314620,201904,2103,5074,1647,4474,56,212,1349,3564,1405,3776
314625,201904,1474,4238,1250,3918,49,270,1016,3094,1065,3364
314630,201904,5029,13344,4144,12100,117,475,3430,10016,3547,10491
314640,201904,623,1560,441,1259,75,244,214,557,289,801
314650,201904,851,2077,519,1549,48,175,250,657,298,832
314655,201904,1539,4333,1106,3534,198,639,503,1579,701,2218
314660,201904,321,778,207,555,8,14,125,320,133,334
314670,201904,1649,3831,1153,3129,34,115,720,1931,754,2046
314675,201904,1679,4588,1463,4217,102,374,1120,3111,1222,3485
314690,201904,2018,5863,1545,5108,469,1676,427,1428,896,3104
314700,201904,9678,28075,6189,20943,1276,4713,1591,5226,2867,9939
314710,201904,7314,20966,5228,16592,1157,3999,1265,3562,2422,7561
314720,201904,2058,6240,1406,4839,308,1182,351,1172,659,2354
314730,201904,1992,5668,1425,4532,351,1155,360,1106,711,2261
314740,201904,2719,7818,2154,6811,303,1069,1101,3393,1404,4462
314750,201904,306,859,241,731,20,71,129,355,149,426
314760,201904,1807,5581,1168,4067,172,686,292,843,464,1529
314770,201904,1062,3175,534,1758,53,187,137,402,190,589
314780,201904,340,830,223,653,48,167,114,295,162,462
314790,201904,9264,25837,6442,20565,1675,6050,1765,5213,3440,11263
314795,201904,1396,3806,1191,3456,40,174,934,2594,974,2768
314800,201904,10500,27190,6099,18845,1193,4025,1237,3438,2430,7463
314810,201904,8056,22372,5913,18542,1635,5401,1760,5544,3395,10945
314820,201904,985,2532,765,2180,57,229,494,1335,551,1564
314830,201904,1415,4430,1196,3982,258,921,546,1814,804,2735
314840,201904,870,2844,678,2522,61,319,459,1623,520,1942
314850,201904,1886,4701,1537,4219,45,155,1327,3634,1372,3789
314860,201904,3072,9487,2555,8448,327,1261,1588,5074,1915,6335
314870,201904,6055,16086,4649,14125,337,1139,3348,10197,3685,11336
314875,201904,1684,5182,1506,4943,111,315,1206,4012,1317,4327
314880,201904,865,2115,679,1851,29,82,456,1285,485,1367
314890,201904,401,1196,290,940,51,184,109,319,160,503
314900,201904,612,1683,474,1440,101,332,182,542,283,874
314910,201904,1586,4662,1186,4003,259,1012,569,1793,828,2805
314915,201904,2213,6641,1867,6037,138,486,1235,3893,1373,4379
314920,201904,454,1188,289,933,9,36,195,623,204,659
314930,201904,5046,14930,3823,12584,763,2732,1386,4309,2149,7041
314940,201904,396,1041,334,931,37,99,199,520,236,619
314950,201904,441,1167,282,904,27,116,121,337,148,453
314960,201904,776,1988,606,1675,35,110,435,1132,470,1242
314970,201904,781,2284,619,1984,98,351,314,947,412,1298
314980,201904,1280,3461,929,2901,230,825,324,977,554,1802
314990,201904,2266,6652,1526,4928,332,1201,318,874,650,2075
314995,201904,1600,4592,1278,4000,68,294,822,2454,890,2748
315000,201904,1070,2854,771,2371,62,203,501,1486,563,1689
315010,201904,375,1080,275,889,48,194,122,361,170,555
315015,201904,2149,6276,1894,5842,185,636,1225,3741,1410,4377
315020,201904,757,2315,552,1852,65,268,228,681,293,949
315030,201904,563,1572,369,1190,92,310,79,236,171,546
315040,201904,795,2361,680,2084,91,302,428,1308,519,1610
315050,201904,1092,2897,832,2510,67,268,454,1332,521,1600
315053,201904,1125,2995,861,2526,61,197,496,1396,557,1593
315057,201904,1582,5095,1367,4670,162,573,872,3004,1034,3577
315060,201904,549,1696,387,1358,73,269,94,314,167,583
315070,201904,546,1464,383,1166,97,326,100,273,197,599
315080,201904,2578,7857,2000,6652,364,1229,1004,3272,1368,4501
315090,201904,769,2417,559,1975,99,375,188,632,287,1007
315100,201904,1151,3565,724,2547,137,545,283,884,420,1429
315110,201904,1582,4123,1185,3455,137,400,574,1695,711,2095
315120,201904,11169,27064,8080,22269,1098,2935,4175,11918,5273,14853
315130,201904,1285,3776,1033,3287,149,557,405,1200,554,1757
315140,201904,2767,7847,2102,6618,403,1427,1029,3007,1432,4434
315150,201904,4094,10277,2852,8218,437,1413,1263,3522,1700,4935
315160,201904,1553,3968,1004,3057,213,652,425,1283,638,1935
315170,201904,1363,4413,925,3322,226,839,179,642,405,1481
315180,201904,16059,40375,8299,25367,1225,4269,2319,6217,3544,10486
315190,201904,2013,4643,1590,4074,214,557,1164,2964,1378,3521
315200,201904,3578,10628,2600,8811,792,2910,613,2018,1405,4928
315210,201904,7760,20843,5458,15846,680,2179,2545,6686,3225,8865
315213,201904,1106,2977,951,2755,23,78,761,2175,784,2253
315217,201904,2518,7791,1981,6845,94,453,1316,4391,1410,4844
315220,201904,7759,21764,6264,19110,1530,4933,2371,7218,3901,12151
315230,201904,3022,7226,2532,6624,134,260,2010,5473,2144,5733
315240,201904,2289,7038,1974,6457,489,1717,1012,3235,1501,4952
315250,201904,10489,29634,7651,24275,1304,4470,3218,9788,4522,14258
315260,201904,973,2797,512,1730,85,281,38,116,123,397
315270,201904,790,2360,530,1837,76,299,153,436,229,735
315280,201904,2768,7103,1610,4886,378,1235,241,725,619,1960
315290,201904,1148,2926,682,2177,192,662,180,586,372,1248
315300,201904,669,1616,430,1281,123,410,154,465,277,875
315310,201904,1276,3689,950,3056,79,271,526,1603,605,1874
315320,201904,681,2025,479,1626,64,275,206,637,270,912
315330,201904,736,2581,412,1668,75,340,116,410,191,750
315340,201904,2960,7437,2182,6305,149,496,1365,3894,1514,4390
315350,201904,1484,4165,1143,3589,172,610,611,1885,783,2495
315360,201904,1646,5061,1195,4045,181,652,471,1509,652,2161
315370,201904,428,1271,336,1076,63,193,136,428,199,621
315380,201904,169,527,128,425,34,116,20,44,54,160
315390,201904,1115,3313,852,2791,167,618,324,971,491,1589
315400,201904,3927,11172,3091,9602,438,1418,1584,4742,2022,6160
315410,201904,2231,5230,1722,4479,434,1222,359,943,793,2165
315415,201904,1190,3364,947,2980,222,825,389,1208,611,2033
315420,201904,1149,3387,744,2584,146,526,112,372,258,898
315430,201904,3453,8644,2418,7031,459,1585,976,2620,1435,4205
315440,201904,961,2622,779,2311,84,308,433,1183,517,1491
315445,201904,1971,4863,1420,4052,114,360,986,2778,1100,3138
315450,201904,2125,6174,1764,5592,234,720,1101,3516,1335,4236
315460,201904,32330,94335,26812,84177,5579,19241,12313,36416,17892,55657
315470,201904,444,1263,355,1102,32,121,205,600,237,721
315480,201904,1216,3613,848,2804,170,589,260,842,430,1431
315490,201904,2930,7368,1986,5907,269,850,724,2105,993,2955
315500,201904,487,1348,291,908,34,135,123,325,157,460
315510,201904,1213,3357,1050,3106,30,140,893,2572,923,2712
315520,201904,1038,2915,816,2533,57,206,588,1782,645,1988
315530,201904,588,1761,450,1484,153,544,177,553,330,1097
315540,201904,1308,3628,887,2824,109,423,368,1135,477,1558
315550,201904,1806,4846,1181,3722,263,936,310,941,573,1877
315560,201904,6159,19328,5299,17716,337,1149,3482,11746,3819,12895
315570,201904,1841,5268,1535,4731,90,401,916,2682,1006,3083
315580,201904,2256,5742,1716,4860,320,1037,608,1656,928,2693
315590,201904,883,2376,700,2081,91,324,346,965,437,1289
315600,201904,2367,7727,1727,6457,264,974,918,3556,1182,4530
315610,201904,872,2272,659,1861,123,417,289,697,412,1114
315620,201904,321,1014,286,957,42,154,176,593,218,747
315630,201904,862,2425,674,2098,143,490,247,698,390,1188
315640,201904,322,864,269,796,31,115,165,458,196,573
315645,201904,937,2493,624,1954,154,523,158,465,312,988
315650,201904,1681,4303,1349,3821,35,152,1103,3006,1138,3158
315660,201904,2427,5978,1816,4924,111,323,1269,3314,1380,3637
315670,201904,12877,36755,9944,31337,2131,7028,4203,12835,6334,19863
315680,201904,2969,9036,2172,7435,373,1392,944,3095,1317,4487
315690,201904,2471,6576,1632,5039,380,1185,498,1687,878,2872
315700,201904,7465,21401,5650,17727,965,3222,2508,7538,3473,10760
315710,201904,1825,4671,1313,3881,54,233,910,2563,964,2796
315720,201904,4136,11902,3480,10704,192,842,2415,7106,2607,7948
315725,201904,1832,5207,1413,4396,156,481,929,2946,1085,3427
315727,201904,523,1399,387,1160,56,190,151,431,207,621
315730,201904,610,1885,534,1733,68,250,236,727,304,977
315733,201904,1331,3474,915,2714,142,509,333,927,475,1436
315737,201904,1085,3207,864,2777,46,188,597,1855,643,2043
315740,201904,893,2576,699,2167,104,383,390,1110,494,1493
315750,201904,1212,3330,976,2926,79,250,628,1898,707,2148
315760,201904,1143,2772,1040,2644,40,109,895,2252,935,2361
315765,201904,1834,4968,1501,4537,38,124,1302,3929,1340,4053
315770,201904,918,2773,763,2552,283,1042,205,624,488,1666
315780,201904,26703,76121,22527,68550,1824,6788,14445,41849,16269,48637
315790,201904,3505,11028,2995,10054,237,820,1930,6625,2167,7445
315800,201904,1183,4383,833,3376,153,690,192,726,345,1416
315810,201904,1277,3226,1075,2908,47,172,851,2183,898,2355
315820,201904,2500,7141,2047,6428,213,768,1380,4251,1593,5019
315830,201904,1036,3047,758,2523,66,246,319,1013,385,1259
315840,201904,802,1998,508,1453,54,189,234,608,288,797
315850,201904,1102,3358,887,2974,174,637,446,1410,620,2047
315860,201904,487,1476,338,1191,82,312,85,280,167,592
315870,201904,450,1194,353,1051,34,119,235,649,269,768
315880,201904,1079,2808,711,2173,83,323,178,477,261,800
315890,201904,1546,4623,1235,4161,336,1219,572,1865,908,3084
315895,201904,5782,16050,4403,13304,490,1679,2217,6256,2707,7935
315900,201904,800,2107,693,1957,49,157,517,1411,566,1568
315910,201904,495,1475,412,1334,65,246,263,811,328,1057
315920,201904,1541,4083,826,2581,139,481,241,687,380,1168
315930,201904,1047,2461,694,1915,132,363,296,821,428,1184
315935,201904,760,2344,617,2065,118,417,208,701,326,1118
315940,201904,582,1693,467,1491,55,191,242,746,297,937
315950,201904,1142,3215,965,2924,98,284,739,2259,837,2543
315960,201904,3910,11205,2264,7842,749,2994,153,339,902,3333
315970,201904,621,1672,480,1481,62,207,318,982,380,1189
315980,201904,4118,9206,2211,6016,385,1096,742,1851,1127,2947
315990,201904,3482,8992,2721,7710,295,911,1586,4373,1881,5284
316000,201904,513,1396,389,1217,66,256,168,484,234,740
316010,201904,789,2114,592,1789,33,124,382,1068,415,1192
316020,201904,948,2921,770,2568,79,337,460,1405,539,1742
316030,201904,2793,7844,2057,6545,237,794,1290,4169,1527,4963
316040,201904,2445,7353,1783,6041,292,1057,430,1335,722,2392
316045,201904,2005,5361,1807,5098,88,198,1511,4367,1599,4565
316050,201904,366,1083,274,917,40,152,149,474,189,626
316060,201904,664,1808,498,1542,28,118,337,970,365,1088
316070,201904,5239,15092,4303,13263,793,2563,1933,5764,2726,8327
316080,201904,703,2227,544,1885,136,506,72,237,208,743
316090,201904,402,1224,285,961,35,143,127,373,162,516
316095,201904,1229,3899,1006,3363,232,822,383,1241,615,2063
316100,201904,2447,7479,1727,5834,319,1170,554,1700,873,2870
316105,201904,839,2274,647,1978,54,191,433,1344,487,1535
316110,201904,12515,37701,10533,34264,983,3551,6990,22567,7973,26118
316120,201904,1075,3208,666,2168,123,433,173,450,296,883
316130,201904,1180,2674,718,1930,57,182,403,1046,460,1228
316140,201904,1090,2988,716,2297,117,405,346,1087,463,1492
316150,201904,1708,3909,1410,3521,207,637,588,1351,795,1988
316160,201904,1002,2824,815,2493,59,214,520,1533,579,1747
316165,201904,884,2246,660,1887,99,334,339,911,438,1245
316170,201904,1053,2739,783,2329,72,262,495,1407,567,1669
316180,201904,1192,3489,793,2640,164,621,141,394,305,1015
316190,201904,2548,7447,1489,4876,234,770,522,1501,756,2271
316200,201904,3168,9420,2282,7688,522,1947,484,1553,1006,3500
316210,201904,4199,12567,3008,9825,987,3449,363,1118,1350,4567
316220,201904,590,1807,386,1323,85,325,45,177,130,502
316225,201904,1443,3398,1094,2805,42,166,812,1937,854,2103
316230,201904,398,1099,306,951,33,101,169,544,202,645
316240,201904,5540,16368,4903,15289,414,1382,3697,11354,4111,12736
316245,201904,2826,9634,2547,9155,151,888,1904,6505,2055,7393
316250,201904,9379,23614,6580,19046,1572,4917,2032,5770,3604,10687
316255,201904,2813,8039,2451,7451,178,604,1767,5397,1945,6001
316257,201904,1208,2993,853,2417,132,382,446,1252,578,1634
316260,201904,1819,4854,1373,4128,115,370,723,2265,838,2635
316265,201904,1126,3083,886,2672,37,133,613,1803,650,1936
316270,201904,3486,11139,2966,9957,540,1917,1365,4373,1905,6290
316280,201904,2865,8629,2450,7829,359,1260,1320,4091,1679,5351
316290,201904,3257,9259,2567,7917,339,1212,1035,3133,1374,4345
316292,201904,4659,12721,3822,11368,479,1586,2589,7507,3068,9093
316294,201904,772,2344,566,1984,104,423,119,398,223,821
316295,201904,2713,7814,2236,6957,132,536,1572,4644,1704,5180
316300,201904,939,2910,803,2670,54,210,548,1810,602,2020
316310,201904,845,2233,510,1642,93,354,96,258,189,612
316320,201904,563,1620,441,1402,51,200,210,627,261,827
316330,201904,1040,2899,772,2386,61,222,533,1583,594,1805
316340,201904,999,2864,741,2359,79,329,390,1153,469,1482
316350,201904,1177,3495,1012,3219,103,347,684,2160,787,2507
316360,201904,631,1669,502,1457,51,168,359,1014,410,1182
316370,201904,4655,13031,3513,10845,707,2510,1168,3196,1875,5706
316380,201904,1596,3926,1255,3449,49,113,907,2516,956,2629
316390,201904,825,2261,593,1834,206,718,131,374,337,1092
316400,201904,1161,3363,761,2560,124,467,264,803,388,1270
316410,201904,1066,3196,894,2918,65,236,689,2211,754,2447
316420,201904,1794,5168,1572,4892,56,242,1299,3940,1355,4182
316430,201904,825,2279,516,1682,107,376,135,419,242,795
316440,201904,699,2216,545,1950,134,539,88,295,222,834
316443,201904,528,1533,406,1297,105,369,92,291,197,660
316447,201904,1796,5004,1571,4638,53,205,1273,3698,1326,3903
316450,201904,2183,6739,1657,5636,209,765,992,3319,1201,4084
316460,201904,949,2506,758,2192,178,557,404,1098,582,1655
316470,201904,6102,17942,4431,14480,808,3012,1565,4724,2373,7736
316480,201904,207,583,172,524,36,108,82,240,118,348
316490,201904,277,749,204,621,23,78,88,234,111,312
316500,201904,1163,3819,766,2809,160,637,139,478,299,1115
316510,201904,684,2331,544,2053,113,459,236,900,349,1359
316520,201904,1053,2791,827,2408,122,419,398,1078,520,1497
316530,201904,1024,2824,754,2324,100,417,351,950,451,1367
316540,201904,761,2104,620,1884,113,405,287,800,400,1205
316550,201904,1304,3984,1127,3625,77,306,833,2619,910,2925
316553,201904,3379,10357,2326,7804,494,1799,626,1870,1120,3669
316555,201904,2471,8269,2256,7956,153,626,1718,6130,1871,6756
316556,201904,559,1375,394,1095,23,65,219,553,242,618
316557,201904,915,3019,787,2785,305,1131,218,762,523,1893
316560,201904,267,827,205,738,56,233,57,189,113,422
316570,201904,1107,3383,957,3093,247,799,342,1103,589,1902
316580,201904,392,897,247,647,43,123,111,274,154,397
316590,201904,1277,3394,917,2690,138,399,506,1414,644,1813
316600,201904,948,3002,810,2701,138,488,420,1364,558,1852
316610,201904,572,1848,485,1711,58,270,296,990,354,1260
316620,201904,1950,5518,1690,5158,82,283,1253,3859,1335,4142
316630,201904,1509,4566,1213,4005,333,1106,470,1681,803,2787
316640,201904,136,371,107,329,20,63,50,135,70,198
316650,201904,996,3264,796,2950,68,281,494,1857,562,2138
316660,201904,197,503,90,277,8,25,13,43,21,68
316670,201904,1808,4700,1346,3948,345,1091,454,1287,799,2378
316680,201904,2074,5423,1601,4608,128,410,1165,3270,1293,3680
316690,201904,1134,3422,916,2985,171,616,413,1322,584,1938
316695,201904,983,2917,815,2619,33,141,556,1762,589,1903
316700,201904,351,869,294,806,14,58,224,574,238,632
316710,201904,2808,9511,2138,8066,518,2080,799,3024,1317,5104
316720,201904,19661,55798,14386,45368,2843,9602,5564,16729,8407,26331
316730,201904,393,1129,311,963,52,182,141,389,193,571
316740,201904,684,2092,600,1946,63,271,383,1217,446,1488
316750,201904,386,1191,294,998,58,228,120,363,178,591
316760,201904,3553,11466,2905,10112,1202,4475,744,2500,1946,6975
316770,201904,1511,3676,1193,3238,29,99,1004,2759,1033,2858
316780,201904,537,1635,419,1413,143,548,68,201,211,749
316790,201904,684,1864,470,1444,112,358,134,379,246,737
316800,201904,5865,17033,4718,14945,428,1596,2622,8022,3050,9618
316805,201904,984,2187,806,1995,28,57,695,1762,723,1819
316810,201904,646,1828,435,1377,90,349,209,620,299,969
316820,201904,308,768,153,476,15,52,49,154,64,206
316830,201904,671,1944,546,1732,84,323,331,1003,415,1326
316840,201904,2648,7290,2185,6478,271,960,1360,3833,1631,4793
316850,201904,1946,5218,1394,4212,208,686,607,1791,815,2477
316860,201904,17023,46118,12879,39778,2335,8253,5875,17694,8210,25947
316870,201904,6844,19539,5106,16123,886,3120,2105,6139,2991,9259
316880,201904,763,2090,619,1890,132,455,279,830,411,1285
316890,201904,1085,2476,643,1870,117,408,347,892,464,1300
316900,201904,2167,6073,1695,5128,355,1189,549,1502,904,2691
316905,201904,508,1535,395,1309,92,330,158,530,250,860
316910,201904,845,2290,551,1783,137,508,55,165,192,673
316920,201904,1547,4031,1022,3174,196,650,398,1232,594,1882
316930,201904,7686,23335,5575,19235,1101,4045,1215,4050,2316,8095
316935,201904,3747,10520,2695,8562,547,1834,992,3038,1539,4872
316940,201904,6425,19485,4897,16165,864,3156,1707,5225,2571,8381
316950,201904,1758,4253,1357,3695,58,186,1056,2818,1114,3004
316960,201904,4809,11343,3546,9510,427,1270,2299,5979,2726,7249
316970,201904,3347,9911,2920,9071,634,2053,1058,3138,1692,5191
316980,201904,697,2136,504,1738,159,614,70,255,229,869
316990,201904,10162,28768,7159,22351,1965,6505,862,2424,2827,8929
317000,201904,2478,7652,2209,7242,157,509,1630,5354,1787,5863
317005,201904,2528,7419,2022,6358,362,1171,1010,3096,1372,4267
317010,201904,22157,53298,13533,40105,3222,10411,4250,13070,7472,23481
317020,201904,59875,145450,33799,99171,6358,20229,9520,25792,15878,46021
317030,201904,643,1799,522,1626,26,114,397,1210,423,1324
317040,201904,10224,26850,7265,21684,1749,5470,2604,7971,4353,13441
317043,201904,801,1899,591,1607,73,200,392,1086,465,1286
317047,201904,1142,2804,769,2187,112,300,440,1258,552,1558
317050,201904,1158,3655,800,2805,110,393,312,972,422,1365
317052,201904,2311,6762,1881,6026,259,890,1165,3686,1424,4576
317057,201904,1606,4095,1136,3276,52,195,691,1940,743,2135
317060,201904,440,1196,265,819,42,144,99,278,141,422
317065,201904,1211,3577,984,3144,53,208,633,1884,686,2092
317070,201904,7269,20513,4948,15925,1090,3961,1109,3381,2199,7342
317075,201904,841,2343,580,1852,109,379,166,491,275,870
317080,201904,5770,14072,4235,11531,1308,3785,1204,3068,2512,6853
317090,201904,4262,13326,3873,12667,349,1121,2780,9066,3129,10187
317100,201904,2330,5674,1569,4502,406,1263,569,1566,975,2829
317103,201904,1797,5567,1572,5145,146,725,1063,3219,1209,3944
317107,201904,1312,3658,1025,3082,55,237,628,1657,683,1894
317110,201904,658,1473,321,966,40,149,104,321,144,470
317115,201904,1082,3143,915,2829,55,160,644,1993,699,2153
317120,201904,11659,33611,9180,29375,1315,4803,4871,14993,6186,19796
317130,201904,9825,23719,6085,17529,1155,3649,1938,5514,3093,9163
317140,201904,656,1832,515,1608,40,136,325,1037,365,1173
317150,201904,989,2461,762,2171,29,110,599,1666,628,1776
317160,201904,3484,8578,2338,6817,198,619,1354,3970,1552,4589
317170,201904,1879,4841,1310,3813,218,750,484,1200,702,1950
317180,201904,1732,5643,1296,4540,272,1006,336,1125,608,2131
317190,201904,1204,3338,898,2840,111,365,519,1634,630,1999
317200,201904,4786,12927,3576,10775,967,3170,693,1921,1660,5091
317210,201904,1128,2855,873,2497,39,148,620,1802,659,1950
317220,201904,269,866,232,789,61,212,84,293,145,505
320010,201904,4336,12986,3553,11433,380,1359,2272,7146,2652,8505
320013,201904,1545,4639,1108,3662,185,591,519,1758,704,2349
320016,201904,2934,7705,2328,6806,106,285,1852,5390,1958,5675
320020,201904,3760,10269,2805,8590,711,2322,940,2985,1651,5307
320030,201904,1495,4460,1039,3496,216,803,342,1078,558,1881
320035,201904,1701,4834,1418,4352,376,1252,607,1821,983,3073
320040,201904,3522,10461,2902,9285,441,1535,1537,4817,1978,6352
320050,201904,1735,4015,1494,3658,234,654,860,2042,1094,2696
320060,201904,10628,30606,7965,25233,1363,4719,3465,10428,4828,15147
320070,201904,1357,3948,974,3167,193,683,332,1035,525,1718
320080,201904,5292,13972,3786,10999,827,2528,1336,3727,2163,6255
320090,201904,7176,19696,4989,15219,1112,3661,2042,5856,3154,9517
320100,201904,2568,7521,2044,6549,419,1445,991,3100,1410,4545
320110,201904,1370,3574,1030,2991,194,582,452,1293,646,1875
320115,201904,1729,5770,1505,5379,653,2418,463,1731,1116,4149
320120,201904,17242,45787,11881,36080,2012,6622,4831,14055,6843,20677
320130,201904,37481,109691,31529,98780,4925,16891,17563,53566,22488,70457
320140,201904,2851,8409,2135,6900,391,1442,861,2719,1252,4161
320150,201904,12546,33700,8821,26264,2470,7825,1506,4208,3976,12033
320160,201904,5191,15278,3932,12802,661,2305,1839,5896,2500,8201
320170,201904,1389,4190,1035,3461,296,1000,394,1334,690,2334
320180,201904,685,2254,557,1982,192,731,131,429,323,1160
320190,201904,2700,8882,2067,7394,506,1905,495,1721,1001,3626
320200,201904,1068,3030,778,2483,202,730,254,807,456,1537
320210,201904,4298,11265,3346,9597,559,1741,1780,4893,2339,6634
320220,201904,2504,7051,1907,5988,360,1210,912,2806,1272,4016
320225,201904,1299,4188,902,3182,346,1292,136,475,482,1767
320230,201904,4462,12876,3399,11074,798,2840,1381,4424,2179,7264
320240,201904,13297,35687,10155,30450,2258,7175,4103,12215,6361,19390
320245,201904,2841,8808,2320,7730,943,3226,522,1714,1465,4940
320250,201904,1910,5533,1273,4005,302,1071,312,883,614,1954
320255,201904,1673,5476,1478,5126,520,1837,635,2307,1155,4144
320260,201904,1002,3023,706,2292,179,647,186,512,365,1159
320265,201904,2274,7223,1919,6518,913,3255,391,1305,1304,4560
320270,201904,2146,6327,1618,5229,351,1228,708,2285,1059,3513
320280,201904,5846,16443,4770,14535,1148,3682,1821,5528,2969,9210
320290,201904,1266,3887,840,2847,235,857,201,638,436,1495
320300,201904,3390,10788,2780,9453,873,3186,556,1800,1429,4986
320305,201904,4706,13843,3757,11905,821,2736,1752,5404,2573,8140
320310,201904,1831,5281,1271,4058,243,822,544,1685,787,2507
320313,201904,2208,5806,1400,4180,317,1022,298,846,615,1868
320316,201904,1427,4209,1200,3767,193,624,695,2175,888,2799
320320,201904,20005,54160,14265,44182,3493,11293,5301,16466,8794,27759
320330,201904,2822,7951,2236,6872,522,1580,1059,3358,1581,4938
320332,201904,5325,15662,4354,13928,1093,3759,2059,6508,3152,10267
320334,201904,1807,5380,1267,4199,289,1135,277,741,566,1876
320335,201904,1498,4472,974,3257,252,902,203,630,455,1532
320340,201904,4587,12059,3844,10897,538,1612,2158,6173,2696,7785
320350,201904,4966,12741,3467,9963,464,1434,1767,4845,2231,6279
320360,201904,1418,3679,1047,2964,143,388,508,1407,651,1795
320370,201904,2287,7446,1833,6394,540,1926,638,2190,1178,4116
320380,201904,2218,6241,1869,5646,269,888,1115,3284,1384,4172
320390,201904,7122,19959,5339,16251,1142,3648,2107,6133,3249,9781
320400,201904,3137,9164,2503,7819,680,2256,977,2945,1657,5201
320405,201904,4264,11562,3233,9796,517,1663,1552,4640,2069,6303
320410,201904,4627,12475,3538,10701,593,1798,1802,5693,2395,7491
320420,201904,2705,7472,2126,6505,631,2115,562,1678,1193,3793
320425,201904,1940,4748,1499,4023,104,318,1014,2613,1118,2931
320430,201904,2735,7058,2128,5894,309,926,1305,3464,1614,4390
320435,201904,2234,7185,1755,6191,630,2330,512,1835,1142,4165
320440,201904,1273,3671,932,2994,142,497,415,1290,557,1787
320450,201904,1546,4647,1230,4047,290,1056,538,1691,828,2747
320455,201904,3792,11748,2548,8785,726,2629,723,2399,1449,5028
320460,201904,2060,6340,1446,4949,364,1305,360,1157,724,2462
320465,201904,1186,3481,898,2902,124,438,501,1604,625,2042
320470,201904,3618,10150,2494,7796,617,2108,572,1653,1189,3761
320480,201904,1573,4585,1317,4099,224,798,698,2090,922,2888
320490,201904,18758,50852,13898,42141,2576,8681,5586,16654,8162,25335
320495,201904,1355,3778,921,2940,203,724,316,955,519,1679
320500,201904,46709,129205,38139,114062,6106,19626,21179,61040,27285,80666
320501,201904,4259,12635,3077,10457,866,3239,951,3203,1817,6442
320503,201904,1963,6129,1430,4963,439,1651,457,1446,896,3097
320506,201904,2598,7918,1804,6104,537,1956,170,556,707,2512
320510,201904,9332,26238,7581,23041,1032,3499,4406,12946,5438,16445
320515,201904,1685,4708,1311,3945,389,1251,424,1229,813,2480
320517,201904,2009,6300,1621,5454,555,2019,407,1351,962,3370
320520,201904,32295,87605,24252,73763,4569,15134,10130,29873,14699,45007
320530,201904,28600,78974,22600,68154,2578,9140,13503,38327,16081,47467
330010,201904,19512,54258,16038,48260,2681,8501,9399,27751,12080,36252
330015,201904,1427,3661,1103,3131,183,591,596,1604,779,2195
330020,201904,19184,49347,16727,45823,2222,6974,12025,32042,14247,39016
330022,201904,1872,5093,1420,4305,225,717,849,2518,1074,3235
330023,201904,4442,10890,3045,8829,587,1802,1454,4139,2041,5941
330025,201904,4606,11599,3106,9080,974,3025,925,2682,1899,5707
330030,201904,9987,27738,7531,23445,908,3314,4416,13008,5324,16322
330040,201904,13740,37000,10932,32066,1243,4121,6959,19551,8202,23672
330045,201904,78975,193096,65879,175872,6187,16370,50418,133507,56605,149877
330050,201904,2316,6306,1716,5277,390,1262,764,2244,1154,3506
330060,201904,4724,12962,3936,11593,849,2764,1701,4649,2550,7413
330070,201904,21166,56400,17464,50696,3219,9989,9543,27418,12762,37407
330080,201904,8293,21837,7222,20249,973,2841,4782,13224,5755,16065
330090,201904,3399,7221,2198,5599,174,475,1423,3582,1597,4057
330093,201904,2391,6126,1767,5163,155,485,1262,3687,1417,4172
330095,201904,1167,3463,906,2954,84,341,511,1533,595,1874
330100,201904,64842,178372,55205,163706,3846,13755,40840,118937,44686,132692
330110,201904,1922,5718,1687,5343,298,1049,852,2597,1150,3646
330115,201904,2023,5237,1528,4487,244,789,883,2511,1127,3300
330120,201904,3365,7790,2476,6578,221,651,1730,4460,1951,5111
330130,201904,3508,10007,2921,9107,455,1498,1775,5504,2230,7002
330140,201904,3331,9050,2707,8109,410,1378,1658,4800,2068,6178
330150,201904,2068,5696,1596,4904,325,1069,696,2070,1021,3139
330160,201904,1301,3648,1026,3181,180,620,544,1603,724,2223
330170,201904,92829,246237,77739,225174,11267,32473,50680,148354,61947,180827
330180,201904,2026,5163,1576,4465,115,387,1057,2902,1172,3289
330185,201904,8983,23997,7515,21685,717,2441,5534,15430,6251,17871
330187,201904,3721,9812,2983,8677,421,1352,1816,5270,2237,6622
330190,201904,29685,75314,25839,69896,2144,6247,20149,53703,22293,59950
330200,201904,14154,38137,11859,35208,2468,6967,7309,22343,9777,29310
330205,201904,2026,5149,1554,4340,101,342,1071,2880,1172,3222
330210,201904,3275,8521,2368,6825,395,1241,986,2626,1381,3867
330220,201904,10639,27644,7635,22414,1790,5765,2389,6429,4179,12194
330225,201904,3329,8938,2624,7875,237,856,1790,5226,2027,6082
330227,201904,16024,40771,13858,37992,759,2414,11638,31364,12397,33778
330230,201904,1626,3821,1167,3231,79,231,810,2223,889,2454
330240,201904,21217,57043,17205,50447,2817,8965,10157,28943,12974,37908
330245,201904,1643,4165,939,2914,208,672,294,923,502,1595
330250,201904,33683,90804,28581,82984,6176,18215,15311,44920,21487,63135
330260,201904,3966,10598,3087,9306,439,1447,1840,5321,2279,6768
330270,201904,24369,51502,14882,37786,2752,7550,6244,15571,8996,23121
330280,201904,2305,6207,1717,5166,204,677,970,2795,1174,3472
330285,201904,20529,51527,16464,45615,1704,5355,11479,30804,13183,36159
330290,201904,3419,8882,2765,7920,394,1244,1701,4704,2095,5948
330300,201904,5355,13199,3807,10840,395,1267,2402,6694,2797,7961
330310,201904,2217,5786,1687,4884,100,275,1117,3246,1217,3521
330320,201904,14582,36666,11661,32855,1542,4440,8170,23058,9712,27498
330330,201904,30841,72628,24681,63991,2757,7851,17210,43510,19967,51361
330340,201904,13546,34902,9921,28977,1825,5875,4778,13309,6603,19184
330350,201904,106108,263987,89436,242850,7338,20945,69920,189123,77258,210068
330360,201904,7320,18210,6316,17007,298,841,5309,14229,5607,15070
330370,201904,4566,13414,3365,11264,778,2713,1331,4608,2109,7321
330380,201904,4965,14041,3794,11918,800,2777,1686,5101,2486,7878
330385,201904,3827,11518,3158,10499,784,2835,1430,4783,2214,7618
330390,201904,23551,67923,18476,58391,3089,10865,9544,28714,12633,39579
330395,201904,3054,7906,2542,7212,209,649,1728,4805,1937,5454
330400,201904,2954,8218,2590,7591,183,681,1888,5206,2071,5887
330410,201904,2794,7806,2077,6503,434,1475,893,2628,1327,4103
330411,201904,2680,7389,2123,6325,166,594,1467,4173,1633,4767
330412,201904,1434,4301,1180,3845,160,592,666,2021,826,2613
330414,201904,22237,58088,18171,52375,2001,5813,12608,36147,14609,41960
330415,201904,3577,10086,2805,8771,372,1168,1580,4997,1952,6165
330420,201904,9689,24542,6487,19216,927,3024,2862,7987,3789,11011
330430,201904,8637,21948,7446,20181,518,1722,5551,14470,6069,16192
330440,201904,2114,5946,1591,5079,342,1248,779,2365,1121,3613
330450,201904,1279,3816,1032,3350,143,506,515,1634,658,2140
330452,201904,14548,38285,11530,33537,1883,5967,6768,19107,8651,25074
330455,201904,523399,1286357,399214,1100835,63904,186722,238485,646800,302389,833522
330460,201904,1160,3304,879,2858,174,610,441,1391,615,2001
330470,201904,4542,11839,3363,9979,1008,3087,1176,3518,2184,6605
330475,201904,8668,23298,7011,21059,1284,4290,4256,12519,5540,16809
330480,201904,5719,15421,4901,14147,485,1562,3250,9107,3735,10669
330490,201904,109696,262149,91417,236569,10458,28580,64518,164459,74976,193039
330500,201904,6085,16151,5149,14817,637,2025,3628,10277,4265,12302
330510,201904,36790,96985,28752,85360,6480,20057,15368,45313,21848,65370
330513,201904,1238,3283,976,2894,216,690,478,1401,694,2091
330515,201904,2415,6729,2001,6060,522,1678,915,2675,1437,4353
330520,201904,10361,28801,8581,25826,1279,4282,4902,14277,6181,18559
330530,201904,1642,4151,1192,3400,267,821,509,1403,776,2224
330540,201904,2796,7675,2163,6534,616,1866,800,2419,1416,4285
330550,201904,7828,22570,6364,20327,2121,7238,2056,6450,4177,13688
330555,201904,13902,32518,11631,29661,1187,3380,8551,21817,9738,25197
330560,201904,4192,11502,3403,10135,506,1549,2002,5809,2508,7358
330570,201904,2803,7879,2297,7007,395,1310,1382,4150,1777,5460
330575,201904,5221,13982,4530,12766,337,1082,3477,9452,3814,10534
330580,201904,14197,39671,10823,33325,2312,7701,4750,14007,7062,21708
330590,201904,1440,4040,1251,3799,177,540,854,2631,1031,3171
330600,201904,11182,30691,8814,26654,1267,4063,4961,14838,6228,18901
330610,201904,8929,24696,7353,22164,716,2517,4866,14265,5582,16782
330615,201904,2014,5640,1535,4957,312,1084,920,2994,1232,4078
330620,201904,3759,11322,3034,9991,822,2947,1114,3404,1936,6351
330630,201904,23535,61385,18490,53091,1746,5973,12505,34377,14251,40350
350010,201904,2038,5410,984,3077,223,717,117,275,340,992
350020,201904,676,1797,357,1137,46,150,130,373,176,523
350030,201904,3673,10686,2693,8784,697,2414,917,2891,1614,5305
350040,201904,654,1936,383,1334,66,260,115,324,181,584
350050,201904,925,2454,649,1953,147,511,220,536,367,1047
350055,201904,848,2252,670,1979,67,229,455,1291,522,1520
350060,201904,102,277,72,227,13,43,37,113,50,156
350070,201904,3568,9554,2182,6906,431,1477,663,1909,1094,3386
350075,201904,586,1800,431,1479,187,670,49,154,236,824
350080,201904,597,1622,369,1170,46,164,160,454,206,618
350090,201904,620,1512,353,1025,75,226,115,302,190,528
350100,201904,2042,5584,1349,4283,148,570,719,2150,867,2720
350110,201904,453,1191,316,949,19,69,175,517,194,586
350115,201904,1275,3796,1028,3246,184,661,517,1479,701,2140
350120,201904,659,1620,352,1015,42,128,170,475,212,603
350130,201904,3012,8295,2392,7107,408,1280,1178,3338,1586,4618
350140,201904,724,2137,469,1601,53,232,215,670,268,902
350150,201904,499,1545,410,1374,97,326,95,293,192,619
350160,201904,10394,26174,6833,19855,851,2920,4062,11069,4913,13989
350170,201904,1799,5403,1383,4435,289,963,511,1553,800,2516
350180,201904,1071,2693,524,1590,122,378,128,362,250,740
350190,201904,2791,8086,1959,6356,408,1516,748,1992,1156,3508
350200,201904,403,1131,318,975,19,64,217,629,236,693
350210,201904,5108,12146,3431,9584,600,1762,1914,5177,2514,6939
350220,201904,2732,7519,1807,5701,425,1410,601,1711,1026,3121
350230,201904,932,2571,769,2314,157,508,392,1155,549,1663
350240,201904,693,2056,444,1458,82,263,138,436,220,699
350250,201904,2329,7126,1753,6081,625,2377,311,1114,936,3491
350260,201904,761,1916,498,1426,54,160,301,834,355,994
350270,201904,4527,12634,3583,10759,612,1965,1763,4948,2375,6913
350275,201904,2256,6311,1797,5495,303,1032,975,2800,1278,3832
350280,201904,18319,41715,10742,29359,2000,5807,3829,10152,5829,15959
350290,201904,3037,8487,2021,6381,389,1359,778,2295,1167,3654
350300,201904,646,1807,458,1409,81,270,201,580,282,850
350310,201904,790,2368,582,1907,95,384,218,603,313,987
350315,201904,550,1490,371,1155,38,142,163,459,201,601
350320,201904,12570,33677,9559,28315,2340,7537,3042,8555,5382,16092
350330,201904,13309,33744,9522,26230,1256,3721,5543,14395,6799,18116
350335,201904,347,994,252,804,21,81,148,455,169,536
350340,201904,1063,2822,614,1982,108,374,216,692,324,1066
350350,201904,737,1964,580,1783,86,313,303,893,389,1206
350360,201904,1027,3148,817,2681,235,777,228,752,463,1529
350370,201904,594,1543,408,1189,128,357,100,281,228,638
350380,201904,4319,11809,2847,8899,769,2436,694,2247,1463,4683
350390,201904,9243,25619,7350,22276,1836,5787,2951,8780,4787,14567
350395,201904,419,1083,201,653,20,61,65,195,85,256
350400,201904,7712,19759,5316,15644,1364,4338,1512,4245,2876,8583
350410,201904,8902,25725,6426,20773,1515,5427,2105,6285,3620,11712
350420,201904,648,1820,469,1482,89,310,108,319,197,629
350430,201904,654,1834,536,1636,61,228,335,935,396,1163
350440,201904,1727,4568,1383,4026,127,446,888,2493,1015,2939
350450,201904,6333,18139,4967,15636,1127,3824,1952,5820,3079,9644
350460,201904,1649,4251,805,2535,131,435,157,431,288,866
350470,201904,259,667,193,546,8,34,126,325,134,359
350480,201904,864,2336,552,1720,111,380,76,208,187,588
350490,201904,1781,4836,1279,3957,298,951,400,1159,698,2110
350500,201904,658,1781,506,1495,80,256,243,673,323,929
350510,201904,1045,2808,742,2233,97,315,386,1108,483,1423
350520,201904,1927,6138,1477,5184,258,1047,626,1997,884,3044
350530,201904,2556,6572,1857,5205,241,761,1068,2812,1309,3573
350535,201904,1413,3999,1224,3712,185,634,756,2210,941,2844
350540,201904,1705,4456,1243,3711,200,637,668,1966,868,2603
350550,201904,8158,20642,5605,16321,644,2208,3090,8393,3734,10601
350560,201904,3740,10816,2973,9358,282,950,1813,5504,2095,6454
350570,201904,21989,63461,17619,54722,3697,12558,8259,24375,11956,36933
350580,201904,1847,5207,988,3236,236,828,143,388,379,1216
350590,201904,4367,12320,3198,9646,514,1780,1751,4796,2265,6576
350600,201904,36304,86854,22427,61656,3244,9834,10555,26500,13799,36334
350610,201904,6317,17854,4575,14327,937,3107,1938,5847,2875,8954
350620,201904,408,1021,241,758,28,102,134,395,162,497
350630,201904,1436,3831,1037,3102,70,275,643,1803,713,2078
350635,201904,7559,19676,5741,16741,1040,3407,3148,8674,4188,12081
350640,201904,914,2517,490,1532,59,204,162,425,221,629
350650,201904,7567,20876,5004,15543,1016,3403,1598,4575,2614,7978
350660,201904,4358,11785,3379,10104,631,1875,1672,5056,2303,6931
350670,201904,1786,4903,1472,4443,166,539,951,2855,1117,3394
350680,201904,1097,3005,704,2248,145,490,282,856,427,1346
350690,201904,1186,3248,858,2660,148,497,440,1297,588,1794
350700,201904,4932,12576,3180,9825,536,1894,1346,3846,1882,5740
350710,201904,2614,7389,2183,6625,317,1100,1219,3500,1536,4600
350715,201904,846,2465,685,2148,72,279,321,898,393,1177
350720,201904,166,404,120,328,25,77,53,135,78,212
350730,201904,537,1555,424,1336,34,143,283,834,317,977
350740,201904,1559,4383,1027,3235,191,624,281,803,472,1427
350745,201904,545,1502,321,1027,31,116,142,412,173,528
350750,201904,9128,24930,6965,20978,1299,4434,2922,7809,4221,12243
350760,201904,12985,33715,9117,26923,2286,7338,2797,7399,5083,14737
350770,201904,919,2303,573,1691,46,137,353,1027,399,1164
350775,201904,655,1644,458,1322,49,148,199,559,248,707
350780,201904,1914,4977,1352,4095,272,911,435,1485,707,2396
350790,201904,1645,4517,1013,3309,190,682,225,618,415,1300
350800,201904,3127,9383,2677,8566,394,1380,1510,4674,1904,6054
350810,201904,2401,6188,1907,5463,299,895,1022,2964,1321,3859
350820,201904,903,2145,488,1381,51,149,221,573,272,722
350830,201904,836,2390,458,1522,81,283,129,377,210,660
350840,201904,2802,8541,2045,7043,516,1912,767,2462,1283,4374
350850,201904,6478,18863,4925,15870,1196,4100,1764,5516,2960,9616
350860,201904,3238,9112,2860,8561,138,540,2143,6290,2281,6830
350870,201904,2619,7565,1908,6381,307,1161,977,3143,1284,4304
350880,201904,1176,3525,933,2986,225,734,294,919,519,1653
350890,201904,556,1479,342,1036,51,169,117,307,168,476
350900,201904,6342,18046,3995,12771,1094,3783,855,2512,1949,6295
350910,201904,840,2213,719,2004,101,319,482,1297,583,1616
350920,201904,11299,29234,9614,26340,508,1693,7548,19816,8056,21509
350925,201904,4301,12126,3077,9770,602,2038,1348,3904,1950,5942
350930,201904,1404,3659,933,2754,116,380,508,1429,624,1809
350940,201904,1991,5598,1583,4857,203,656,986,2964,1189,3620
350945,201904,816,2328,611,1919,106,380,275,789,381,1169
350950,201904,78812,211298,60971,176087,8694,27577,35616,97916,44310,125493
350960,201904,5622,15974,4398,13618,649,2270,2491,7274,3140,9544
350970,201904,3457,10439,2570,8526,814,2994,403,1169,1217,4163
350980,201904,599,1685,474,1448,152,491,174,522,326,1013
350990,201904,1675,4973,1256,4250,305,1157,441,1409,746,2566
350995,201904,739,2389,663,2229,43,183,452,1450,495,1633
351000,201904,2650,7045,1866,5625,385,1248,603,1745,988,2993
351010,201904,299,749,189,546,15,48,100,279,115,327
351015,201904,725,2245,587,1972,84,331,278,845,362,1176
351020,201904,8863,24827,6664,21027,1344,4429,3300,10171,4644,14600
351030,201904,2480,7621,2008,6641,313,1173,1056,3374,1369,4547
351040,201904,4496,11626,3810,10537,225,788,3027,8052,3252,8840
351050,201904,16685,41528,11208,32688,2412,7488,4418,12628,6830,20116
351060,201904,44482,115426,33980,96982,4235,13169,21535,59519,25770,72688
351070,201904,1314,3431,768,2445,227,776,107,328,334,1104
351080,201904,2556,6606,1858,5725,309,1118,1062,3055,1371,4173
351090,201904,327,984,226,788,47,166,53,188,100,354
351100,201904,2255,6240,1447,4590,338,1114,401,1340,739,2454
351110,201904,5723,14997,3731,11292,726,2400,1452,4079,2178,6479
351120,201904,746,1988,505,1552,75,242,215,620,290,862
351130,201904,1057,2776,452,1470,95,324,76,223,171,547
351140,201904,1806,5304,1283,4270,318,1168,418,1241,736,2409
351150,201904,1962,5829,1241,4180,265,956,410,1226,675,2182
351160,201904,1091,3541,858,2998,198,725,264,816,462,1541
351170,201904,1328,3838,1143,3461,118,397,740,2158,858,2555
351190,201904,989,2789,612,1977,103,327,204,597,307,924
351200,201904,1571,3881,1196,3317,78,251,814,2157,892,2408
351210,201904,1509,3807,876,2511,84,277,487,1287,571,1564
351220,201904,3034,8905,2612,8184,326,1066,1670,5171,1996,6237
351230,201904,1731,4898,1270,4059,260,960,523,1473,783,2433
351240,201904,1973,5213,1306,3821,256,785,571,1540,827,2325
351250,201904,1079,2891,596,1875,76,249,218,691,294,940
351260,201904,909,2398,659,1937,153,434,224,674,377,1108
351270,201904,379,1106,311,993,47,187,170,471,217,658
351280,201904,3793,10428,2893,8681,493,1612,1336,3817,1829,5429
351290,201904,1041,2716,702,2099,126,386,338,979,464,1365
351300,201904,14748,41726,10088,32501,2047,7094,3919,12329,5966,19423
351310,201904,3044,7980,2314,6764,220,781,1535,4203,1755,4984
351320,201904,874,2660,642,2100,115,419,246,736,361,1155
351330,201904,585,1783,502,1629,40,116,383,1264,423,1380
351340,201904,6145,18213,4909,15998,1245,4215,1985,6460,3230,10675
351350,201904,11091,29225,9340,26249,1015,3070,6801,18526,7816,21596
351360,201904,3737,10310,3092,9256,794,2561,1078,2965,1872,5526
351370,201904,2098,6039,1398,4533,365,1229,442,1277,807,2506
351380,201904,43773,110290,31183,87383,4829,14348,16646,44739,21475,59087
351385,201904,269,670,143,419,25,68,42,110,67,178
351390,201904,1340,3408,826,2610,131,483,467,1371,598,1854
351400,201904,900,2598,717,2208,153,473,377,1131,530,1604
351410,201904,2415,6874,1738,5525,326,1051,715,2232,1041,3283
351420,201904,351,862,185,555,35,93,81,236,116,329
351430,201904,810,2397,698,2204,66,226,485,1491,551,1717
351440,201904,3241,8737,2097,6318,396,1295,541,1370,937,2665
351450,201904,1707,4551,1125,3466,234,778,224,596,458,1374
351460,201904,758,2072,595,1789,159,471,307,919,466,1390
351470,201904,1159,3040,877,2539,85,290,546,1487,631,1777
351480,201904,2519,7640,2020,6766,343,1256,900,2861,1243,4117
351490,201904,1828,5424,1569,4922,79,321,1183,3540,1262,3861
351492,201904,336,942,272,801,14,52,177,495,191,547
351495,201904,195,546,139,425,17,54,71,203,88,257
351500,201904,34250,88134,25422,72293,4581,13862,13591,36837,18172,50699
351510,201904,11880,30649,8633,24748,1209,3910,5152,14069,6361,17979
351512,201904,478,1336,315,956,48,147,103,280,151,427
351515,201904,3113,7166,1850,5087,354,1099,525,1452,879,2551
351518,201904,2251,5851,1435,4377,210,743,761,2090,971,2833
351519,201904,731,2035,407,1319,65,210,67,203,132,413
351520,201904,1146,2916,443,1399,59,208,172,480,231,688
351530,201904,342,966,194,620,36,120,64,162,100,282
351535,201904,2002,4910,1415,3914,198,617,758,1957,956,2574
351540,201904,2131,5469,1384,4179,383,1296,331,840,714,2136
351550,201904,6026,15608,4044,11714,440,1517,2269,6047,2709,7564
351560,201904,422,1245,341,1079,82,299,94,262,176,561
351565,201904,183,560,143,483,36,132,41,133,77,265
351570,201904,18625,51692,13840,41393,1720,5635,8307,23733,10027,29368
351580,201904,264,685,152,464,15,46,60,185,75,231
351590,201904,502,1159,261,720,32,109,134,322,166,431
351600,201904,1440,3819,1096,3172,114,374,655,1754,769,2128
351610,201904,748,1770,471,1286,26,83,246,603,272,686
351620,201904,20481,57227,15167,47195,2662,9438,6359,17677,9021,27115
351630,201904,25089,69372,20265,60640,3523,11012,11982,34885,15505,45897
351640,201904,15459,42499,11867,35551,1373,4637,7631,21900,9004,26537
351650,201904,403,1094,180,593,22,76,42,119,64,195
351660,201904,752,2204,455,1481,77,279,83,234,160,513
351670,201904,5195,14458,3656,11024,753,2277,1650,4668,2403,6945
351680,201904,403,1208,251,816,50,137,62,194,112,331
351685,201904,429,1285,343,1130,83,274,114,347,197,621
351690,201904,1031,2665,595,1747,103,333,238,630,341,963
351700,201904,1204,3119,871,2496,120,339,488,1334,608,1673
351710,201904,743,2029,501,1566,46,173,235,645,281,818
351720,201904,1440,3858,912,2868,162,560,321,927,483,1487
351730,201904,913,2502,753,2215,85,311,465,1276,550,1587
351740,201904,3517,9074,2726,7520,493,1438,1276,3236,1769,4674
351750,201904,1245,3469,771,2574,159,568,252,829,411,1397
351760,201904,3237,9311,2279,7274,481,1723,794,2319,1275,4042
351770,201904,1750,5337,1424,4676,335,1115,643,2094,978,3209
351780,201904,1382,3596,718,2204,129,460,203,582,332,1042
351790,201904,1229,3040,975,2688,162,435,585,1632,747,2067
351800,201904,523,1223,254,714,31,94,84,199,115,293
351810,201904,967,2633,788,2326,51,150,566,1603,617,1753
351820,201904,2415,6987,1660,5456,441,1578,319,999,760,2577
351830,201904,4160,11542,3186,9785,343,1225,1893,5541,2236,6766
351840,201904,7707,22440,5838,18870,971,3454,2723,8327,3694,11781
351850,201904,1735,4686,1076,3419,215,771,310,872,525,1643
351860,201904,2738,8171,2142,6992,386,1312,1149,3756,1535,5068
351870,201904,21916,58253,16778,49600,5229,15841,5956,18289,11185,34130
351880,201904,110324,302443,82599,251474,22634,74406,28697,82930,51331,157336
351885,201904,840,2383,662,2038,93,305,364,1069,457,1374
351890,201904,673,1894,493,1578,108,347,68,185,176,532
351900,201904,1025,2859,794,2489,149,480,382,1190,531,1670
351905,201904,374,1072,250,811,21,72,90,256,111,328
351907,201904,21286,57004,16392,48062,1826,5869,10612,30053,12438,35922
351910,201904,1227,3275,847,2482,94,305,456,1216,550,1521
351920,201904,831,2229,602,1772,70,252,295,791,365,1043
351925,201904,891,2502,692,2118,107,355,318,906,425,1261
351930,201904,3066,8867,2792,8337,408,1312,2036,5951,2444,7263
351940,201904,1069,2819,763,2274,107,360,389,1115,496,1475
351950,201904,1539,3668,1098,2998,76,228,698,1838,774,2066
351960,201904,4992,13096,3721,10846,840,2636,1590,4325,2430,6961
351970,201904,6078,19140,5051,17275,867,3348,2714,8941,3581,12289
351980,201904,1024,2463,645,1827,81,274,369,969,450,1243
351990,201904,1372,3357,955,2694,87,306,414,1053,501,1359
352000,201904,2434,7178,2066,6403,244,880,1321,3787,1565,4667
352010,201904,2096,5899,1697,5174,432,1438,308,992,740,2430
352020,201904,1423,3991,1120,3468,193,638,531,1565,724,2203
352030,201904,5289,14507,4216,12743,868,2844,2145,6288,3013,9132
352040,201904,2502,6929,1564,4976,282,934,442,1237,724,2171
352042,201904,3078,7725,1838,5539,384,1237,716,2145,1100,3382
352044,201904,2033,5576,1122,3779,196,710,223,683,419,1393
352050,201904,11871,32600,7527,23727,1869,6598,1178,3224,3047,9822
352060,201904,727,2025,518,1610,71,237,232,672,303,909
352070,201904,728,1521,511,1231,67,183,286,644,353,827
352080,201904,464,1214,282,837,36,118,104,270,140,388
352090,201904,1418,4304,1138,3690,158,577,461,1330,619,1907
352100,201904,2954,8505,2450,7554,596,1968,1103,3219,1699,5187
352110,201904,564,1752,434,1462,102,367,162,497,264,864
352115,201904,503,1455,414,1310,62,220,237,745,299,965
352120,201904,850,2620,664,2208,82,311,368,1142,450,1453
352130,201904,1843,5277,1193,3641,231,719,463,1314,694,2033
352140,201904,1234,3363,815,2522,127,431,382,1139,509,1570
352150,201904,801,2213,595,1836,123,400,320,965,443,1365
352160,201904,965,2438,704,2028,91,310,368,1010,459,1320
352170,201904,2915,8090,2281,6776,414,1356,1185,3221,1599,4577
352180,201904,2543,7049,2010,6025,507,1691,632,1648,1139,3339
352190,201904,1125,3082,843,2633,140,444,374,1202,514,1646
352200,201904,370,1136,254,885,33,128,85,279,118,407
352210,201904,17790,43803,13903,38400,1313,3936,10106,27524,11419,31460
352215,201904,522,1419,457,1338,53,162,317,911,370,1073
352220,201904,16368,42972,10999,32935,2798,8759,3659,10527,6457,19286
352230,201904,12340,37449,9392,31637,2331,8632,3187,10052,5518,18684
352240,201904,10477,27873,7886,23377,1788,6031,3189,8532,4977,14563
352250,201904,21783,62929,17576,55228,3576,11910,9444,29107,13020,41017
352260,201904,4736,12409,3279,9469,483,1651,1830,4768,2313,6419
352265,201904,903,2618,795,2438,52,206,580,1709,632,1915
352270,201904,1453,4516,1084,3703,239,896,351,1105,590,2001
352280,201904,2326,6092,1774,5260,186,696,998,2722,1184,3418
352290,201904,1073,3263,882,2855,152,540,425,1230,577,1770
352300,201904,931,2577,640,1966,94,338,313,861,407,1199
352310,201904,43755,118741,32142,97843,8200,25329,13577,41597,21777,66926
352320,201904,6056,16672,4636,13746,747,2467,2301,6141,3048,8608
352330,201904,2102,5834,1603,5106,317,1163,764,2309,1081,3472
352340,201904,4959,13615,3592,11126,683,2360,1596,4570,2279,6930
352350,201904,2066,6145,1619,5085,196,758,840,2350,1036,3108
352360,201904,1181,3224,1007,2926,101,361,743,2052,844,2413
352370,201904,1029,3032,884,2760,33,142,681,2069,714,2211
352380,201904,795,2273,611,1913,140,469,207,615,347,1084
352390,201904,15241,38274,10278,29666,1659,5271,5505,14927,7164,20198
352400,201904,3293,9323,2814,8425,450,1657,1733,4815,2183,6472
352410,201904,2943,7931,2233,6691,236,845,1343,3839,1579,4684
352420,201904,852,2121,581,1685,111,336,203,561,314,897
352430,201904,7024,18362,5010,14784,1330,4353,2005,5525,3335,9878
352440,201904,16676,46876,12653,38953,2929,9433,5070,15081,7999,24514
352450,201904,802,2100,399,1322,58,197,117,363,175,560
352460,201904,2853,8114,1930,6339,409,1483,651,2012,1060,3495
352470,201904,3350,8489,2392,6903,294,974,1311,3511,1605,4485
352480,201904,3306,8194,2195,6154,368,1164,1027,2637,1395,3801
352490,201904,693,2132,545,1831,104,384,239,754,343,1138
352500,201904,9917,26407,6831,20522,3154,10272,789,1493,3943,11765
352510,201904,3354,9400,2488,7855,572,1990,984,2911,1556,4901
352520,201904,2441,6885,1873,5857,430,1484,896,2552,1326,4036
352530,201904,8962,24727,5700,17899,1272,4478,1042,2535,2314,7013
352540,201904,532,1593,390,1260,75,251,104,306,179,557
352550,201904,958,2838,666,2232,133,493,197,609,330,1102
352560,201904,559,1598,411,1282,67,218,161,458,228,676
352570,201904,1945,5774,1260,4327,317,1149,174,516,491,1665
352580,201904,703,1936,570,1694,92,321,295,820,387,1141
352585,201904,234,694,175,567,20,83,94,283,114,366
352590,201904,12950,34851,8982,27056,2632,8515,3516,9792,6148,18307
352600,201904,1903,5343,1443,4426,232,760,755,2171,987,2931
352610,201904,2908,8337,2158,6970,480,1714,815,2469,1295,4183
352620,201904,5550,14823,4295,12871,1366,4131,1509,4590,2875,8721
352630,201904,827,2087,624,1779,99,326,285,738,384,1064
352640,201904,2893,7706,2089,6303,213,687,1236,3576,1449,4263
352650,201904,555,1614,393,1231,57,211,143,415,200,626
352660,201904,992,3076,804,2676,174,600,345,1122,519,1722
352670,201904,8295,23418,5308,17201,1477,5075,750,2373,2227,7448
352680,201904,3205,9778,2242,7458,379,1476,1026,3096,1405,4572
352690,201904,26586,68977,19836,56697,1814,5978,12702,34498,14516,40476
352700,201904,544,1423,402,1216,161,537,85,222,246,759
352710,201904,4827,12886,3432,10276,890,2942,1378,3806,2268,6748
352720,201904,7677,22001,5931,18494,2770,8789,812,2239,3582,11028
352725,201904,523,1340,268,799,20,64,122,343,142,407
352730,201904,2649,7673,2230,6692,336,1137,1286,3522,1622,4659
352740,201904,2175,5257,1605,4394,209,642,899,2346,1108,2988
352750,201904,407,1036,217,675,41,137,74,199,115,336
352760,201904,1521,4351,1144,3569,145,487,563,1703,708,2190
352770,201904,899,2472,594,1856,121,385,215,631,336,1016
352780,201904,642,1889,439,1474,90,325,134,445,224,770
352790,201904,512,1382,339,1028,36,112,125,331,161,443
352800,201904,1229,3909,881,3066,225,830,144,456,369,1286
352810,201904,1077,2610,664,1843,88,269,376,981,464,1250
352820,201904,507,1341,326,1028,73,238,70,235,143,473
352830,201904,585,1507,252,780,30,97,52,129,82,226
352840,201904,3730,11119,3082,9895,1077,3718,957,2965,2034,6683
352850,201904,9961,25370,6613,19854,1884,6054,1949,5504,3833,11558
352860,201904,1004,2804,709,2236,144,483,223,680,367,1163
352870,201904,874,2241,602,1649,43,142,389,1015,432,1157
352880,201904,1775,4382,1231,3370,179,531,700,1759,879,2290
352885,201904,281,813,207,674,35,124,112,346,147,470
352890,201904,706,1695,433,1129,44,127,236,532,280,659
352900,201904,17327,46289,11535,34749,1990,6454,5052,14188,7042,20642
352910,201904,461,1230,218,686,25,76,53,152,78,228
352920,201904,2551,6803,1850,5509,160,534,1190,3386,1350,3920
352930,201904,5519,15443,4041,12465,740,2429,1770,5121,2510,7550
352940,201904,21880,62878,16120,50160,3966,13530,5320,15565,9286,29095
352950,201904,472,1263,262,843,57,188,27,84,84,272
352960,201904,705,1960,358,1177,63,228,67,204,130,432
352965,201904,267,723,152,504,42,141,32,93,74,234
352970,201904,2949,7188,2218,5978,258,726,1438,3822,1696,4548
352980,201904,1348,3754,1049,3269,260,854,472,1428,732,2282
352990,201904,3946,11263,3203,10040,615,2160,1669,5023,2284,7183
353000,201904,458,1273,219,712,34,118,46,128,80,246
353010,201904,2486,6366,1607,4757,398,1289,551,1499,949,2788
353020,201904,3601,9426,2053,6175,305,1034,710,1954,1015,2988
353030,201904,4085,10854,2769,8379,693,2247,631,1877,1324,4124
353040,201904,591,1431,430,1177,60,184,243,613,303,797
353050,201904,4973,14806,3632,11976,790,2824,1561,4881,2351,7705
353060,201904,45666,120174,37363,106520,2995,10323,27094,74087,30089,84410
353070,201904,8916,25982,6301,20469,1398,4850,2175,6633,3573,11483
353080,201904,4042,11632,2791,9105,586,2121,949,2759,1535,4880
353090,201904,571,1765,423,1436,45,175,225,727,270,902
353100,201904,304,841,124,410,26,90,29,81,55,171
353110,201904,7264,20481,5900,18412,1037,3348,3389,10760,4426,14108
353120,201904,456,1171,292,862,42,135,114,307,156,442
353130,201904,2229,5558,1479,4337,423,1358,468,1270,891,2628
353140,201904,2389,6134,1758,4955,153,488,1105,2900,1258,3388
353150,201904,1455,3749,1032,3041,211,649,424,1174,635,1823
353160,201904,560,1485,400,1218,82,279,156,425,238,704
353170,201904,499,1435,392,1270,76,285,181,551,257,836
353180,201904,9395,23941,7316,20433,868,2721,5089,13794,5957,16515
353190,201904,3206,8822,2539,7492,275,898,1578,4334,1853,5232
353200,201904,2010,5440,911,3022,130,454,199,612,329,1066
353205,201904,329,1041,277,911,57,201,127,409,184,610
353210,201904,961,2309,604,1710,30,100,380,1051,410,1151
353215,201904,383,1106,296,924,43,138,133,371,176,509
353220,201904,776,2121,460,1450,104,319,68,197,172,516
353230,201904,769,2213,625,1982,172,608,256,720,428,1328
353240,201904,2181,6138,1759,5364,253,882,1029,3003,1282,3885
353250,201904,1268,2906,737,2005,107,300,370,973,477,1273
353260,201904,1042,2492,594,1734,112,367,229,629,341,996
353270,201904,660,1798,538,1565,44,144,355,980,399,1124
353280,201904,712,1963,488,1518,97,310,151,430,248,740
353282,201904,1745,5058,1483,4542,174,609,873,2494,1047,3103
353284,201904,352,857,176,505,28,103,69,162,97,265
353286,201904,155,405,93,296,24,80,32,99,56,179
353290,201904,1530,4048,930,2813,93,336,465,1282,558,1618
353300,201904,1700,4685,1250,3760,211,745,560,1480,771,2225
353310,201904,385,975,268,757,24,90,161,425,185,515
353320,201904,609,1600,518,1442,17,54,428,1185,445,1239
353325,201904,622,1876,419,1416,93,317,145,473,238,790
353330,201904,544,1432,339,1000,45,138,169,470,214,608
353340,201904,2667,7410,1836,5782,465,1577,705,2128,1170,3705
353350,201904,3171,8676,2140,6463,479,1604,471,1193,950,2797
353360,201904,576,1656,450,1419,50,163,235,731,285,894
353370,201904,539,1646,443,1478,37,128,290,931,327,1059
353380,201904,257,797,205,688,33,123,94,291,127,414
353390,201904,5480,14073,4017,11476,590,1852,2045,5496,2635,7348
353400,201904,387,1117,291,921,47,176,78,197,125,373
353410,201904,527,1444,408,1224,78,257,220,651,298,908
353420,201904,453,1240,270,831,54,157,21,44,75,201
353430,201904,2160,6179,1555,5022,379,1355,587,1742,966,3097
353440,201904,60949,171395,43025,135066,7998,26800,21109,63055,29107,89855
353450,201904,382,1011,258,794,43,152,113,319,156,471
353460,201904,3241,8933,2317,7046,176,620,1059,3129,1235,3749
353470,201904,7419,20058,5154,15727,962,3295,1956,5440,2918,8735
353475,201904,1374,3713,956,2801,134,429,452,1215,586,1644
353480,201904,1642,4461,1272,3769,86,298,825,2349,911,2647
353490,201904,960,2629,631,1931,114,383,276,791,390,1174
353500,201904,968,2354,753,2028,178,482,410,1120,588,1602
353510,201904,813,2471,591,1911,138,467,128,359,266,826
353520,201904,1087,2908,690,2162,83,293,313,930,396,1223
353530,201904,2398,6528,1836,5457,238,787,912,2514,1150,3301
353540,201904,1979,5609,1622,4994,312,991,868,2601,1180,3592
353550,201904,5650,15140,4484,13143,848,2603,2294,6459,3142,9062
353560,201904,1971,5675,1448,4794,475,1700,347,1070,822,2770
353570,201904,545,1462,399,1201,57,168,233,665,290,833
353580,201904,1969,5290,1547,4511,373,1077,681,1928,1054,3005
353590,201904,709,1999,451,1436,112,394,142,437,254,831
353600,201904,1745,4434,1338,3699,169,468,699,1884,868,2352
353610,201904,544,1675,389,1343,88,342,98,309,186,651
353620,201904,2570,7092,1794,5677,374,1324,547,1554,921,2878
353625,201904,482,1206,305,892,28,98,185,527,213,625
353630,201904,1175,3807,932,3224,222,832,274,856,496,1688
353640,201904,1358,3593,1064,3123,127,408,621,1793,748,2201
353650,201904,8666,23989,6196,18852,766,2590,3371,9530,4137,12120
353657,201904,359,964,249,760,30,110,119,324,149,434
353660,201904,1132,2479,766,1964,314,801,210,504,524,1305
353670,201904,3763,10850,2969,9247,629,2182,1474,4220,2103,6402
353680,201904,693,1924,514,1651,95,324,272,846,367,1170
353690,201904,445,1162,166,543,11,31,16,45,27,76
353700,201904,1877,5230,1572,4655,153,504,1088,3102,1241,3606
353710,201904,4198,9497,2298,6097,246,674,1340,3244,1586,3918
353715,201904,465,1229,265,837,15,60,71,206,86,266
353720,201904,1839,5102,1446,4512,179,649,912,2752,1091,3401
353730,201904,4144,11494,3053,9350,488,1640,1387,3938,1875,5578
353740,201904,1895,5117,1299,4005,325,1107,386,1104,711,2211
353750,201904,793,2487,558,2015,137,521,96,378,233,899
353760,201904,11630,28509,9107,24923,1499,4320,5462,14600,6961,18920
353770,201904,723,2192,351,1210,61,212,43,119,104,331
353780,201904,4859,14332,3708,11897,827,2919,1474,4337,2301,7256
353790,201904,2439,7617,1795,6238,504,1976,392,1194,896,3170
353800,201904,16420,45173,12583,38616,2075,6842,6441,19611,8516,26453
353810,201904,1084,2986,719,2239,102,344,293,858,395,1202
353820,201904,1683,4804,1172,3710,267,896,385,1188,652,2084
353830,201904,628,1577,440,1254,67,190,188,508,255,698
353850,201904,1594,4596,1212,3830,316,1000,385,1241,701,2241
353860,201904,2529,7364,1985,6304,509,1785,821,2386,1330,4171
353870,201904,27699,74727,19083,57701,2770,9364,9211,25446,11981,34810
353880,201904,2816,8166,2226,6982,216,790,1298,3898,1514,4688
353890,201904,2350,5290,1513,4078,153,442,985,2535,1138,2977
353900,201904,649,1815,459,1441,92,315,176,518,268,833
353910,201904,1814,5384,1519,4880,200,738,1018,3215,1218,3953
353920,201904,2031,5638,1369,4327,291,1056,329,877,620,1933
353930,201904,4044,10996,2671,8498,567,2032,844,2398,1411,4430
353940,201904,1073,3203,713,2422,145,504,221,706,366,1210
353950,201904,2909,8257,2295,7102,442,1505,1219,3476,1661,4981
353960,201904,735,2001,476,1483,100,323,167,499,267,822
353970,201904,699,1717,507,1430,44,130,305,825,349,955
353980,201904,14120,37215,10839,31114,1065,3397,7186,19867,8251,23264
353990,201904,849,2097,508,1460,64,208,256,692,320,900
354000,201904,2475,6150,1326,3911,283,871,204,601,487,1472
354010,201904,332,893,242,745,27,91,147,440,174,531
354020,201904,3344,9791,2621,8172,698,2343,931,2626,1629,4969
354025,201904,722,2012,450,1465,85,319,80,227,165,546
354030,201904,486,1068,233,628,41,105,93,237,134,342
354040,201904,763,1833,476,1335,28,98,322,860,350,958
354050,201904,928,2755,646,2204,161,569,176,614,337,1183
354060,201904,3512,10327,2374,7833,559,1931,708,2178,1267,4109
354070,201904,3262,9205,2250,7168,478,1678,721,1979,1199,3657
354075,201904,2351,7119,1783,6029,251,1007,946,3102,1197,4109
354080,201904,1391,3917,886,2890,164,566,235,710,399,1276
354085,201904,403,873,317,764,2,5,224,505,226,510
354090,201904,1425,4125,1259,3781,96,317,943,2777,1039,3094
354100,201904,17164,49334,11961,39743,2745,9763,4550,14970,7295,24733
354105,201904,1505,3834,995,2896,125,379,467,1312,592,1691
354110,201904,482,1326,324,1033,58,204,102,319,160,523
354120,201904,1498,4117,977,2984,193,609,325,887,518,1496
354130,201904,5590,15083,3612,11197,1010,3387,210,420,1220,3807
354140,201904,18679,46503,12108,34483,2346,7213,4691,12357,7037,19570
354150,201904,3065,7547,2239,6159,504,1448,877,2351,1381,3799
354160,201904,3034,9040,2222,7319,648,2276,651,2004,1299,4280
354165,201904,578,1757,434,1461,82,316,209,650,291,966
354170,201904,1484,4316,1209,3740,87,300,731,2148,818,2448
354180,201904,434,1236,305,952,62,201,115,321,177,522
354190,201904,1427,4114,1005,3242,97,347,379,1216,476,1563
354200,201904,865,2229,668,1915,86,261,380,1016,466,1277
354210,201904,646,1860,529,1637,48,167,348,1003,396,1170
354220,201904,3002,8337,2160,6594,411,1353,982,2838,1393,4191
354230,201904,693,1792,536,1589,47,177,362,1012,409,1189
354240,201904,1514,4329,983,3178,182,637,292,827,474,1464
354250,201904,499,1298,317,1007,91,297,92,300,183,597
354260,201904,7936,21689,6007,18281,1384,4367,2244,6710,3628,11077
354270,201904,1015,3150,806,2735,188,642,281,933,469,1575
354280,201904,741,1935,621,1762,70,261,376,969,446,1230
354290,201904,864,2795,716,2465,117,402,350,1226,467,1628
354300,201904,3469,10527,2945,9524,950,3122,930,2949,1880,6071
354310,201904,592,1855,478,1594,117,429,133,380,250,809
354320,201904,884,2262,558,1664,73,266,225,586,298,852
354323,201904,476,1200,309,883,36,90,123,338,159,428
354325,201904,1187,3630,828,2826,138,479,334,1098,472,1577
354330,201904,7987,20983,5272,15289,749,2564,2992,8020,3741,10584
354340,201904,27112,71397,18484,55804,3694,12233,8263,23786,11957,36019
354350,201904,1160,3089,920,2643,113,345,595,1623,708,1968
354360,201904,563,1502,321,1061,62,208,51,159,113,367
354370,201904,974,2981,802,2671,144,498,422,1393,566,1891
354380,201904,758,2041,522,1632,92,344,117,291,209,635
354390,201904,13003,32580,8073,23695,1554,4810,2759,7718,4313,12528
354400,201904,1529,4999,1184,4185,208,771,424,1488,632,2259
354410,201904,5191,14742,3896,12047,935,3100,1609,4759,2544,7859
354420,201904,1416,3854,1033,3101,135,442,613,1760,748,2202
354425,201904,2516,6349,1774,5000,421,1202,691,2001,1112,3203
354430,201904,1498,4134,1158,3550,156,544,626,1767,782,2311
354440,201904,569,1561,350,1090,42,148,158,451,200,599
354450,201904,410,1096,224,737,33,107,62,178,95,285
354460,201904,904,2361,586,1787,87,298,298,858,385,1156
354470,201904,497,1274,307,877,21,65,146,366,167,431
354480,201904,1061,2455,716,1912,64,188,476,1205,540,1393
354490,201904,782,2353,566,1883,124,429,216,663,340,1092
354500,201904,1966,5665,1638,5165,530,1843,377,1172,907,3015
354510,201904,732,2054,584,1728,65,198,314,854,379,1052
354515,201904,290,890,218,741,38,154,79,240,117,394
354520,201904,6351,18124,4190,13187,659,2325,2170,6338,2829,8663
354530,201904,3975,11868,3046,9956,731,2511,1160,3694,1891,6205
354540,201904,1264,3457,912,2800,229,732,299,942,528,1674
354550,201904,513,1375,392,1145,58,178,228,633,286,811
354560,201904,1992,5021,1070,3136,146,446,528,1461,674,1907
354570,201904,1145,2980,471,1404,92,280,73,215,165,495
354580,201904,9005,24026,5767,17793,933,3170,2663,7796,3596,10966
354600,201904,1675,4778,1284,4006,154,557,792,2358,946,2915
354610,201904,400,1074,214,668,32,109,77,229,109,338
354620,201904,430,1261,274,942,42,157,101,306,143,463
354625,201904,321,897,178,599,27,95,42,112,69,207
354630,201904,1791,5482,1449,4785,568,1965,194,625,762,2590
354640,201904,3092,9138,2218,7260,383,1426,696,2079,1079,3505
354650,201904,883,2362,707,2051,66,198,430,1221,496,1419
354660,201904,2841,7163,1723,5207,157,568,999,2884,1156,3452
354670,201904,1045,2969,707,2248,146,513,271,790,417,1303
354680,201904,4536,12591,3618,11022,881,2770,1796,5564,2677,8334
354690,201904,567,1803,380,1359,89,340,106,369,195,709
354700,201904,865,2359,601,1806,99,332,264,717,363,1049
354710,201904,498,1371,349,1067,55,191,145,382,200,573
354720,201904,323,793,137,409,45,133,27,84,72,217
354730,201904,9269,26768,6889,22092,1008,3531,3749,11608,4757,15139
354740,201904,317,868,124,430,16,63,20,56,36,119
354750,201904,2398,6537,1510,4759,292,1005,574,1588,866,2593
354760,201904,1875,5260,1289,4090,337,1163,354,1038,691,2201
354765,201904,334,904,133,443,21,78,25,70,46,148
354770,201904,2267,5740,1622,4639,327,1010,710,1880,1037,2890
354780,201904,51641,135081,38878,109041,5111,15992,22458,58914,27569,74906
354790,201904,957,2755,759,2405,100,347,439,1336,539,1683
354800,201904,2534,6845,1948,5827,497,1532,778,2204,1275,3736
354805,201904,1295,3111,855,2391,118,340,416,1047,534,1387
354810,201904,655,1909,350,1246,53,201,73,234,126,435
354820,201904,905,2710,639,2156,129,494,150,427,279,921
354830,201904,477,1183,303,865,73,204,100,270,173,474
354840,201904,914,2327,488,1451,49,147,249,714,298,861
354850,201904,20313,54808,14017,42981,1937,6859,7858,22590,9795,29449
354860,201904,1565,4499,1012,3338,194,702,313,903,507,1605
354870,201904,51649,133431,40153,112087,5032,15363,23778,62992,28810,78355
354880,201904,5640,14388,2566,7558,311,1034,837,1990,1148,3024
354890,201904,16015,41293,12341,34918,1721,5473,7178,19529,8899,25002
354900,201904,406,1090,267,831,41,132,69,195,110,327
354910,201904,5024,13698,2894,9584,646,2274,343,1054,989,3328
354920,201904,440,1183,180,621,24,97,32,100,56,197
354925,201904,286,843,151,527,27,100,28,86,55,186
354930,201904,398,962,212,638,18,65,85,220,103,285
354940,201904,2003,6299,1404,4910,469,1777,208,655,677,2432
354950,201904,1434,3949,1134,3477,71,320,766,2185,837,2505
354960,201904,848,2307,649,2014,80,288,347,1009,427,1297
354970,201904,3931,11438,3055,9809,412,1425,1800,5633,2212,7058
354980,201904,29665,72300,19085,53562,2319,7698,10528,27387,12847,35085
354990,201904,58123,152113,42692,123415,4434,14445,25764,70618,30198,85063
354995,201904,2490,6038,1857,5164,231,722,1231,3249,1462,3971
355000,201904,1464,3911,1147,3413,184,620,475,1302,659,1922
355010,201904,3409,9632,2054,6667,678,2279,177,589,855,2868
355020,201904,3362,9820,2414,8035,729,2668,641,1992,1370,4660
355030,201904,1280237,3224748,912039,2483131,154100,457311,435619,1093584,589719,1550895
355040,201904,2708,7284,2183,6533,364,1130,1371,4107,1735,5237
355050,201904,936,2303,659,1851,190,543,201,521,391,1064
355060,201904,5545,15738,4047,12754,719,2584,1928,5509,2647,8093
355070,201904,7796,21012,6172,18292,775,2673,3718,10307,4493,12980
355080,201904,847,2470,513,1789,111,422,60,159,171,581
355090,201904,1122,3314,836,2788,222,745,234,798,456,1543
355100,201904,20810,56146,16182,49204,2908,9392,9511,28546,12419,37938
355110,201904,935,2702,698,2301,222,779,127,427,349,1206
355120,201904,668,1819,460,1477,51,182,149,449,200,631
355130,201904,772,1749,331,889,19,52,191,473,210,525
355140,201904,1576,3894,1367,3587,111,370,1089,2736,1200,3106
355150,201904,4088,11244,3236,9673,393,1297,1917,5491,2310,6788
355160,201904,1777,5091,1296,4222,326,1201,296,931,622,2132
355170,201904,9030,23901,7022,20456,1644,5080,3409,9691,5053,14771
355180,201904,2673,7445,1887,6060,439,1600,623,1784,1062,3384
355190,201904,1802,4848,1409,4217,330,1032,719,2242,1049,3274
355200,201904,800,2552,671,2333,200,789,230,721,430,1510
355210,201904,2775,7952,2244,6796,331,1137,1213,3458,1544,4595
355220,201904,42167,115914,33041,97777,8574,26748,12512,34113,21086,60861
355230,201904,1130,2869,591,1777,110,333,168,465,278,798
355240,201904,21807,58460,14963,44849,2303,7501,7352,21045,9655,28546
355250,201904,34808,95823,25165,76827,6438,20815,8897,25887,15335,46702
355255,201904,797,2083,417,1308,76,250,133,401,209,651
355260,201904,1354,3530,970,2854,116,413,577,1579,693,1992
355270,201904,1190,3563,889,2896,223,741,263,816,486,1557
355280,201904,27106,72264,18905,55973,3113,9844,8566,24039,11679,33883
355290,201904,853,2413,622,1955,133,385,254,765,387,1150
355300,201904,1218,3619,960,3095,163,552,314,975,477,1527
355310,201904,1007,2820,747,2370,94,303,404,1302,498,1605
355320,201904,523,1415,381,1133,66,226,147,367,213,593
355330,201904,2207,6042,1686,5081,140,520,1173,3357,1313,3877
355340,201904,3565,7996,2819,6964,368,834,1823,4567,2191,5401
355350,201904,1311,3926,968,3213,207,718,319,1052,526,1770
355360,201904,1240,3317,961,2872,127,392,574,1689,701,2081
355365,201904,365,1002,181,636,40,127,29,104,69,231
355370,201904,5571,14392,4210,12305,1008,2839,1833,5801,2841,8640
355380,201904,2882,7932,2125,6421,377,1248,708,1856,1085,3104
355385,201904,1373,3789,1124,3420,122,461,670,1855,792,2316
355390,201904,781,2197,554,1690,124,391,216,612,340,1003
355395,201904,2015,5745,1374,4365,189,640,508,1459,697,2099
355400,201904,8754,26548,6994,22861,1920,6988,2243,6578,4163,13566
355410,201904,21209,59159,13716,44545,3231,11505,3192,10282,6423,21787
355420,201904,653,2157,534,1903,141,574,130,420,271,994
355430,201904,3624,9370,2725,7767,702,1958,1157,3312,1859,5270
355440,201904,810,2257,469,1500,88,300,132,393,220,693
355450,201904,3230,8609,2012,6177,358,1160,778,2196,1136,3356
355460,201904,525,1311,319,951,41,137,154,421,195,558
355465,201904,385,1089,285,887,49,161,112,337,161,498
355470,201904,1124,2971,611,1897,174,588,176,487,350,1075
355475,201904,274,678,245,635,17,40,196,512,213,552
355480,201904,3558,10313,2918,9287,444,1615,1817,5596,2261,7211
355490,201904,940,2573,500,1587,43,139,232,695,275,834
355495,201904,776,2276,559,1865,77,287,197,624,274,911
355500,201904,6563,17540,3773,11755,580,1961,1133,3229,1713,5190
355510,201904,1276,3315,793,2394,112,385,294,787,406,1172
355520,201904,375,845,175,496,33,92,47,116,80,208
355530,201904,421,964,135,402,23,82,48,124,71,206
355535,201904,497,1383,378,1186,74,272,155,438,229,710
355540,201904,9425,25215,7693,22559,1430,4513,4448,12707,5878,17220
355550,201904,640,1959,524,1736,72,256,257,820,329,1076
355560,201904,1114,2955,593,1906,120,429,42,130,162,559
355570,201904,226,664,121,412,24,82,20,59,44,141
355580,201904,1194,2979,779,2283,114,381,387,1064,501,1445
355590,201904,173,436,130,369,16,46,78,210,94,256
355600,201904,1447,3651,954,2790,220,677,380,1083,600,1760
355610,201904,1691,4353,1119,3293,143,425,522,1472,665,1897
355620,201904,4344,12234,3186,9847,435,1596,1639,4620,2074,6216
355630,201904,2240,6326,1535,4922,270,903,728,2290,998,3193
355635,201904,890,2683,666,2232,122,465,229,719,351,1184
355640,201904,2604,7704,1783,5995,409,1443,412,1364,821,2807
355645,201904,4137,12051,3118,10200,387,1389,1796,5779,2183,7168
355650,201904,6297,17566,5082,15294,1430,4477,2096,5810,3526,10287
355660,201904,1259,3418,855,2619,116,440,286,871,402,1311
355670,201904,3235,9240,2131,6622,301,1123,1017,2750,1318,3873
355680,201904,3067,8756,1215,4100,343,1186,123,435,466,1621
355690,201904,759,2348,493,1787,130,484,9,15,139,499
355695,201904,229,684,132,443,14,57,16,33,30,90
355700,201904,6645,19669,5345,16704,1048,3361,2556,7580,3604,10941
355710,201904,8090,19349,4931,13481,844,2482,2073,5118,2917,7600
355715,201904,460,1219,239,755,48,168,42,107,90,275
355720,201904,1437,4244,1116,3618,201,713,547,1616,748,2329
355730,201904,920,2675,719,2252,183,608,254,723,437,1331
410010,201904,1225,3443,920,2797,210,705,194,569,404,1274
410020,201904,973,3056,767,2563,272,851,197,668,469,1519
410030,201904,1426,4094,1211,3735,176,619,644,1968,820,2587
410040,201904,10943,31750,8166,26261,1793,6238,2630,7898,4423,14136
410045,201904,911,2405,599,1823,89,296,194,556,283,852
410050,201904,2436,6187,1533,4540,334,1093,388,1034,722,2127
410060,201904,2025,6060,1547,5005,388,1298,432,1368,820,2666
410070,201904,1747,4615,1245,3635,220,700,460,1278,680,1978
410080,201904,1357,3666,958,2902,150,461,394,1220,544,1681
410090,201904,990,2728,879,2536,96,275,502,1515,598,1790
410100,201904,1902,5665,1319,4227,177,676,242,742,419,1418
410105,201904,464,1240,249,773,41,150,58,167,99,317
410110,201904,3044,8043,2095,6097,311,970,846,2339,1157,3309
410115,201904,543,1399,379,1111,63,202,130,372,193,574
410120,201904,2347,7181,2041,6632,613,2151,738,2325,1351,4476
410130,201904,1101,3076,953,2785,235,759,419,1123,654,1882
410140,201904,13933,34480,8333,24246,1645,5161,1838,4863,3483,10024
410150,201904,15905,38464,7456,21334,1337,4129,1543,4114,2880,8243
410160,201904,2852,8107,2316,7141,480,1627,831,2555,1311,4182
410165,201904,716,2019,588,1731,55,189,348,963,403,1152
410170,201904,2500,6695,1611,4709,390,1231,136,403,526,1634
410180,201904,13825,39992,10778,33387,1628,5533,5609,16261,7237,21794
410185,201904,437,1215,309,943,52,172,101,283,153,455
410190,201904,2162,5588,1569,4494,335,981,422,1177,757,2158
410200,201904,4780,11552,2552,7489,448,1527,529,1537,977,3064
410210,201904,2803,7305,1751,5312,310,1084,579,1488,889,2572
410220,201904,514,1364,322,975,46,158,48,138,94,296
410230,201904,1552,4373,1213,3650,172,619,654,1836,826,2455
410240,201904,4395,12166,3148,9713,838,2847,228,671,1066,3518
410250,201904,2501,6193,1803,4978,170,579,829,2206,999,2785
410260,201904,1776,4574,1130,3347,231,723,447,1290,678,2013
410270,201904,453,1196,321,947,60,207,113,309,173,516
410275,201904,654,1913,417,1358,57,201,194,576,251,777
410280,201904,2218,6065,1426,4418,232,786,539,1551,771,2337
410290,201904,2922,8484,2079,6641,477,1535,648,2080,1125,3615
410300,201904,623,1591,493,1368,53,166,228,586,281,752
410302,201904,356,940,182,577,34,109,79,236,113,345
410304,201904,1119,3096,953,2754,137,394,519,1476,656,1870
410305,201904,1639,4083,1125,3314,175,548,616,1759,791,2307
410310,201904,2492,7384,1946,6213,390,1354,751,2382,1141,3736
410315,201904,703,1732,349,1129,119,391,77,242,196,633
410320,201904,1097,3106,706,2243,105,388,111,344,216,732
410322,201904,541,1504,275,870,24,90,115,339,139,429
410330,201904,1463,3707,1014,2817,160,496,297,810,457,1306
410335,201904,814,2333,653,2004,83,273,293,841,376,1114
410337,201904,798,1984,547,1482,48,134,244,625,292,759
410340,201904,479,1309,315,905,30,105,161,390,191,495
410345,201904,2227,5933,1122,3454,248,777,246,691,494,1468
410347,201904,682,1764,484,1387,51,189,136,381,187,570
410350,201904,1298,3426,898,2700,93,314,383,1079,476,1393
410360,201904,3961,9909,3101,8413,209,667,2008,5216,2217,5883
410370,201904,11465,31332,7568,22409,990,3273,2914,7645,3904,10918
410380,201904,1360,3637,1003,2919,110,360,423,1138,533,1498
410390,201904,2498,6661,1600,4910,401,1348,384,1074,785,2422
410395,201904,839,2503,681,2160,140,479,291,905,431,1384
410400,201904,5145,14259,3822,11646,659,2121,1644,4792,2303,6913
410405,201904,786,1949,603,1675,134,410,253,657,387,1067
410410,201904,1148,3231,1093,3154,168,604,677,2003,845,2607
410420,201904,7775,22726,5983,19003,1148,4049,1919,5467,3067,9516
410425,201904,2850,8346,2038,6670,372,1306,700,2092,1072,3398
410430,201904,12505,32227,8433,24426,1447,4537,2800,7686,4247,12223
410440,201904,2346,7193,1984,6482,332,1213,1004,3213,1336,4426
410442,201904,2149,6783,1795,5944,528,1727,534,1782,1062,3509
410445,201904,2232,6716,1743,5741,359,1323,479,1653,838,2976
410450,201904,1425,3803,1029,3059,206,687,297,817,503,1504
410460,201904,1772,4587,1380,3981,182,551,643,1796,825,2347
410465,201904,2553,7720,1961,6433,393,1319,614,1919,1007,3238
410470,201904,1815,5329,1297,4258,325,1194,263,888,588,2082
410480,201904,34295,83630,18398,54821,3069,10224,3805,9785,6874,20009
410490,201904,10450,29882,7352,23168,1451,4946,2587,7641,4038,12587
410500,201904,1689,4704,1167,3615,255,909,312,826,567,1735
410510,201904,1946,4922,1251,3540,236,651,370,1072,606,1723
410520,201904,2985,9648,2688,9048,853,2909,1034,3542,1887,6451
410530,201904,1519,3960,715,2132,112,342,125,281,237,623
410540,201904,2476,6919,1780,5514,294,985,866,2644,1160,3629
410550,201904,6661,18270,4226,12725,749,2465,1104,2920,1853,5385
410560,201904,1407,3807,1062,3098,216,668,400,1030,616,1698
410570,201904,2443,7001,1830,5851,536,1989,135,458,671,2447
410580,201904,23106,62164,17068,50698,3642,11549,7015,19461,10657,31010
410590,201904,1423,4215,936,2954,167,539,245,682,412,1221
410600,201904,1757,4835,1320,3957,285,809,468,1457,753,2266
410610,201904,731,1975,518,1552,51,184,227,652,278,836
410620,201904,2047,6210,1297,4357,307,1119,212,650,519,1769
410630,201904,2316,6353,1480,4552,297,991,251,634,548,1625
410640,201904,4476,10879,2839,8005,680,2179,380,1076,1060,3255
410645,201904,995,2980,823,2732,276,943,325,1093,601,2036
410650,201904,1957,5594,1338,4264,311,1059,404,1144,715,2203
410655,201904,887,2224,617,1730,30,109,308,810,338,919
410657,201904,621,1683,390,1195,61,223,158,415,219,638
410660,201904,3125,8301,1700,5080,318,990,353,1017,671,2007
410670,201904,1044,2634,590,1705,119,350,252,678,371,1028
410680,201904,2642,8165,1908,6326,467,1512,455,1533,922,3045
410685,201904,549,1431,424,1204,87,281,192,494,279,775
410690,201904,116595,298249,76186,220653,13217,43216,25953,65886,39170,109102
410700,201904,2316,5984,1961,5434,306,891,1018,2704,1324,3595
410710,201904,769,1985,504,1502,54,173,262,748,316,921
410712,201904,640,1952,538,1719,142,492,188,563,330,1055
410715,201904,854,2584,517,1774,102,353,155,514,257,867
410720,201904,3099,8223,2286,6548,332,1120,463,1195,795,2315
410725,201904,1094,2795,635,1911,119,388,109,280,228,668
410730,201904,588,1590,433,1302,86,297,96,277,182,574
410740,201904,920,2616,658,2116,103,354,259,821,362,1175
410750,201904,1672,4390,1348,3812,221,693,557,1507,778,2200
410752,201904,346,901,153,478,18,71,64,181,82,252
410753,201904,228,711,157,550,18,74,31,105,49,179
410754,201904,1105,2912,902,2599,61,156,595,1821,656,1977
410755,201904,575,1508,412,1177,57,191,187,466,244,657
410760,201904,3209,8522,2309,6902,651,2159,520,1458,1171,3617
410765,201904,12202,35634,9462,30023,1626,5660,1637,4789,3263,10449
410770,201904,967,2397,661,1864,69,212,328,903,397,1115
410773,201904,1245,3345,1073,3065,124,400,677,1861,801,2261
410775,201904,1406,3696,1226,3422,77,250,721,1963,798,2213
410780,201904,595,1500,371,1037,60,173,95,262,155,435
410785,201904,721,2054,570,1762,98,330,214,632,312,962
410790,201904,632,1843,506,1586,136,476,58,132,194,608
410800,201904,3149,7262,2510,6247,71,233,1559,3765,1630,3998
410810,201904,367,1040,282,869,39,133,119,343,158,476
410820,201904,756,2227,400,1255,91,293,73,188,164,481
410830,201904,29731,75380,20126,58703,4610,15236,6603,18124,11213,33360
410832,201904,956,2567,774,2238,100,337,427,1143,527,1480
410840,201904,7147,18984,4249,13182,901,3103,878,2385,1779,5488
410845,201904,1105,2990,877,2607,181,574,332,966,513,1540
410850,201904,2223,6616,1918,6034,335,1146,897,2771,1232,3917
410855,201904,724,1861,469,1366,36,111,210,562,246,673
410860,201904,3842,10001,3010,8465,502,1565,1275,3372,1777,4937
410865,201904,1336,4155,1172,3808,174,628,668,2214,842,2842
410870,201904,1257,3465,1062,3132,46,144,763,2229,809,2373
410880,201904,4091,11601,2919,9281,517,1867,438,1531,955,3398
410890,201904,934,2677,668,2120,159,539,175,547,334,1086
410895,201904,950,3171,784,2780,298,1132,122,420,420,1552
410900,201904,896,2446,578,1802,93,292,114,295,207,587
410910,201904,367,897,208,580,10,34,125,318,135,352
410920,201904,838,2039,563,1587,85,273,249,688,334,961
410930,201904,1437,3947,1061,3228,276,980,237,704,513,1684
410940,201904,21008,59908,15170,48824,3337,11740,4164,13326,7501,25066
410950,201904,1890,5632,1686,5303,69,268,1368,4207,1437,4475
410960,201904,6858,18082,4400,13631,1032,3501,1532,4695,2564,8196
410965,201904,939,2577,706,2128,106,326,376,1122,482,1448
410970,201904,3715,10273,2598,8093,608,2287,365,961,973,3248
410975,201904,1256,3258,946,2717,143,471,361,1013,504,1484
410980,201904,6549,17060,4125,12508,540,1820,1647,4711,2187,6531
410990,201904,1251,3196,803,2437,242,850,186,483,428,1333
411000,201904,519,1449,357,1112,57,206,93,247,150,453
411005,201904,403,1116,251,778,56,179,46,134,102,313
411007,201904,2123,6198,1733,5449,391,1316,562,1780,953,3096
411010,201904,4120,12623,3210,10636,848,3010,321,941,1169,3951
411020,201904,2278,6654,1867,5919,545,1819,524,1609,1069,3428
411030,201904,721,1811,482,1308,46,150,242,587,288,737
411040,201904,901,2342,410,1221,53,159,118,306,171,465
411050,201904,1790,5820,1471,5043,400,1429,212,636,612,2065
411060,201904,1677,4520,1074,3297,239,859,183,522,422,1381
411065,201904,344,943,247,755,41,126,106,321,147,447
411070,201904,6292,16806,4977,14450,823,2625,2223,6235,3046,8860
411080,201904,2103,5768,1663,4951,428,1394,403,1145,831,2539
411090,201904,832,2212,514,1567,39,147,126,351,165,498
411095,201904,1528,3677,1030,2858,117,371,356,928,473,1299
411100,201904,1076,2843,730,2217,85,302,211,655,296,957
411110,201904,610,1613,261,819,37,99,20,43,57,142
411120,201904,1188,3463,945,2941,329,1132,194,499,523,1631
411125,201904,4929,14815,4367,13659,953,3056,2046,6601,2999,9657
411130,201904,670,1855,475,1447,86,261,179,567,265,828
411140,201904,2205,6941,1828,6068,509,1795,554,1828,1063,3623
411150,201904,3636,9680,2490,7244,519,1740,224,485,743,2225
411155,201904,947,2474,543,1669,50,155,244,699,294,854
411160,201904,335,780,212,586,29,90,42,113,71,203
411170,201904,687,2118,505,1676,109,353,169,557,278,910
411180,201904,5121,14123,3930,11896,669,2231,1683,4810,2352,7041
411190,201904,1464,3905,1071,3182,185,584,358,1007,543,1591
411200,201904,4871,13438,3273,10285,909,3064,628,1787,1537,4851
411210,201904,2630,6041,1738,4638,352,1078,483,1197,835,2275
411220,201904,837,2279,612,1803,132,410,178,513,310,923
411230,201904,820,2263,562,1752,116,379,198,612,314,991
411240,201904,1555,3814,907,2537,98,315,439,1142,537,1457
411250,201904,2035,5572,1518,4618,328,1144,459,1376,787,2520
411260,201904,325,883,212,650,30,96,81,214,111,310
411270,201904,1879,5259,1431,4321,225,705,656,1875,881,2580
411275,201904,1299,3147,898,2452,142,451,389,986,531,1437
411280,201904,1299,3622,844,2715,212,686,120,380,332,1066
411290,201904,709,1950,480,1499,52,147,242,773,294,920
411295,201904,1146,2913,846,2317,86,252,415,1088,501,1340
411300,201904,1002,2536,616,1760,66,204,231,579,297,783
411310,201904,849,2029,633,1705,43,116,278,740,321,856
411320,201904,5173,13963,3718,11228,772,2442,1377,3811,2149,6253
411325,201904,1445,4179,1203,3743,210,644,660,2108,870,2752
411330,201904,3180,8870,2327,7264,573,1955,663,2096,1236,4051
411340,201904,839,2354,495,1561,70,248,177,530,247,778
411342,201904,958,2382,571,1591,89,252,253,702,342,954
411345,201904,1072,2856,789,2376,78,257,529,1596,607,1853
411350,201904,2414,6837,1608,5153,444,1518,168,518,612,2036
411360,201904,640,1557,449,1259,47,135,156,428,203,563
411370,201904,47696,120658,34043,96972,2905,9973,19511,51920,22416,61893
411373,201904,1319,3431,1068,3031,105,343,555,1585,660,1928
411375,201904,1052,2709,753,2132,120,354,293,762,413,1116
411380,201904,1043,2481,719,1836,40,112,455,1086,495,1198
411390,201904,1573,4426,1201,3588,193,636,458,1194,651,1830
411400,201904,2139,5547,1641,4597,227,763,786,2081,1013,2844
411410,201904,2082,5974,1546,4736,357,1216,324,936,681,2152
411420,201904,3847,9794,2126,6392,332,1159,380,908,712,2067
411430,201904,3240,9048,2500,7605,536,1806,932,2584,1468,4390
411435,201904,410,1190,269,882,48,156,98,276,146,432
411440,201904,2461,7238,2007,6295,419,1451,691,2140,1110,3591
411450,201904,2489,6740,1892,5719,271,799,985,3007,1256,3806
411460,201904,3673,9880,2099,6631,383,1383,344,995,727,2378
411470,201904,710,1946,516,1541,86,278,171,466,257,744
411480,201904,4286,12004,3031,9543,640,2301,859,2469,1499,4770
411490,201904,1558,4140,1190,3490,169,573,446,1151,615,1724
411500,201904,1323,3609,869,2632,129,448,213,586,342,1034
411510,201904,2193,5865,1751,5049,394,1305,378,1097,772,2402
411520,201904,28328,69996,15678,45218,2098,6790,5470,14166,7568,20956
411530,201904,912,2452,563,1769,115,409,101,283,216,692
411535,201904,460,1365,228,775,22,82,40,102,62,184
411540,201904,2706,6986,1821,5181,252,809,750,2063,1002,2872
411545,201904,919,2737,762,2453,74,244,493,1598,567,1842
411550,201904,683,1799,481,1387,82,258,90,263,172,521
411560,201904,1875,5084,1074,3347,155,552,81,206,236,758
411570,201904,6672,16227,4379,12454,937,2922,1011,2864,1948,5786
411573,201904,756,2103,632,1887,75,252,354,1014,429,1266
411575,201904,1790,5043,1341,4102,286,957,325,927,611,1884
411580,201904,4209,9989,2354,7013,321,1131,349,898,670,2029
411585,201904,659,1971,276,940,71,247,42,121,113,368
411590,201904,377,1097,260,817,23,84,141,395,164,479
411600,201904,275,741,165,548,39,132,53,169,92,301
411605,201904,1511,3571,900,2510,126,439,455,1233,581,1672
411610,201904,2309,5876,1593,4431,105,361,961,2505,1066,2866
411620,201904,2769,7613,2351,6941,394,1277,1312,3800,1706,5077
411630,201904,733,1932,492,1456,82,293,153,391,235,684
411640,201904,529,1468,354,1058,47,150,124,326,171,476
411650,201904,209,603,136,442,28,93,30,94,58,187
411660,201904,898,2284,638,1799,47,139,323,873,370,1012
411670,201904,1203,3106,836,2322,104,296,354,916,458,1212
411680,201904,1488,4060,1141,3378,141,477,550,1603,691,2080
411690,201904,3451,9177,2599,7684,542,1657,768,2359,1310,4016
411695,201904,664,2091,426,1426,53,189,168,560,221,749
411700,201904,1558,4161,1024,3123,249,835,130,344,379,1179
411705,201904,1824,5816,1538,5301,322,1100,820,3022,1142,4122
411710,201904,1781,4674,1242,3650,335,1028,165,481,500,1509
411720,201904,1047,2527,722,1923,116,334,304,742,420,1076
411721,201904,874,2292,646,1851,124,365,153,442,277,807
411722,201904,726,1997,393,1171,60,203,147,362,207,565
411725,201904,1166,3442,787,2625,187,646,158,545,345,1191
411727,201904,1432,4081,927,2992,243,811,130,394,373,1205
411729,201904,688,1696,429,1189,56,196,149,362,205,558
411730,201904,5116,14119,3787,11383,964,3005,1348,3970,2312,6975
411740,201904,529,1394,265,819,48,151,55,147,103,298
411745,201904,757,2221,478,1545,58,192,86,221,144,413
411750,201904,4755,12849,3363,10006,459,1478,1576,4408,2035,5886
411760,201904,6765,18457,5206,15666,1777,5518,1011,3361,2788,8879
411770,201904,2966,8838,2119,6893,547,1907,273,816,820,2723
411780,201904,2845,8296,2407,7384,664,2167,814,2492,1478,4659
411790,201904,2828,7050,1503,4533,342,1164,190,464,532,1628
411800,201904,975,2802,659,2051,109,343,133,397,242,740
411810,201904,1576,4165,1159,3338,169,517,573,1545,742,2062
411820,201904,10253,31022,8445,27502,2411,8337,3173,10041,5584,18378
411830,201904,589,1469,394,1122,73,225,85,260,158,485
411840,201904,11319,30746,7376,22260,1304,4283,1946,5401,3250,9684
411845,201904,458,1338,242,799,37,141,35,110,72,251
411850,201904,7119,18925,4971,14967,1381,4611,725,1962,2106,6573
411860,201904,707,2083,508,1645,98,351,131,378,229,729
411870,201904,641,1972,432,1456,94,343,85,256,179,599
411880,201904,2022,5337,1461,4368,270,876,375,1094,645,1970
411885,201904,1017,2643,714,2084,94,309,252,719,346,1028
411890,201904,1135,3132,771,2393,136,469,62,157,198,626
411900,201904,787,2280,470,1547,111,383,52,179,163,562
411910,201904,940,2899,672,2279,181,659,178,551,359,1210
411915,201904,15175,38105,9511,27576,1587,5073,3139,8146,4726,13219
411920,201904,1005,3108,836,2734,200,716,267,825,467,1541
411925,201904,480,1286,326,989,71,242,110,317,181,559
411930,201904,4984,15941,4218,14393,1873,6923,243,973,2116,7896
411940,201904,3166,9744,2411,7960,600,2075,683,2028,1283,4103
411950,201904,12854,35880,10450,31746,1848,6140,5453,16026,7301,22166
411960,201904,5510,15398,4473,13196,930,3023,1554,4296,2484,7319
411965,201904,420,1186,294,929,39,134,110,316,149,450
411970,201904,1005,2456,779,2130,165,430,332,1030,497,1460
411980,201904,1416,3710,1028,3008,260,798,368,1016,628,1814
411990,201904,34983,96155,22903,72566,4680,16285,7617,22953,12297,39238
411995,201904,2778,7242,2069,6093,602,1954,567,1544,1169,3498
412000,201904,1951,4575,1383,3599,50,166,938,2281,988,2447
412010,201904,611,1919,424,1473,51,190,107,307,158,497
412015,201904,547,1576,454,1404,57,188,257,795,314,983
412020,201904,430,1230,256,839,33,127,103,321,136,448
412030,201904,622,1796,427,1406,75,257,115,371,190,628
412033,201904,835,2285,573,1706,72,208,201,555,273,763
412035,201904,771,2106,489,1592,69,260,242,737,311,997
412040,201904,574,1594,354,1113,70,230,58,169,128,399
412050,201904,1684,4354,1144,3341,215,718,272,783,487,1501
412060,201904,6923,21380,5812,19137,1749,6393,1456,4534,3205,10927
412065,201904,613,1745,425,1320,90,291,122,390,212,681
412070,201904,1109,2899,846,2341,117,345,357,944,474,1289
412080,201904,1909,5594,1182,3935,195,691,147,400,342,1091
412085,201904,281,736,91,306,13,42,12,27,25,69
412090,201904,5526,14733,4293,12430,1210,3578,1612,4808,2822,8386
412100,201904,1652,4666,1233,3878,362,1223,243,823,605,2046
412110,201904,847,2318,611,1806,97,292,204,587,301,879
412120,201904,1834,5570,1428,4720,294,1111,407,1156,701,2267
412125,201904,648,1902,470,1513,100,324,147,444,247,768
412130,201904,682,1805,476,1389,64,200,114,348,178,548
412135,201904,599,1615,265,800,45,132,90,247,135,379
412140,201904,1539,3925,982,2893,206,710,166,437,372,1147
412150,201904,2782,7552,2304,6674,352,1132,1350,3732,1702,4864
412160,201904,990,3117,592,2053,132,492,86,268,218,760
412170,201904,4126,11846,3475,10709,736,2428,1437,4125,2173,6553
412175,201904,1237,3807,1033,3407,254,842,408,1389,662,2231
412180,201904,1634,4619,1189,3762,174,659,507,1435,681,2094
412190,201904,3271,8371,2410,6810,317,984,1067,3006,1384,3990
412200,201904,1737,5329,1238,4089,341,1202,199,618,540,1820
412210,201904,613,1556,336,1008,62,214,85,232,147,446
412215,201904,3460,9463,2771,8140,750,2146,1112,3718,1862,5864
412217,201904,950,2541,792,2272,64,185,520,1450,584,1635
412220,201904,5665,16181,4566,14052,1167,3576,1445,4689,2612,8265
412230,201904,2566,7884,2055,6831,398,1513,552,1544,950,3057
412240,201904,6440,16892,4069,12201,734,2413,1140,3162,1874,5575
412250,201904,1950,5117,1482,4243,365,1051,321,899,686,1950
412260,201904,1201,3289,838,2501,143,420,241,672,384,1092
412265,201904,790,2306,668,2065,137,466,288,845,425,1311
412270,201904,804,2297,524,1663,74,258,206,573,280,831
412280,201904,450,1304,350,1128,80,269,98,286,178,555
412290,201904,972,2509,651,1898,103,322,206,576,309,898
412300,201904,1394,3899,1092,3293,253,789,257,793,510,1582
412310,201904,748,2067,615,1826,48,206,330,924,378,1130
412320,201904,827,2166,557,1624,73,281,202,588,275,869
412330,201904,1423,3962,967,3034,185,612,337,1090,522,1702
412340,201904,1056,3077,652,2111,107,380,125,377,232,757
412350,201904,2724,7304,1750,5341,359,1107,358,1098,717,2205
412360,201904,251,709,156,487,10,40,78,229,88,269
412370,201904,778,2269,519,1710,104,382,33,112,137,494
412380,201904,1535,4270,1044,3216,300,968,152,509,452,1477
412382,201904,517,1315,338,990,57,195,113,274,170,469
412385,201904,2103,5936,1726,5192,583,1677,488,1613,1071,3290
412390,201904,2340,5951,1885,5224,332,944,765,2112,1097,3056
412395,201904,698,2031,471,1499,61,192,190,581,251,773
412400,201904,875,2376,626,1871,140,437,161,504,301,941
412402,201904,1780,4528,1239,3610,301,933,142,427,443,1360
412405,201904,3051,8344,1953,6093,485,1762,54,148,539,1910
412410,201904,5336,14525,3829,11815,778,2749,1068,3073,1846,5822
412420,201904,497,1328,304,906,31,103,125,328,156,431
412430,201904,536,1419,351,1054,32,103,156,444,188,547
412440,201904,2643,7469,1756,5669,495,1710,258,847,753,2557
412450,201904,372,1133,243,800,52,167,20,40,72,207
412460,201904,972,2655,773,2304,146,490,320,932,466,1422
412470,201904,1563,5107,1263,4409,326,1191,319,1134,645,2325
412480,201904,919,2564,579,1779,103,336,147,404,250,740
412490,201904,1137,2956,927,2549,99,267,538,1417,637,1684
412500,201904,1826,4747,1375,3866,331,936,363,960,694,1896
412510,201904,1936,6027,1332,4423,306,1074,101,294,407,1368
412520,201904,1279,3415,677,2042,162,496,38,98,200,594
412530,201904,635,1730,459,1359,70,236,113,329,183,565
412535,201904,775,2112,539,1634,115,376,110,297,225,673
412540,201904,1207,3224,828,2444,96,356,264,795,360,1151
412545,201904,670,1755,452,1294,77,247,129,333,206,580
412550,201904,28956,80449,19837,61296,3680,12252,6905,19737,10585,31989
412555,201904,252,696,158,480,19,63,43,100,62,163
412560,201904,4668,13960,3419,10955,594,2031,1039,3335,1633,5366
412570,201904,4002,10545,2266,7043,535,1815,305,1057,840,2872
412575,201904,935,2466,754,2111,78,251,446,1164,524,1415
412580,201904,1352,3677,929,2822,120,418,445,1304,565,1722
412590,201904,402,1078,204,660,35,133,17,47,52,180
412600,201904,1359,3870,1006,3125,170,603,397,1177,567,1780
412610,201904,778,2141,514,1534,57,191,249,661,306,852
412620,201904,1227,3393,906,2801,189,660,273,783,462,1443
412625,201904,8189,22336,5108,16026,780,2759,302,868,1082,3627
412627,201904,1017,2915,669,2185,152,559,174,554,326,1113
412630,201904,2789,8277,1992,6466,395,1295,631,1842,1026,3137
412635,201904,347,931,232,677,36,119,70,176,106,295
412640,201904,1034,2859,563,1766,80,274,138,378,218,652
412650,201904,1518,4311,1201,3625,215,706,421,1111,636,1817
412660,201904,2440,6606,1709,5122,294,960,495,1345,789,2305
412665,201904,404,1102,294,863,55,162,107,300,162,462
412667,201904,1693,4545,1244,3635,171,558,501,1370,672,1928
412670,201904,773,1934,513,1467,94,310,164,437,258,747
412680,201904,1554,4352,1023,3262,125,468,418,1191,543,1659
412690,201904,866,2411,640,1927,106,342,228,654,334,996
412700,201904,2006,5448,1607,4798,240,868,784,2211,1024,3079
412710,201904,5744,17321,4430,14464,949,3401,1270,3844,2219,7245
412720,201904,1201,3604,894,2866,155,530,183,498,338,1028
412730,201904,2065,5738,1215,3879,248,862,277,825,525,1687
412740,201904,1727,4915,1140,3637,207,737,170,554,377,1291
412750,201904,3741,10237,3156,9349,383,1344,2013,5642,2396,6986
412760,201904,2826,7873,2344,7018,371,1224,1259,3591,1630,4815
412770,201904,9867,25515,5155,15959,750,2478,1043,2814,1793,5292
412780,201904,1184,3235,897,2699,192,620,341,987,533,1607
412785,201904,1926,4941,1333,3852,193,585,747,2101,940,2686
412788,201904,1285,3759,1048,3284,271,843,440,1358,711,2201
412790,201904,1254,3368,658,2079,108,399,198,543,306,942
412795,201904,1311,3510,679,2119,112,380,123,370,235,750
412796,201904,2288,6863,1887,5989,386,1302,613,1816,999,3118
412800,201904,3318,8352,2239,6267,284,888,945,2349,1229,3237
412810,201904,10449,27040,6275,18334,873,2924,2162,5555,3035,8479
412820,201904,6187,17430,4405,13778,1026,3353,1295,4045,2321,7398
412830,201904,340,986,222,711,29,88,48,146,77,234
412840,201904,1790,4637,1274,3621,179,556,439,1177,618,1733
412850,201904,2814,7629,2048,6225,343,1110,758,2213,1101,3323
412853,201904,1612,4261,1341,3703,174,523,674,1701,848,2224
412855,201904,1176,3197,738,2215,154,510,194,551,348,1061
412860,201904,793,2074,540,1639,73,249,250,718,323,967
412862,201904,698,1702,462,1292,73,215,207,559,280,774
412863,201904,1179,3676,1092,3534,132,438,769,2494,901,2932
412865,201904,713,2012,522,1639,101,331,177,550,278,881
412870,201904,849,2282,627,1911,178,602,131,426,309,1028
412880,201904,830,2344,530,1692,98,332,76,217,174,549
420005,201904,458,1381,247,879,36,134,107,389,143,523
420010,201904,3326,8344,2168,6286,169,532,1536,4471,1705,5003
420020,201904,476,1502,295,1040,55,221,46,137,101,358
420030,201904,89,309,65,258,21,89,15,58,36,147
420040,201904,558,1745,331,1221,54,219,19,57,73,276
420050,201904,657,1606,402,1133,42,144,251,657,293,801
420055,201904,165,509,87,318,18,77,26,88,44,165
420060,201904,110,310,67,201,12,46,17,29,29,75
420070,201904,741,2376,547,1911,116,421,192,659,308,1080
420075,201904,78,213,36,117,8,26,7,11,15,37
420080,201904,334,1014,261,850,86,311,79,239,165,550
420090,201904,414,1346,251,925,63,243,56,209,119,452
420100,201904,1109,3069,944,2816,47,164,753,2226,800,2390
420110,201904,245,813,222,768,46,181,91,291,137,472
420120,201904,434,1263,283,915,59,213,112,321,171,534
420125,201904,305,1007,234,845,59,225,106,372,165,597
420127,201904,274,786,92,323,19,74,21,74,40,148
420130,201904,2297,6667,1728,5604,276,1090,865,2648,1141,3738
420140,201904,3267,9083,2356,7477,651,2369,303,944,954,3313
420150,201904,547,1455,352,1116,56,192,175,528,231,720
420160,201904,226,582,101,329,10,39,33,101,43,140
420165,201904,158,468,93,314,23,78,27,86,50,164
420170,201904,257,790,158,551,22,74,31,90,53,164
420180,201904,180,563,100,365,14,56,33,114,47,170
420190,201904,165,546,98,370,34,140,21,72,55,212
420195,201904,1290,3508,948,2936,286,993,118,308,404,1301
420200,201904,3359,8787,1930,5973,305,1182,709,1877,1014,3059
420205,201904,1364,3810,968,3070,155,486,540,1745,695,2231
420207,201904,1578,4318,994,3173,204,756,376,1136,580,1892
420208,201904,339,969,198,710,38,148,75,266,113,414
420209,201904,138,462,85,298,21,88,29,91,50,179
420210,201904,2373,6325,1540,4951,339,1202,668,2100,1007,3302
420213,201904,740,2380,609,2093,138,515,295,988,433,1503
420215,201904,210,644,143,496,43,161,17,45,60,206
420220,201904,226,696,135,480,29,122,58,185,87,307
420230,201904,4143,11730,3120,9790,460,1594,1656,5024,2116,6618
420240,201904,11342,31560,7030,21977,941,3438,3477,9638,4418,13076
420243,201904,363,1063,296,929,49,166,162,481,211,647
420245,201904,1209,3244,833,2567,81,321,471,1365,552,1686
420250,201904,415,1242,362,1142,72,265,186,539,258,804
420253,201904,503,1289,367,1082,31,98,198,574,229,672
420257,201904,181,472,103,324,20,69,52,159,72,228
420260,201904,1053,2921,758,2467,131,479,433,1395,564,1874
420270,201904,446,1198,198,606,27,92,75,216,102,308
420280,201904,1160,3348,792,2617,161,589,230,752,391,1341
420285,201904,89,245,49,162,7,32,9,25,16,57
420287,201904,446,1104,305,880,88,259,96,283,184,542
420290,201904,3789,11013,2856,8900,422,1556,1531,4327,1953,5883
420300,201904,6414,18474,3686,12072,728,2624,942,2752,1670,5376
420310,201904,813,1955,383,1097,61,175,175,453,236,628
420315,201904,810,2423,550,1898,122,461,211,727,333,1188
420320,201904,3981,11629,3090,10004,958,3418,689,2085,1647,5503
420325,201904,235,718,178,619,40,136,60,206,100,342
420330,201904,840,2574,548,1919,120,468,174,543,294,1011
420340,201904,925,2726,665,2199,172,595,64,201,236,796
420350,201904,1275,3450,878,2678,94,318,564,1687,658,2005
420360,201904,2432,7004,1298,4416,259,944,124,415,383,1359
420370,201904,1007,2850,808,2496,95,354,538,1588,633,1942
420380,201904,4526,12318,2943,9280,647,2202,985,2949,1632,5151
420390,201904,1037,2631,678,1854,114,377,299,603,413,980
420395,201904,949,2804,615,2087,102,363,68,190,170,553
420400,201904,877,2597,576,1919,107,396,183,578,290,974
420410,201904,492,1388,360,1108,40,147,216,619,256,766
420415,201904,290,887,219,729,61,222,77,265,138,487
420417,201904,602,1859,490,1613,129,436,177,601,306,1037
420419,201904,143,507,110,421,41,168,10,33,51,201
420420,201904,10010,27078,6648,20807,2092,7213,1618,4662,3710,11875
420425,201904,656,1784,450,1380,43,161,197,587,240,748
420430,201904,2799,7974,1716,5473,446,1536,499,1419,945,2955
420435,201904,257,665,108,367,20,76,47,156,67,232
420440,201904,656,1934,386,1290,122,444,104,301,226,745
420445,201904,290,763,173,513,36,117,58,155,94,272
420450,201904,636,1914,452,1499,85,350,162,470,247,820
420455,201904,1905,4913,1394,4081,183,637,711,1986,894,2623
420460,201904,8173,22632,6123,18798,1023,3607,2935,8563,3958,12170
420470,201904,576,1569,323,1056,62,233,75,215,137,448
420475,201904,52,150,26,90,10,33,3,13,13,46
420480,201904,5032,12976,3134,9637,651,2161,960,2915,1611,5076
420490,201904,342,1027,230,781,54,214,74,242,128,456
420500,201904,1284,3796,882,2992,175,636,336,1127,511,1763
420510,201904,165,471,89,296,15,54,28,86,43,140
420515,201904,45,128,30,95,1,1,14,49,15,50
420517,201904,738,2074,637,1899,47,143,482,1436,529,1579
420519,201904,304,727,196,559,25,75,101,295,126,370
420520,201904,355,951,159,547,20,67,16,50,36,117
420530,201904,791,2346,543,1809,110,414,165,481,275,895
420535,201904,214,632,83,286,19,77,20,63,39,140
420540,201904,27239,66840,17020,48747,2908,9326,5964,14543,8872,23869
420543,201904,214,659,163,531,25,76,80,256,105,332
420545,201904,1037,3148,790,2584,165,576,305,933,470,1509
420550,201904,3284,9339,2109,7155,408,1537,867,2981,1275,4518
420555,201904,286,861,196,659,31,118,101,317,132,435
420560,201904,406,1041,276,839,66,202,139,413,205,615
420570,201904,2005,5851,1517,4882,309,1099,556,1688,865,2787
420580,201904,1652,4354,1173,3603,262,833,474,1475,736,2308
420590,201904,2767,7573,1606,5027,308,1114,373,880,681,1994
420600,201904,918,2762,698,2301,133,485,314,993,447,1478
420610,201904,349,1028,185,642,44,147,52,187,96,334
420620,201904,558,1451,369,1125,99,307,138,417,237,724
420630,201904,875,2636,625,1990,115,414,311,883,426,1297
420640,201904,501,1433,237,840,61,214,21,61,82,275
420650,201904,2935,8112,1742,5479,289,1023,660,1775,949,2798
420660,201904,339,935,227,702,49,165,63,185,112,350
420665,201904,518,1390,317,1026,57,204,129,369,186,573
420670,201904,1358,3750,875,2807,137,547,339,945,476,1492
420675,201904,136,397,81,288,24,103,21,68,45,171
420680,201904,327,785,170,561,29,111,78,252,107,363
420690,201904,818,2535,495,1695,74,296,116,316,190,612
420700,201904,2590,7129,1977,6049,275,963,1035,3029,1310,3992
420710,201904,705,2144,529,1739,78,328,287,843,365,1171
420720,201904,1230,3477,880,2878,211,676,383,1237,594,1913
420730,201904,2586,7043,1985,6064,321,1029,1116,3307,1437,4336
420740,201904,555,1720,342,1231,97,366,34,140,131,506
420750,201904,1777,5344,1155,3862,201,768,435,1331,636,2099
420757,201904,59,160,28,101,2,8,11,36,13,44
420760,201904,351,1055,148,479,38,138,26,68,64,206
420765,201904,373,1167,202,708,28,103,81,282,109,385
420768,201904,1164,3550,999,3242,154,507,692,2219,846,2726
420770,201904,412,1131,185,663,28,112,82,280,110,392
420775,201904,358,1061,226,772,48,187,43,120,91,307
420780,201904,901,2588,527,1774,110,405,97,285,207,690
420785,201904,187,513,131,397,12,34,57,154,69,188
420790,201904,983,3152,726,2589,158,643,353,1183,511,1826
420800,201904,700,1799,323,1022,92,298,70,231,162,529
420810,201904,1414,4667,1155,4107,350,1395,326,998,676,2393
420820,201904,9941,25787,6950,20757,1434,4849,3061,8245,4495,13094
420830,201904,2926,8203,2191,6851,498,1678,852,2605,1350,4283
420840,201904,529,1628,244,902,66,254,39,135,105,389
420845,201904,1928,5165,1138,3712,225,842,406,1287,631,2129
420850,201904,1032,3408,628,2320,139,561,91,305,230,866
420860,201904,275,720,154,496,41,147,31,96,72,243
420870,201904,796,2196,615,1878,174,626,266,751,440,1377
420880,201904,891,2787,700,2391,150,580,245,764,395,1344
420890,201904,7383,20155,4185,13446,695,2480,1287,3538,1982,6018
420895,201904,158,474,95,306,26,85,26,83,52,168
420900,201904,1327,3411,789,2441,107,405,341,938,448,1343
420910,201904,25039,67810,15501,49047,2515,8962,5615,16011,8130,24973
420915,201904,518,1940,369,1492,63,251,166,685,229,936
420917,201904,329,876,170,501,23,74,76,216,99,290
420920,201904,73,207,24,92,2,9,3,9,5,18
420930,201904,16465,43952,11592,35276,2097,7028,5185,15010,7282,22038
420940,201904,2267,5766,1364,4172,325,1112,192,456,517,1568
420945,201904,126,373,99,309,24,89,39,104,63,193
420950,201904,303,902,168,575,31,126,37,106,68,232
420960,201904,944,2421,648,1893,118,411,262,671,380,1082
420970,201904,2366,6902,1568,5233,452,1557,250,862,702,2419
420980,201904,277,887,236,822,106,368,76,295,182,663
420985,201904,317,936,157,563,30,116,51,161,81,277
420990,201904,373,1150,189,694,38,143,29,84,67,227
421000,201904,483,1588,317,1170,80,325,74,235,154,560
421003,201904,461,1080,142,426,12,34,23,63,35,97
421005,201904,56,185,51,178,13,45,21,72,34,117
421010,201904,3223,9071,2325,7426,495,1754,565,1583,1060,3337
421020,201904,359,1108,282,971,38,153,161,540,199,693
421030,201904,723,2289,572,1976,173,658,162,511,335,1169
421040,201904,670,1602,399,1181,34,107,244,713,278,820
421050,201904,1035,2924,638,2026,119,410,219,625,338,1035
421055,201904,168,467,82,262,14,50,30,78,44,128
421060,201904,532,1613,335,1100,60,220,119,344,179,564
421070,201904,521,1615,293,1043,67,261,49,164,116,425
421080,201904,438,1284,382,1182,46,154,249,777,295,931
421085,201904,363,1091,138,515,24,98,24,66,48,164
421090,201904,284,761,165,510,19,63,54,161,73,224
421100,201904,911,2087,375,1118,85,281,60,165,145,446
421105,201904,1440,4062,1034,3269,169,523,499,1581,668,2104
421110,201904,1015,2917,854,2672,41,117,602,1960,643,2077
421120,201904,869,2792,613,2164,90,352,197,640,287,992
421125,201904,247,690,202,617,71,242,69,169,140,411
421130,201904,3911,11954,3270,10673,698,2553,1814,5667,2512,8220
421140,201904,284,795,185,589,34,115,67,189,101,304
421145,201904,434,1240,268,861,50,169,124,375,174,544
421150,201904,524,1451,277,927,61,231,81,261,142,492
421160,201904,499,1342,336,1052,43,149,200,610,243,759
421165,201904,186,570,121,410,27,91,48,163,75,254
421170,201904,1004,2736,781,2374,128,377,488,1517,616,1894
421175,201904,1019,2703,665,2123,133,492,267,780,400,1272
421180,201904,363,966,199,630,40,160,63,177,103,337
421185,201904,292,782,188,564,32,103,103,300,135,403
421187,201904,290,874,181,594,35,115,63,191,98,306
421189,201904,344,1018,259,837,40,127,100,313,140,440
421190,201904,8977,24928,5858,19052,1224,4359,1533,4722,2757,9081
421200,201904,616,1909,503,1675,86,313,261,841,347,1154
421205,201904,186,507,137,426,25,86,70,208,95,294
421210,201904,1029,2747,616,2010,151,498,198,651,349,1149
421220,201904,1284,4101,1013,3460,241,910,247,743,488,1653
421223,201904,345,1000,221,753,55,175,94,328,149,503
421225,201904,847,2617,730,2398,147,538,410,1344,557,1882
421227,201904,941,2508,546,1711,93,320,245,769,338,1089
421230,201904,570,1540,355,1134,93,311,103,332,196,643
421240,201904,300,919,118,447,14,71,15,56,29,127
421250,201904,1513,3980,1010,3135,162,554,442,1339,604,1893
421260,201904,168,494,43,162,10,43,10,36,20,79
421265,201904,555,1618,518,1564,12,38,482,1462,494,1500
421270,201904,388,1044,174,629,28,102,64,225,92,327
421280,201904,1485,4408,1114,3696,227,897,508,1549,735,2446
421290,201904,778,2166,403,1278,79,262,80,248,159,510
421300,201904,235,641,129,421,20,70,33,112,53,182
421310,201904,156,475,119,391,22,78,55,187,77,265
421315,201904,202,586,124,395,36,108,25,77,61,185
421320,201904,609,1812,299,1008,47,161,43,107,90,268
421330,201904,605,1804,427,1440,89,323,118,383,207,706
421335,201904,351,1092,283,970,56,215,105,349,161,564
421340,201904,1262,3722,912,3022,198,738,357,1139,555,1877
421350,201904,1135,3150,780,2496,155,598,337,1000,492,1598
421360,201904,2156,6071,1300,4294,276,1108,459,1319,735,2427
421370,201904,483,1598,288,1075,59,229,83,289,142,518
421380,201904,802,2216,684,2000,87,288,411,1166,498,1454
421390,201904,170,461,61,206,14,41,16,44,30,85
421400,201904,243,799,169,617,33,140,78,256,111,396
421410,201904,243,658,103,352,16,54,38,133,54,187
421415,201904,220,682,120,401,33,111,24,67,57,178
421420,201904,482,1389,400,1232,54,187,244,715,298,902
421430,201904,114,380,90,322,11,40,31,96,42,136
421440,201904,574,1530,364,1172,72,228,175,561,247,789
421450,201904,362,1122,229,784,34,133,37,141,71,274
421460,201904,303,890,191,658,34,123,44,128,78,251
421470,201904,242,737,139,496,25,105,54,193,79,298
421480,201904,2565,7046,1679,5343,380,1369,582,1661,962,3030
421490,201904,98,317,61,217,9,40,17,49,26,89
421500,201904,2037,6222,1421,4923,400,1579,300,942,700,2521
421505,201904,282,841,248,782,37,128,152,457,189,585
421507,201904,378,1142,217,758,64,235,63,210,127,445
421510,201904,257,741,147,471,30,98,66,196,96,294
421520,201904,507,1372,313,935,39,135,175,484,214,619
421530,201904,312,993,184,666,42,186,40,112,82,298
421535,201904,387,1071,241,789,36,138,130,395,166,533
421540,201904,255,622,128,402,18,66,40,112,58,178
421545,201904,664,2005,487,1662,99,389,237,761,336,1150
421550,201904,1828,5296,1502,4769,317,1095,760,2351,1077,3446
421555,201904,191,608,71,272,13,61,10,24,23,85
421560,201904,80,270,49,189,12,45,15,55,27,100
421565,201904,861,2329,599,1893,155,539,182,586,337,1125
421567,201904,436,1518,276,1032,118,452,53,177,171,629
421568,201904,324,994,232,773,34,130,110,349,144,479
421569,201904,183,537,71,245,18,66,29,96,47,162
421570,201904,896,2545,641,2057,184,651,146,462,330,1113
421575,201904,269,827,210,667,41,148,80,208,121,356
421580,201904,2892,8376,1956,6412,385,1500,683,1873,1068,3373
421590,201904,132,434,103,357,36,131,26,77,62,208
421600,201904,500,1406,340,1062,85,285,82,209,167,494
421605,201904,707,1899,486,1518,96,292,183,583,279,875
421610,201904,1055,2950,654,2139,124,419,170,553,294,972
421620,201904,3710,10259,2127,7215,528,1933,519,1710,1047,3643
421625,201904,181,507,73,239,14,42,14,42,28,84
421630,201904,2258,6198,1328,4258,238,911,374,1021,612,1932
421635,201904,220,618,147,452,16,51,80,226,96,277
421640,201904,648,1822,459,1505,100,349,137,454,237,803
421650,201904,2107,5987,1345,4502,347,1323,311,866,658,2189
421660,201904,7571,21962,5571,18091,938,3463,2223,6640,3161,10103
421670,201904,723,2144,503,1628,94,348,244,767,338,1115
421680,201904,928,2741,710,2308,195,670,288,863,483,1533
421690,201904,1155,3479,816,2713,159,597,262,880,421,1477
421700,201904,447,1389,240,861,42,169,68,219,110,388
421710,201904,215,686,91,307,24,85,19,60,43,145
421715,201904,98,284,72,224,21,60,42,128,63,188
421720,201904,1852,5217,1052,3490,280,1031,273,772,553,1803
421725,201904,204,502,104,329,19,64,40,102,59,166
421730,201904,367,1113,187,587,20,71,86,253,106,324
421740,201904,605,1804,419,1386,120,404,106,334,226,738
421750,201904,825,2022,390,1182,80,263,148,417,228,680
421755,201904,173,479,94,287,16,63,43,114,59,177
421760,201904,828,2299,505,1661,93,337,157,441,250,778
421770,201904,2122,5850,1559,4842,393,1243,539,1824,932,3067
421775,201904,217,575,136,407,19,64,66,178,85,242
421780,201904,746,2335,500,1783,103,400,194,654,297,1054
421790,201904,665,1765,388,1265,77,264,185,584,262,848
421795,201904,210,618,130,407,21,77,49,144,70,221
421800,201904,2314,6681,1707,5511,285,1026,863,2660,1148,3686
421810,201904,597,1685,409,1309,52,203,224,683,276,886
421820,201904,828,2471,443,1512,87,335,108,307,195,642
421825,201904,1254,3612,1123,3410,141,468,773,2286,914,2754
421830,201904,1864,5903,1579,5352,329,1206,669,2188,998,3394
421835,201904,207,545,115,366,16,68,46,123,62,191
421840,201904,196,630,129,472,30,116,26,79,56,195
421850,201904,375,1111,208,741,43,178,65,168,108,346
421860,201904,280,831,176,599,23,93,61,175,84,268
421870,201904,3382,8870,2358,6876,445,1482,1078,2887,1523,4369
421875,201904,223,681,110,397,22,89,25,69,47,158
421880,201904,456,1324,330,1079,97,366,67,227,164,593
421885,201904,195,560,128,419,33,112,34,96,67,208
421890,201904,717,2322,563,1990,110,442,256,829,366,1271
421895,201904,375,1003,310,916,35,124,209,624,244,748
421900,201904,921,2424,627,1850,106,366,272,720,378,1086
421910,201904,309,934,214,721,46,182,44,117,90,299
421915,201904,369,1051,199,645,44,143,27,79,71,222
421917,201904,529,1325,305,1008,111,398,67,219,178,617
421920,201904,413,1292,298,1061,129,481,92,329,221,810
421930,201904,2264,6031,1047,3549,279,1035,171,547,450,1582
421935,201904,405,1327,314,1113,60,221,171,583,231,804
421940,201904,301,923,112,385,18,74,29,93,47,167
421950,201904,2887,7334,1428,4510,303,1073,332,907,635,1980
421960,201904,154,401,89,294,21,82,17,51,38,133
421970,201904,1798,4792,1011,3160,218,741,301,827,519,1568
421985,201904,242,632,140,427,14,52,44,133,58,185
422000,201904,1598,4371,1300,3858,153,523,832,2459,985,2982
430003,201904,509,1459,339,1122,63,235,136,443,199,678
430005,201904,253,696,155,506,41,134,68,220,109,354
430010,201904,1595,4186,1287,3643,152,472,873,2383,1025,2855
430020,201904,567,1337,434,1154,63,201,266,660,329,861
430030,201904,995,2424,559,1640,156,478,162,453,318,931
430040,201904,9307,23292,5502,16295,1465,4727,458,1475,1923,6202
430045,201904,539,1400,363,1058,35,119,211,591,246,710
430047,201904,244,538,94,272,20,63,23,67,43,130
430050,201904,939,2466,524,1596,120,396,113,332,233,728
430055,201904,258,659,113,345,18,70,57,154,75,224
430057,201904,94,213,31,87,8,28,6,14,14,42
430060,201904,15440,43403,12056,37880,2809,9451,5257,16507,8066,25958
430063,201904,854,2416,673,2023,128,385,363,1073,491,1458
430064,201904,955,2747,723,2233,199,634,263,773,462,1407
430066,201904,97,224,69,177,4,11,49,111,53,122
430070,201904,705,1800,95,313,7,28,11,27,18,55
430080,201904,696,1824,438,1289,77,256,198,518,275,774
430085,201904,851,2002,506,1429,84,248,216,599,300,847
430087,201904,495,1368,399,1227,73,222,223,708,296,930
430090,201904,562,1476,180,588,17,75,55,170,72,245
430100,201904,581,1470,322,957,69,213,113,299,182,512
430105,201904,986,2705,622,2066,119,421,289,987,408,1408
430107,201904,170,498,111,357,20,70,30,79,50,149
430110,201904,2037,5132,1481,4290,228,689,834,2397,1062,3086
430120,201904,1301,3968,795,2644,155,534,343,1160,498,1694
430130,201904,3299,8021,2493,6870,972,2684,492,1587,1464,4271
430140,201904,861,2508,586,1940,153,498,234,774,387,1272
430150,201904,532,1404,294,922,65,217,91,277,156,494
430155,201904,247,652,116,363,23,73,23,62,46,135
430160,201904,17046,43119,13606,37944,2455,7263,6635,18704,9090,25967
430163,201904,2419,6106,1675,4903,123,382,1124,3306,1247,3688
430165,201904,330,801,76,247,11,24,12,30,23,54
430170,201904,887,2390,321,1110,60,211,60,191,120,402
430175,201904,644,2000,529,1741,137,439,248,808,385,1247
430180,201904,616,1611,493,1387,65,194,337,920,402,1114
430185,201904,432,1040,263,737,46,126,99,248,145,374
430187,201904,635,1593,445,1323,74,240,214,652,288,892
430190,201904,1365,3779,1095,3327,250,814,477,1355,727,2169
430192,201904,125,364,53,159,8,27,14,39,22,66
430195,201904,398,1197,56,196,10,32,5,20,15,52
430200,201904,1061,3259,865,2898,287,1006,253,863,540,1869
430205,201904,478,1294,398,1129,16,53,329,908,345,961
430210,201904,4557,11823,3093,8819,623,1901,1027,2399,1650,4300
430215,201904,299,792,184,545,38,117,69,205,107,322
430220,201904,647,1608,171,579,32,135,38,103,70,238
430222,201904,172,503,133,423,18,69,58,174,76,243
430223,201904,232,650,191,570,26,81,111,320,137,401
430225,201904,15,35,12,30,1,2,9,15,10,17
430230,201904,1690,4848,1479,4529,138,399,1149,3569,1287,3968
430235,201904,253,771,177,594,44,164,52,157,96,321
430237,201904,512,1262,351,973,18,64,235,613,253,677
430240,201904,1062,2413,613,1679,69,225,364,940,433,1165
430245,201904,640,1964,498,1669,157,521,225,769,382,1290
430250,201904,937,2500,729,2167,238,766,34,83,272,849
430258,201904,101,275,76,224,5,10,39,122,44,132
430260,201904,605,1656,438,1320,80,247,230,689,310,936
430265,201904,200,579,142,466,32,114,40,114,72,228
430270,201904,2591,6715,2086,5906,347,1075,1275,3489,1622,4564
430280,201904,4770,11738,3370,9204,718,2012,1408,3822,2126,5834
430290,201904,2024,4919,1743,4562,50,159,1485,3815,1535,3974
430300,201904,8526,23010,6681,19579,1183,3789,3339,9589,4522,13378
430310,201904,9678,25141,6416,18679,907,3055,3018,8128,3925,11183
430320,201904,925,2507,501,1594,71,193,265,875,336,1068
430330,201904,597,1536,386,1094,77,231,170,436,247,667
430340,201904,674,1533,352,1022,60,190,190,530,250,720
430350,201904,6310,17187,4689,14029,1000,3111,2115,6188,3115,9299
430355,201904,324,837,109,361,26,77,16,52,42,129
430360,201904,790,1977,533,1530,116,366,198,527,314,893
430367,201904,329,813,175,512,41,130,66,192,107,322
430370,201904,474,1325,208,685,39,139,52,147,91,286
430380,201904,654,1677,325,1040,83,304,67,210,150,514
430390,201904,2909,7278,1564,4698,296,961,120,271,416,1232
430400,201904,1061,2314,818,1959,73,188,591,1362,664,1550
430410,201904,544,1334,361,1029,55,174,207,567,262,741
430420,201904,2615,7346,1990,5932,575,1799,708,2000,1283,3799
430430,201904,649,1697,309,955,68,202,68,213,136,415
430435,201904,1458,3788,1089,3167,234,721,483,1401,717,2122
430440,201904,3463,9987,2596,8244,410,1470,1403,4372,1813,5842
430450,201904,6548,17118,5212,14669,640,2065,3002,8195,3642,10260
430460,201904,27665,73353,19570,59631,4057,13701,8514,24676,12571,38377
430461,201904,387,981,108,338,21,69,29,83,50,152
430462,201904,240,659,138,460,17,62,48,171,65,233
430463,201904,4548,12948,3520,11096,676,2330,1732,5355,2408,7685
430465,201904,454,1226,372,1064,57,177,226,623,283,800
430466,201904,3703,9600,2914,8228,767,2241,1319,3534,2086,5775
430467,201904,489,1237,341,990,51,174,170,461,221,635
430468,201904,1276,3218,1002,2802,119,355,594,1617,713,1972
430469,201904,648,1825,76,263,12,41,11,15,23,56
430470,201904,5229,13993,3553,10944,1134,3728,853,2525,1987,6253
430471,201904,505,1516,426,1358,71,228,205,632,276,860
430480,201904,815,2163,421,1316,63,205,86,235,149,440
430485,201904,163,446,64,213,13,38,9,33,22,71
430490,201904,409,1067,222,653,26,80,107,290,133,370
430495,201904,355,995,204,679,33,120,75,229,108,349
430500,201904,993,2629,694,2104,211,691,218,595,429,1286
430510,201904,22379,60040,15761,46659,3119,10385,6317,17079,9436,27464
430511,201904,317,940,119,419,14,52,14,41,28,93
430512,201904,887,2094,691,1793,171,447,237,633,408,1080
430513,201904,775,1977,363,1051,56,170,170,471,226,641
430515,201904,380,1089,266,846,39,116,132,424,171,540
430517,201904,983,3090,760,2560,140,475,375,1302,515,1777
430520,201904,1263,3369,653,2037,116,349,131,393,247,742
430530,201904,1034,2680,381,1194,81,259,89,271,170,530
430535,201904,2947,7902,2098,6300,322,1018,1019,2985,1341,4003
430537,201904,305,1110,276,1017,31,102,211,781,242,883
430540,201904,561,1378,338,1016,51,143,158,472,209,615
430543,201904,641,1242,381,930,61,131,197,513,258,644
430544,201904,624,1866,436,1423,96,339,203,642,299,981
430545,201904,1907,5191,1417,4424,290,933,696,2233,986,3166
430550,201904,398,1130,249,795,45,141,75,227,120,368
430558,201904,111,257,48,137,8,21,14,39,22,60
430560,201904,317,702,134,399,10,40,43,120,53,160
430570,201904,746,1785,542,1463,78,233,333,848,411,1081
430580,201904,891,2240,614,1806,144,472,265,735,409,1207
430583,201904,191,470,36,113,4,12,7,20,11,32
430585,201904,215,523,112,303,14,39,53,119,67,158
430587,201904,194,569,135,431,22,71,61,197,83,268
430590,201904,1349,3304,1149,2993,51,148,970,2484,1021,2632
430593,201904,19,70,13,48,2,8,6,21,8,29
430595,201904,423,1035,90,303,7,28,17,43,24,71
430597,201904,346,944,207,626,21,68,76,172,97,240
430600,201904,1768,4688,800,2427,155,487,215,610,370,1097
430605,201904,1075,3049,789,2470,115,429,331,982,446,1411
430607,201904,547,1288,413,1071,27,73,297,778,324,851
430610,201904,5351,13318,3611,10568,1056,3325,638,1963,1694,5288
430613,201904,254,603,69,203,8,27,18,45,26,72
430620,201904,521,1368,394,1113,69,214,199,535,268,749
430630,201904,409,1155,120,391,18,60,23,62,41,122
430632,201904,517,1400,238,739,30,97,104,312,134,409
430635,201904,510,1328,371,1059,50,148,257,732,307,880
430637,201904,446,1138,350,987,44,141,199,538,243,679
430640,201904,1042,2712,591,1788,96,306,196,554,292,860
430642,201904,333,923,252,736,47,138,131,365,178,503
430645,201904,218,487,77,210,17,49,11,31,28,80
430650,201904,1513,4605,1263,4167,339,1133,587,2001,926,3134
430655,201904,245,598,140,387,18,52,66,165,84,217
430660,201904,4661,12535,3537,10509,822,2605,1558,4559,2380,7164
430670,201904,604,1513,465,1267,28,83,309,843,337,926
430673,201904,555,1290,212,640,40,123,79,229,119,352
430675,201904,201,582,56,197,16,64,18,59,34,123
430676,201904,4281,11057,3343,9535,451,1390,2007,5565,2458,6955
430680,201904,930,2514,560,1749,156,504,139,416,295,920
430690,201904,2909,8121,2328,7024,767,2406,610,1798,1377,4204
430692,201904,206,640,157,557,12,46,111,397,123,443
430693,201904,989,2641,563,1741,109,388,130,377,239,765
430695,201904,463,1210,272,813,33,93,150,427,183,520
430697,201904,382,980,286,827,64,176,141,430,205,606
430700,201904,6420,16322,3485,10746,842,2778,445,1349,1287,4127
430705,201904,390,970,186,567,28,90,73,212,101,302
430710,201904,1618,3632,1124,2908,167,475,623,1583,790,2058
430720,201904,720,1749,375,1140,57,158,171,516,228,674
430730,201904,1036,2864,708,2217,107,311,352,1117,459,1428
430740,201904,582,1638,300,1009,48,173,85,299,133,472
430745,201904,434,1216,233,742,41,148,63,173,104,321
430750,201904,1280,3412,903,2730,194,619,463,1332,657,1951
430755,201904,447,1096,282,754,16,56,161,397,177,453
430760,201904,1800,4736,1455,4176,362,1087,620,1724,982,2811
430770,201904,5645,14555,4355,12598,644,2083,2655,7450,3299,9533
430780,201904,1970,4974,1123,3489,233,749,343,1070,576,1819
430781,201904,405,1150,219,705,46,149,51,136,97,285
430783,201904,409,951,234,672,26,91,133,353,159,444
430786,201904,33,112,17,67,3,10,1,8,4,18
430790,201904,4230,10842,2853,8282,415,1388,1560,4209,1975,5597
430800,201904,701,1760,528,1453,45,140,340,919,385,1059
430805,201904,409,1127,243,739,24,89,144,396,168,485
430807,201904,308,678,196,512,11,37,118,278,129,315
430810,201904,795,1962,262,858,33,126,75,231,108,357
430820,201904,1311,3512,701,2294,149,506,156,529,305,1035
430825,201904,263,685,89,253,16,45,22,53,38,98
430830,201904,1623,4805,1330,4231,73,283,918,2889,991,3172
430840,201904,891,2384,686,2015,101,314,445,1292,546,1606
430843,201904,116,288,36,111,3,9,19,51,22,60
430845,201904,374,912,241,689,74,224,70,183,144,407
430850,201904,2168,5838,1572,4664,270,847,723,2130,993,2977
430860,201904,770,1805,418,1188,61,207,193,469,254,676
430865,201904,492,1279,381,1078,62,192,200,539,262,731
430870,201904,626,1670,261,841,41,146,87,251,128,397
430880,201904,1199,2894,818,2290,168,493,396,1066,564,1559
430885,201904,190,465,86,278,8,37,50,148,58,185
430890,201904,985,2648,670,2061,56,265,111,307,167,572
430900,201904,2832,6493,1938,5145,168,535,1211,3004,1379,3539
430905,201904,739,1930,461,1388,86,286,174,497,260,783
430910,201904,1345,3710,918,2822,157,554,389,1084,546,1638
430912,201904,464,1296,314,1012,30,90,201,664,231,754
430915,201904,481,1492,352,1243,93,336,115,409,208,745
430920,201904,21906,56996,16748,48369,2417,7761,9765,27315,12182,35076
430925,201904,135,305,49,143,11,32,16,50,27,82
430930,201904,9276,22290,5654,16621,1239,3856,2103,6412,3342,10268
430940,201904,1075,2987,604,1876,189,618,86,202,275,820
430950,201904,688,1711,432,1230,45,160,256,661,301,821
430955,201904,220,593,65,212,13,38,17,49,30,87
430957,201904,173,608,162,580,30,112,90,318,120,430
430960,201904,1290,3077,754,2132,164,516,327,889,491,1405
430965,201904,1645,4047,1246,3413,71,216,935,2542,1006,2758
430970,201904,370,959,186,579,29,97,81,237,110,334
430975,201904,475,1486,358,1195,92,321,146,472,238,793
430980,201904,385,932,209,619,41,128,83,225,124,353
430990,201904,546,1620,330,1066,38,136,168,535,206,671
430995,201904,554,1460,402,1208,61,189,184,546,245,735
431000,201904,1301,3114,514,1525,86,277,35,84,121,361
431010,201904,2020,5369,1205,3909,229,812,142,396,371,1208
431020,201904,7947,17854,4748,12828,1124,3339,1545,3746,2669,7085
431030,201904,317,869,140,484,25,91,21,70,46,161
431033,201904,3098,7596,1919,5703,487,1498,604,1869,1091,3367
431036,201904,351,777,76,227,9,21,18,44,27,65
431040,201904,906,2388,588,1781,91,313,258,723,349,1036
431041,201904,450,1059,332,887,28,74,191,502,219,576
431043,201904,380,925,192,604,49,165,70,220,119,385
431046,201904,106,282,44,135,2,5,11,33,13,38
431050,201904,1346,3402,961,2786,168,505,509,1483,677,1988
431053,201904,551,1553,307,1008,62,212,98,308,160,520
431055,201904,571,1423,479,1285,37,90,360,957,397,1047
431057,201904,258,743,123,416,17,59,36,107,53,166
431060,201904,4877,13326,3367,10597,935,3153,690,2232,1625,5385
431065,201904,447,1195,301,932,61,189,104,323,165,512
431070,201904,437,1289,244,827,63,235,38,116,101,351
431075,201904,220,668,141,477,26,86,39,136,65,222
431080,201904,586,1649,398,1254,92,316,115,341,207,657
431085,201904,686,1876,482,1399,72,205,251,712,323,917
431087,201904,450,1287,354,1074,26,76,238,736,264,812
431090,201904,396,941,147,467,28,98,39,116,67,214
431100,201904,3049,7036,2180,5844,341,968,1071,2883,1412,3851
431110,201904,1337,3194,924,2456,244,638,400,1041,644,1679
431112,201904,500,1517,416,1343,83,293,214,663,297,956
431113,201904,329,954,289,873,62,201,159,473,221,674
431115,201904,1020,2948,801,2537,124,429,446,1346,570,1775
431120,201904,2222,6435,1554,5029,525,1887,358,1040,883,2927
431123,201904,373,1057,229,750,45,121,121,425,166,546
431125,201904,1025,3093,773,2540,292,944,232,823,524,1767
431127,201904,252,667,58,192,8,24,6,15,14,39
431130,201904,2908,7856,2099,6356,397,1320,969,2862,1366,4182
431140,201904,4721,11456,2633,7450,351,1063,1091,2775,1442,3838
431142,201904,470,1305,348,1075,49,149,201,619,250,768
431150,201904,990,2722,690,2131,147,474,277,853,424,1327
431160,201904,676,1939,471,1500,91,306,153,481,244,787
431162,201904,493,1216,230,703,22,88,108,300,130,388
431164,201904,196,457,41,128,9,28,5,15,14,43
431170,201904,514,1435,346,1088,95,279,89,276,184,555
431171,201904,611,1515,502,1373,78,199,315,867,393,1066
431173,201904,390,1049,285,878,89,307,98,285,187,592
431175,201904,1012,2531,623,1846,132,393,176,516,308,909
431177,201904,676,1978,510,1697,149,539,241,786,390,1325
431179,201904,311,671,69,207,14,47,15,33,29,80
431180,201904,2181,5719,1346,4067,370,1111,295,895,665,2006
431190,201904,447,1227,234,745,28,83,58,161,86,244
431198,201904,305,947,261,865,101,350,67,244,168,594
431200,201904,368,947,74,233,13,32,3,11,16,43
431205,201904,177,515,85,300,20,76,30,108,50,184
431210,201904,601,1575,481,1396,118,328,235,720,353,1048
431213,201904,243,696,183,585,15,58,89,287,104,345
431215,201904,521,1261,231,690,29,95,95,255,124,350
431217,201904,156,437,103,330,7,27,63,185,70,212
431220,201904,580,1540,332,1038,31,119,177,507,208,626
431225,201904,1477,3628,1127,3034,127,382,724,1927,851,2309
431230,201904,652,1927,477,1486,66,223,270,798,336,1021
431235,201904,148,379,26,84,4,15,4,12,8,27
431237,201904,310,998,261,882,43,159,146,472,189,631
431238,201904,25,65,19,51,6,14,6,15,12,29
431240,201904,3719,9697,2900,8360,576,1834,1365,3804,1941,5638
431242,201904,283,787,233,692,61,191,109,320,170,511
431244,201904,322,777,149,416,21,80,51,106,72,186
431245,201904,1285,3077,791,2183,99,286,383,1006,482,1292
431247,201904,224,631,116,382,27,99,27,70,54,169
431250,201904,1537,4157,1156,3591,256,795,550,1780,806,2575
431260,201904,207,584,117,400,21,90,35,107,56,197
431261,201904,234,745,188,655,22,84,96,315,118,399
431262,201904,380,1079,169,564,13,47,104,342,117,389
431265,201904,1422,3393,556,1643,75,259,183,457,258,716
431267,201904,255,712,141,434,5,21,93,259,98,280
431270,201904,2554,5981,1357,3901,342,1068,372,1071,714,2139
431275,201904,141,404,73,238,19,61,8,18,27,79
431280,201904,235,652,63,214,8,29,6,16,14,45
431290,201904,291,847,199,639,33,114,55,149,88,263
431295,201904,72,193,25,76,2,5,6,15,8,20
431300,201904,362,922,57,194,4,14,12,37,16,51
431301,201904,262,788,65,230,9,22,3,8,12,30
431303,201904,555,1502,317,971,30,113,123,347,153,460
431306,201904,2082,5022,1201,3485,197,631,456,1171,653,1802
431308,201904,24,76,21,66,13,44,5,12,18,56
431310,201904,537,1546,355,1111,44,154,162,475,206,629
431320,201904,573,1592,267,900,44,143,43,128,87,271
431330,201904,1616,3912,735,2253,190,636,209,575,399,1211
431333,201904,218,610,107,320,19,51,36,103,55,154
431335,201904,39,110,21,71,5,12,3,4,8,16
431337,201904,2472,6821,1753,5550,436,1556,671,2015,1107,3571
431339,201904,399,1058,293,858,69,203,132,382,201,585
431340,201904,18870,47387,12915,37005,2565,8024,4956,13372,7521,21396
431342,201904,435,980,314,799,18,51,272,685,290,736
431344,201904,387,999,224,665,10,33,140,405,150,438
431346,201904,255,642,99,324,14,48,29,93,43,141
431349,201904,640,1705,345,1037,72,229,128,356,200,585
431350,201904,3805,10272,2783,8453,416,1401,1364,4080,1780,5481
431360,201904,550,1336,308,878,77,232,100,278,177,510
431365,201904,1629,4171,1366,3785,138,448,1000,2740,1138,3188
431370,201904,3932,10234,2891,8412,749,2321,1224,3649,1973,5970
431380,201904,754,2137,635,1927,40,144,421,1267,461,1411
431390,201904,2436,6103,1407,4180,217,742,556,1434,773,2176
431395,201904,1159,3106,829,2579,204,664,338,1067,542,1731
431400,201904,334,962,173,563,31,102,39,116,70,218
431402,201904,810,1913,572,1511,72,204,368,920,440,1124
431403,201904,173,491,138,427,24,90,74,190,98,280
431405,201904,4225,11432,3307,9968,518,1791,1748,4992,2266,6783
431406,201904,442,1355,345,1139,83,259,165,553,248,812
431407,201904,452,1261,291,904,57,191,137,412,194,603
431410,201904,14987,39527,9639,29461,1693,5920,4148,11759,5841,17679
431413,201904,207,541,52,165,5,15,6,17,11,32
431415,201904,663,1685,405,1246,67,238,166,461,233,699
431417,201904,549,1254,374,990,62,179,197,505,259,684
431420,201904,1407,3380,1085,2916,185,516,541,1464,726,1980
431430,201904,506,1327,238,776,38,136,59,168,97,304
431440,201904,25339,62277,18172,50546,3656,10916,6487,17414,10143,28330
431442,201904,104,301,49,172,6,20,7,20,13,40
431445,201904,423,1201,135,468,16,48,15,53,31,101
431446,201904,296,838,202,640,49,169,82,248,131,417
431447,201904,610,1681,404,1238,88,290,152,471,240,761
431449,201904,716,1902,428,1269,71,207,181,520,252,727
431450,201904,2027,4419,1650,3882,103,263,1257,2841,1360,3104
431454,201904,39,122,35,113,7,25,13,42,20,67
431455,201904,568,1392,278,763,40,123,137,335,177,458
431460,201904,2795,7145,2032,5728,545,1614,607,1728,1152,3342
431470,201904,1416,4033,1012,3158,190,597,440,1388,630,1985
431475,201904,244,711,31,126,2,9,2,10,4,19
431477,201904,413,1077,254,750,40,115,111,292,151,407
431478,201904,271,707,61,194,15,46,5,14,20,60
431480,201904,2920,7505,2268,6465,451,1335,1220,3472,1671,4807
431490,201904,97035,239699,77612,209354,6629,20804,56446,147075,63075,167879
431500,201904,472,1255,350,1010,62,172,184,518,246,690
431505,201904,318,778,206,599,18,52,130,379,148,431
431507,201904,343,818,144,416,35,115,48,122,83,237
431510,201904,1435,3842,1012,2997,240,764,375,1111,615,1875
431513,201904,225,530,118,336,9,22,79,228,88,250
431514,201904,82,211,44,136,4,10,25,76,29,86
431515,201904,475,1242,327,962,67,205,160,448,227,653
431517,201904,70,197,55,159,10,28,21,59,31,87
431520,201904,426,1062,159,523,31,116,55,158,86,274
431530,201904,3801,8253,2271,6084,612,1678,415,1117,1027,2795
431531,201904,190,512,120,366,13,39,50,150,63,189
431532,201904,536,1272,329,901,68,202,132,351,200,553
431535,201904,240,650,97,318,23,79,14,42,37,121
431540,201904,1714,5590,1598,5410,59,237,1287,4359,1346,4596
431545,201904,346,911,60,190,8,23,14,41,22,64
431550,201904,1855,4989,1489,4268,271,837,734,2020,1005,2857
431555,201904,664,1546,408,1102,29,93,245,649,274,742
431560,201904,20059,51330,13234,40100,2814,9119,3945,12626,6759,21745
431570,201904,4570,11280,3561,9845,490,1539,2283,6067,2773,7606
431575,201904,220,619,162,503,29,79,37,105,66,184
431580,201904,539,1459,313,974,46,171,148,425,194,596
431590,201904,644,1768,457,1378,93,280,184,564,277,844
431595,201904,328,926,214,673,43,143,86,248,129,391
431600,201904,1245,3086,908,2594,261,769,328,977,589,1746
431610,201904,1306,3486,879,2649,137,387,445,1382,582,1769
431620,201904,539,1455,228,698,40,133,99,282,139,415
431630,201904,1257,3229,566,1768,112,386,192,533,304,919
431640,201904,5684,14755,5015,13811,587,1688,3582,9901,4169,11589
431642,201904,481,1182,316,862,28,66,173,451,201,517
431643,201904,342,859,147,439,15,41,51,150,66,191
431645,201904,1685,4097,1337,3566,100,319,998,2614,1098,2933
431647,201904,217,560,98,286,12,39,23,57,35,96
431650,201904,159,449,106,347,17,63,40,114,57,177
431660,201904,835,2288,431,1434,74,282,95,292,169,574
431670,201904,1121,2763,734,2065,103,306,392,1056,495,1362
431673,201904,235,614,85,293,16,48,14,49,30,97
431675,201904,558,1387,112,360,10,37,26,64,36,101
431680,201904,6941,18525,5074,14892,1304,3957,1976,5767,3280,9724
431690,201904,20119,51467,13673,39815,3176,9788,4895,14405,8071,24193
431695,201904,145,378,88,272,15,59,37,87,52,146
431697,201904,452,1092,336,901,56,145,177,490,233,635
431700,201904,1373,3655,1152,3237,158,436,667,1858,825,2294
431710,201904,10863,28219,8119,24113,1779,5542,3579,11041,5358,16583
431720,201904,5454,14334,3382,10091,895,2821,525,1418,1420,4239
431725,201904,24,67,17,51,5,14,4,11,9,25
431730,201904,3538,8979,2240,6767,561,1823,674,2139,1235,3962
431740,201904,4838,12039,3180,9093,922,2964,659,1608,1581,4572
431750,201904,6708,18106,5574,16285,1114,3500,2769,8106,3883,11606
431755,201904,306,834,66,239,8,30,12,46,20,76
431760,201904,5315,12276,3405,9181,349,1149,2037,5100,2386,6249
431770,201904,1721,4271,1372,3798,93,284,1002,2730,1095,3014
431775,201904,205,541,96,295,24,76,17,43,41,119
431780,201904,1854,4771,1200,3540,223,706,443,1278,666,1984
431790,201904,830,2271,594,1797,112,338,258,748,370,1086
431795,201904,223,583,103,317,24,77,29,84,53,161
431800,201904,6991,18241,4787,14492,1430,4802,599,1890,2029,6692
431805,201904,293,694,77,262,6,21,30,95,36,116
431810,201904,3207,7853,2014,5610,369,1123,842,2206,1211,3329
431820,201904,2056,5861,1665,5196,451,1469,628,2023,1079,3492
431830,201904,8463,19248,6257,16079,1579,4588,2124,5467,3703,10055
431840,201904,2357,6524,1947,5805,353,1068,1147,3442,1500,4510
431842,201904,667,1656,225,702,31,105,67,189,98,294
431843,201904,300,830,232,689,29,96,115,318,144,414
431844,201904,185,506,64,215,18,71,20,57,38,128
431845,201904,508,1342,353,1022,28,85,214,611,242,696
431846,201904,253,703,222,659,17,50,183,546,200,596
431848,201904,150,380,79,245,8,29,11,26,19,55
431849,201904,398,947,58,163,7,16,6,12,13,28
431850,201904,3860,10769,3020,9055,729,2356,941,2770,1670,5126
431860,201904,658,1673,386,1118,72,217,197,539,269,756
431861,201904,107,282,46,143,8,27,17,45,25,72
431862,201904,420,1338,341,1200,74,286,171,587,245,873
431870,201904,16023,43407,13095,38411,2005,6553,7221,20427,9226,26980
431880,201904,3894,10288,2747,8200,498,1690,1167,3328,1665,5018
431890,201904,3889,10275,2416,7250,752,2439,351,1146,1103,3585
431900,201904,954,2504,600,1806,101,347,299,833,400,1180
431910,201904,770,1894,270,777,53,159,73,163,126,322
431912,201904,436,1286,350,1117,63,216,205,652,268,868
431915,201904,949,2508,771,2198,42,132,557,1549,599,1681
431920,201904,1090,2781,924,2531,38,124,777,2090,815,2214
431930,201904,651,1821,459,1462,121,349,217,721,338,1070
431935,201904,80,233,47,160,14,45,7,26,21,71
431936,201904,287,861,156,521,37,130,50,157,87,287
431937,201904,179,458,113,311,24,81,46,101,70,182
431940,201904,2776,6775,1588,4550,210,695,752,2044,962,2739
431950,201904,1700,4698,1412,4227,422,1254,573,1748,995,3002
431960,201904,2664,6814,1983,5539,575,1657,527,1477,1102,3134
431970,201904,411,1073,150,475,34,101,34,96,68,197
431971,201904,58,149,32,102,4,16,5,10,9,26
431973,201904,447,1468,363,1299,43,150,256,926,299,1076
431975,201904,89,189,18,59,3,10,5,13,8,23
431980,201904,1031,2778,782,2347,179,581,343,986,522,1567
431990,201904,5511,13750,3601,10800,587,1982,1509,4337,2096,6319
432000,201904,9954,25030,7288,20728,1818,5345,3084,8822,4902,14167
432010,201904,1846,4888,1389,4014,205,651,788,2183,993,2834
432020,201904,1718,4284,1161,3288,264,781,515,1373,779,2154
432023,201904,490,1211,254,739,45,141,119,319,164,460
432026,201904,1012,2910,729,2344,175,551,281,907,456,1458
432030,201904,316,835,184,569,24,78,99,299,123,377
432032,201904,384,1015,260,770,31,105,133,358,164,463
432035,201904,653,1882,577,1753,203,640,199,617,402,1257
432040,201904,1074,2483,363,1144,63,225,116,324,179,549
432045,201904,180,493,106,338,26,85,38,122,64,207
432050,201904,470,1248,353,1033,88,250,136,404,224,654
432055,201904,651,1751,408,1265,135,447,96,269,231,716
432057,201904,233,614,170,463,31,75,75,184,106,259
432060,201904,452,1105,142,451,28,104,49,130,77,234
432065,201904,220,627,151,472,30,87,53,161,83,248
432067,201904,704,2097,599,1851,63,214,394,1173,457,1387
432070,201904,1737,4673,1089,3357,225,783,300,817,525,1600
432080,201904,3890,9980,3011,8454,620,1996,1305,3497,1925,5493
432085,201904,371,969,250,777,85,263,86,287,171,550
432090,201904,1237,3280,882,2606,186,591,420,1180,606,1771
432100,201904,963,2594,423,1392,81,285,50,126,131,411
432110,201904,2051,5684,1372,4395,350,1271,98,317,448,1588
432120,201904,2539,7319,2073,6462,561,1889,594,1807,1155,3696
432130,201904,2345,6323,1999,5816,657,1975,797,2367,1454,4342
432132,201904,177,510,104,350,20,69,42,119,62,188
432135,201904,942,2361,611,1733,47,171,428,1182,475,1353
432140,201904,1493,4630,1115,3856,183,666,623,2180,806,2846
432143,201904,1281,3492,1021,3076,85,288,663,1977,748,2265
432145,201904,1304,3575,733,2306,121,420,196,521,317,941
432146,201904,105,301,67,225,22,80,15,43,37,123
432147,201904,458,1385,285,992,86,315,56,178,142,493
432149,201904,413,1075,214,654,20,61,100,295,120,356
432150,201904,2727,7400,2019,6054,475,1601,638,1836,1113,3437
432160,201904,4663,13046,3529,11120,998,3402,1155,3549,2153,6951
432162,201904,271,610,37,109,7,19,4,13,11,32
432163,201904,131,339,25,71,0,0,3,6,3,6
432166,201904,533,1563,407,1285,67,225,157,452,224,677
432170,201904,1263,3545,797,2626,169,607,240,764,409,1371
432180,201904,2564,6513,1353,4077,266,860,406,1089,672,1949
432183,201904,328,953,210,672,53,197,62,181,115,378
432185,201904,771,2044,450,1389,33,119,248,728,281,847
432190,201904,1912,4825,1171,3500,256,862,456,1267,712,2129
432195,201904,932,2343,586,1729,164,458,219,671,383,1129
432200,201904,2965,8057,2105,6549,410,1299,1010,3212,1420,4511
432210,201904,329,905,214,681,39,155,102,295,141,450
432215,201904,623,1862,556,1757,49,141,397,1271,446,1412
432218,201904,254,642,115,327,20,60,52,137,72,197
432220,201904,3585,8746,2660,7241,393,1190,1557,4087,1950,5277
432225,201904,91,269,68,217,14,43,32,105,46,148
432230,201904,697,1731,381,1115,52,151,163,446,215,597
432232,201904,476,1209,302,894,62,199,118,338,180,537
432234,201904,286,754,125,378,29,75,15,37,44,112
432235,201904,81,230,28,90,7,21,7,26,14,47
432237,201904,350,896,300,807,16,43,225,578,241,621
432240,201904,13188,35872,10120,31375,830,2949,6367,20474,7197,23423
432250,201904,4092,12912,3450,11653,1055,3619,1245,4340,2300,7959
432252,201904,427,1093,260,756,40,125,117,327,157,452
432253,201904,1005,3133,585,2038,161,610,28,81,189,691
432254,201904,823,2029,159,515,34,109,15,40,49,149
432255,201904,114,283,52,160,5,18,22,57,27,75
432260,201904,4591,12105,3368,9764,938,2831,976,2776,1914,5607
432270,201904,1824,5307,1474,4592,459,1514,264,803,723,2317
432280,201904,1075,2828,604,1865,105,359,231,619,336,978
432285,201904,188,583,23,83,0,0,2,5,2,5
432290,201904,339,998,177,601,57,200,35,90,92,290
432300,201904,24468,64884,18696,55195,2786,9130,10910,31211,13696,40341
432310,201904,720,2031,525,1664,62,200,335,1066,397,1266
432320,201904,200,475,63,186,8,32,24,59,32,91
432330,201904,215,551,75,246,9,21,19,64,28,85
432335,201904,180,510,56,204,7,27,14,54,21,81
432340,201904,308,742,124,391,20,75,34,88,54,163
432345,201904,575,1395,510,1316,20,61,404,1026,424,1087
432350,201904,325,881,163,543,28,94,56,189,84,283
432360,201904,218,636,39,124,4,18,12,33,16,51
432370,201904,304,769,199,581,15,39,127,361,142,400
432375,201904,484,1234,365,1007,70,168,190,532,260,700
432377,201904,200,638,36,129,5,17,3,6,8,23
432380,201904,1454,4101,921,3044,177,672,421,1321,598,1993
500020,201904,2242,6045,1572,4877,254,877,823,2481,1077,3358
500025,201904,1169,2738,725,1993,69,203,416,1094,485,1297
500060,201904,6197,17776,4594,15007,645,2158,2703,9262,3348,11420
500070,201904,3837,10199,2702,8249,533,1646,1178,3711,1711,5357
500080,201904,1264,3333,850,2590,161,568,378,1054,539,1622
500085,201904,1984,4984,1315,3886,308,973,629,1784,937,2757
500090,201904,1866,5115,1270,4042,246,823,490,1621,736,2444
500100,201904,3324,8669,2530,7356,373,1178,1330,3751,1703,4929
500110,201904,6942,18813,4451,14658,988,3574,1277,4916,2265,8490
500124,201904,1895,5837,1550,5212,286,931,840,2964,1126,3895
500150,201904,1177,2741,724,2038,190,558,221,578,411,1136
500190,201904,4013,9934,2805,8089,701,2076,961,2788,1662,4864
500200,201904,2108,5132,1537,4164,188,529,898,2338,1086,2867
500210,201904,4264,11345,3205,9818,847,2655,1401,4370,2248,7025
500215,201904,1327,3800,935,3043,90,329,477,1551,567,1880
500220,201904,2568,7272,1769,5848,304,1106,622,2027,926,3133
500230,201904,2038,4975,1518,4180,186,501,973,2641,1159,3142
500240,201904,3370,10386,2342,8183,391,1496,828,2974,1219,4470
500260,201904,2996,6550,1817,4888,252,665,921,2393,1173,3058
500270,201904,127236,307710,73864,213328,13875,43645,25096,68573,38971,112218
500280,201904,1201,3088,820,2476,104,346,493,1448,597,1794
500290,201904,3472,8135,1910,5643,337,1114,688,1911,1025,3025
500295,201904,2956,7448,1739,5116,302,965,659,1717,961,2682
500310,201904,858,1932,602,1607,105,231,316,872,421,1103
500315,201904,3214,9534,2620,8577,278,908,1784,6013,2062,6921
500320,201904,16851,48601,11968,40197,3247,11546,3875,13815,7122,25361
500325,201904,4037,9344,2731,7470,278,813,1658,4547,1936,5360
500330,201904,6506,15202,4140,11550,340,1091,2308,6534,2648,7625
500345,201904,1925,4799,1233,3692,322,1008,416,1213,738,2221
500348,201904,2464,6381,1859,5358,244,725,1072,3172,1316,3897
500350,201904,1244,3424,663,2140,81,275,258,817,339,1092
500370,201904,22400,59986,15270,47848,2413,8538,7293,22854,9706,31392
500375,201904,2295,6286,1583,4770,341,1125,534,1522,875,2647
500380,201904,3358,8571,2303,6773,650,2010,716,2128,1366,4138
500390,201904,487,1046,295,788,49,138,154,411,203,549
500400,201904,1140,3061,759,2275,152,513,262,704,414,1217
500410,201904,2264,5875,1635,4887,214,632,934,2886,1148,3518
500430,201904,2428,6291,1660,5111,260,912,661,2151,921,3063
500440,201904,1086,2670,675,1999,106,317,255,812,361,1129
500450,201904,1321,3397,719,2235,145,474,135,397,280,871
500460,201904,3350,9317,2088,6836,407,1494,605,2012,1012,3506
500470,201904,2254,6275,1395,4474,460,1613,259,712,719,2325
500480,201904,2121,6360,1819,5905,170,604,1228,4158,1398,4762
500490,201904,951,2290,545,1658,135,486,158,469,293,955
500500,201904,4087,11305,2648,8917,916,3537,527,1819,1443,5356
500510,201904,681,1750,437,1276,30,100,253,710,283,810
500515,201904,1809,4569,1399,3939,149,434,903,2481,1052,2915
500520,201904,2914,9713,2345,8554,666,2515,937,3528,1603,6043
500525,201904,840,2565,686,2321,62,231,427,1476,489,1707
500540,201904,4115,10960,2483,8015,719,2784,226,614,945,3398
500560,201904,4961,14570,4109,13381,317,1155,3104,10214,3421,11369
500568,201904,4136,9286,2481,6822,603,1818,802,2181,1405,3999
500570,201904,7110,17151,4067,11776,868,2773,1110,2998,1978,5771
500580,201904,2994,8156,2247,6866,483,1581,1086,3260,1569,4841
500600,201904,2922,7440,2049,6120,410,1247,880,2710,1290,3957
500620,201904,7041,19286,4747,14792,1073,3447,1696,5230,2769,8677
500625,201904,489,1376,272,889,54,191,103,328,157,519
500627,201904,713,1859,421,1309,56,171,143,450,199,621
500630,201904,5816,14093,3412,9977,737,2330,1053,3128,1790,5458
500635,201904,2706,8902,2116,8083,154,632,1533,6246,1687,6878
500640,201904,1600,3651,1077,2913,36,126,735,1910,771,2036
500660,201904,15411,43319,10860,36006,3834,14076,2457,8268,6291,22344
500690,201904,2080,5876,1440,4863,586,2241,89,204,675,2445
500710,201904,2788,7841,2126,6609,629,2065,629,1827,1258,3892
500720,201904,4779,12450,2991,9423,711,2425,767,2464,1478,4889
500730,201904,862,2271,546,1683,76,211,211,661,287,872
500740,201904,4443,10835,3082,8573,327,953,1768,4942,2095,5895
500750,201904,925,2437,627,1902,95,295,232,640,327,935
500755,201904,840,2320,471,1589,90,319,66,203,156,522
500769,201904,4713,11945,2429,7380,474,1628,346,790,820,2418
500770,201904,1450,4034,909,3011,172,639,283,936,455,1575
500780,201904,1228,3072,786,2311,174,554,209,573,383,1127
500790,201904,7274,19406,5740,16914,1099,3511,3044,8995,4143,12506
500793,201904,1785,4666,1211,3672,419,1315,242,648,661,1963
500795,201904,2361,6340,1962,5807,110,314,1643,4999,1753,5313
500797,201904,680,1801,446,1353,101,308,170,511,271,819
500800,201904,2678,6423,1742,5036,592,1962,244,774,836,2736
500830,201904,16797,43146,11493,33383,2097,6605,4830,13270,6927,19875
500840,201904,1360,3420,776,2269,92,283,315,878,407,1161
510010,201904,1825,4325,1192,3445,136,392,763,2226,899,2618
510020,201904,3490,9126,1809,5625,426,1390,347,959,773,2349
510025,201904,6547,16922,4011,12412,672,2305,1447,4283,2119,6588
510030,201904,2151,4930,1397,3855,332,923,489,1382,821,2305
510035,201904,1172,3053,714,2305,88,302,422,1431,510,1733
510040,201904,2078,4884,1509,4101,148,399,950,2616,1098,3015
510050,201904,1922,4441,1269,3503,200,628,782,2047,982,2675
510060,201904,1321,3394,976,2854,190,603,345,966,535,1569
510080,201904,1162,3176,766,2466,233,803,225,636,458,1439
510100,201904,631,1527,415,1159,52,150,213,566,265,716
510120,201904,247,460,136,326,7,20,100,245,107,265
510125,201904,2064,5238,1607,4541,203,755,767,1989,970,2744
510130,201904,1404,3599,978,2903,213,722,297,872,510,1594
510140,201904,2818,7668,1953,6538,739,2839,644,1981,1383,4820
510160,201904,1660,4391,1209,3791,205,622,818,2600,1023,3222
510170,201904,4336,11905,3203,10022,778,2497,1297,4169,2075,6666
510180,201904,12889,30949,7818,22835,1892,5948,2239,7415,4131,13363
510185,201904,1603,4357,1055,3553,423,1408,306,1274,729,2682
510190,201904,1956,5679,1309,4529,399,1492,272,996,671,2488
510250,201904,13621,36725,11113,33173,2137,6569,6278,19397,8415,25966
510260,201904,2013,8324,1631,7619,266,1304,968,4972,1234,6276
510263,201904,2800,8066,1728,5835,325,1188,205,617,530,1805
510267,201904,4535,13266,2720,9186,594,2094,372,1260,966,3354
510268,201904,1239,3164,876,2551,124,364,488,1381,612,1745
510269,201904,1011,2821,631,2087,156,552,214,668,370,1220
510270,201904,2796,8322,1980,6824,382,1426,756,2566,1138,3992
510279,201904,1672,4520,1116,3512,206,722,503,1499,709,2221
510285,201904,1067,2965,750,2408,227,810,166,497,393,1307
510300,201904,3467,9022,2574,7777,375,1077,1509,4835,1884,5912
510305,201904,1438,4067,872,2944,190,692,228,847,418,1539
510310,201904,917,2364,642,1896,180,557,201,620,381,1177
510320,201904,3540,9277,2522,7487,570,1808,674,2055,1244,3863
510325,201904,4265,12985,3333,11374,941,3287,1277,4516,2218,7803
510330,201904,2757,8512,1880,6912,381,1417,680,2823,1061,4240
510335,201904,4390,12811,3291,11170,452,1635,1871,6603,2323,8238
510336,201904,449,1346,334,1155,63,209,152,571,215,780
510337,201904,1582,4772,1057,3791,415,1616,177,651,592,2267
510340,201904,83832,191742,50207,140872,13578,44483,12876,33467,26454,77950
510343,201904,1003,2833,684,2198,125,462,267,813,392,1275
510345,201904,1214,3556,898,2932,172,584,383,1207,555,1791
510350,201904,2676,7231,1735,5616,415,1388,674,2160,1089,3548
510360,201904,1794,3865,1140,3073,61,172,817,2299,878,2471
510370,201904,1618,4915,1157,4030,186,709,617,2188,803,2897
510380,201904,479,1250,264,842,69,252,81,245,150,497
510385,201904,1015,3635,752,3093,83,384,470,2030,553,2414
510390,201904,1042,3111,769,2719,197,676,347,1362,544,2038
510395,201904,713,1631,467,1259,29,92,263,759,292,851
510410,201904,4280,12522,3193,10485,675,2285,1702,5780,2377,8065
510420,201904,2090,4647,1431,3735,122,365,885,2292,1007,2657
510450,201904,488,1220,281,818,70,198,46,159,116,357
510452,201904,624,1776,403,1348,74,247,189,636,263,883
510454,201904,877,2505,658,2110,74,212,402,1377,476,1589
510455,201904,891,2583,631,2011,108,408,236,690,344,1098
510460,201904,1742,4445,1249,3692,108,377,790,2234,898,2611
510480,201904,4483,11293,2937,8262,602,1841,1105,2984,1707,4825
510490,201904,1593,4432,1184,3857,217,719,651,2161,868,2880
510500,201904,1539,3992,922,2931,186,635,315,998,501,1633
510510,201904,3155,9673,2391,8197,694,2597,651,2390,1345,4987
510515,201904,5123,13746,3287,10237,749,2580,863,2439,1612,5019
510517,201904,1048,3087,791,2625,241,890,133,378,374,1268
510520,201904,1952,4042,1139,3040,72,202,622,1780,694,1982
510523,201904,965,2576,716,2142,147,418,395,1199,542,1617
510525,201904,5760,16468,4275,13454,730,2605,1880,5527,2610,8132
510530,201904,534,1380,395,1175,33,119,252,716,285,835
510550,201904,2461,7436,1787,6214,460,1641,702,2499,1162,4140
510558,201904,2006,5533,1510,4756,161,544,783,2633,944,3177
510560,201904,1527,4513,886,3233,213,858,229,884,442,1742
510562,201904,4999,13651,3560,10900,930,3085,1088,3362,2018,6447
510590,201904,2939,7611,2129,6552,223,709,1428,4468,1651,5177
510600,201904,1465,3443,928,2595,176,487,371,1046,547,1533
510610,201904,2691,6611,1806,5368,174,597,1084,3215,1258,3812
510615,201904,2107,5854,1517,4771,278,880,836,2690,1114,3570
510617,201904,926,2733,670,2295,114,431,379,1361,493,1792
510618,201904,1195,3282,825,2605,171,591,402,1252,573,1843
510619,201904,700,1812,420,1298,78,262,86,251,164,513
510620,201904,1376,3178,630,1995,154,571,42,98,196,669
510621,201904,1388,3844,861,2817,206,739,245,748,451,1487
510622,201904,3971,11541,2736,8735,996,3406,400,1136,1396,4542
510623,201904,2532,6590,1784,5366,421,1511,464,1327,885,2838
510624,201904,1568,4106,678,2321,91,333,137,405,228,738
510625,201904,2555,6317,1384,4194,293,1018,287,848,580,1866
510626,201904,1434,3515,876,2629,266,908,192,579,458,1487
510627,201904,579,1529,336,1043,91,291,73,241,164,532
510628,201904,1497,3490,990,2807,169,486,502,1469,671,1955
510629,201904,1522,4532,1145,3809,264,951,392,1302,656,2253
510630,201904,3148,9081,1819,6424,417,1564,298,1155,715,2719
510631,201904,534,1320,382,1098,18,49,288,834,306,883
510637,201904,3200,8036,2309,6636,654,2069,620,1750,1274,3819
510642,201904,4949,14918,3937,13361,1065,3830,1570,5546,2635,9376
510645,201904,827,1820,485,1351,113,330,197,512,310,842
510650,201904,6702,18060,5411,16646,658,1871,3841,12724,4499,14595
510665,201904,1749,4027,1014,2819,149,442,418,1214,567,1656
510670,201904,405,860,231,601,30,88,128,327,158,415
510675,201904,5543,15890,3903,12760,1193,4201,669,2181,1862,6382
510677,201904,2058,5417,1419,4435,197,653,727,2268,924,2921
510680,201904,657,1766,383,1241,88,310,52,157,140,467
510682,201904,1547,4777,1147,4056,388,1505,237,844,625,2349
510685,201904,609,1815,446,1477,65,228,208,675,273,903
510700,201904,3642,9333,2583,7730,348,1135,1695,5065,2043,6200
510704,201904,9478,23220,6213,17459,1213,3724,1776,4776,2989,8500
510706,201904,1775,5437,1266,4621,224,845,679,2683,903,3528
510710,201904,2403,6403,1640,4898,359,1120,574,1640,933,2760
510715,201904,594,1381,442,1167,46,125,210,581,256,706
510718,201904,2349,5258,1316,3975,538,1641,277,1098,815,2739
510719,201904,400,858,239,648,36,102,129,331,165,433
510720,201904,911,2264,596,1760,130,412,222,620,352,1032
510724,201904,725,1997,480,1546,82,292,218,672,300,964
510726,201904,1156,2106,579,1377,67,168,289,684,356,852
510729,201904,600,1444,266,817,35,121,66,209,101,330
510730,201904,2841,7071,1906,5585,365,1182,793,2274,1158,3456
510735,201904,989,2953,739,2581,79,316,524,1826,603,2142
510740,201904,886,2252,567,1641,85,245,289,855,374,1100
510757,201904,540,1769,438,1599,163,654,147,507,310,1161
510760,201904,39472,88283,22759,62603,5241,16569,6657,16722,11898,33291
510770,201904,3928,9280,2838,7917,290,757,1897,5523,2187,6280
510774,201904,328,918,223,710,32,105,118,391,150,496
510775,201904,593,1646,412,1352,96,362,89,268,185,630
510776,201904,436,1141,295,850,78,241,91,267,169,508
510777,201904,1537,4208,1112,3627,141,584,715,2263,856,2847
510779,201904,552,1555,432,1357,52,148,256,854,308,1002
510780,201904,3508,9479,2595,8100,634,2000,1075,3736,1709,5736
510785,201904,1991,5347,1114,3691,297,1054,159,598,456,1652
510787,201904,2394,6989,1571,5215,629,2220,87,261,716,2481
510788,201904,647,1556,444,1241,70,191,176,577,246,768
510790,201904,14870,39887,8909,28199,2063,7367,1410,3862,3473,11229
510792,201904,8162,22332,5126,16542,1072,3877,1065,3222,2137,7099
510794,201904,1164,3219,765,2501,248,897,153,427,401,1324
510795,201904,7270,20008,4889,15653,1193,4183,1235,3982,2428,8165
510800,201904,1683,4467,1093,3420,341,1104,190,541,531,1645
510805,201904,1562,4354,1021,3307,226,802,304,868,530,1670
510810,201904,625,1346,408,1040,112,311,182,460,294,771
510820,201904,755,1485,410,1043,37,114,191,495,228,609
510830,201904,803,2013,560,1674,65,196,371,1157,436,1353
510835,201904,528,1329,348,1061,49,167,182,540,231,707
510840,201904,46248,104020,32731,86993,6071,15405,17130,49481,23201,64886
510850,201904,1823,4458,1019,3147,323,1122,116,277,439,1399
510860,201904,2415,6609,1546,5120,506,1956,150,492,656,2448
510880,201904,638,1904,486,1603,122,420,198,665,320,1085
510885,201904,532,1356,368,1112,62,209,130,390,192,599
510890,201904,619,1876,467,1612,102,376,212,737,314,1113
510895,201904,1184,3127,791,2451,200,705,310,876,510,1581
520005,201904,2108,5664,1667,5115,459,1362,752,2595,1211,3957
520010,201904,2122,6301,1522,5058,402,1468,393,1149,795,2617
520013,201904,2556,6857,1761,5338,407,1289,451,1479,858,2768
520015,201904,520,1336,387,1148,91,285,131,420,222,705
520017,201904,1072,2886,812,2476,110,357,503,1510,613,1867
520020,201904,372,886,288,770,36,124,189,470,225,594
520025,201904,31453,89773,27419,84092,2891,9512,19618,60006,22509,69518
520030,201904,5025,13566,4084,12195,419,1359,2662,7932,3081,9291
520050,201904,396,941,254,690,16,38,150,427,166,465
520055,201904,1306,3403,914,2631,50,151,524,1463,574,1614
520060,201904,1353,3935,1016,3290,270,951,256,835,526,1786
520080,201904,1807,4723,1350,4091,246,751,618,2062,864,2813
520082,201904,885,2306,721,2015,74,182,417,1219,491,1401
520085,201904,752,2104,581,1815,115,377,242,717,357,1094
520090,201904,808,1634,543,1338,88,173,378,992,466,1165
520110,201904,36639,101768,25871,83898,8628,31383,1882,5639,10510,37022
520120,201904,195,480,110,335,14,50,36,109,50,159
520130,201904,3586,9132,2846,7928,543,1560,1273,3569,1816,5129
520140,201904,37068,103781,26769,85832,9999,34599,3086,10354,13085,44953
520145,201904,523,1250,350,987,70,210,162,417,232,627
520150,201904,548,1309,397,1111,68,186,213,612,281,798
520160,201904,795,1859,568,1505,98,245,275,748,373,993
520170,201904,4856,10148,3370,8417,197,553,2593,6348,2790,6901
520180,201904,1963,5545,1616,4997,370,1235,751,2298,1121,3533
520215,201904,1861,4479,1331,3649,308,907,516,1364,824,2271
520235,201904,582,1403,358,1053,39,124,143,407,182,531
520250,201904,1477,3903,1074,3243,341,1142,201,619,542,1761
520260,201904,818,1935,495,1379,99,282,198,555,297,837
520280,201904,649,1699,506,1452,130,377,208,639,338,1016
520310,201904,1136,2586,740,1983,183,525,277,772,460,1297
520320,201904,1642,4573,1274,3958,139,477,675,2073,814,2550
520330,201904,3524,10005,2572,8375,468,1788,1169,3710,1637,5498
520340,201904,2242,5097,1442,3967,166,425,874,2484,1040,2909
520350,201904,2771,6885,2009,5656,638,1905,672,1872,1310,3777
520355,201904,1747,4900,1287,3995,343,1171,414,1211,757,2382
520357,201904,741,1887,576,1621,41,112,412,1179,453,1291
520360,201904,682,1819,510,1520,160,495,137,444,297,939
520380,201904,1253,3208,752,2261,69,236,387,1081,456,1317
520390,201904,955,2122,544,1599,176,556,142,442,318,998
520393,201904,529,1269,356,998,48,161,171,431,219,592
520396,201904,771,2119,648,1898,65,218,420,1190,485,1408
520400,201904,1536,3949,1208,3492,204,633,762,2201,966,2834
520410,201904,1770,3929,1044,2851,154,428,485,1277,639,1705
520420,201904,372,892,282,725,28,83,200,486,228,569
520425,201904,1378,3394,886,2546,215,622,294,848,509,1470
520430,201904,2169,5085,1186,3548,226,784,44,121,270,905
520440,201904,2917,7161,1823,5246,449,1387,487,1361,936,2748
520450,201904,11318,27977,7452,21807,2417,7658,940,2894,3357,10552
520455,201904,642,1814,466,1534,123,427,135,455,258,882
520460,201904,875,2227,746,2047,98,227,559,1583,657,1810
520465,201904,784,2049,623,1811,102,317,396,1113,498,1430
520470,201904,1871,5259,1540,4819,375,1164,760,2542,1135,3706
520480,201904,866,2468,582,1965,181,626,117,425,298,1051
520485,201904,1512,4319,1280,3990,199,618,829,2583,1028,3201
520490,201904,3839,10865,2931,9444,866,2806,1247,4192,2113,6998
520495,201904,1484,3354,1135,2882,63,181,886,2241,949,2422
520500,201904,1326,3545,912,2762,206,681,334,1007,540,1688
520505,201904,709,1688,504,1411,75,210,283,785,358,995
520510,201904,7174,18592,4793,14829,1125,3885,1275,4232,2400,8117
520520,201904,1118,2916,837,2465,196,598,266,801,462,1399
520530,201904,1967,5910,1468,5022,488,1719,408,1585,896,3304
520540,201904,2778,7546,1716,5338,340,1092,404,1218,744,2310
520545,201904,864,2376,672,2064,137,412,251,784,388,1196
520547,201904,735,2066,585,1796,154,480,250,767,404,1247
520549,201904,11653,32967,9658,29784,1644,5288,5897,18119,7541,23407
520551,201904,4244,11927,3595,10968,413,1505,2481,7359,2894,8864
520552,201904,800,2134,673,1973,122,354,423,1306,545,1660
520570,201904,553,1301,370,1037,101,265,131,398,232,663
520580,201904,2213,5204,1673,4553,136,417,1162,3130,1298,3547
520590,201904,1178,3170,828,2538,230,711,154,475,384,1186
520620,201904,7872,21814,6261,19425,1609,5086,2805,8964,4414,14050
520630,201904,750,1968,471,1469,84,271,115,369,199,640
520640,201904,2387,5974,1831,5018,455,1236,736,2104,1191,3340
520650,201904,864,2101,611,1711,110,305,288,846,398,1151
520660,201904,521,1258,247,758,49,170,54,174,103,344
520670,201904,910,2587,777,2396,66,218,520,1547,586,1765
520680,201904,701,1756,512,1460,96,267,248,721,344,988
520690,201904,345,804,236,654,79,211,71,215,150,426
520710,201904,469,1113,302,832,9,22,200,535,209,557
520725,201904,1541,3743,1090,2996,128,379,679,1803,807,2182
520735,201904,691,1760,480,1403,102,275,183,577,285,852
520740,201904,1929,4573,1487,4008,258,687,835,2350,1093,3037
520750,201904,632,1574,450,1277,86,238,212,630,298,868
520753,201904,1339,3585,1033,3000,195,594,436,1204,631,1798
520760,201904,1046,2325,941,2190,60,111,792,1914,852,2025
520780,201904,1479,3610,1087,3043,118,346,550,1492,668,1838
520790,201904,3308,7906,2306,6347,258,734,1336,3885,1594,4619
520800,201904,14479,38629,11564,34441,2165,6583,6592,20321,8757,26904
520810,201904,1284,2730,918,2310,163,439,532,1391,695,1830
520815,201904,593,1776,429,1442,91,312,97,342,188,654
520830,201904,1808,3973,1264,3346,52,140,999,2588,1051,2728
520840,201904,2272,6301,1853,5751,781,2541,533,1782,1314,4323
520850,201904,656,1777,463,1474,168,611,100,321,268,932
520860,201904,5775,16155,4420,13962,1099,3751,1703,5354,2802,9105
520870,201904,90139,216631,61824,174311,15873,48577,19746,54367,35619,102944
520880,201904,6053,17637,4741,15340,1295,4371,1528,4987,2823,9358
520890,201904,3635,9162,2496,7357,542,1711,1039,3054,1581,4765
520910,201904,4392,11317,2800,8490,736,2434,538,1634,1274,4068
520915,201904,608,1688,382,1206,67,234,122,361,189,595
520920,201904,4371,10258,2963,8329,399,1185,1563,4426,1962,5611
520929,201904,711,1726,496,1365,81,195,238,704,319,899
520940,201904,976,2656,773,2360,45,166,572,1695,617,1861
520945,201904,473,1089,382,948,33,80,262,633,295,713
520960,201904,1014,2618,792,2237,112,333,494,1341,606,1674
520970,201904,2378,6814,1929,6059,536,1841,479,1586,1015,3427
520980,201904,779,1954,579,1664,124,382,224,610,348,992
520990,201904,2915,8202,2389,7468,296,971,1564,4917,1860,5888
520993,201904,1035,2477,687,1909,57,189,443,1186,500,1375
520995,201904,2197,5683,1672,4964,284,852,664,2005,948,2857
521000,201904,8034,21605,5540,17155,1255,4058,1563,4845,2818,8903
521010,201904,3661,9630,2752,8060,318,959,1566,4554,1884,5513
521015,201904,685,1734,508,1432,59,185,311,838,370,1023
521020,201904,2836,7450,1720,5278,518,1686,152,490,670,2176
521030,201904,463,1023,318,821,42,88,151,428,193,516
521040,201904,7393,18187,5484,15201,1274,3685,2240,6330,3514,10015
521056,201904,873,2380,678,2085,207,646,200,669,407,1315
521060,201904,962,2546,721,2133,59,181,365,1081,424,1262
521080,201904,1069,2400,547,1544,68,202,213,523,281,725
521090,201904,3299,8787,2242,6805,649,2081,293,936,942,3017
521100,201904,1721,4084,1241,3400,211,569,700,1949,911,2518
521120,201904,4646,10973,3249,9202,270,709,1597,5160,1867,5869
521130,201904,902,2110,559,1528,28,99,307,863,335,962
521140,201904,1217,3201,878,2606,154,488,374,1093,528,1581
521150,201904,11661,26259,7451,20346,1434,4471,3310,9188,4744,13659
521160,201904,616,1364,433,1077,55,138,257,611,312,749
521170,201904,1032,2471,741,2008,73,205,497,1318,570,1523
521180,201904,6562,19121,5474,17142,1073,3638,2498,7569,3571,11207
521190,201904,10115,26248,5780,18511,1468,4992,1118,3801,2586,8793
521200,201904,712,1795,486,1404,46,138,275,782,321,920
521205,201904,600,1528,452,1283,17,42,327,898,344,940
521210,201904,700,1801,404,1211,103,331,62,145,165,476
521220,201904,3776,9447,2443,7238,541,1765,621,1693,1162,3458
521225,201904,315,723,240,636,39,111,149,385,188,496
521230,201904,1232,3414,1132,3276,408,1170,557,1726,965,2896
521250,201904,29344,81628,23259,72805,8913,29091,7020,23476,15933,52567
521260,201904,577,1352,416,1090,64,169,235,606,299,775
521270,201904,1789,4602,1540,4295,89,223,1181,3322,1270,3545
521280,201904,1826,5000,1374,4212,360,1188,511,1574,871,2762
521290,201904,459,1126,319,940,49,163,174,498,223,661
521295,201904,1050,2300,822,2052,78,176,629,1659,707,1835
521300,201904,1848,4679,1475,4167,294,782,883,2570,1177,3352
521305,201904,701,1754,479,1395,62,168,273,799,335,967
521308,201904,4590,12574,3309,10086,408,1258,1812,5419,2220,6677
521310,201904,7897,20690,5322,16216,1263,4118,1861,5471,3124,9589
521340,201904,410,953,290,773,19,56,214,555,233,611
521350,201904,2014,5210,1545,4494,154,510,1033,2909,1187,3419
521370,201904,1161,3061,705,2263,186,684,108,355,294,1039
521375,201904,1325,3380,932,2814,221,672,302,965,523,1637
521377,201904,1439,3142,1055,2662,75,145,861,2247,936,2392
521380,201904,5870,15988,3902,12241,432,1531,945,3123,1377,4654
521385,201904,621,1517,477,1332,72,193,264,794,336,987
521390,201904,677,1711,479,1406,152,472,165,513,317,985
521400,201904,2451,5680,1904,5027,190,490,1382,3793,1572,4283
521405,201904,1259,3252,932,2706,188,552,420,1214,608,1766
521410,201904,749,2043,600,1800,115,333,300,967,415,1300
521440,201904,1277,3332,932,2783,282,913,257,754,539,1667
521450,201904,3769,11496,2815,9556,683,2321,778,2793,1461,5114
521460,201904,5573,15119,4066,12412,1476,4678,824,2535,2300,7213
521470,201904,646,1792,395,1255,61,194,115,345,176,539
521480,201904,339,866,193,575,34,105,48,126,82,231
521483,201904,2425,5933,1683,4749,423,1281,586,1587,1009,2868
521486,201904,1644,3962,1248,3403,74,215,934,2517,1008,2732
521487,201904,436,1096,313,912,59,175,144,434,203,609
521490,201904,834,2289,608,1909,35,141,437,1322,472,1463
521500,201904,1994,5128,1458,4231,86,316,1029,2914,1115,3230
521520,201904,741,1709,507,1358,92,251,204,560,296,811
521523,201904,10927,35439,9323,32759,3062,11469,2521,9125,5583,20594
521525,201904,1029,2393,751,1994,83,229,525,1381,608,1610
521530,201904,2250,5881,1294,3911,273,879,318,1007,591,1886
521540,201904,841,2155,541,1634,84,299,231,716,315,1015
521550,201904,1246,3246,748,2248,147,483,222,709,369,1192
521560,201904,4089,11266,2880,9608,531,2107,1422,4918,1953,7025
521565,201904,610,1526,482,1339,83,215,291,800,374,1015
521570,201904,3543,9531,2358,7281,472,1641,294,977,766,2618
521580,201904,514,1284,288,872,37,122,67,174,104,296
521590,201904,592,1464,443,1237,102,308,221,594,323,902
521600,201904,385,1062,234,735,44,115,64,207,108,322
521630,201904,1606,3634,970,2643,204,588,311,818,515,1406
521640,201904,1819,4340,1287,3572,296,893,429,1137,725,2030
521645,201904,547,1451,353,1099,80,235,104,330,184,565
521680,201904,1123,3483,877,2984,257,945,107,397,364,1342
521690,201904,502,1329,436,1217,59,180,262,710,321,890
521710,201904,2886,7528,1913,5849,370,1292,419,1219,789,2511
521720,201904,2115,5121,1439,4079,173,548,809,2224,982,2772
521730,201904,3523,10323,2739,8901,844,3074,552,1535,1396,4609
521740,201904,3767,10141,2892,8834,841,2766,965,3080,1806,5846
521760,201904,14015,40251,11153,35740,3299,11610,3747,12427,7046,24037
521770,201904,2834,7064,1963,5617,607,1871,449,1281,1056,3152
521800,201904,5841,16389,4489,14111,1172,3792,1556,5342,2728,9134
521805,201904,515,1240,378,1040,127,331,152,431,279,762
521810,201904,672,1600,460,1291,75,214,232,662,307,876
521830,201904,5112,14551,4161,13117,350,1308,2875,8903,3225,10211
521839,201904,658,1689,467,1351,94,288,207,551,301,839
521850,201904,4895,12490,3271,9764,542,1777,291,784,833,2561
521860,201904,1667,4450,1143,3519,192,632,359,1083,551,1715
521870,201904,676,1925,464,1513,107,357,120,366,227,723
521878,201904,614,1646,450,1339,68,229,211,562,279,791
521880,201904,17629,43251,11852,34473,3046,9359,3869,11584,6915,20943
521890,201904,3038,8227,2012,6283,535,1767,298,877,833,2644
521900,201904,1584,3796,947,2840,278,809,181,574,459,1383
521910,201904,1134,2575,769,2123,72,190,445,1286,517,1476
521920,201904,442,1251,321,1016,63,213,122,393,185,606
521925,201904,732,2009,544,1696,106,330,230,695,336,1025
521930,201904,4608,11769,3251,9719,917,2633,1172,3870,2089,6503
521935,201904,878,2175,616,1712,61,174,360,948,421,1122
521940,201904,1270,2931,828,2318,185,563,327,887,512,1450
521945,201904,514,1453,407,1255,85,265,199,638,284,903
521950,201904,705,1706,509,1423,129,388,236,605,365,993
521960,201904,714,1961,475,1469,69,233,223,639,292,872
521970,201904,2451,6280,2054,5797,144,397,1606,4596,1750,4993
521971,201904,736,1792,518,1472,142,400,126,358,268,758
521973,201904,1149,3138,902,2739,54,203,620,1845,674,2048
521975,201904,11475,31077,9648,28553,1531,4729,6035,17838,7566,22567
521980,201904,2487,6033,1914,5264,172,436,1406,3919,1578,4355
521990,201904,1105,3075,879,2694,143,439,405,1268,548,1707
522000,201904,2760,7557,2142,6780,242,746,1408,4644,1650,5390
522005,201904,320,785,240,676,46,114,119,345,165,459
522010,201904,3764,9437,2673,7668,737,2268,743,2079,1480,4347
522015,201904,934,2522,670,2091,151,482,261,830,412,1312
522020,201904,5116,12407,3396,9674,718,2145,1377,4047,2095,6192
522026,201904,630,1800,472,1502,95,324,167,519,262,843
522028,201904,460,1239,333,985,58,169,133,369,191,538
522040,201904,2879,6610,2029,5480,250,737,1336,3524,1586,4261
522045,201904,16331,47012,12187,39299,2951,10176,3062,9567,6013,19743
522050,201904,973,2584,660,2052,143,473,266,793,409,1266
522060,201904,2456,6804,1933,5972,219,691,1120,3582,1339,4273
522068,201904,1725,4625,1356,4165,173,480,949,3007,1122,3487
522070,201904,591,1528,481,1360,28,97,376,1020,404,1117
522100,201904,613,1644,436,1351,53,171,235,726,288,897
522108,201904,884,2426,692,2124,43,189,555,1643,598,1832
522119,201904,1499,3906,1156,3441,182,565,600,1849,782,2414
522130,201904,355,898,255,765,50,161,140,439,190,600
522140,201904,15714,42845,11473,35316,3287,10804,2561,7589,5848,18393
522145,201904,816,2028,577,1674,152,414,241,744,393,1158
522150,201904,984,2465,709,2008,202,568,208,615,410,1183
522155,201904,876,2318,684,1999,123,351,367,1074,490,1425
522157,201904,531,1357,452,1249,30,106,347,945,377,1051
522160,201904,5659,15147,3780,11640,1079,3610,283,932,1362,4542
522170,201904,2578,6745,1892,5691,396,1221,922,2814,1318,4035
522180,201904,441,1086,278,807,62,181,26,94,88,275
522185,201904,15771,40421,11793,35114,5063,16121,2682,8779,7745,24900
522190,201904,730,1793,516,1415,96,265,199,550,295,815
522200,201904,1610,4779,1020,3476,194,705,68,210,262,915
522205,201904,1568,3717,1196,3202,113,328,838,2227,951,2555
522220,201904,1273,3335,957,2845,142,421,500,1517,642,1938
522230,201904,1107,2944,918,2666,216,732,469,1289,685,2021
530010,201904,151270,429603,125720,389294,22999,78308,67776,206411,90775,284719
110001,201905,3634,10592,2523,8467,670,2378,953,3214,1623,5592
110002,201905,11223,30259,7982,24653,2298,7529,2408,7532,4706,15061
110003,201905,610,1854,435,1473,120,434,95,310,215,744
110004,201905,9455,26255,6473,20619,1599,5465,1717,5659,3316,11124
110005,201905,2439,6480,1519,4779,358,1221,429,1447,787,2668
110006,201905,1773,5041,1080,3562,238,883,177,527,415,1410
110007,201905,1043,2953,788,2533,283,937,215,800,498,1737
110008,201905,3105,8974,2292,7703,264,868,1543,5457,1807,6325
110009,201905,4037,11660,2606,8984,671,2391,938,3336,1609,5727
110010,201905,6352,21801,4918,19000,1140,4314,2293,9819,3433,14133
110011,201905,6231,17279,4438,13969,1590,5158,728,2423,2318,7581
110012,201905,13774,35850,8500,26380,2208,7203,975,3248,3183,10451
110013,201905,5069,15277,3867,12785,1692,5731,561,2084,2253,7815
110014,201905,3626,9902,2488,7729,674,2136,928,2859,1602,4995
110015,201905,4791,12973,2697,8686,730,2526,403,1200,1133,3726
110018,201905,3386,8850,2017,6411,422,1510,558,1725,980,3235
110020,201905,72024,178706,49894,147309,11079,33803,20221,64228,31300,98031
110025,201905,4833,12086,3147,9108,675,2073,1409,4029,2084,6102
110026,201905,465,1284,348,1107,104,355,136,432,240,787
110028,201905,6000,16081,3833,12042,1078,3595,560,1744,1638,5339
110029,201905,1358,3359,785,2386,187,577,310,985,497,1562
110030,201905,12239,29165,7881,22841,1654,5561,2114,6466,3768,12027
110032,201905,2803,8336,1888,6370,627,2122,454,1574,1081,3696
110033,201905,3617,11773,2888,10373,1078,3946,675,2718,1753,6664
110034,201905,3290,8063,2188,6515,657,2093,874,2728,1531,4821
110037,201905,1586,4988,1256,4352,298,1028,569,2017,867,3045
110040,201905,2905,8387,2096,6863,652,2282,534,1699,1186,3981
110045,201905,4837,14365,3779,12457,1015,3622,1432,4736,2447,8358
110050,201905,1692,4887,1230,4001,517,1779,227,752,744,2531
110060,201905,768,2350,532,1820,213,766,64,233,277,999
110070,201905,1654,5319,1275,4461,435,1614,261,839,696,2453
110080,201905,5940,14210,4308,12276,490,1289,2981,9019,3471,10308
110090,201905,575,1579,406,1272,103,355,162,490,265,845
110092,201905,1162,3515,850,2899,154,547,437,1566,591,2113
110094,201905,2724,8267,2089,7107,832,2946,474,1703,1306,4649
110100,201905,1666,5123,1367,4484,347,1189,632,2063,979,3252
110110,201905,1701,4880,1179,3926,407,1409,252,904,659,2313
110120,201905,1244,3794,939,3175,246,862,285,960,531,1822
110130,201905,2499,6545,1583,4853,351,1176,556,1693,907,2869
110140,201905,2015,6218,1424,4975,384,1373,362,1303,746,2676
110143,201905,1297,3575,880,2741,296,915,193,613,489,1528
110145,201905,844,2310,543,1745,137,457,179,601,316,1058
110146,201905,423,1150,290,940,53,167,145,503,198,670
110147,201905,748,1987,471,1410,71,224,186,477,257,701
110148,201905,769,2262,469,1609,118,444,53,182,171,626
110149,201905,2908,8285,2068,6935,788,2683,434,1620,1222,4303
110150,201905,2484,6396,1689,5273,550,1849,458,1597,1008,3446
110155,201905,646,1994,486,1616,119,413,164,521,283,934
110160,201905,1464,4647,1087,3802,346,1200,261,956,607,2156
110170,201905,2151,5710,1328,4066,264,841,665,1975,929,2816
110175,201905,1523,4461,1097,3714,188,672,504,1785,692,2457
110180,201905,1314,3721,895,2861,174,568,422,1335,596,1903
120001,201905,3074,9634,2607,8962,419,1396,1726,6156,2145,7552
120005,201905,1918,7399,1730,7105,156,708,1349,5636,1505,6344
120010,201905,5160,16017,4407,14796,518,1705,3105,10710,3623,12415
120013,201905,2134,7933,1989,7725,485,1795,1203,4971,1688,6766
120017,201905,2127,7110,1900,6755,319,1184,1190,4390,1509,5574
120020,201905,14243,58469,13321,56595,1235,5887,10262,44055,11497,49942
120025,201905,2904,8702,2396,8047,432,1469,1580,5432,2012,6901
120030,201905,6497,25806,6146,25161,413,2208,4876,20019,5289,22227
120032,201905,1640,7548,1573,7392,97,620,1297,6018,1394,6638
120033,201905,4061,15150,3797,14675,131,738,3272,12542,3403,13280
120034,201905,2597,9581,2216,8875,116,701,1792,7017,1908,7718
120035,201905,3466,14519,3299,14197,287,1391,2672,11587,2959,12978
120038,201905,2682,8834,2320,8230,551,2082,1220,4363,1771,6445
120039,201905,1960,8657,1832,8384,147,918,1437,6505,1584,7423
120040,201905,41226,135421,36406,127330,5929,21874,22391,79279,28320,101153
120042,201905,3330,12654,3033,12040,161,858,2441,9645,2602,10503
120043,201905,1392,5618,1266,5402,45,262,1126,4813,1171,5075
120045,201905,5922,16008,5209,15206,136,548,4775,13791,4911,14339
120050,201905,9143,33351,8375,32153,475,2424,6824,26241,7299,28665
120060,201905,9308,36684,8639,35633,422,2464,7420,30498,7842,32962
120070,201905,3042,10036,2659,9505,271,1015,1861,6908,2132,7923
120080,201905,4260,14282,3818,13572,562,2172,2601,9354,3163,11526
130002,201905,3082,12340,2761,11876,198,908,2338,10163,2536,11071
130006,201905,2343,8980,1928,8228,175,825,1434,6109,1609,6934
130008,201905,2549,9066,2287,8662,76,401,1940,7330,2016,7731
130010,201905,3896,11390,3298,10706,61,207,3082,10101,3143,10308
130014,201905,2986,9149,2354,8065,442,1530,1424,4989,1866,6519
130020,201905,2644,10625,2405,10238,151,896,1888,8009,2039,8905
130030,201905,9638,32085,8818,31117,231,928,7941,28319,8172,29247
130040,201905,3722,11316,3149,10532,165,577,2558,8616,2723,9193
130050,201905,7456,27610,6248,26043,186,958,5627,23664,5813,24622
130060,201905,7442,29972,6421,28608,535,3047,5115,22650,5650,25697
130063,201905,6116,20455,5465,19731,135,627,5043,18300,5178,18927
130068,201905,3487,13116,3019,12311,252,1402,2192,8762,2444,10164
130070,201905,7547,21898,6299,20504,285,952,5334,17702,5619,18654
130080,201905,6775,25759,6016,24827,300,1753,4997,20821,5297,22574
130083,201905,2631,8937,2390,8635,186,795,2011,7220,2197,8015
130090,201905,3423,10815,3052,10324,69,314,2637,9085,2706,9399
130100,201905,7643,23443,6567,22304,72,199,6134,21405,6206,21604
130110,201905,8279,24037,6899,22316,888,2361,5212,17929,6100,20290
130115,201905,5411,17147,4729,16336,106,424,4177,14608,4283,15032
130120,201905,14224,51618,12921,49909,1215,5172,10482,40794,11697,45966
130130,201905,5128,16921,4047,15501,449,1906,3039,11663,3488,13569
130140,201905,6892,24906,6329,24268,217,1170,5603,21526,5820,22696
130150,201905,3597,13662,3375,13393,103,654,3052,12086,3155,12740
130160,201905,5046,18351,4379,17483,318,1451,3639,14729,3957,16180
130165,201905,3218,12378,3053,12145,120,604,2726,10871,2846,11475
130170,201905,11572,35002,9418,32399,768,3073,7535,25965,8303,29038
130180,201905,4477,14200,4231,13923,43,234,4077,13371,4120,13605
130185,201905,18186,45292,14843,41709,869,1581,12739,37545,13608,39126
130190,201905,18838,62901,15408,57762,1873,7217,10805,41731,12678,48948
130195,201905,2390,8886,1940,8302,76,417,1718,7352,1794,7769
130200,201905,2485,7291,2077,6730,117,482,1694,5445,1811,5927
130210,201905,1300,4960,1171,4808,96,571,943,3781,1039,4352
130220,201905,2229,8056,1993,7714,77,396,1720,6666,1797,7062
130230,201905,4331,18495,3805,17733,282,1705,3178,14799,3460,16504
130240,201905,11543,35574,9434,32686,205,1213,8350,28815,8555,30028
130250,201905,25565,78211,22284,74492,1692,5320,18098,62738,19790,68058
130255,201905,4248,14607,3759,13728,181,839,3015,11010,3196,11849
130260,201905,250396,727019,208119,663513,57986,197078,94527,306257,152513,503335
130270,201905,8688,32377,7449,30413,1113,4641,5072,21419,6185,26060
130280,201905,3478,14103,3206,13800,107,517,2956,12903,3063,13420
130290,201905,12894,43759,11403,41921,598,2446,9886,36847,10484,39293
130300,201905,4668,16702,4268,16120,172,960,3645,13668,3817,14628
130310,201905,5892,20776,5218,19837,357,1569,4285,16411,4642,17980
130320,201905,3379,11186,2913,10614,323,1153,2231,8379,2554,9532
130330,201905,4546,14697,3711,13671,196,910,3168,11646,3364,12556
130340,201905,22403,73403,19577,70098,1530,5232,16230,59821,17760,65053
130350,201905,3916,14433,3543,13942,153,881,3077,11991,3230,12872
130353,201905,6726,19204,5558,17694,907,2802,3751,12392,4658,15194
130356,201905,4944,16468,4241,15325,639,2336,2745,10305,3384,12641
130360,201905,3141,9614,2691,9098,66,227,2499,8516,2565,8743
130370,201905,5669,22340,5024,21454,313,1619,4160,17708,4473,19327
130380,201905,7204,30394,6773,29740,422,2437,5698,24727,6120,27164
130390,201905,5942,25018,5245,23784,569,3066,3805,17195,4374,20261
130395,201905,2317,7549,2001,7013,208,775,1478,5152,1686,5927
130400,201905,2666,8645,2311,8170,108,374,2042,7334,2150,7708
130406,201905,10793,39251,9338,37369,1740,7081,6307,26017,8047,33098
130410,201905,4046,14666,3511,13763,1099,4459,1615,6592,2714,11051
130420,201905,13359,47886,11333,45397,1016,5200,8901,35586,9917,40786
130423,201905,4210,13550,3714,12973,178,880,3262,11222,3440,12102
130426,201905,2815,11116,2681,10920,87,470,2468,10077,2555,10547
130430,201905,4138,12168,3627,11466,336,1229,2879,8948,3215,10177
130440,201905,4759,15101,4164,14393,108,470,3835,13292,3943,13762
140002,201905,2207,6615,1930,6253,98,377,1610,5182,1708,5559
140005,201905,3158,8912,2858,8574,148,406,2485,7571,2633,7977
140010,201905,54746,146649,43249,129377,11097,34846,17260,53053,28357,87899
140015,201905,3433,10723,2977,10159,209,731,2560,8864,2769,9595
140017,201905,3971,11696,3499,11077,309,976,2714,8851,3023,9827
140020,201905,5123,15357,4384,14352,282,1224,3457,11229,3739,12453
140023,201905,2324,7089,1894,6475,230,837,1348,4673,1578,5510
140028,201905,2091,5422,1775,5007,116,374,1389,3875,1505,4249
140030,201905,4922,13077,4386,12435,330,738,3717,10863,4047,11601
140040,201905,2280,9444,2095,9165,113,710,1843,7912,1956,8622
140045,201905,2627,9666,2229,9103,403,1538,1481,6428,1884,7966
140047,201905,5717,16869,4879,15591,742,2533,3282,10591,4024,13124
140050,201905,1384,4158,1182,3857,141,482,845,2802,986,3284
140060,201905,1628,4386,1372,4005,131,351,1065,3184,1196,3535
140070,201905,1785,9544,1727,9393,142,955,1373,7382,1515,8337
150010,201905,45086,113348,40985,108047,977,2627,36461,95635,37438,98262
150013,201905,1921,5084,1598,4723,150,336,1221,3824,1371,4160
150020,201905,14071,43038,13162,41849,1139,2861,11121,36417,12260,39278
150030,201905,8581,32721,7873,31842,393,1873,6896,27978,7289,29851
150034,201905,4275,10903,3544,9955,261,708,2904,8302,3165,9010
150040,201905,16059,41879,14072,39650,1360,2313,11450,35195,12810,37508
150050,201905,6788,24194,6251,23429,148,691,5707,21543,5855,22234
150060,201905,20853,58365,17188,52853,2879,9008,10721,33766,13600,42774
150070,201905,6585,25237,5849,24345,194,1053,5269,22154,5463,23207
150080,201905,92190,211491,78560,193046,18460,48756,26100,77589,44560,126345
150085,201905,7004,21275,6431,20566,166,548,5974,19216,6140,19764
150090,201905,9955,37341,9373,36217,637,2766,7611,29474,8248,32240
150095,201905,5471,16619,4861,15825,274,700,4046,13691,4320,14391
150100,201905,3002,10626,2654,10012,206,777,2047,7797,2253,8574
150110,201905,4165,17975,3969,17730,220,1053,3593,16144,3813,17197
150120,201905,7696,24893,7436,24550,313,834,6588,22492,6901,23326
150125,201905,737,2029,558,1785,108,395,318,1000,426,1395
150130,201905,22760,66653,19936,62416,2715,7563,14196,46231,16911,53794
150140,201905,231350,551474,200027,508066,32080,79879,117277,311525,149357,391404
150145,201905,4448,13517,3805,12594,838,2521,2377,8474,3215,10995
150150,201905,15346,40612,13648,38447,726,2193,11264,31774,11990,33967
150157,201905,3315,9346,2751,8615,283,927,1964,6367,2247,7294
150160,201905,2922,8979,2734,8675,615,1924,1590,5222,2205,7146
150170,201905,24262,80696,21227,75525,3974,13396,12893,48788,16867,62184
150172,201905,4535,12831,3689,11629,264,751,2769,9017,3033,9768
150175,201905,1629,5149,1378,4670,250,895,821,2814,1071,3709
150178,201905,10368,29002,8669,26995,310,923,7520,23788,7830,24711
150180,201905,21182,78036,19680,76175,986,3844,17259,67934,18245,71778
150190,201905,6765,23053,6364,22523,281,1245,5563,19594,5844,20839
150195,201905,5242,17078,5021,16750,86,460,4662,15398,4748,15858
150200,201905,5587,16729,5122,16218,63,171,4806,15365,4869,15536
150210,201905,25360,90540,23866,88407,1979,7280,19434,73756,21413,81036
150215,201905,7093,20885,6124,19452,1382,4325,3286,10995,4668,15320
150220,201905,11611,34129,10334,32257,1283,3951,6862,21846,8145,25797
150230,201905,12328,35625,10764,33539,1255,3644,7437,24137,8692,27781
150240,201905,32026,90591,26581,81128,8044,24933,8321,26089,16365,51022
150250,201905,4106,16451,3916,16192,554,2276,3007,12693,3561,14969
150260,201905,2607,8835,2404,8504,189,653,1851,6637,2040,7290
150270,201905,8695,25349,6172,21072,2019,7217,1930,6994,3949,14211
150275,201905,6710,21860,6206,21114,235,934,5361,18140,5596,19074
150276,201905,2237,6127,1919,5742,244,656,1338,4365,1582,5021
150277,201905,5209,13887,4250,12769,368,1022,3269,10421,3637,11443
150280,201905,6510,27009,6315,26648,527,2216,5257,22433,5784,24649
150285,201905,3223,11514,2843,10921,307,1209,1992,7806,2299,9015
150290,201905,10624,29065,9742,28103,340,758,8773,25894,9113,26652
150293,201905,9461,23834,7040,20598,1251,3607,3907,12213,5158,15820
150295,201905,7872,21499,5734,18603,2030,7205,1867,6644,3897,13849
150300,201905,2273,7011,2043,6700,52,222,1821,5963,1873,6185
150304,201905,4024,12319,3345,11194,633,2016,2028,7078,2661,9094
150307,201905,6220,20197,5807,19534,406,1325,4737,16153,5143,17478
150309,201905,6134,19014,4953,16907,974,3234,2660,9513,3634,12747
150310,201905,7171,28381,6828,27964,228,1318,6032,24884,6260,26202
150320,201905,9437,25764,8613,24619,458,1414,6685,19065,7143,20479
150330,201905,13797,45374,12782,43654,1477,4828,9473,33253,10950,38081
150340,201905,2557,7518,2299,7141,336,953,1616,5165,1952,6118
150345,201905,7713,23285,7033,22386,401,1378,6016,19245,6417,20623
150350,201905,8874,23459,8204,22578,825,1626,6666,19053,7491,20679
150360,201905,23596,67143,19116,61336,2200,6262,13086,44312,15286,50574
150370,201905,10201,32540,8577,30283,961,3130,6286,23482,7247,26612
150375,201905,3338,13876,3022,13395,250,1243,2490,11107,2740,12350
150380,201905,10799,28427,9001,26010,207,740,7837,22671,8044,23411
150390,201905,7814,32075,7097,30876,1139,4542,4913,22547,6052,27089
150400,201905,6298,23110,6049,22622,283,1150,5234,19603,5517,20753
150405,201905,9096,24561,8111,23343,510,1171,6557,19534,7067,20705
150410,201905,1895,6168,1617,5674,207,694,1052,3775,1259,4469
150420,201905,40249,115790,31121,101745,9423,32290,9738,36876,19161,69166
150430,201905,8339,24912,7699,24049,833,2056,6033,19634,6866,21690
150440,201905,5524,18237,5163,17681,630,1994,3847,13539,4477,15533
150442,201905,24944,62324,20790,56811,2302,6138,14147,39587,16449,45725
150445,201905,6139,19331,5470,18287,236,845,4641,15557,4877,16402
150450,201905,4968,21779,4681,21383,374,1862,3957,18129,4331,19991
150460,201905,8365,27686,7752,26898,247,1019,6699,24018,6946,25037
150470,201905,21087,55188,18795,52559,557,1431,17360,48758,17917,50189
150475,201905,4597,15043,4075,14222,186,714,3377,11914,3563,12628
150480,201905,13611,45173,12267,43098,2140,7010,8275,30686,10415,37696
150490,201905,8069,28656,7565,28001,242,1108,6738,25031,6980,26139
150495,201905,5145,18215,4998,17991,117,588,4584,16406,4701,16994
150497,201905,2798,9186,2266,8229,560,2107,1124,4313,1684,6420
150500,201905,3282,8606,2927,8090,261,674,2283,6322,2544,6996
150503,201905,4484,12280,3195,10513,999,3491,1011,3759,2010,7250
150506,201905,10095,31479,8697,29489,1863,5597,5485,20352,7348,25949
150510,201905,9813,36164,8573,33763,1157,4412,5807,23908,6964,28320
150520,201905,7255,27684,6940,27282,213,1232,6325,24763,6538,25995
150530,201905,12210,41999,10725,39858,1551,4714,7733,30490,9284,35204
150540,201905,4914,13736,4210,12674,141,435,3616,10849,3757,11284
150543,201905,7120,19439,5858,17810,620,1938,4271,13539,4891,15477
150548,201905,9837,31177,8910,29915,294,1043,7851,26495,8145,27538
150549,201905,2019,6139,1746,5771,48,208,1518,5009,1566,5217
150550,201905,19568,58818,16672,53989,3975,13113,7487,25849,11462,38962
150553,201905,23897,73570,18941,64540,6139,21452,5932,22105,12071,43557
150555,201905,1866,5108,1479,4491,131,331,1035,3242,1166,3573
150560,201905,1824,5675,1620,5269,284,884,928,3134,1212,4018
150563,201905,2481,7800,2126,7154,456,1627,1165,3906,1621,5533
150565,201905,4230,13853,3759,13077,117,564,3074,10738,3191,11302
150570,201905,6140,20331,5871,19922,266,1073,5097,17180,5363,18253
150580,201905,10113,41233,9142,40133,643,3234,7532,33881,8175,37115
150590,201905,7429,26912,6729,26016,218,1216,6069,23330,6287,24546
150600,201905,9275,31588,8668,30816,231,958,7959,28402,8190,29360
150610,201905,2733,8267,2456,7783,121,470,2005,6263,2126,6733
150611,201905,3072,8999,2770,8552,94,392,2428,7409,2522,7801
150613,201905,13031,36565,9924,31214,1848,6202,4876,15450,6724,21652
150616,201905,3275,9141,2409,7693,604,2006,926,2925,1530,4931
150618,201905,6828,20223,5530,18165,624,1995,3447,11867,4071,13862
150619,201905,6134,17913,5117,16389,205,812,4168,13355,4373,14167
150620,201905,6516,21813,5681,20457,774,2731,3936,14572,4710,17303
150630,201905,6067,16902,5586,16294,449,1212,4617,13735,5066,14947
150635,201905,4571,12985,3907,11891,580,1736,2474,7696,3054,9432
150640,201905,2200,6435,2016,6217,33,109,1881,5875,1914,5984
150650,201905,11333,32327,10045,30147,3096,8750,4427,14399,7523,23149
150655,201905,5809,16770,5275,15968,227,720,4503,13592,4730,14312
150658,201905,4425,12666,3522,11309,597,2021,2107,7083,2704,9104
150660,201905,5682,16548,5119,15731,528,1555,3540,11081,4068,12636
150670,201905,8160,19437,6451,17472,647,1462,5053,14348,5700,15810
150680,201905,65021,197042,50078,172968,12621,42992,22368,86313,34989,129305
150690,201905,2755,7639,2481,7287,126,318,2169,6486,2295,6804
150700,201905,6163,18564,5554,17770,396,1159,4393,14391,4789,15550
150710,201905,3733,12594,3431,12101,242,885,2657,9500,2899,10385
150715,201905,5051,14982,4239,13696,361,1137,3296,10809,3657,11946
150720,201905,6698,24727,6272,23999,433,1872,5169,19832,5602,21704
150730,201905,11321,35700,9967,33642,1107,3915,7547,25940,8654,29855
150740,201905,3885,11087,3439,10340,353,924,2534,7778,2887,8702
150745,201905,5124,14869,4151,13409,842,2860,2634,8554,3476,11414
150746,201905,1607,5070,1474,4861,82,258,1205,3991,1287,4249
150747,201905,4795,15685,4285,14824,764,2350,2801,10215,3565,12565
150750,201905,3639,11588,3076,10694,223,822,2348,8359,2571,9181
150760,201905,11865,35119,10831,33752,1397,4050,7839,25036,9236,29086
150770,201905,6241,22865,5975,22533,200,664,5473,21197,5673,21861
150775,201905,888,2616,711,2353,134,492,385,1284,519,1776
150780,201905,4532,13700,4098,13171,118,339,3740,12227,3858,12566
150790,201905,5522,16204,4835,15458,212,533,4026,13953,4238,14486
150795,201905,13266,42790,12018,40705,3146,10102,6737,24321,9883,34423
150796,201905,3665,9392,3195,8825,175,456,2700,7526,2875,7982
150797,201905,3908,12346,3385,11560,140,433,2826,9787,2966,10220
150800,201905,13098,41938,12116,40679,1531,4717,9247,32121,10778,36838
150803,201905,6911,22971,6527,22376,367,1280,5575,19209,5942,20489
150805,201905,3402,10729,2900,9948,257,918,2205,7646,2462,8564
150808,201905,6053,17575,4435,14823,1684,6134,611,2280,2295,8414
150810,201905,20643,56270,15837,50358,3183,10177,8399,28996,11582,39173
150812,201905,5413,15578,4798,14486,451,1459,3523,10415,3974,11874
150815,201905,9080,27908,7781,26260,702,2364,6212,21306,6914,23670
150820,201905,11859,32775,10022,30523,1002,2691,7728,24356,8730,27047
150830,201905,11371,43098,10818,42393,391,2006,9439,37560,9830,39566
150835,201905,2165,7413,1908,6934,383,1380,968,3565,1351,4945
150840,201905,7083,20895,5666,18396,1098,3796,2884,9275,3982,13071
160005,201905,1170,3221,1056,3062,34,135,956,2753,990,2888
160010,201905,2442,6294,2324,6170,18,93,2259,5926,2277,6019
160015,201905,2441,7596,2234,7317,76,268,2043,6708,2119,6976
160020,201905,2005,6746,1783,6444,218,807,1364,4985,1582,5792
160021,201905,1087,4279,1012,4172,81,466,808,3244,889,3710
160023,201905,1240,4431,1096,4190,103,368,795,3181,898,3549
160025,201905,1954,5570,1891,5495,13,45,1859,5405,1872,5450
160027,201905,8686,24496,7866,23471,570,1614,6434,19518,7004,21132
160030,201905,63725,187438,52308,172161,11552,36057,28075,101509,39627,137566
160040,201905,5358,18908,4899,18293,107,531,4507,16880,4614,17411
160050,201905,4483,14349,3622,13098,1452,4983,1270,5630,2722,10613
160053,201905,3622,11710,3351,11359,261,849,2767,9588,3028,10437
160055,201905,846,2611,824,2586,28,102,773,2411,801,2513
160060,201905,23230,64396,19386,59940,1056,3351,15514,50021,16570,53372
160070,201905,2874,10936,2595,10478,199,797,2049,8515,2248,9312
160080,201905,3094,10351,2852,10068,61,314,2574,9134,2635,9448
170025,201905,615,1670,453,1430,89,278,238,761,327,1039
170030,201905,1182,3674,918,3166,159,527,443,1585,602,2112
170035,201905,1468,3824,1057,3143,101,332,621,1841,722,2173
170040,201905,1798,5289,1440,4791,111,429,848,2944,959,3373
170070,201905,1777,4234,1252,3567,88,300,738,2133,826,2433
170100,201905,2428,7069,2002,6337,180,536,1305,4204,1485,4740
170105,201905,736,2173,503,1659,128,404,177,583,305,987
170110,201905,928,2930,713,2508,119,459,307,1069,426,1528
170130,201905,1311,4024,933,3271,174,631,442,1605,616,2236
170190,201905,1382,3995,944,3255,331,1145,170,785,501,1930
170200,201905,1802,4524,1105,3339,247,800,321,974,568,1774
170210,201905,24145,67188,18424,57325,6601,22139,1934,7203,8535,29342
170215,201905,1310,3594,1090,3296,55,234,833,2500,888,2734
170220,201905,5844,18319,4930,16595,1255,4001,2208,8055,3463,12056
170230,201905,1273,3842,956,3191,265,902,195,693,460,1595
170240,201905,2643,7498,2027,6508,162,642,1371,4266,1533,4908
170255,201905,3999,11799,2798,9489,521,1837,1242,4330,1763,6167
170270,201905,1000,2462,646,1958,23,79,409,1228,432,1307
170290,201905,2936,8631,2505,8105,119,364,2005,6737,2124,7101
170300,201905,1896,5349,1548,4809,177,578,1030,3239,1207,3817
170305,201905,697,1989,548,1714,68,244,264,800,332,1044
170307,201905,934,3255,754,2883,112,453,411,1596,523,2049
170310,201905,1613,4145,1112,3303,190,617,497,1482,687,2099
170320,201905,1039,2727,771,2302,67,216,490,1473,557,1689
170330,201905,909,2831,814,2678,49,217,654,2091,703,2308
170360,201905,469,1304,326,1053,34,123,197,597,231,720
170370,201905,1288,3485,920,2860,296,884,232,849,528,1733
170380,201905,1768,5241,1315,4519,113,427,727,2581,840,3008
170382,201905,546,1674,441,1485,48,206,300,964,348,1170
170384,201905,1553,5709,1269,5142,294,1238,584,2403,878,3641
170386,201905,861,2378,531,1723,74,286,173,511,247,797
170388,201905,628,1810,447,1485,63,240,202,670,265,910
170389,201905,1033,3376,883,3116,45,193,690,2464,735,2657
170390,201905,1631,3851,1201,3316,71,177,941,2677,1012,2854
170410,201905,554,1665,399,1364,21,98,260,870,281,968
170460,201905,378,1017,297,879,43,124,180,542,223,666
170510,201905,881,2649,642,2184,52,228,384,1254,436,1482
170550,201905,6498,17719,4678,14641,1288,4335,1022,3403,2310,7738
170555,201905,1323,3730,1036,3264,62,213,550,1795,612,2008
170560,201905,1029,2969,766,2581,78,309,453,1646,531,1955
170600,201905,1334,3684,1072,3290,224,548,610,2049,834,2597
170610,201905,1750,4772,1262,3994,78,284,770,2406,848,2690
170625,201905,434,1205,269,845,30,90,93,283,123,373
170650,201905,1283,3882,996,3383,161,552,504,1788,665,2340
170700,201905,3354,9989,2521,8412,503,1731,1101,3758,1604,5489
170710,201905,1512,4082,1146,3445,172,569,663,1963,835,2532
170720,201905,1838,4690,1461,4129,74,160,1121,3299,1195,3459
170730,201905,1010,2835,740,2388,158,483,326,1120,484,1603
170740,201905,2052,6945,1747,6350,222,856,1164,4220,1386,5076
170755,201905,865,2484,601,1977,60,226,289,914,349,1140
170765,201905,1229,3232,836,2601,179,570,344,1117,523,1687
170770,201905,1790,5355,1497,4872,199,607,959,3215,1158,3822
170820,201905,3402,10738,2811,9622,472,1699,1419,4985,1891,6684
170825,201905,949,2288,767,2030,82,221,531,1413,613,1634
170830,201905,1382,3790,1143,3408,26,100,914,2715,940,2815
170900,201905,2651,8702,2264,8097,191,750,1744,6323,1935,7073
170930,201905,3663,10275,2835,8761,636,2075,1096,3369,1732,5444
170950,201905,11082,31243,7642,24980,2246,8295,988,3467,3234,11762
170980,201905,424,1196,342,1062,17,84,241,697,258,781
171050,201905,1574,5096,1367,4705,54,267,1109,3776,1163,4043
171070,201905,1330,3938,1137,3650,260,817,581,2071,841,2888
171090,201905,1035,2590,834,2297,72,189,579,1608,651,1797
171110,201905,567,1577,404,1267,61,214,189,529,250,743
171150,201905,1068,2709,640,1955,82,281,384,1157,466,1438
171180,201905,759,2130,496,1616,86,263,199,672,285,935
171190,201905,1657,5827,1464,5474,245,971,871,3324,1116,4295
171195,201905,830,2721,685,2442,107,440,408,1422,515,1862
171200,201905,517,1512,389,1279,75,266,172,561,247,827
171215,201905,381,1093,296,938,49,172,173,532,222,704
171240,201905,750,2577,617,2303,40,201,394,1463,434,1664
171245,201905,629,1933,484,1611,50,196,282,894,332,1090
171250,201905,1061,2809,766,2343,139,451,380,1169,519,1620
171270,201905,383,1517,328,1380,72,325,126,574,198,899
171280,201905,846,2590,658,2246,91,293,358,1287,449,1580
171320,201905,3989,11401,3102,9842,610,1937,1251,4160,1861,6097
171330,201905,2677,7412,2057,6350,433,1299,964,3082,1397,4381
171360,201905,1419,4205,1152,3818,86,321,824,2775,910,3096
171370,201905,664,1743,519,1540,58,178,351,1057,409,1235
171380,201905,1503,4288,1254,3912,105,324,881,2799,986,3123
171395,201905,943,2751,640,2137,69,259,354,1154,423,1413
171420,201905,1893,5740,1371,4676,237,898,601,2049,838,2947
171430,201905,1028,3082,852,2729,70,265,571,1767,641,2032
171488,201905,2323,6958,1792,6049,299,1068,873,3023,1172,4091
171500,201905,967,2451,735,2084,43,126,544,1542,587,1668
171510,201905,759,2610,669,2426,45,205,462,1664,507,1869
171515,201905,468,1270,340,1053,37,156,200,580,237,736
171525,201905,653,1933,515,1688,37,160,312,951,349,1111
171550,201905,335,1005,238,834,35,153,129,430,164,583
171570,201905,1106,3403,925,3062,162,527,522,1787,684,2314
171575,201905,1812,4854,1133,3599,155,521,487,1518,642,2039
171610,201905,5704,16282,4267,13819,967,3454,1174,4027,2141,7481
171620,201905,2663,7627,2244,7007,128,496,1768,5516,1896,6012
171630,201905,950,2633,769,2375,124,383,497,1585,621,1968
171650,201905,2074,6067,1556,5109,398,1392,481,1687,879,3079
171660,201905,2323,6031,1600,4780,247,727,820,2472,1067,3199
171665,201905,1336,3805,1004,3252,161,614,473,1546,634,2160
171670,201905,1823,4979,1403,4282,208,714,784,2348,992,3062
171700,201905,1203,3482,878,2901,109,350,490,1618,599,1968
171720,201905,802,2119,617,1813,58,193,430,1254,488,1447
171750,201905,1248,3570,870,2860,213,716,126,507,339,1223
171780,201905,1211,3155,882,2669,70,247,612,1814,682,2061
171790,201905,1430,4818,1147,4210,238,883,507,1938,745,2821
171800,201905,742,2081,551,1782,67,257,309,994,376,1251
171820,201905,10894,31169,8146,26292,1959,6593,2669,9161,4628,15754
171830,201905,1481,5001,1248,4559,123,558,795,2856,918,3414
171840,201905,747,2021,591,1774,28,80,399,1197,427,1277
171845,201905,627,1615,454,1358,60,225,256,762,316,987
171850,201905,852,2952,728,2667,69,326,516,1820,585,2146
171855,201905,1054,3272,903,2994,74,240,570,1864,644,2104
171865,201905,378,1231,309,1106,50,187,148,504,198,691
171870,201905,775,2214,545,1771,54,180,288,965,342,1145
171875,201905,1242,3751,998,3347,52,230,734,2427,786,2657
171880,201905,1108,3493,988,3326,31,125,799,2723,830,2848
171884,201905,827,2296,601,1930,116,434,221,760,337,1194
171886,201905,1429,4080,1004,3332,292,1045,203,704,495,1749
171888,201905,738,2099,497,1633,36,123,307,999,343,1122
171889,201905,413,1298,350,1183,71,259,151,513,222,772
171890,201905,1140,3197,846,2720,180,535,455,1517,635,2052
171900,201905,511,1795,357,1393,82,322,133,542,215,864
172000,201905,573,1788,478,1595,48,198,282,899,330,1097
172010,201905,1030,3619,879,3295,83,394,543,1950,626,2344
172015,201905,356,1271,265,1076,65,250,106,467,171,717
172020,201905,2450,7338,2200,7001,169,658,1653,5318,1822,5976
172025,201905,745,2071,538,1724,42,162,353,1121,395,1283
172030,201905,1225,3679,1049,3404,33,147,843,2721,876,2868
172049,201905,1279,3153,864,2552,208,604,448,1395,656,1999
172065,201905,1477,3699,1159,3313,103,216,947,2865,1050,3081
172080,201905,2276,6933,1850,6140,124,479,1221,4044,1345,4523
172085,201905,477,1331,308,964,55,164,108,318,163,482
172090,201905,3941,10211,3027,8976,134,473,2281,6768,2415,7241
172093,201905,485,1451,351,1204,35,142,188,622,223,764
172097,201905,594,1613,426,1324,56,174,208,664,264,838
172100,201905,48725,123171,32925,97087,6545,21218,10684,32358,17229,53576
172110,201905,1600,5973,1385,5626,163,679,999,4262,1162,4941
172120,201905,4800,14547,3801,12892,558,1898,2072,7299,2630,9197
172125,201905,296,838,218,703,22,77,118,372,140,449
172130,201905,698,1886,575,1687,26,93,417,1181,443,1274
172208,201905,2460,6253,1981,5608,197,501,1374,3982,1571,4483
172210,201905,2727,7262,2075,6412,418,1343,1088,3480,1506,4823
210005,201905,19324,57013,15165,50119,4479,15367,5750,19820,10229,35187
210010,201905,1893,5939,1714,5687,62,281,1465,4892,1527,5173
210015,201905,3350,10098,2980,9593,123,330,2565,8404,2688,8734
210020,201905,7468,17215,6509,16101,85,233,6040,14944,6125,15177
210030,201905,4734,15916,4453,15503,198,964,3871,13374,4069,14338
210040,201905,1893,4686,1713,4468,29,51,1595,4213,1624,4264
210043,201905,6401,18006,5286,16555,565,1731,3899,12573,4464,14304
210047,201905,6595,21318,5545,19819,177,886,4786,17023,4963,17909
210050,201905,2260,7755,1775,6852,198,870,1178,4520,1376,5390
210055,201905,1841,6039,1686,5777,63,263,1416,4823,1479,5086
210060,201905,7027,26413,6260,24976,779,3233,4323,17760,5102,20993
210070,201905,7214,20569,6810,20079,40,147,6510,19291,6550,19438
210080,201905,4068,14040,3900,13844,41,248,3675,13100,3716,13348
210083,201905,5553,16175,4637,15198,64,342,4370,14258,4434,14600
210087,201905,2977,8278,2618,7801,120,298,2222,6805,2342,7103
210090,201905,9460,29708,8873,28679,366,1231,7736,24936,8102,26167
210095,201905,6288,20657,5821,20087,250,1064,4886,17330,5136,18394
210100,201905,6784,20675,6148,19675,294,1052,5073,16229,5367,17281
210110,201905,2989,10328,2786,10065,54,353,2568,9185,2622,9538
210120,201905,22730,63533,19158,58850,2201,5766,12881,41919,15082,47685
210125,201905,4220,11810,3769,11237,759,1820,2670,8527,3429,10347
210130,201905,4289,11571,3578,10648,150,374,3045,9116,3195,9490
210135,201905,1454,4440,1271,4141,59,206,1033,3394,1092,3600
210140,201905,17492,48515,13714,43533,2688,8383,7654,25377,10342,33760
210150,201905,4486,10987,3984,10276,118,331,3484,8870,3602,9201
210160,201905,16361,49015,14404,46403,1329,4473,10264,34084,11593,38557
210170,201905,14754,47186,13793,45897,683,2292,12135,40464,12818,42756
210173,201905,2296,8698,2108,8360,66,427,1889,7459,1955,7886
210177,201905,3329,9377,2990,8954,108,200,2693,8341,2801,8541
210180,201905,1461,4022,1297,3806,33,95,1162,3397,1195,3492
210190,201905,4980,14323,4386,13431,97,485,3718,11130,3815,11615
210193,201905,1252,3790,1119,3578,38,141,895,2908,933,3049
210197,201905,1976,6471,1843,6273,159,544,1482,5142,1641,5686
210200,201905,7485,24592,6820,23500,576,2080,5411,18761,5987,20841
210203,201905,6965,20947,6098,19762,510,1691,4878,16056,5388,17747
210207,201905,3384,9373,2980,8874,149,375,2469,7531,2618,7906
210210,201905,8188,26786,7616,26014,126,748,6977,23731,7103,24479
210215,201905,2221,7361,2017,7057,63,322,1787,6223,1850,6545
210220,201905,6097,21242,5790,20757,230,1383,5009,17531,5239,18914
210230,201905,5147,15847,4677,15142,323,868,3990,13162,4313,14030
210232,201905,11391,36437,9455,33551,1521,5501,6040,22754,7561,28255
210235,201905,3466,10366,3037,9786,75,342,2681,8645,2756,8987
210237,201905,2549,8869,2327,8582,32,185,2159,7970,2191,8155
210240,201905,2667,8487,2455,8117,88,369,2125,6945,2213,7314
210250,201905,5524,17109,5064,16529,77,441,4520,14715,4597,15156
210255,201905,2514,7829,2142,7126,237,798,1433,4732,1670,5530
210260,201905,5402,16547,4789,15625,253,959,4036,13118,4289,14077
210270,201905,4764,13440,4276,12798,94,479,3831,11349,3925,11828
210275,201905,3584,9055,3195,8576,47,111,2941,7988,2988,8099
210280,201905,5491,16053,4434,14374,286,1244,3172,10031,3458,11275
210290,201905,6908,19509,6272,18704,144,443,5683,16962,5827,17405
210300,201905,33335,91460,27542,83456,1821,5640,20439,64279,22260,69919
210310,201905,3025,7912,2677,7400,124,300,2319,6465,2443,6765
210312,201905,2627,6946,2321,6598,47,196,2134,5990,2181,6186
210315,201905,3009,8443,2560,7919,76,201,2309,7307,2385,7508
210317,201905,4112,13140,3768,12736,123,621,3378,11335,3501,11956
210320,201905,18793,58352,17273,56315,472,2285,15208,49287,15680,51572
210325,201905,3438,10146,3032,9603,89,313,2715,8704,2804,9017
210330,201905,23928,70927,20553,66201,5764,17014,10265,37466,16029,54480
210340,201905,9862,30179,8942,28801,766,2542,6843,22447,7609,24989
210350,201905,9373,27353,8251,25957,179,692,7241,22882,7420,23574
210355,201905,4307,14909,3813,14123,124,642,3252,12101,3376,12743
210360,201905,13480,42399,12133,40439,513,2417,9744,31998,10257,34415
210370,201905,10514,24082,8296,21723,249,466,7553,20214,7802,20680
210375,201905,3234,8727,2448,7676,610,1930,1174,4049,1784,5979
210380,201905,5500,14401,4822,13566,238,607,4093,11581,4331,12188
210390,201905,2538,9247,2378,8942,130,636,1959,7301,2089,7937
210400,201905,4423,13927,3994,13386,153,497,3532,11944,3685,12441
210405,201905,7050,19312,5697,17365,1057,3037,3211,10391,4268,13428
210407,201905,1970,6609,1638,5972,89,406,1308,4685,1397,5091
210408,201905,2431,9319,2289,9092,144,733,1837,7320,1981,8053
210409,201905,3748,13129,3451,12719,113,631,2849,10505,2962,11136
210410,201905,3489,10868,2971,9981,213,806,2169,7259,2382,8065
210420,201905,3943,12685,3560,12017,196,606,2987,10186,3183,10792
210430,201905,2269,6652,2050,6377,89,260,1803,5638,1892,5898
210440,201905,4150,11672,3776,11160,69,272,3505,10304,3574,10576
210450,201905,2468,7495,2168,7030,105,392,1788,5772,1893,6164
210455,201905,4159,11108,3181,9856,912,2796,1564,5064,2476,7860
210460,201905,3524,10445,3070,9838,84,363,2678,8526,2762,8889
210462,201905,1552,4941,1358,4617,38,175,1096,3699,1134,3874
210465,201905,2602,7716,2288,7273,68,258,1983,6301,2051,6559
210467,201905,5636,18799,5110,18098,291,1213,4365,15549,4656,16762
210470,201905,2101,5514,1442,4563,86,203,1079,3545,1165,3748
210480,201905,15727,47526,13251,44401,1233,3816,9753,34741,10986,38557
210490,201905,3720,9519,3032,8540,81,245,2617,7363,2698,7608
210500,201905,6144,24372,5768,23699,365,1918,4698,19066,5063,20984
210510,201905,6021,20402,5397,19702,122,597,4817,17797,4939,18394
210515,201905,3749,10997,3274,10471,113,405,2873,9260,2986,9665
210520,201905,2478,7195,2249,6903,82,306,1983,6019,2065,6325
210530,201905,54000,132380,42555,115368,6846,23401,11470,39782,18316,63183
210535,201905,3086,10556,2874,10223,108,438,2425,8696,2533,9134
210540,201905,14306,42290,12056,39198,1433,4426,8506,28736,9939,33162
210542,201905,6306,15296,5200,14055,392,691,4324,12440,4716,13131
210545,201905,2222,7011,2095,6794,51,216,1841,5888,1892,6104
210547,201905,3536,12734,3127,11924,294,1127,2274,8910,2568,10037
210550,201905,6147,18687,4977,16881,339,1281,3748,13013,4087,14294
210560,201905,3466,10787,3135,10240,116,407,2647,8591,2763,8998
210565,201905,1461,4975,1226,4611,67,343,958,3656,1025,3999
210570,201905,10731,29615,9596,28243,306,918,8560,25526,8866,26444
210580,201905,2964,8196,2547,7697,190,359,2058,6541,2248,6900
210590,201905,4269,12979,3750,12278,89,467,3313,10774,3402,11241
210592,201905,2572,7657,2410,7394,32,149,2148,6535,2180,6684
210594,201905,2550,6933,1971,6040,86,232,1474,4659,1560,4891
210596,201905,2455,8843,2211,8336,146,615,1750,6645,1896,7260
210598,201905,1878,5426,1726,5204,33,145,1570,4702,1603,4847
210600,201905,3006,8204,2435,7373,79,207,1981,6115,2060,6322
210610,201905,2583,7550,2254,7141,69,333,1931,6058,2000,6391
210620,201905,2580,7239,2202,6779,48,147,2010,6305,2058,6452
210630,201905,3057,10460,2785,10023,144,731,2278,8048,2422,8779
210632,201905,4320,14208,3873,13554,274,1181,3017,10441,3291,11622
210635,201905,1783,6361,1685,6185,141,503,1371,5148,1512,5651
210637,201905,2285,7861,2054,7514,161,719,1541,5667,1702,6386
210640,201905,4579,16384,4354,16113,50,278,4117,15191,4167,15469
210650,201905,7277,20909,6668,20120,82,368,6187,18671,6269,19039
210660,201905,8218,24231,7284,22745,304,1165,6266,19342,6570,20507
210663,201905,2566,7697,2409,7514,114,282,2100,6727,2214,7009
210667,201905,1885,6216,1762,6033,51,212,1588,5472,1639,5684
210670,201905,4471,15459,4130,14902,139,695,3552,12713,3691,13408
210675,201905,5001,13772,4352,12893,240,601,3629,11004,3869,11605
210680,201905,4169,10723,3537,9939,127,233,3135,9027,3262,9260
210690,201905,7384,23668,6557,22710,267,1224,5735,19916,6002,21140
210700,201905,2715,7456,2215,6802,144,398,1721,5573,1865,5971
210710,201905,5028,15772,4434,14898,121,631,3873,12871,3994,13502
210720,201905,2824,9477,2633,9237,52,300,2379,8296,2431,8596
210725,201905,1343,4569,1154,4270,46,206,805,3075,851,3281
210730,201905,1201,3246,1008,2977,70,184,798,2379,868,2563
210735,201905,4596,13882,3955,13000,275,914,3297,11047,3572,11961
210740,201905,5284,14390,4650,13683,122,438,3856,11269,3978,11707
210745,201905,4472,12412,4153,11989,141,390,3753,10864,3894,11254
210750,201905,22291,57050,19530,53639,1514,4047,13742,39631,15256,43678
210760,201905,5792,15588,5076,14817,28,87,4832,14194,4860,14281
210770,201905,6050,15828,5237,14898,51,221,4904,13908,4955,14129
210780,201905,7087,23350,6348,22076,571,1839,4959,17602,5530,19441
210790,201905,4400,13898,4035,13425,221,655,3217,11302,3438,11957
210800,201905,4951,13294,4264,12375,64,266,3845,11006,3909,11272
210805,201905,3889,14417,3745,14202,115,636,3327,12529,3442,13165
210810,201905,4910,14582,4499,14047,218,506,3851,12379,4069,12885
210820,201905,6989,20201,5919,18458,761,2387,3660,11660,4421,14047
210825,201905,6669,20868,6139,20172,238,836,5332,17707,5570,18543
210830,201905,7553,21846,7080,21263,431,996,6092,18824,6523,19820
210840,201905,3196,8582,2883,8152,88,290,2515,6997,2603,7287
210845,201905,6412,17580,5844,16948,27,87,5678,16511,5705,16598
210850,201905,5817,20154,5018,18924,277,1356,3912,14749,4189,16105
210860,201905,20111,53242,17045,49323,761,2059,13858,41846,14619,43905
210870,201905,6782,18738,5792,17559,232,706,5029,15280,5261,15986
210880,201905,4385,13527,3968,13045,228,871,3265,10720,3493,11591
210890,201905,3992,12046,3619,11597,228,602,2983,9846,3211,10448
210900,201905,4544,13435,3505,11537,1406,4909,583,2146,1989,7055
210905,201905,1924,5438,1628,5040,51,109,1467,4637,1518,4746
210910,201905,7213,22173,6154,20473,815,2797,4087,13642,4902,16439
210920,201905,3262,10790,2847,10233,82,457,2533,9014,2615,9471
210923,201905,1426,4488,1271,4234,61,239,963,3206,1024,3445
210927,201905,5202,16459,4600,15772,187,693,3958,13800,4145,14493
210930,201905,2450,8591,2211,8153,156,718,1708,6224,1864,6942
210940,201905,3959,11435,3729,11149,125,507,3386,9981,3511,10488
210945,201905,6067,18096,5582,17514,245,750,4803,15287,5048,16037
210950,201905,5073,14735,3968,13117,605,1671,2632,9294,3237,10965
210955,201905,1545,5017,1373,4719,142,482,984,3446,1126,3928
210960,201905,8782,26787,7737,25227,1290,3834,4990,17171,6280,21005
210970,201905,1259,3986,1022,3580,61,276,771,2624,832,2900
210975,201905,1665,5397,1499,5111,98,348,1187,4061,1285,4409
210980,201905,10120,23318,8894,22057,104,216,8439,21060,8543,21276
210990,201905,15251,44435,12317,40537,853,3075,9300,30993,10153,34068
211000,201905,14197,43099,12229,40793,606,2445,10031,34154,10637,36599
211003,201905,5406,16761,4621,15793,137,522,3996,13971,4133,14493
211010,201905,6266,22727,5689,21987,80,485,5151,20079,5231,20564
211020,201905,7654,23821,7065,23111,260,1083,6118,20060,6378,21143
211023,201905,1982,6624,1892,6496,95,397,1596,5423,1691,5820
211027,201905,2905,9574,2809,9414,175,647,2447,8119,2622,8766
211030,201905,3840,10768,3456,10300,242,555,2819,8647,3061,9202
211040,201905,4525,16550,4233,16046,132,779,3744,14048,3876,14827
211050,201905,9195,23828,8397,22810,151,406,7738,21027,7889,21433
211060,201905,6850,21359,6349,20678,153,610,5832,18990,5985,19600
211065,201905,2127,6086,1788,5627,87,282,1479,4741,1566,5023
211070,201905,7245,24085,6339,22644,503,1839,4957,17865,5460,19704
211080,201905,1282,3621,1028,3218,36,203,792,2333,828,2536
211085,201905,1966,5786,1714,5439,91,244,1487,4814,1578,5058
211090,201905,3217,8948,2896,8538,38,198,2638,7699,2676,7897
211100,201905,6618,17019,6160,16446,45,151,5655,15155,5700,15306
211102,201905,2944,10473,2730,10146,147,722,2342,8602,2489,9324
211105,201905,2335,7540,1955,6811,188,682,1368,4730,1556,5412
211107,201905,4463,14309,3868,13419,149,617,3153,11177,3302,11794
211110,201905,5883,16484,4593,14504,457,1331,3263,10541,3720,11872
211120,201905,41272,106278,36749,101032,4822,12308,23842,70127,28664,82435
211125,201905,2011,6101,1709,5629,48,189,1429,4715,1477,4904
211130,201905,192659,466980,174777,444281,25326,64911,75717,220871,101043,285782
211140,201905,4913,14880,4348,14106,199,630,3703,12034,3902,12664
211150,201905,9313,26000,8029,24307,332,1031,6753,20559,7085,21590
211153,201905,2530,7461,2046,6857,288,1025,1361,4754,1649,5779
211157,201905,1076,3450,898,3131,35,191,647,2228,682,2419
211160,201905,3892,11510,3135,10335,162,686,2337,7559,2499,8245
211163,201905,1716,5469,1577,5270,27,125,1434,4864,1461,4989
211167,201905,1552,5000,1452,4839,34,160,1329,4389,1363,4549
211170,201905,6300,15711,5938,15289,46,165,5650,14483,5696,14648
211172,201905,2410,6731,2081,6217,92,301,1709,4971,1801,5272
211174,201905,2788,8331,2566,8059,60,304,2323,7242,2383,7546
211176,201905,4236,12334,3306,10969,181,742,2597,8570,2778,9312
211178,201905,4642,10899,4014,10199,35,143,3776,9503,3811,9646
211180,201905,3941,13279,3664,12858,193,795,3125,10943,3318,11738
211190,201905,3021,9082,2609,8446,41,221,2250,7210,2291,7431
211195,201905,1331,3890,1147,3609,48,126,969,3115,1017,3241
211200,201905,2102,6202,1709,5680,197,673,1188,4019,1385,4692
211210,201905,6437,19727,5855,18956,274,1034,5041,16262,5315,17296
211220,201905,35262,91869,29352,84533,2835,7993,21593,63649,24428,71642
211223,201905,4872,13497,4265,12636,452,1296,3137,9411,3589,10707
211227,201905,1737,5879,1585,5653,41,208,1387,5000,1428,5208
211230,201905,7088,21597,6348,20432,403,1227,5114,16640,5517,17867
211240,201905,8120,26242,7646,25616,157,861,6981,23128,7138,23989
211245,201905,6621,17159,6214,16742,79,216,6039,16282,6118,16498
211250,201905,13221,40529,12043,39078,477,2092,10205,32664,10682,34756
211260,201905,7744,25547,7093,24651,204,943,6383,22256,6587,23199
211270,201905,10254,33422,8991,31672,387,1815,7399,26103,7786,27918
211280,201905,12786,36224,11456,34540,966,2387,9165,28840,10131,31227
211285,201905,1712,5864,1511,5551,186,733,967,3634,1153,4367
211290,201905,7204,22439,6674,21682,173,783,5755,18562,5928,19345
211300,201905,7942,22707,7183,21687,141,496,6540,19677,6681,20173
211400,201905,11132,32858,9223,30144,1248,4112,6004,20597,7252,24709
220005,201905,1802,4881,1643,4645,40,159,1360,3767,1400,3926
220010,201905,1470,4214,1232,3793,32,133,955,2896,987,3029
220020,201905,3392,9910,2997,9290,213,750,2343,7152,2556,7902
220025,201905,2197,5064,1875,4570,25,67,1578,3740,1603,3807
220027,201905,1231,3198,1066,2981,26,91,882,2413,908,2504
220030,201905,3284,8543,3112,8299,92,272,2731,7158,2823,7430
220040,201905,6833,21017,6111,19648,1264,3783,3578,11928,4842,15711
220045,201905,1459,4535,1223,4120,37,191,982,3239,1019,3430
220050,201905,4539,12757,3882,11817,88,418,3493,10470,3581,10888
220060,201905,2377,5071,2007,4644,23,57,1880,4327,1903,4384
220070,201905,2483,6382,2131,5867,80,180,1743,4797,1823,4977
220080,201905,700,1985,600,1835,30,127,514,1530,544,1657
220090,201905,1775,4338,1471,3919,21,79,1236,3375,1257,3454
220095,201905,636,1650,602,1612,17,29,549,1477,566,1506
220100,201905,1370,3843,1112,3409,48,183,881,2620,929,2803
220105,201905,1997,6307,1742,5774,148,489,1307,4357,1455,4846
220110,201905,3392,9442,3175,9038,47,233,2828,7920,2875,8153
220115,201905,2649,7962,2454,7669,67,282,2207,6781,2274,7063
220117,201905,1345,3296,1042,2866,14,57,885,2390,899,2447
220120,201905,12217,34055,11232,32815,102,405,10520,30676,10622,31081
220130,201905,1087,3017,911,2771,12,85,817,2427,829,2512
220140,201905,1976,4274,1708,3948,139,377,1449,3271,1588,3648
220150,201905,6370,19100,5945,18413,140,686,5020,15197,5160,15883
220155,201905,1097,3234,874,2814,27,108,621,1962,648,2070
220157,201905,1031,2565,876,2319,17,79,704,1790,721,1869
220160,201905,2725,7763,2356,7092,42,214,1951,5723,1993,5937
220170,201905,1460,3929,1241,3598,11,60,1097,3140,1108,3200
220173,201905,2017,5744,1631,5030,42,186,1309,3941,1351,4127
220177,201905,1938,5586,1858,5491,15,52,1818,5376,1833,5428
220180,201905,1113,2828,902,2452,5,27,677,1723,682,1750
220190,201905,6295,16754,5333,15399,392,1273,3989,11445,4381,12718
220191,201905,1398,4439,1285,4234,76,298,944,3035,1020,3333
220192,201905,1839,4994,1444,4292,28,105,1169,3399,1197,3504
220194,201905,1679,4859,1504,4572,66,276,1242,3681,1308,3957
220196,201905,1912,5189,1737,4906,30,137,1476,4069,1506,4206
220198,201905,1288,3531,1071,3251,9,28,988,3027,997,3055
220200,201905,4912,14562,4358,13820,199,742,3588,11382,3787,12124
220202,201905,2188,6198,1871,5662,28,150,1588,4714,1616,4864
220205,201905,2515,7163,2256,6732,55,241,1904,5553,1959,5794
220207,201905,766,2328,636,2098,55,202,412,1354,467,1556
220208,201905,1662,5229,1357,4624,214,781,719,2404,933,3185
220209,201905,1571,4555,1369,4201,24,126,1108,3352,1132,3478
220210,201905,1573,4093,1374,3760,14,63,1145,3056,1159,3119
220211,201905,1560,4075,1442,3911,17,65,1270,3463,1287,3528
220213,201905,1741,4735,1510,4302,29,110,1217,3362,1246,3472
220217,201905,2059,6260,1947,6137,31,104,1822,5794,1853,5898
220220,201905,10158,27086,8477,24423,527,1381,5974,17716,6501,19097
220225,201905,1069,2813,869,2556,9,45,789,2293,798,2338
220230,201905,5761,14296,4973,13210,196,496,4256,11318,4452,11814
220240,201905,2869,8499,2643,8064,103,342,2145,6540,2248,6882
220245,201905,1617,4000,1296,3589,10,52,1180,3293,1190,3345
220250,201905,2942,8298,2572,7818,22,121,2365,7146,2387,7267
220253,201905,1622,4458,1398,4064,84,279,1145,3228,1229,3507
220255,201905,1814,4508,1548,4106,45,203,1265,3192,1310,3395
220260,201905,4173,13098,3680,12236,160,628,2949,9746,3109,10374
220265,201905,1185,3947,1096,3805,52,226,897,3058,949,3284
220270,201905,6340,20065,5951,19339,245,1126,4958,15557,5203,16683
220271,201905,1449,3761,1261,3497,30,108,1112,3074,1142,3182
220272,201905,1727,4970,1541,4625,69,214,1140,3326,1209,3540
220273,201905,1214,3496,1006,3110,39,156,766,2310,805,2466
220275,201905,2207,5394,1742,4747,31,106,1517,4135,1548,4241
220277,201905,2110,5433,1835,5004,35,123,1554,4141,1589,4264
220280,201905,1608,3873,1322,3482,27,96,1132,2909,1159,3005
220285,201905,1432,3732,1209,3449,14,68,1081,3046,1095,3114
220290,201905,6003,17742,4840,16095,370,1350,3526,11910,3896,13260
220300,201905,1963,5821,1611,5338,40,241,1327,4317,1367,4558
220310,201905,2976,8188,2346,7458,52,252,1943,6112,1995,6364
220320,201905,3008,8992,2324,7665,107,477,1757,5610,1864,6087
220323,201905,1613,4909,1295,4373,60,263,1063,3510,1123,3773
220325,201905,1279,3773,1089,3446,28,127,903,2801,931,2928
220327,201905,1450,4248,1289,3976,46,206,1053,3170,1099,3376
220330,201905,4257,10470,3533,9560,85,266,3087,8237,3172,8503
220335,201905,1740,5219,1555,4995,22,81,1410,4523,1432,4604
220340,201905,1828,4853,1429,4187,46,157,999,2810,1045,2967
220342,201905,1165,3466,1029,3254,51,245,799,2463,850,2708
220345,201905,3085,7063,2451,6144,17,53,2232,5575,2249,5628
220350,201905,3268,8512,2633,7537,132,410,1921,5464,2053,5874
220360,201905,1222,3148,969,2744,20,66,780,2188,800,2254
220370,201905,8727,25129,7939,23930,183,763,6954,20712,7137,21475
220375,201905,1546,4518,1388,4319,8,37,1319,4123,1327,4160
220380,201905,1506,3657,1238,3267,20,53,1070,2784,1090,2837
220385,201905,828,2008,659,1705,9,30,564,1437,573,1467
220390,201905,8663,24125,6998,21360,1837,5493,2916,9581,4753,15074
220400,201905,1489,3615,1128,3061,22,77,866,2285,888,2362
220410,201905,1138,3149,928,2800,43,131,748,2211,791,2342
220415,201905,808,2125,679,1914,16,50,528,1464,544,1514
220420,201905,1959,5455,1596,4770,53,162,1232,3624,1285,3786
220430,201905,2491,6782,2368,6601,84,269,2053,5628,2137,5897
220435,201905,1684,4485,1469,4155,53,178,1176,3242,1229,3420
220440,201905,2357,7545,2052,7044,106,447,1685,5698,1791,6145
220450,201905,2376,6363,1960,5833,115,411,1586,4703,1701,5114
220455,201905,1308,4035,1241,3946,22,105,1105,3503,1127,3608
220460,201905,931,2339,867,2263,24,83,755,1929,779,2012
220465,201905,2324,7311,2055,6884,165,580,1529,5199,1694,5779
220470,201905,3399,9658,3049,9080,80,261,2473,7245,2553,7506
220480,201905,2534,6716,2024,5870,160,414,1428,4097,1588,4511
220490,201905,2378,6211,2128,5876,39,173,1884,5123,1923,5296
220500,201905,2557,6830,2334,6478,44,173,1946,5222,1990,5395
220510,201905,2476,7096,1987,6230,87,266,1551,4857,1638,5123
220515,201905,1628,3973,1489,3780,32,69,1303,3297,1335,3366
220520,201905,4908,12802,4406,12082,100,314,3867,10521,3967,10835
220525,201905,1283,3337,1145,3151,19,85,1031,2786,1050,2871
220527,201905,1325,3709,1139,3425,18,66,971,2962,989,3028
220530,201905,1365,3495,1185,3260,25,88,1096,2971,1121,3059
220535,201905,796,2246,740,2174,42,166,597,1718,639,1884
220540,201905,3269,10430,3077,10072,109,423,2632,8545,2741,8968
220545,201905,1353,4246,1259,4085,79,319,1038,3301,1117,3620
220550,201905,8581,26522,7705,25053,553,1980,5799,18637,6352,20617
220551,201905,1420,4123,1243,3810,33,134,996,2993,1029,3127
220552,201905,1582,4621,1290,4076,41,194,1017,3103,1058,3297
220553,201905,1555,4267,1370,4010,52,120,1096,3301,1148,3421
220554,201905,866,2302,626,1896,47,106,415,1254,462,1360
220555,201905,2090,6575,1947,6341,51,236,1568,5219,1619,5455
220556,201905,1211,3584,1046,3240,56,228,744,2191,800,2419
220557,201905,1592,4856,1347,4372,70,272,981,3079,1051,3351
220558,201905,1398,3672,1090,3233,21,96,920,2696,941,2792
220559,201905,1585,4128,1339,3739,5,29,1083,3062,1088,3091
220560,201905,1755,4003,1407,3547,31,65,1263,3188,1294,3253
220570,201905,7092,21522,6480,20646,438,1460,5157,16392,5595,17852
220580,201905,6847,19175,6323,18309,111,421,5677,16252,5788,16673
220585,201905,1899,6182,1671,5747,49,185,1367,4725,1416,4910
220590,201905,1295,3591,1072,3247,92,283,755,2289,847,2572
220595,201905,2465,6812,2248,6515,19,89,2023,5806,2042,5895
220600,201905,1395,3139,1169,2852,108,156,955,2410,1063,2566
220605,201905,1645,4794,1390,4346,22,121,1102,3343,1124,3464
220610,201905,2786,8583,2611,8338,31,134,2418,7728,2449,7862
220620,201905,7899,24660,7307,23859,220,1104,6557,21114,6777,22218
220630,201905,359,1076,278,928,26,87,174,591,200,678
220635,201905,1612,5166,1431,4767,59,254,1081,3522,1140,3776
220640,201905,2564,7080,2200,6543,86,333,1776,5219,1862,5552
220650,201905,2030,5671,1751,5224,37,142,1391,4135,1428,4277
220660,201905,2615,8255,2280,7678,96,471,1844,6040,1940,6511
220665,201905,1258,3855,1079,3560,34,169,874,2827,908,2996
220667,201905,1607,5068,1433,4736,72,274,1142,3751,1214,4025
220669,201905,1649,5088,1584,4977,78,350,1349,4128,1427,4478
220670,201905,2194,5806,1763,5201,28,97,1511,4442,1539,4539
220672,201905,3136,7759,2542,7040,129,376,2200,6050,2329,6426
220675,201905,1211,3330,1106,3140,40,125,895,2518,935,2643
220680,201905,2650,7344,2521,7154,105,262,2279,6489,2384,6751
220690,201905,1484,3964,1323,3724,85,215,1039,2946,1124,3161
220695,201905,859,2439,805,2335,18,66,690,1988,708,2054
220700,201905,9404,23713,7476,20989,353,1052,5714,15880,6067,16932
220710,201905,874,2461,659,2045,28,104,492,1490,520,1594
220720,201905,2119,5038,1904,4738,21,82,1625,3978,1646,4060
220730,201905,1264,3608,1086,3322,20,104,927,2764,947,2868
220735,201905,956,2272,735,1915,21,69,608,1520,629,1589
220740,201905,1364,3725,1093,3368,37,107,914,2848,951,2955
220750,201905,3741,9750,3320,9138,231,532,2844,7902,3075,8434
220755,201905,1216,3078,1014,2758,30,113,805,2100,835,2213
220760,201905,3009,8682,2648,8178,105,348,2290,7149,2395,7497
220770,201905,20985,64537,17894,59077,5940,20365,6323,21594,12263,41959
220775,201905,1096,2899,1021,2805,13,54,983,2685,996,2739
220777,201905,1649,4212,1250,3571,34,84,933,2650,967,2734
220779,201905,1322,3270,1164,3048,27,86,1011,2623,1038,2709
220780,201905,5477,14102,4803,13024,198,650,3958,10423,4156,11073
220785,201905,1465,3263,1300,3040,9,20,1252,2916,1261,2936
220790,201905,9927,28701,8992,27345,259,1218,7542,22538,7801,23756
220793,201905,872,2329,712,2050,17,42,576,1685,593,1727
220795,201905,1369,3607,1231,3431,26,97,1073,2967,1099,3064
220800,201905,16912,39683,14268,35926,722,1835,10698,26653,11420,28488
220810,201905,2951,8337,2516,7545,51,191,2085,6140,2136,6331
220820,201905,5087,13213,4361,12201,385,942,3212,9041,3597,9983
220830,201905,7132,19218,6437,18214,254,848,5394,15078,5648,15926
220840,201905,11956,37016,10110,33185,2385,7431,4804,16454,7189,23885
220850,201905,3127,9723,2785,9287,67,353,2426,8042,2493,8395
220855,201905,621,1663,546,1540,11,50,480,1329,491,1379
220860,201905,1006,2522,865,2294,20,77,770,2015,790,2092
220865,201905,2515,6686,1957,5725,67,235,1497,4276,1564,4511
220870,201905,2866,8223,2387,7577,35,174,2169,6840,2204,7014
220880,201905,5251,12592,4570,11748,83,287,4198,10662,4281,10949
220885,201905,1355,4270,1126,3885,51,235,901,3108,952,3343
220887,201905,1497,3322,1241,2981,7,25,1159,2750,1166,2775
220890,201905,1427,4503,1231,4164,60,222,990,3352,1050,3574
220900,201905,1998,4865,1677,4428,35,81,1456,3811,1491,3892
220910,201905,1475,4141,1256,3812,44,156,1051,3170,1095,3326
220915,201905,950,2593,755,2209,8,32,586,1661,594,1693
220920,201905,1338,4447,1159,4196,71,314,930,3350,1001,3664
220930,201905,1623,4551,1419,4235,26,97,1296,3826,1322,3923
220935,201905,1053,3020,853,2607,27,104,571,1653,598,1757
220937,201905,1343,3652,1164,3368,21,84,951,2699,972,2783
220940,201905,1458,4204,1170,3658,40,152,879,2696,919,2848
220945,201905,429,1490,375,1374,18,100,278,988,296,1088
220950,201905,1409,3298,913,2506,15,53,713,1891,728,1944
220955,201905,1568,4096,1333,3683,40,118,1104,3016,1144,3134
220960,201905,828,2104,631,1783,9,41,478,1294,487,1335
220965,201905,1759,4863,1534,4534,21,131,1318,3800,1339,3931
220970,201905,1849,4623,1385,3900,39,115,1129,3135,1168,3250
220975,201905,689,2095,603,1991,22,141,526,1648,548,1789
220980,201905,1152,3283,1027,3107,32,144,864,2567,896,2711
220985,201905,1180,3220,1049,3027,45,157,831,2297,876,2454
220987,201905,1472,4390,1270,4035,59,248,1018,3171,1077,3419
220990,201905,1709,4737,1495,4414,24,137,1235,3556,1259,3693
220995,201905,1125,3390,899,2983,49,192,648,2134,697,2326
220997,201905,2415,7132,2220,6839,47,222,1991,6049,2038,6271
221000,201905,4150,11694,3810,11209,90,452,3269,9424,3359,9876
221005,201905,1456,3906,1334,3699,39,177,1139,3023,1178,3200
221010,201905,1182,2804,964,2523,30,80,830,2126,860,2206
221020,201905,1523,4670,1406,4439,25,107,1062,3310,1087,3417
221030,201905,1588,4104,1361,3810,30,112,1186,3312,1216,3424
221035,201905,1441,3785,1251,3526,22,40,1096,3177,1118,3217
221037,201905,622,1793,522,1615,10,56,352,1036,362,1092
221038,201905,506,1457,410,1271,17,62,282,862,299,924
221039,201905,862,2354,752,2160,19,81,616,1694,635,1775
221040,201905,3999,12097,3525,11241,158,583,2786,8834,2944,9417
221050,201905,3767,10099,3345,9543,53,226,3029,8554,3082,8780
221060,201905,8372,23273,6905,20989,231,677,5567,16996,5798,17673
221062,201905,1162,3818,985,3498,43,216,790,2755,833,2971
221063,201905,1077,3077,912,2837,68,240,664,2012,732,2252
221065,201905,2600,6760,2284,6199,24,109,1998,5310,2022,5419
221070,201905,3255,10352,2749,9316,299,1012,1743,6018,2042,7030
221080,201905,3492,8580,2834,7600,54,213,2338,6155,2392,6368
221090,201905,1389,3663,1136,3219,13,52,969,2667,982,2719
221093,201905,1332,3785,1233,3571,124,364,850,2420,974,2784
221095,201905,887,2321,742,2096,8,25,607,1683,615,1708
221097,201905,814,2154,624,1807,20,69,460,1265,480,1334
221100,201905,104839,285406,89543,260190,11487,35170,57377,162876,68864,198046
221110,201905,9777,29389,9017,28411,184,974,8036,24930,8220,25904
221120,201905,4599,13052,4140,12273,191,627,3516,10336,3707,10963
221130,201905,5004,13333,3737,10818,818,2256,1752,5123,2570,7379
221135,201905,1570,4303,1410,4083,41,150,1239,3561,1280,3711
221140,201905,1287,3126,1096,2865,10,42,966,2462,976,2504
221150,201905,1094,2709,865,2311,22,98,673,1680,695,1778
221160,201905,757,1902,665,1777,20,36,540,1449,560,1485
221170,201905,972,2851,897,2723,22,71,765,2313,787,2384
230010,201905,3151,8348,2526,7245,78,277,1950,5443,2028,5720
230015,201905,2945,9704,2635,9084,198,795,1830,6237,2028,7032
230020,201905,12962,41164,12243,40002,403,1723,10269,33121,10672,34844
230030,201905,12510,32203,10768,29818,198,647,9446,26055,9644,26702
230040,201905,4449,11633,3729,10434,78,342,3075,8450,3153,8792
230050,201905,2788,8780,2061,7000,346,1140,868,2866,1214,4006
230060,201905,2297,6341,1849,5492,38,174,1483,4302,1521,4476
230070,201905,3823,10497,3139,9122,163,515,2146,6172,2309,6687
230075,201905,9077,29494,8349,28206,364,1843,6795,22361,7159,24204
230080,201905,2970,6280,2270,5402,9,36,2043,4857,2052,4893
230090,201905,4153,10531,3561,9556,150,446,2801,7445,2951,7891
230100,201905,17479,46833,15612,44179,1360,4023,10854,30744,12214,34767
230110,201905,12145,36622,10479,33265,1702,5366,5727,18221,7429,23587
230120,201905,7292,20092,6441,18658,541,1412,4688,13792,5229,15204
230125,201905,3090,8310,2541,7401,82,294,1939,5574,2021,5868
230130,201905,5636,17669,4612,15385,344,1283,3037,9926,3381,11209
230140,201905,3395,10344,2908,9323,118,493,2188,6805,2306,7298
230150,201905,1596,4801,1344,4231,206,553,778,2553,984,3106
230160,201905,6427,17030,5567,15682,145,569,4636,12776,4781,13345
230170,201905,6011,17475,5042,15497,301,951,3641,10972,3942,11923
230180,201905,1634,4572,1388,4082,25,113,1102,3132,1127,3245
230185,201905,4193,12295,3592,11274,277,961,2632,8248,2909,9209
230190,201905,12832,38048,11000,34568,1654,5329,6019,18856,7673,24185
230195,201905,5084,15189,4633,14330,311,1013,3568,10952,3879,11965
230200,201905,4974,13781,4241,12354,151,506,3243,9233,3394,9739
230205,201905,3913,12138,3522,11485,148,636,2701,8626,2849,9262
230210,201905,10209,25130,8688,22977,395,1287,6719,17421,7114,18708
230220,201905,13358,34406,11944,32283,517,1475,9941,26542,10458,28017
230230,201905,6842,20860,6150,19414,411,1343,4497,14071,4908,15414
230240,201905,12417,33617,11029,31350,309,1135,9132,25538,9441,26673
230250,201905,8893,25695,8539,25120,278,1027,6719,19186,6997,20213
230260,201905,14213,43719,12530,40631,1567,5192,7332,24061,8899,29253
230270,201905,7363,20315,5742,17249,501,1493,3816,11486,4317,12979
230280,201905,20314,54830,16647,48576,563,2362,13054,36671,13617,39033
230290,201905,4741,13341,4017,11921,326,858,2985,8912,3311,9770
230300,201905,4638,12763,4278,12239,78,293,3743,10554,3821,10847
230310,201905,4626,13266,3940,12068,138,602,2821,8394,2959,8996
230320,201905,7612,22138,6585,20194,300,1175,5017,15059,5317,16234
230330,201905,4640,12817,3792,11187,171,558,2796,8088,2967,8646
230340,201905,3550,11288,3036,10218,301,1046,1990,6653,2291,7699
230350,201905,17869,50326,15864,47060,1016,3515,10240,30549,11256,34064
230360,201905,2780,7731,2243,6720,146,455,1498,4447,1644,4902
230365,201905,3041,7604,2543,6827,46,228,2140,5651,2186,5879
230370,201905,54623,157298,46863,145206,7995,25077,26003,82476,33998,107553
230380,201905,6404,17944,5076,15437,160,603,3696,11032,3856,11635
230390,201905,3270,9830,2875,9179,114,477,2207,6970,2321,7447
230393,201905,3044,9318,2504,8220,97,542,1924,6020,2021,6562
230395,201905,5757,15738,5021,14478,375,1038,3458,10005,3833,11043
230400,201905,5696,15957,5061,14892,138,676,3955,11235,4093,11911
230410,201905,14227,42715,11700,37867,1047,3642,7723,24933,8770,28575
230420,201905,27294,77206,22678,68687,2900,9117,12653,38139,15553,47256
230423,201905,4746,14183,4136,12927,94,423,3313,10139,3407,10562
230425,201905,5500,17180,5021,16183,427,1439,3557,11411,3984,12850
230426,201905,2626,7067,1949,5707,36,148,1473,4213,1509,4361
230427,201905,1852,5256,1299,4025,66,223,878,2625,944,2848
230428,201905,9463,26046,8288,24187,1150,3402,4889,14128,6039,17530
230430,201905,4710,13530,3809,11971,158,600,2863,8808,3021,9408
230435,201905,5533,15013,4735,13641,564,1631,2998,8606,3562,10237
230440,201905,394167,1005546,329960,907912,40058,116498,200849,546742,240907,663240
230445,201905,4253,11388,3490,10049,193,539,2402,6782,2595,7321
230450,201905,3614,10590,3143,9844,249,987,2274,6913,2523,7900
230460,201905,2093,5940,1842,5534,78,293,1506,4497,1584,4790
230465,201905,3953,11214,3396,10170,102,443,2500,7171,2602,7614
230470,201905,11052,37037,9982,34996,843,3597,7219,24825,8062,28422
230480,201905,1402,4112,1193,3731,100,391,845,2532,945,2923
230490,201905,2416,6865,2057,6179,187,623,1284,3646,1471,4269
230495,201905,5786,17403,5097,16111,377,1481,3334,10339,3711,11820
230500,201905,9015,29659,8275,28251,313,1289,6651,22610,6964,23899
230510,201905,1635,5102,1213,4123,204,734,548,1845,752,2579
230520,201905,4447,12847,3895,11813,305,942,2750,8278,3055,9220
230523,201905,14430,43328,11849,37698,2774,8781,3159,10606,5933,19387
230526,201905,3851,11061,3249,9972,157,546,2395,7263,2552,7809
230530,201905,5261,16512,4472,14986,352,1295,3159,10507,3511,11802
230533,201905,4150,10534,3555,9509,90,258,2916,7713,3006,7971
230535,201905,5232,14716,4461,13388,222,685,3171,9589,3393,10274
230540,201905,15884,44010,13933,41049,255,1102,11660,33865,11915,34967
230550,201905,20085,54659,16419,48195,1674,5129,10143,29541,11817,34670
230560,201905,7840,19701,6444,17387,72,293,5471,14606,5543,14899
230565,201905,3016,8466,2526,7550,81,358,1914,5609,1995,5967
230570,201905,3515,8933,3028,8294,71,220,2560,6965,2631,7185
230580,201905,10347,27706,9046,25842,336,1060,7544,21385,7880,22445
230590,201905,8814,25609,7339,22820,466,1677,5246,15757,5712,17434
230600,201905,3664,9659,2823,8085,87,271,1906,5497,1993,5768
230610,201905,6579,18355,5841,17148,478,1370,4497,13179,4975,14549
230620,201905,2061,5655,1577,4687,125,412,954,2744,1079,3156
230625,201905,7737,22558,6593,20396,2029,6486,1758,5808,3787,12294
230630,201905,10461,31715,9145,28921,1844,5521,4660,15371,6504,20892
230640,201905,27621,84383,24956,79977,1497,5896,19368,61091,20865,66987
230650,201905,5096,14096,4321,12686,158,665,3420,9752,3578,10417
230655,201905,9252,32053,8805,31228,689,2651,6848,24406,7537,27057
230660,201905,6100,18238,4979,16185,172,905,4020,12758,4192,13663
230670,201905,6048,14721,4483,12120,147,458,3547,9372,3694,9830
230680,201905,2555,7167,2200,6523,157,476,1539,4556,1696,5032
230690,201905,6830,20559,6006,18874,423,1517,3778,11601,4201,13118
230700,201905,9576,25012,8108,22319,336,1039,6082,16268,6418,17307
230710,201905,6742,21326,5855,19442,542,1944,4069,13239,4611,15183
230720,201905,1941,5759,1577,4998,121,372,1045,3235,1166,3607
230725,201905,3835,11835,3404,10977,452,1605,1771,5598,2223,7203
230730,201905,54586,151762,44163,135037,10366,34182,14723,47266,25089,81448
230740,201905,6020,17064,5200,15687,136,570,4157,12404,4293,12974
230750,201905,8337,22632,7004,20381,182,699,5466,15431,5648,16130
230760,201905,10961,29699,9720,27712,636,2133,7164,19881,7800,22014
230763,201905,4489,12745,3849,11531,139,602,3053,8854,3192,9456
230765,201905,40521,113135,34041,102215,5955,18595,15531,46538,21486,65133
230770,201905,24981,63668,21205,58485,2429,6966,13636,37569,16065,44535
230780,201905,5982,21476,5601,20644,823,3067,3325,12552,4148,15619
230790,201905,2931,8624,2613,8080,120,522,1946,5822,2066,6344
230800,201905,7740,25198,6942,23524,799,3030,4172,13814,4971,16844
230810,201905,11678,35271,10411,33154,435,1665,7944,24748,8379,26413
230820,201905,3250,10755,2738,9565,270,1124,1665,5536,1935,6660
230830,201905,7621,20999,6496,19017,162,692,5281,15051,5443,15743
230835,201905,4130,10015,3184,8509,80,256,2579,6762,2659,7018
230837,201905,3064,9600,2653,8837,110,539,2089,6752,2199,7291
230840,201905,8824,26380,7691,24501,606,2007,5649,18058,6255,20065
230850,201905,9318,27562,7975,24870,423,1529,5666,17448,6089,18977
230860,201905,5076,13339,4293,12166,86,305,3695,10358,3781,10663
230870,201905,16327,40616,14165,37042,443,1268,11447,29603,11890,30871
230880,201905,2074,6398,1884,6056,51,276,1476,4615,1527,4891
230890,201905,4410,14398,4094,13769,343,1280,2973,9824,3316,11104
230900,201905,2972,8797,2558,7961,215,764,1685,5090,1900,5854
230910,201905,2907,8076,2413,7228,75,380,1927,5642,2002,6022
230920,201905,4446,12868,3795,11790,165,662,2856,8665,3021,9327
230930,201905,6406,18318,5404,16398,350,1098,3737,11285,4087,12383
230940,201905,7627,20142,6718,18731,193,551,5664,15648,5857,16199
230945,201905,6512,18906,5604,17079,360,1250,3870,11690,4230,12940
230950,201905,6185,15744,5592,14987,136,330,4942,13392,5078,13722
230960,201905,12804,38022,11486,35520,1775,5579,5902,18453,7677,24032
230970,201905,13123,35860,11144,32728,1960,5837,5811,17236,7771,23073
230980,201905,2710,8034,2368,7391,434,1292,1385,4455,1819,5747
230990,201905,1678,4799,1412,4253,76,312,954,2722,1030,3034
231000,201905,2436,6585,2035,5797,77,219,1462,4069,1539,4288
231010,201905,3365,8092,2711,6962,71,239,2290,5691,2361,5930
231020,201905,7891,25411,7101,23759,1251,3933,4111,14249,5362,18182
231025,201905,7311,20813,6431,19351,810,2407,4333,13134,5143,15541
231030,201905,7086,21492,5654,18406,936,3017,2979,9721,3915,12738
231040,201905,3007,8842,2616,8100,103,376,2028,6144,2131,6520
231050,201905,11742,30807,9512,26751,662,1847,6937,19114,7599,20961
231060,201905,2706,7830,2410,7332,78,280,1932,5840,2010,6120
231070,201905,7986,23592,6758,21362,862,2779,4047,12715,4909,15494
231080,201905,3940,11449,3448,10624,145,664,2592,7766,2737,8430
231085,201905,6321,16008,5143,14550,225,647,3940,11154,4165,11801
231090,201905,4322,11466,3250,9336,105,407,2265,6292,2370,6699
231095,201905,2153,6571,1741,5650,134,462,1182,3818,1316,4280
231100,201905,2949,8723,2464,7799,132,477,1859,5820,1991,6297
231110,201905,3487,10574,3232,10081,132,521,2421,7420,2553,7941
231120,201905,2160,6476,1836,5899,92,355,1264,4000,1356,4355
231123,201905,1900,5024,1590,4476,79,213,1141,3180,1220,3393
231126,201905,5555,15575,4472,13440,239,754,3220,9502,3459,10256
231130,201905,20255,53769,17034,49521,1170,4302,12202,34671,13372,38973
231135,201905,4139,11724,3467,10437,156,568,2489,7335,2645,7903
231140,201905,16425,47167,13367,41647,710,3021,9209,27762,9919,30783
231150,201905,5427,15405,4311,13113,757,2313,1926,5966,2683,8279
231160,201905,5889,18256,5286,17087,959,2937,2929,9748,3888,12685
231170,201905,4379,13067,3591,11472,217,797,2427,7489,2644,8286
231180,201905,13947,40400,11600,35252,3039,9082,4239,13115,7278,22197
231190,201905,3785,10874,3226,9806,106,465,2509,7408,2615,7873
231195,201905,4690,14596,3963,13039,219,880,2915,9367,3134,10247
231200,201905,7797,24775,6821,22708,258,1306,5201,16747,5459,18053
231210,201905,4743,14195,4073,13024,192,733,3041,9495,3233,10228
231220,201905,11881,31741,9389,26894,491,1547,6705,18446,7196,19993
231230,201905,9016,28993,8064,27332,477,1922,5995,20308,6472,22230
231240,201905,11430,34090,10097,31465,1604,4963,5805,18239,7409,23202
231250,201905,2053,5387,1331,3748,108,297,788,2172,896,2469
231260,201905,3195,9255,2797,8614,293,880,1854,5851,2147,6731
231270,201905,6382,16866,5293,15059,138,552,4005,11104,4143,11656
231280,201905,1653,5267,1554,5074,115,385,1140,3691,1255,4076
231290,201905,36801,111941,31346,100621,5507,17808,14372,45907,19879,63715
231300,201905,3970,11176,3140,9463,250,783,1999,5924,2249,6707
231310,201905,7182,19089,5813,16477,504,1434,3888,10830,4392,12264
231320,201905,7681,21416,6060,18447,96,446,4681,14047,4777,14493
231325,201905,2471,6735,2035,6023,205,548,1311,3953,1516,4501
231330,201905,9515,29140,7959,26003,1484,4707,4189,14112,5673,18819
231335,201905,5729,15139,4833,13655,83,378,4215,11701,4298,12079
231340,201905,17522,54979,15711,51770,1332,4507,11245,37390,12577,41897
231350,201905,15608,42820,14188,40813,350,1205,12622,35953,12972,37158
231355,201905,4376,13267,3922,12441,221,797,3014,9482,3235,10279
231360,201905,7317,22501,6384,20819,390,1416,4834,15711,5224,17127
231370,201905,2223,6082,1778,5267,38,132,1371,4010,1409,4142
231375,201905,4380,13776,4000,13118,149,693,3269,10551,3418,11244
231380,201905,5860,16047,5390,15427,207,569,4379,12713,4586,13282
231390,201905,3351,9868,3013,9309,155,581,2191,6554,2346,7135
231395,201905,3966,11918,3326,10865,523,1678,1848,6166,2371,7844
231400,201905,9184,26859,7894,24432,321,1315,5997,18165,6318,19480
231410,201905,14566,45922,13166,43568,747,2844,10317,33644,11064,36488
240010,201905,2485,6760,1925,5700,210,670,1144,3285,1354,3955
240020,201905,11597,33454,10016,30635,768,2835,6553,19634,7321,22469
240030,201905,2719,6963,2508,6640,106,320,2185,5694,2291,6014
240040,201905,817,2346,676,2092,16,69,505,1516,521,1585
240050,201905,3117,8438,2604,7501,52,154,2049,5801,2101,5955
240060,201905,1373,3734,1165,3353,37,121,933,2641,970,2762
240070,201905,2082,6201,1945,5921,205,684,1441,4285,1646,4969
240080,201905,2804,7702,2369,6889,58,233,1825,5172,1883,5405
240090,201905,2228,5573,1815,4862,20,65,1514,4001,1534,4066
240100,201905,9467,24023,7747,20789,285,880,6023,15599,6308,16479
240110,201905,4296,12558,3717,11490,196,748,2689,8135,2885,8883
240120,201905,3509,9528,2599,8473,205,781,1742,5824,1947,6605
240130,201905,3549,7543,3001,6808,40,117,2728,6084,2768,6201
240140,201905,1894,5703,1625,5189,180,651,1071,3332,1251,3983
240145,201905,6423,18310,5332,16349,773,2426,3100,9572,3873,11998
240150,201905,869,2558,794,2407,52,182,618,1812,670,1994
240160,201905,1435,4366,1222,3940,58,274,880,2819,938,3093
240165,201905,931,2577,791,2301,48,154,610,1741,658,1895
240170,201905,2314,6516,1976,5896,204,694,1298,3722,1502,4416
240180,201905,3025,8990,2424,7778,531,1653,1162,3873,1693,5526
240185,201905,1233,3973,1119,3785,63,259,911,3042,974,3301
240190,201905,1013,3028,892,2822,28,128,732,2289,760,2417
240200,201905,10547,27836,8680,24571,992,3011,4785,13282,5777,16293
240210,201905,2937,7506,2558,6930,29,142,2159,5655,2188,5797
240220,201905,7318,22258,6570,21076,410,1798,5024,15725,5434,17523
240230,201905,5773,14833,4689,12999,236,670,3682,10160,3918,10830
240240,201905,1928,5876,1223,4107,125,412,480,1585,605,1997
240250,201905,2811,7639,2533,7219,132,330,2076,5961,2208,6291
240260,201905,13477,40492,11759,37469,1683,5192,7250,24114,8933,29306
240270,201905,2215,6630,1962,6233,120,369,1478,4792,1598,5161
240280,201905,1655,4286,1411,3894,49,150,1134,3074,1183,3224
240290,201905,1197,3523,984,3050,34,151,680,1964,714,2115
240300,201905,2151,5609,1552,4443,75,232,997,2764,1072,2996
240310,201905,8593,23106,6916,20092,885,2680,3681,10563,4566,13243
240320,201905,2029,5557,1476,4461,28,134,1122,3244,1150,3378
240325,201905,29383,80970,23047,69605,4903,15482,8668,26712,13571,42194
240330,201905,1659,4568,1302,3878,46,162,910,2597,956,2759
240340,201905,1940,4591,1592,4037,48,122,1298,3204,1346,3326
240350,201905,2042,5416,1903,5254,28,121,1703,4692,1731,4813
240360,201905,8049,22983,7246,21700,952,2822,4746,14620,5698,17442
240370,201905,1914,5151,1503,4293,74,211,1026,2862,1100,3073
240375,201905,892,2292,748,2009,27,105,597,1521,624,1626
240380,201905,2246,6408,1653,5076,158,470,976,2941,1134,3411
240390,201905,982,2478,678,1866,26,66,435,1117,461,1183
240400,201905,1369,3455,1073,2916,35,128,746,1913,781,2041
240410,201905,555,1747,468,1552,52,221,286,904,338,1125
240420,201905,4590,16444,4051,15204,522,2345,2246,8222,2768,10567
240430,201905,3319,8952,2810,7958,215,685,2002,5462,2217,6147
240440,201905,2547,5738,2148,5171,131,304,1704,4032,1835,4336
240450,201905,4228,11878,3431,10401,326,1154,2077,6036,2403,7190
240460,201905,2912,8418,2665,8017,274,893,2061,6156,2335,7049
240470,201905,3513,10719,2745,9119,387,1277,1513,5074,1900,6351
240480,201905,546,1529,384,1176,30,103,171,503,201,606
240485,201905,2070,6001,1707,5288,152,475,1136,3526,1288,4001
240490,201905,1695,4301,1343,3661,68,168,1048,2866,1116,3034
240500,201905,2108,5722,1861,5346,63,205,1566,4454,1629,4659
240510,201905,1655,4419,1485,4179,74,250,1232,3371,1306,3621
240520,201905,1301,3352,1058,3012,42,152,840,2347,882,2499
240530,201905,2004,6059,1847,5784,111,381,1468,4558,1579,4939
240540,201905,2225,5606,1937,5155,72,167,1662,4395,1734,4562
240550,201905,675,1914,620,1812,26,104,486,1364,512,1468
240560,201905,3242,8608,2779,7976,265,693,2045,5957,2310,6650
240570,201905,2830,7487,1904,5406,273,811,804,2092,1077,2903
240580,201905,7733,22799,6993,21454,548,1692,5595,17183,6143,18875
240590,201905,693,1863,609,1717,12,47,464,1282,476,1329
240600,201905,1771,4820,1302,3835,52,180,868,2460,920,2640
240610,201905,4193,11519,3539,10302,141,493,2665,7595,2806,8088
240615,201905,1118,3070,888,2607,56,203,615,1702,671,1905
240620,201905,1821,5161,1556,4685,90,268,1240,3701,1330,3969
240630,201905,2022,5891,1829,5541,130,338,1281,4005,1411,4343
240640,201905,910,2462,727,2148,31,138,532,1526,563,1664
240650,201905,3894,10874,3437,10045,204,617,2644,7656,2848,8273
240660,201905,2916,7687,2614,7283,53,197,2378,6567,2431,6764
240670,201905,2377,6734,1962,5890,137,426,1276,3743,1413,4169
240680,201905,1599,4323,1285,3770,58,191,954,2714,1012,2905
240690,201905,934,2407,743,2078,11,48,597,1610,608,1658
240700,201905,2323,6788,1960,6131,63,259,1540,4716,1603,4975
240710,201905,15905,41846,13405,37430,2130,5767,7795,21978,9925,27745
240720,201905,5103,13107,4441,12081,521,1506,3032,8106,3553,9612
240725,201905,1079,3124,836,2619,34,121,562,1704,596,1825
240730,201905,2099,5992,1777,5358,82,264,1353,4011,1435,4275
240740,201905,1812,4909,1491,4303,54,222,1089,2970,1143,3192
240750,201905,2204,7393,1847,6614,258,1042,1007,3607,1265,4649
240760,201905,1507,3712,1074,3044,52,115,834,2400,886,2515
240770,201905,3162,8803,2695,8132,145,572,2105,6189,2250,6761
240780,201905,5123,14129,4095,12391,517,1586,2479,7647,2996,9233
240790,201905,842,2426,710,2170,15,58,528,1581,543,1639
240800,201905,43793,109742,34869,95815,4888,14036,17304,47427,22192,61463
240810,201905,81146,217508,70617,199658,11536,32991,41684,117166,53220,150157
240820,201905,5668,17247,4887,15803,746,2450,2893,9473,3639,11923
240830,201905,8599,25228,7832,24003,299,1340,6363,19087,6662,20427
240840,201905,1129,2857,894,2454,44,117,621,1642,665,1759
240850,201905,1233,3469,899,2744,42,142,519,1547,561,1689
240860,201905,1224,3343,918,2776,17,81,687,1973,704,2054
240870,201905,1119,2845,869,2412,94,297,553,1487,647,1784
240880,201905,1279,4034,1145,3769,80,326,914,2941,994,3267
240890,201905,4505,12412,3419,10288,509,1657,1684,4866,2193,6523
240895,201905,2658,8472,2419,8103,161,582,2040,6812,2201,7394
240910,201905,3154,8859,2738,8045,63,226,2227,6437,2290,6663
240920,201905,808,2327,688,2111,65,185,387,1233,452,1418
240930,201905,3664,8474,3055,7727,192,280,2353,6180,2545,6460
240933,201905,1769,4285,1447,3796,48,187,1236,3178,1284,3365
240940,201905,6057,15085,4849,13016,313,892,3409,8818,3722,9710
240950,201905,949,2878,835,2654,27,118,688,2143,715,2261
240960,201905,686,2107,612,1953,33,129,471,1463,504,1592
240970,201905,1847,4823,1517,4252,51,195,1268,3452,1319,3647
240980,201905,3032,9364,2765,8859,156,650,2169,6766,2325,7416
240990,201905,2538,7266,2306,6795,274,885,1624,4620,1898,5505
241000,201905,940,2502,755,2142,41,93,535,1532,576,1625
241010,201905,2782,8936,2558,8434,180,711,1873,6045,2053,6756
241020,201905,2050,5532,1516,4432,148,432,960,2732,1108,3164
241025,201905,1728,4990,1373,4286,61,244,957,2932,1018,3176
241030,201905,2488,7888,2047,6947,223,791,1338,4521,1561,5312
241040,201905,2249,7162,2020,6770,92,426,1626,5393,1718,5819
241050,201905,1281,3579,1044,3129,39,136,795,2320,834,2456
241060,201905,708,2038,636,1882,35,113,447,1266,482,1379
241070,201905,642,1777,566,1644,18,61,439,1222,457,1283
241080,201905,1110,3186,859,2675,10,42,631,1946,641,1988
241090,201905,2019,5867,1628,5207,59,294,1274,3998,1333,4292
241100,201905,1140,3235,900,2704,54,167,622,1811,676,1978
241105,201905,1018,3102,827,2729,265,867,259,894,524,1761
241110,201905,907,2619,684,2127,40,148,456,1353,496,1501
241120,201905,7459,21464,6391,19553,1035,3124,3596,11353,4631,14477
241140,201905,3216,8642,2606,7401,149,439,1908,5272,2057,5711
241142,201905,755,2054,554,1654,32,113,311,853,343,966
241150,201905,5792,15448,5163,14377,169,609,4215,11437,4384,12046
241160,201905,1270,3591,1067,3226,136,401,707,2117,843,2518
241170,201905,1296,3332,1127,3046,39,153,932,2385,971,2538
241180,201905,1008,2630,729,2083,75,211,421,1171,496,1382
241190,201905,1084,2894,900,2523,24,91,655,1752,679,1843
241200,201905,18461,49263,16035,45519,2684,7727,9171,26084,11855,33811
241210,201905,1356,3762,1000,3032,113,377,586,1724,699,2101
241220,201905,8583,25966,7544,24147,1896,6007,3399,11383,5295,17390
241230,201905,2880,7743,2560,7221,106,368,2129,5872,2235,6240
241240,201905,1174,3340,707,2258,48,170,337,1076,385,1246
241250,201905,5174,15508,4312,13840,182,832,3188,9817,3370,10649
241255,201905,2020,6575,1780,6046,132,563,1290,4244,1422,4807
241260,201905,4811,12763,3773,10979,97,419,2932,8301,3029,8720
241270,201905,1767,5154,1463,4550,131,452,1013,3094,1144,3546
241280,201905,2117,5407,1838,4895,69,198,1541,4046,1610,4244
241290,201905,3415,8425,2578,7035,83,321,2005,5266,2088,5587
241300,201905,1440,3917,1151,3396,44,154,768,2205,812,2359
241310,201905,2025,5212,1728,4798,20,94,1454,4031,1474,4125
241320,201905,985,3212,818,2870,92,387,508,1763,600,2150
241330,201905,1777,4585,1383,4088,27,115,1174,3468,1201,3583
241335,201905,3055,8674,2744,8097,97,349,2286,6659,2383,7008
241340,201905,1616,4673,1264,3925,265,840,534,1634,799,2474
241350,201905,1964,5776,1748,5378,107,372,1325,3993,1432,4365
241355,201905,1291,3524,1072,3107,20,75,828,2362,848,2437
241360,201905,2032,5321,1549,4317,57,169,1114,2986,1171,3155
241370,201905,1351,3749,1052,3147,59,200,706,2011,765,2211
241380,201905,631,1771,499,1501,75,217,267,820,342,1037
241390,201905,2685,8120,2425,7701,186,590,1866,5952,2052,6542
241400,201905,3477,9749,3139,9245,174,568,2546,7437,2720,8005
241410,201905,2327,6984,1891,6084,355,1170,972,3133,1327,4303
241415,201905,1616,4820,1330,4251,71,276,950,2958,1021,3234
241420,201905,2145,7099,1833,6522,456,1751,796,2815,1252,4566
241430,201905,568,1632,394,1209,27,93,245,726,272,819
241440,201905,7190,22980,6475,21667,401,1626,5085,16706,5486,18332
241445,201905,1071,2774,978,2659,24,65,881,2444,905,2509
241450,201905,2667,6761,2330,6211,262,626,1703,4569,1965,5195
241460,201905,3579,9847,3008,8628,168,524,2141,5962,2309,6486
241470,201905,1413,3725,1127,3298,30,116,920,2667,950,2783
241475,201905,1190,3407,934,2916,31,164,680,2016,711,2180
241480,201905,2772,8801,2342,7884,795,2648,674,2588,1469,5236
241490,201905,667,1618,532,1425,26,73,357,931,383,1004
241500,201905,812,2331,711,2199,9,36,630,1960,639,1996
250010,201905,2582,7753,2140,6823,56,233,1552,4807,1608,5040
250020,201905,1588,4333,1127,3420,51,145,811,2422,862,2567
250030,201905,6736,18717,6052,17645,483,1462,4591,13179,5074,14641
250040,201905,4040,12525,3502,11519,231,918,2482,7990,2713,8908
250050,201905,3443,9504,3157,9083,129,468,2555,7281,2684,7749
250053,201905,1154,3338,1045,3160,73,239,769,2336,842,2575
250057,201905,638,2286,602,2231,4,25,543,2042,547,2067
250060,201905,5282,14227,4835,13661,388,1043,3824,10933,4212,11976
250070,201905,3921,11200,3443,10340,56,264,2730,7979,2786,8243
250073,201905,733,1999,605,1797,6,27,497,1423,503,1450
250077,201905,2201,6004,1657,5087,71,247,1215,3698,1286,3945
250080,201905,4572,11856,4029,11130,88,340,3466,9419,3554,9759
250090,201905,3103,7799,2742,7309,60,196,2361,6162,2421,6358
250100,201905,3634,11288,3363,10776,162,651,2684,8349,2846,9000
250110,201905,4820,13591,4356,12919,334,1205,3353,9674,3687,10879
250115,201905,551,1599,470,1463,10,57,349,1053,359,1110
250120,201905,1860,5460,1552,4942,39,178,1216,3842,1255,4020
250130,201905,5449,15256,4631,14055,78,433,3831,11401,3909,11834
250135,201905,1170,3191,1048,2997,15,61,942,2681,957,2742
250140,201905,2136,6482,2025,6324,116,538,1717,5223,1833,5761
250150,201905,4761,15089,4300,14254,162,736,3439,11161,3601,11897
250153,201905,1436,3724,1198,3368,27,88,974,2698,1001,2786
250157,201905,1709,5171,1529,4810,79,301,1197,3689,1276,3990
250160,201905,3840,9762,3108,8761,34,143,2774,7783,2808,7926
250170,201905,1781,4600,1595,4334,35,128,1374,3680,1409,3808
250180,201905,18507,46698,16192,43638,855,2682,12476,32851,13331,35533
250190,201905,3997,10966,3399,10026,411,1172,2210,6468,2621,7640
250200,201905,1867,5122,1603,4712,50,178,1364,3975,1414,4153
250205,201905,816,2603,711,2426,23,118,587,1983,610,2101
250210,201905,1562,4772,1414,4523,49,248,1123,3515,1172,3763
250215,201905,1554,4413,1284,3952,72,243,786,2396,858,2639
250220,201905,662,1877,539,1684,36,137,351,1038,387,1175
250230,201905,1579,3645,1147,2986,25,82,912,2289,937,2371
250240,201905,2218,6756,1983,6339,39,166,1691,5342,1730,5508
250250,201905,4534,12660,3939,11779,91,297,3318,9903,3409,10200
250260,201905,1702,4733,1428,4267,42,131,1136,3360,1178,3491
250270,201905,1197,3644,1077,3493,70,228,801,2703,871,2931
250280,201905,3200,9142,2821,8544,107,341,2230,6736,2337,7077
250290,201905,1601,4245,1362,3915,27,78,1087,3147,1114,3225
250300,201905,5387,14660,4965,14163,205,906,4112,11293,4317,12199
250310,201905,1141,3191,969,2898,39,129,745,2188,784,2317
250320,201905,10521,25170,9273,23679,342,1002,8028,20206,8370,21208
250330,201905,2286,6567,1937,6105,118,420,1540,4791,1658,5211
250340,201905,1092,2809,961,2628,6,20,857,2317,863,2337
250350,201905,3997,11199,3613,10599,145,378,2928,8827,3073,9205
250355,201905,1957,6015,1751,5730,27,154,1580,5135,1607,5289
250360,201905,1751,4968,1588,4724,34,126,1300,3844,1334,3970
250370,201905,12435,33164,10507,30224,345,1319,8609,24276,8954,25595
250375,201905,1150,3009,947,2755,6,18,883,2596,889,2614
250380,201905,1588,4192,1461,4023,37,158,1240,3287,1277,3445
250390,201905,1758,4573,1494,4142,118,312,1122,3105,1240,3417
250400,201905,69275,171392,49993,141525,13713,40816,15483,45727,29196,86543
250403,201905,1653,4732,1508,4540,76,374,1191,3418,1267,3792
250407,201905,1209,3084,992,2767,61,144,721,2036,782,2180
250410,201905,599,1641,526,1521,4,19,438,1240,442,1259
250415,201905,1804,5189,1603,4853,39,171,1356,4057,1395,4228
250420,201905,1217,3473,1104,3320,14,64,1030,3096,1044,3160
250430,201905,6125,15331,5289,14170,155,500,4386,11536,4541,12036
250435,201905,1508,4219,1238,3746,21,95,934,2773,955,2868
250440,201905,4472,11997,3866,11246,77,272,3359,9748,3436,10020
250450,201905,1806,4910,1519,4513,33,130,1265,3736,1298,3866
250460,201905,7194,19576,6459,18518,348,1057,5260,15014,5608,16071
250470,201905,1542,3994,1279,3603,53,182,982,2688,1035,2870
250480,201905,4040,11039,3517,10416,17,78,3180,9514,3197,9592
250485,201905,723,1655,534,1391,34,69,388,979,422,1048
250490,201905,4861,12074,4379,11497,194,624,3792,9766,3986,10390
250500,201905,1950,5397,1735,5036,69,225,1418,4101,1487,4326
250510,201905,5418,13658,4696,12714,93,284,4126,11187,4219,11471
250520,201905,1767,4886,1534,4553,135,440,1076,3165,1211,3605
250523,201905,2194,5425,1970,5141,78,338,1647,4149,1725,4487
250527,201905,1650,4332,1511,4166,31,96,1326,3672,1357,3768
250530,201905,607,1632,523,1515,8,25,459,1322,467,1347
250535,201905,1323,3912,1216,3706,32,144,987,2920,1019,3064
250540,201905,2921,6813,2415,6240,70,148,2107,5519,2177,5667
250550,201905,762,2473,671,2293,20,89,518,1725,538,1814
250560,201905,1636,4592,1468,4353,46,179,1218,3507,1264,3686
250570,201905,2614,7876,2253,7217,77,315,1786,5608,1863,5923
250580,201905,1036,2720,939,2578,52,170,771,2089,823,2259
250590,201905,816,2311,722,2172,15,78,600,1791,615,1869
250600,201905,8095,20923,6781,19195,316,957,5572,15691,5888,16648
250610,201905,2984,8373,2689,7944,117,442,2220,6462,2337,6904
250620,201905,727,1976,613,1771,12,53,467,1310,479,1363
250625,201905,2525,7355,2267,6935,45,240,1881,5580,1926,5820
250630,201905,9473,26977,7935,24139,864,2753,5199,15389,6063,18142
250640,201905,3271,9341,3010,8973,85,407,2551,7396,2636,7803
250650,201905,911,2264,763,2060,21,72,648,1692,669,1764
250660,201905,1572,3978,1346,3666,39,110,1126,3001,1165,3111
250670,201905,2301,7240,2128,6944,51,240,1832,5846,1883,6086
250680,201905,5885,13562,5227,12804,102,375,4721,11297,4823,11672
250690,201905,6655,15378,5811,14290,103,286,5182,12590,5285,12876
250700,201905,4277,12143,3759,11339,310,952,2802,8344,3112,9296
250710,201905,4413,12754,3816,11928,289,1020,2774,8631,3063,9651
250720,201905,2734,7268,2478,6900,43,203,2181,5968,2224,6171
250730,201905,4052,10871,3574,10224,119,429,2952,8186,3071,8615
250740,201905,1949,4980,1594,4496,107,312,1231,3433,1338,3745
250750,201905,97192,248076,84438,229962,7541,22204,60263,160805,67804,183009
250760,201905,2336,6083,2048,5615,107,325,1586,4213,1693,4538
250770,201905,3847,11873,3498,11396,340,1139,2539,8265,2879,9404
250780,201905,1713,4695,1438,4176,77,264,1065,3017,1142,3281
250790,201905,2428,7286,2116,6830,205,787,1390,4392,1595,5179
250800,201905,2450,6543,2116,6004,87,186,1740,4970,1827,5156
250810,201905,1263,3429,1032,3084,26,76,877,2634,903,2710
250820,201905,1871,5411,1768,5292,45,200,1598,4741,1643,4941
250830,201905,5644,17022,4766,15255,332,1244,3246,10100,3578,11344
250840,201905,789,2507,671,2261,21,91,481,1623,502,1714
250850,201905,1792,5453,1624,5163,41,211,1344,4161,1385,4372
250855,201905,947,2773,822,2563,66,227,609,1879,675,2106
250860,201905,2999,9205,2535,8362,461,1597,1386,4544,1847,6141
250870,201905,1032,2835,875,2568,33,113,709,2060,742,2173
250880,201905,1560,4082,1285,3675,137,388,902,2574,1039,2962
250890,201905,9664,26314,8813,25119,420,1834,7117,19281,7537,21115
250900,201905,2755,7927,2374,7210,72,273,1987,5907,2059,6180
250905,201905,2310,6645,2117,6358,50,203,1899,5683,1949,5886
250910,201905,5849,14707,4811,13482,101,372,4063,11430,4164,11802
250915,201905,1961,4747,1460,4206,13,32,1325,3863,1338,3895
250920,201905,3441,8891,3023,8239,322,835,2182,5860,2504,6695
250930,201905,2130,5835,1950,5589,56,218,1680,4714,1736,4932
250933,201905,1121,3405,998,3174,20,112,747,2299,767,2411
250937,201905,707,1935,592,1741,23,82,433,1289,456,1371
250939,201905,1711,4667,1497,4356,57,192,1198,3431,1255,3623
250940,201905,3809,10410,3400,9845,56,243,2932,8416,2988,8659
250950,201905,1662,4274,1343,3866,24,97,1134,3224,1158,3321
250960,201905,1091,3235,960,3022,25,133,787,2379,812,2512
250970,201905,8215,21651,7187,19960,300,977,5760,15641,6060,16618
250980,201905,2462,6613,2216,6218,43,167,1864,5095,1907,5262
250990,201905,1942,6091,1672,5573,79,355,1239,4060,1318,4415
251000,201905,2084,5851,1705,5220,33,137,1413,4291,1446,4428
251010,201905,2593,7363,2357,6987,27,118,2128,6282,2155,6400
251020,201905,1661,4464,1509,4241,34,142,1324,3649,1358,3791
251030,201905,989,2684,830,2378,29,82,577,1614,606,1696
251040,201905,1839,5339,1562,4859,49,229,1225,3764,1274,3993
251050,201905,1093,2979,912,2634,43,145,663,1847,706,1992
251060,201905,1049,2255,780,1921,11,52,642,1530,653,1582
251065,201905,443,1225,358,1082,14,38,257,749,271,787
251070,201905,735,1994,635,1858,9,32,535,1552,544,1584
251080,201905,18427,47896,15212,43076,1843,5529,9904,28009,11747,33538
251090,201905,2618,7644,2236,6947,52,201,1829,5640,1881,5841
251100,201905,797,2511,715,2367,27,105,551,1765,578,1870
251110,201905,1671,4560,1445,4148,52,154,1110,3158,1162,3312
251120,201905,6963,20266,5945,18936,251,1063,4690,14761,4941,15824
251130,201905,3866,8930,3453,8461,160,412,3019,7351,3179,7763
251140,201905,4188,11853,3795,11283,88,356,3134,9200,3222,9556
251150,201905,2666,7789,2399,7362,117,512,1918,5686,2035,6198
251160,201905,2046,6128,1808,5782,104,391,1474,4649,1578,5040
251170,201905,1496,4173,1343,3989,37,157,1170,3436,1207,3593
251180,201905,2588,7098,2157,6495,182,544,1437,4294,1619,4838
251190,201905,4285,11349,3986,10999,52,254,3614,9773,3666,10027
251200,201905,4141,12399,3744,11884,94,392,3230,10283,3324,10675
251203,201905,925,3038,867,2914,33,141,656,2143,689,2284
251207,201905,1059,2979,830,2579,18,88,582,1759,600,1847
251210,201905,7330,19183,5990,17422,277,724,4584,13490,4861,14214
251220,201905,1167,2879,905,2517,48,119,705,1980,753,2099
251230,201905,4593,12739,3996,11743,131,521,3175,9047,3306,9568
251240,201905,3581,9963,2988,8990,147,483,2229,6534,2376,7017
251250,201905,9750,26799,8672,24995,806,2453,6319,17622,7125,20075
251260,201905,470,1394,431,1320,12,60,332,979,344,1039
251270,201905,4115,12920,3716,12393,106,439,3109,10527,3215,10966
251272,201905,1326,3640,1211,3475,37,166,1040,2877,1077,3043
251274,201905,888,2518,729,2242,48,177,496,1449,544,1626
251275,201905,1227,3428,1052,3157,47,220,780,2226,827,2446
251276,201905,1332,3580,1171,3372,36,183,952,2643,988,2826
251278,201905,562,1604,501,1503,37,107,374,1121,411,1228
251280,201905,2221,6184,1990,5809,50,200,1648,4716,1698,4916
251290,201905,5712,13931,5305,13408,187,677,4587,11115,4774,11792
251300,201905,807,2433,748,2348,8,30,634,1986,642,2016
251310,201905,2758,7968,2417,7413,60,307,1909,5684,1969,5991
251315,201905,1685,5335,1551,5094,65,234,1170,3782,1235,4016
251320,201905,1634,4327,1151,3492,29,105,837,2514,866,2619
251330,201905,2007,4741,1673,4342,25,90,1513,3943,1538,4033
251335,201905,1002,3095,915,2962,27,106,778,2468,805,2574
251340,201905,3609,8966,2894,7979,119,365,2149,5819,2268,6184
251350,201905,1067,3153,951,2960,29,135,793,2403,822,2538
251360,201905,1798,5095,1486,4665,22,95,1276,4011,1298,4106
251365,201905,700,1993,558,1691,9,31,426,1285,435,1316
251370,201905,22081,60768,19615,57303,2327,7062,12965,38047,15292,45109
251380,201905,1172,3420,1050,3207,20,115,878,2573,898,2688
251385,201905,714,1876,564,1605,16,48,424,1160,440,1208
251390,201905,6290,18866,5516,17573,602,2074,3437,10832,4039,12906
251392,201905,960,2650,800,2401,26,128,623,1816,649,1944
251394,201905,599,1786,491,1591,24,99,367,1167,391,1266
251396,201905,689,1869,587,1697,20,53,402,1143,422,1196
251398,201905,912,2379,661,1922,17,74,503,1419,520,1493
251400,201905,1168,2969,954,2665,28,105,737,1975,765,2080
251410,201905,1523,3642,1266,3268,21,93,1084,2699,1105,2792
251420,201905,1888,5115,1565,4740,48,190,1217,3636,1265,3826
251430,201905,1527,4741,1365,4472,31,151,1180,3835,1211,3986
251440,201905,1103,3113,902,2727,31,100,713,2155,744,2255
251445,201905,1490,4302,1386,4146,46,195,1152,3327,1198,3522
251450,201905,4354,13064,3938,12427,92,408,3300,10298,3392,10706
251455,201905,901,2732,815,2577,27,105,618,1929,645,2034
251460,201905,898,2601,798,2438,24,91,659,2012,683,2103
251465,201905,440,1304,377,1169,6,27,282,856,288,883
251470,201905,1156,3225,861,2607,71,226,522,1510,593,1736
251480,201905,977,2602,817,2322,20,88,624,1695,644,1783
251490,201905,1872,5061,1491,4528,58,195,1088,3290,1146,3485
251500,201905,1902,5481,1758,5263,47,191,1539,4550,1586,4741
251510,201905,2654,8112,2222,7221,133,492,1471,4671,1604,5163
251520,201905,939,2512,713,2080,70,193,465,1325,535,1518
251530,201905,14053,34314,11592,31210,121,686,10256,27059,10377,27745
251540,201905,2789,8304,2559,7874,104,415,2068,6205,2172,6620
251550,201905,3658,8855,2929,7920,80,216,2456,6627,2536,6843
251560,201905,571,1724,508,1620,77,258,334,1015,411,1273
251570,201905,891,2579,741,2264,20,92,568,1675,588,1767
251580,201905,1896,4570,1694,4278,65,214,1451,3538,1516,3752
251590,201905,1585,4070,1348,3793,60,194,1078,2925,1138,3119
251593,201905,886,2661,823,2556,88,296,531,1590,619,1886
251597,201905,2072,5824,1889,5579,25,102,1654,4813,1679,4915
251600,201905,6321,17290,5625,16215,170,554,4715,13387,4885,13941
251610,201905,3257,9290,2780,8404,301,886,1884,5739,2185,6625
251615,201905,1215,3082,987,2709,21,63,778,2092,799,2155
251620,201905,17997,42457,14247,37942,203,698,11913,32168,12116,32866
251630,201905,4633,11077,3759,9877,197,571,2898,7514,3095,8085
251640,201905,2039,5822,1853,5484,44,213,1578,4535,1622,4748
251650,201905,4033,10729,3531,10104,131,440,3024,8612,3155,9052
251660,201905,3406,10245,3007,9527,81,387,2497,7751,2578,8138
251670,201905,4050,11501,3569,10830,56,287,3151,9462,3207,9749
251675,201905,649,1895,588,1816,82,275,384,1182,466,1457
251680,201905,2529,6859,2114,6299,43,161,1697,5033,1740,5194
251690,201905,3155,8993,2675,8125,79,259,1997,5950,2076,6209
251700,201905,1902,5710,1715,5466,50,242,1449,4509,1499,4751
251710,201905,785,2071,542,1556,49,169,306,861,355,1030
251720,201905,1314,3765,1085,3351,27,117,825,2468,852,2585
251740,201905,621,1749,501,1523,35,136,356,1036,391,1172
260005,201905,28881,61663,23722,55046,1747,4154,17980,40834,19727,44988
260010,201905,9814,26150,8140,23447,495,1530,4886,14171,5381,15701
260020,201905,6699,15999,5764,14621,126,560,4786,11900,4912,12460
260030,201905,6378,16867,5434,15418,187,650,4327,12133,4514,12783
260040,201905,7712,20930,6386,18841,568,1642,4205,12668,4773,14310
260050,201905,13181,35229,11407,33236,241,892,10243,30018,10484,30910
260060,201905,3900,10029,3372,9166,186,504,2662,7190,2848,7694
260070,201905,10303,26525,8844,24361,457,1555,6878,18466,7335,20021
260080,201905,6430,14936,5641,13831,126,414,4675,11180,4801,11594
260090,201905,4786,12480,4284,11810,604,1636,2898,8088,3502,9724
260100,201905,3018,8241,2577,7571,82,337,2079,5998,2161,6335
260105,201905,5081,13760,4506,12951,143,535,3705,10466,3848,11001
260110,201905,22319,61142,20016,57836,1105,3668,16336,46419,17441,50087
260120,201905,14219,38822,11974,35344,1580,4627,7350,22123,8930,26750
260130,201905,2974,7886,2675,7422,205,619,1982,5387,2187,6006
260140,201905,12967,29932,11135,27663,617,1758,9195,22448,9812,24206
260150,201905,3497,8348,3005,7737,111,371,2561,6473,2672,6844
260160,201905,6558,17375,5555,16097,111,457,4873,14197,4984,14654
260170,201905,18484,45867,15802,42071,1326,3424,12000,31759,13326,35183
260180,201905,3291,9156,2900,8622,98,369,2430,7074,2528,7443
260190,201905,18221,37207,15346,33820,184,531,13458,28995,13642,29526
260200,201905,10923,26645,9470,24800,446,1092,7973,20976,8419,22068
260210,201905,11782,33754,9983,30815,355,1432,7933,24280,8288,25712
260220,201905,10226,25051,9471,24083,189,656,8285,20675,8474,21331
260230,201905,10507,26428,9181,24600,229,743,7628,20084,7857,20827
260240,201905,2693,8089,2356,7453,156,556,1793,5619,1949,6175
260250,201905,2168,5800,1899,5396,112,284,1436,4059,1548,4343
260260,201905,12733,33785,11270,31452,462,1607,8828,24060,9290,25667
260270,201905,4005,10119,3509,9482,148,604,2827,7401,2975,8005
260280,201905,12774,38927,11485,37125,537,2261,9645,30750,10182,33011
260290,201905,38512,100943,33470,93293,3882,11092,22057,60961,25939,72053
260300,201905,9690,26096,8412,24299,253,1079,6942,19855,7195,20934
260310,201905,4696,12510,4248,11915,311,847,3301,9346,3612,10193
260320,201905,7476,21833,6477,20110,274,845,5250,16332,5524,17177
260330,201905,2521,7790,2241,7202,70,259,1818,5722,1888,5981
260340,201905,2025,5474,1755,5058,36,171,1468,4109,1504,4280
260345,201905,24308,65289,20580,59694,3329,10368,10389,29420,13718,39788
260350,201905,5071,12460,4495,11754,101,323,3925,10161,4026,10484
260360,201905,2492,6576,2270,6161,41,181,1571,4178,1612,4359
260370,201905,5439,15836,4733,14612,238,858,3614,11037,3852,11895
260380,201905,4891,14721,4209,13581,186,665,3111,9894,3297,10559
260390,201905,4338,13189,3685,11855,206,693,2537,7999,2743,8692
260392,201905,3428,10953,3037,10453,136,802,2396,8198,2532,9000
260400,201905,16535,39728,14461,36973,599,1801,11251,27662,11850,29463
260410,201905,70588,173900,54356,150990,10110,29598,24434,69511,34544,99109
260415,201905,4423,12418,3808,11325,83,370,3015,8760,3098,9130
260420,201905,12708,26857,10773,24666,154,437,9773,22098,9927,22535
260430,201905,2799,8691,2395,7905,137,524,1653,5398,1790,5922
260440,201905,3640,9771,3187,9000,96,346,2583,7114,2679,7460
260450,201905,5613,14399,5072,13722,291,670,4161,11435,4452,12105
260460,201905,5089,15627,4387,14292,488,1827,2581,8170,3069,9997
260470,201905,4945,12984,4203,12122,109,271,3768,11064,3877,11335
260480,201905,4066,10823,3393,9853,240,867,2314,6728,2554,7595
260490,201905,5226,12251,4623,11321,54,208,4124,9870,4178,10078
260500,201905,6035,15502,5183,14255,456,1232,3601,9957,4057,11189
260510,201905,9483,23636,8011,21576,149,558,7004,18610,7153,19168
260515,201905,4207,11797,3275,9972,153,495,2146,6358,2299,6853
260520,201905,17155,40329,15080,37590,902,2294,12079,29726,12981,32020
260530,201905,9644,27916,8319,25815,186,859,7033,21507,7219,22366
260540,201905,6982,15422,6236,14452,346,767,5354,12367,5700,13134
260545,201905,37,123,15,73,3,11,4,18,7,29
260550,201905,2974,8467,2460,7555,146,613,1603,4783,1749,5396
260560,201905,5882,15256,5042,14040,148,605,4199,11408,4347,12013
260570,201905,7540,21000,6673,19791,444,1452,5168,15273,5612,16725
260580,201905,4407,10571,3932,9928,31,140,3586,8977,3617,9117
260590,201905,6643,15689,5603,14498,252,660,4597,11994,4849,12654
260600,201905,29932,79247,24577,70804,1326,4232,18218,51588,19544,55820
260610,201905,6992,18708,6355,17839,412,1277,4719,13077,5131,14354
260620,201905,15433,41709,13654,39064,1486,4688,9404,26367,10890,31055
260630,201905,2317,6358,1922,5715,38,169,1542,4478,1580,4647
260640,201905,20463,47831,17425,44263,912,2421,13798,34707,14710,37128
260650,201905,5715,15798,4772,14546,171,727,4010,12090,4181,12817
260660,201905,7168,19127,6169,17767,173,755,5182,14554,5355,15309
260670,201905,2162,5703,1790,5133,75,186,1347,3825,1422,4011
260680,201905,26114,64003,22001,57893,1832,5145,14722,37917,16554,43062
260690,201905,3616,9337,2954,8336,112,410,2327,6465,2439,6875
260700,201905,5915,17322,5608,16966,22,70,5436,16575,5458,16645
260710,201905,1323,3543,1182,3357,43,155,895,2538,938,2693
260720,201905,21594,57239,19003,53449,2443,7108,12459,34588,14902,41696
260730,201905,7277,21669,6472,20493,319,1205,5310,16533,5629,17738
260740,201905,1339,3748,1119,3392,10,57,886,2713,896,2770
260750,201905,6834,19309,5891,18058,130,436,5247,16289,5377,16725
260760,201905,5559,13368,4812,12442,221,650,3865,9995,4086,10645
260765,201905,7643,22807,6716,21480,515,2154,4610,14322,5125,16476
260770,201905,3813,9899,3256,8953,86,297,2591,7013,2677,7310
260775,201905,5182,14002,4603,13107,225,851,3505,9633,3730,10484
260780,201905,3614,10876,3223,10235,296,1140,2069,6358,2365,7498
260790,201905,114590,262791,95936,237805,14878,36159,58819,145364,73697,181523
260795,201905,2999,7977,2588,7400,117,393,1955,5582,2072,5975
260800,201905,5326,12531,4796,11781,168,530,4166,9872,4334,10402
260805,201905,3566,10348,3007,9340,178,664,2172,6606,2350,7270
260810,201905,6538,17861,5786,16408,559,1571,4109,11410,4668,12981
260820,201905,4391,10542,3873,9866,140,493,3167,7854,3307,8347
260825,201905,2890,8770,2506,8072,120,453,1853,5898,1973,6351
260830,201905,4266,12506,3560,11221,455,1302,2275,7348,2730,8650
260840,201905,4107,10935,3669,10285,206,570,3034,8490,3240,9060
260845,201905,4119,11168,3719,10444,258,710,2748,7643,3006,8353
260850,201905,4781,13676,4092,12329,382,1257,2612,7631,2994,8888
260860,201905,3425,9820,2931,8949,91,338,2366,7033,2457,7371
260870,201905,4419,10720,3829,9976,99,381,3373,8604,3472,8985
260875,201905,6678,17165,5521,15400,630,1788,3673,10198,4303,11986
260880,201905,9611,27195,8388,25025,471,1394,6594,19741,7065,21135
260890,201905,13089,34243,11526,31869,747,2295,8258,22241,9005,24536
260900,201905,5195,15076,4371,13794,304,1116,2933,9113,3237,10229
260910,201905,3146,8726,2729,8081,108,373,2134,6246,2242,6619
260915,201905,5156,15208,4554,14497,60,297,4114,13129,4174,13426
260920,201905,3302,8469,2839,7939,101,308,2411,6748,2512,7056
260930,201905,3506,11373,3090,10624,171,738,2326,7831,2497,8569
260940,201905,14407,35120,12562,32417,811,2289,9494,23957,10305,26246
260950,201905,6572,18179,5334,15903,453,1574,3211,9086,3664,10660
260960,201905,65483,152184,52986,135441,6605,17643,32286,81137,38891,98780
260970,201905,5250,14151,4693,13397,165,444,3621,10344,3786,10788
260980,201905,4436,13131,3998,12564,68,258,3596,11376,3664,11634
260990,201905,17678,49831,15062,46278,879,3126,11554,35110,12433,38236
261000,201905,15954,38632,13510,35340,462,1714,10596,27011,11058,28725
261010,201905,2410,6310,2109,5903,73,187,1833,5139,1906,5326
261020,201905,6066,16827,5202,15268,253,904,4124,11643,4377,12547
261030,201905,4071,11645,3530,10735,159,584,2774,8211,2933,8795
261040,201905,5159,15379,4203,13458,199,787,3061,9611,3260,10398
261050,201905,7612,20378,6916,19215,510,1170,4986,13908,5496,15078
261060,201905,13577,34816,11964,32769,390,1267,9811,26569,10201,27836
261070,201905,59720,132808,49672,119326,3078,7343,37083,87310,40161,94653
261080,201905,6231,15656,5743,15010,161,432,5236,13654,5397,14086
261090,201905,18100,44304,16175,41812,365,1275,13876,35244,14241,36519
261100,201905,8147,23134,7058,21490,570,1875,5069,15424,5639,17299
261110,201905,60312,172098,50891,155536,8781,28063,27508,84043,36289,112106
261120,201905,3776,9423,3247,8714,90,259,2790,7471,2880,7730
261130,201905,7365,17975,6492,16824,126,367,5729,14755,5855,15122
261140,201905,3526,8322,3161,7828,177,491,2535,6154,2712,6645
261150,201905,5252,14055,4652,13120,96,381,3992,11093,4088,11474
261153,201905,1860,5587,1629,5165,64,258,1118,3519,1182,3777
261160,201905,204387,486414,167843,435159,41813,111571,68169,179545,109982,291116
261170,201905,5903,15076,5284,14127,359,928,4161,11043,4520,11971
261180,201905,9725,24819,8553,23258,508,1479,6121,16552,6629,18031
261190,201905,4657,13936,4186,13112,243,1024,3139,9492,3382,10516
261200,201905,3331,7756,2975,7279,140,353,2478,5956,2618,6309
261210,201905,1923,4696,1630,4285,64,204,1360,3511,1424,3715
261220,201905,13601,39223,11307,34797,1445,4805,6368,19280,7813,24085
261230,201905,4133,11958,3441,10992,67,288,2827,9106,2894,9394
261240,201905,5068,13127,4477,12187,253,732,3663,9832,3916,10564
261245,201905,3526,10114,3003,9186,93,427,2351,6931,2444,7358
261247,201905,2903,8775,2440,7914,140,521,1684,5389,1824,5910
261250,201905,21065,49010,18164,45574,1761,4092,13623,34985,15384,39077
261255,201905,3952,11843,3329,10629,150,665,2445,7504,2595,8169
261260,201905,12887,34703,11108,32408,409,1672,9312,26773,9721,28445
261270,201905,3998,10468,3557,9860,170,599,2955,8003,3125,8602
261280,201905,2571,7289,2275,6766,81,327,1778,5145,1859,5472
261290,201905,2942,7755,2506,7240,85,336,2026,5868,2111,6204
261300,201905,11796,33775,10049,30727,571,2154,7217,21557,7788,23711
261310,201905,8503,22180,7258,20378,782,2442,5080,13865,5862,16307
261320,201905,5945,16932,5191,15629,92,423,4323,12759,4415,13182
261330,201905,5930,14773,5383,14029,148,521,4665,11924,4813,12445
261340,201905,4122,12054,3592,11322,181,736,2813,8734,2994,9470
261350,201905,8628,25477,7707,23910,134,664,6243,18965,6377,19629
261360,201905,8167,20132,6938,18378,256,809,5473,14018,5729,14827
261370,201905,21728,55944,18410,51318,2414,6786,11447,32074,13861,38860
261380,201905,3943,12229,3545,11503,473,1666,2319,7401,2792,9067
261390,201905,15914,46184,13520,42250,1231,4208,8777,27222,10008,31430
261400,201905,4623,14820,4013,13529,165,769,2978,9746,3143,10515
261410,201905,9316,23920,7784,21463,523,1469,6034,16342,6557,17811
261420,201905,7185,22172,6560,21376,811,3038,4501,14540,5312,17578
261430,201905,3430,9745,2887,8890,78,311,2367,7178,2445,7489
261440,201905,1448,4364,1227,3927,41,199,858,2630,899,2829
261450,201905,14955,40604,13340,38035,246,979,11067,31327,11313,32306
261460,201905,7384,20430,6583,19237,179,677,5521,15961,5700,16638
261470,201905,4193,10513,3703,9866,42,196,3132,8323,3174,8519
261480,201905,4843,15159,4208,14071,231,963,3189,10430,3420,11393
261485,201905,4949,14185,4257,13073,388,1320,2914,8778,3302,10098
261500,201905,5594,14736,4933,13825,432,1080,3387,9838,3819,10918
261510,201905,1849,5617,1599,5173,65,244,1177,3857,1242,4101
261520,201905,2388,7349,2184,6931,92,338,1514,4802,1606,5140
261530,201905,11264,33920,9280,30076,1148,4284,4459,14068,5607,18352
261540,201905,7908,23044,7123,21850,1106,3352,4027,12880,5133,16232
261550,201905,3585,9640,3144,8937,215,707,2247,6227,2462,6934
261560,201905,7658,23066,6668,21572,363,1409,4946,15974,5309,17383
261570,201905,3456,9406,2784,8311,206,756,1915,5558,2121,6314
261580,201905,6542,17450,5771,16409,122,562,5143,14408,5265,14970
261590,201905,2675,6931,2136,6140,74,239,1583,4517,1657,4756
261600,201905,5090,13184,4273,11938,417,1054,2838,8236,3255,9290
261610,201905,2336,6468,1940,5807,96,366,1397,4123,1493,4489
261618,201905,2551,6480,2228,6006,76,230,1768,4703,1844,4933
261620,201905,4015,11628,3733,11202,874,2366,2253,7133,3127,9499
261630,201905,6392,18049,5462,16289,404,1485,3587,10178,3991,11663
261640,201905,36280,82859,31313,76600,1687,3506,24123,60295,25810,63801
261650,201905,4143,10413,3617,9723,153,528,2701,7156,2854,7684
270010,201905,4233,14533,3708,13588,170,949,2890,10317,3060,11266
270020,201905,3860,9868,3421,9293,187,600,2840,7551,3027,8151
270030,201905,32973,91671,28329,84243,4039,11842,18409,55034,22448,66876
270040,201905,11067,30005,9555,28194,419,1722,7813,22709,8232,24431
270050,201905,5469,12671,4650,11759,181,452,4106,10418,4287,10870
270060,201905,2019,5275,1713,4913,126,336,1358,3944,1484,4280
270070,201905,4566,13038,3997,12228,149,584,3336,10006,3485,10590
270080,201905,1419,3960,1179,3549,45,159,893,2570,938,2729
270090,201905,1869,5723,1648,5299,74,329,1302,4053,1376,4382
270100,201905,5512,14974,4808,13915,199,787,3883,10950,4082,11737
270110,201905,3230,7869,2599,7113,139,345,2036,5797,2175,6142
270120,201905,2922,7973,2542,7481,78,314,2168,6314,2246,6628
270130,201905,5119,13505,4435,12691,162,528,3744,10743,3906,11271
270135,201905,2032,4916,1723,4563,54,173,1540,4052,1594,4225
270140,201905,9593,22513,7900,20187,354,1329,6364,15385,6718,16714
270150,201905,2709,8103,2525,7835,6,29,2418,7491,2424,7520
270160,201905,5771,16356,5077,15521,71,430,4675,14128,4746,14558
270170,201905,3431,10127,2926,9423,219,1002,2154,6646,2373,7648
270180,201905,2235,6984,2040,6723,48,240,1795,5828,1843,6068
270190,201905,1664,4992,1493,4773,53,260,1285,4037,1338,4297
270200,201905,2399,7363,2084,6920,129,510,1508,4909,1637,5419
270210,201905,5663,13645,4909,12789,133,482,4442,11398,4575,11880
270220,201905,1427,3869,1161,3489,221,672,632,1906,853,2578
270230,201905,9152,26176,7628,23777,701,2516,5242,16032,5943,18548
270235,201905,5837,18113,5074,16855,163,720,4061,13327,4224,14047
270240,201905,10442,28673,8531,26209,954,3221,6083,18610,7037,21831
270250,201905,2827,7303,2492,6835,226,589,1900,5256,2126,5845
270255,201905,4554,13142,3513,11191,141,571,2565,7996,2706,8567
270260,201905,5591,16690,5099,15877,119,619,4379,13211,4498,13830
270270,201905,1043,2753,892,2557,120,342,623,1767,743,2109
270280,201905,3896,9446,3107,8444,485,830,2138,6269,2623,7099
270290,201905,7679,24529,6923,23260,241,1078,5870,19475,6111,20553
270300,201905,4120,11048,3254,10095,172,545,2464,7769,2636,8314
270310,201905,7050,19808,6108,18414,141,727,5176,15166,5317,15893
270320,201905,5537,16261,4846,14944,522,1670,3373,10147,3895,11817
270330,201905,3821,12689,3428,12074,258,1100,2640,9199,2898,10299
270340,201905,1632,4522,1400,4208,62,192,1143,3410,1205,3602
270350,201905,1839,4507,1529,4130,182,547,1042,2819,1224,3366
270360,201905,2453,6391,2193,6088,70,194,1989,5539,2059,5733
270370,201905,1407,4402,1277,4151,49,221,1024,3267,1073,3488
270375,201905,3057,7268,2596,6735,17,57,2427,6297,2444,6354
270380,201905,5590,16269,4726,15086,534,1716,3147,10373,3681,12089
270390,201905,1198,3073,982,2811,26,128,793,2237,819,2365
270400,201905,6181,16683,5242,15207,217,722,4077,11581,4294,12303
270410,201905,4532,13409,3955,12464,183,681,3198,9968,3381,10649
270420,201905,5475,16471,5001,15779,169,792,4230,13043,4399,13835
270430,201905,136933,336634,109208,300790,22397,64320,50327,140640,72724,204960
270440,201905,4776,13063,4109,12241,99,446,3499,10277,3598,10723
270450,201905,6744,18684,6038,17826,272,1015,5041,14776,5313,15791
270460,201905,3778,8406,3298,7848,91,223,3029,7131,3120,7354
270470,201905,10924,31248,9578,29262,853,2801,7066,21593,7919,24394
270480,201905,2836,7755,2446,7178,138,542,1941,5503,2079,6045
270490,201905,954,2716,835,2567,45,164,658,1980,703,2144
270500,201905,4886,15050,4376,14265,229,937,3483,11176,3712,12113
270510,201905,5495,15167,4714,14096,398,1552,3441,9805,3839,11357
270520,201905,3896,11360,3094,9929,683,2244,1205,4047,1888,6291
270530,201905,1184,3515,1032,3270,49,156,763,2427,812,2583
270540,201905,2142,6398,1884,6060,66,307,1618,5107,1684,5414
270550,201905,6665,17723,5481,16407,548,1417,4133,12801,4681,14218
270560,201905,3051,8177,2689,7679,168,526,2081,5839,2249,6365
270570,201905,4049,11535,3446,10599,101,412,2819,8533,2920,8945
270580,201905,2293,6538,2087,6230,100,308,1787,5296,1887,5604
270590,201905,1606,4788,1483,4621,16,84,1401,4348,1417,4432
270600,201905,2739,8562,2474,8138,59,308,2168,7016,2227,7324
270610,201905,3704,9754,3158,9025,90,341,2788,7864,2878,8205
270620,201905,1215,3796,1116,3613,45,191,936,2934,981,3125
270630,201905,16570,41968,14482,39035,701,2303,11957,31556,12658,33859
270640,201905,5408,15703,4730,14641,186,768,3805,11450,3991,12218
270642,201905,2460,8011,2195,7579,152,727,1673,5562,1825,6289
270644,201905,3556,8952,2907,8100,240,647,2191,6208,2431,6855
270650,201905,3127,9367,2774,8850,419,1511,1848,5701,2267,7212
270660,201905,2086,5241,1699,4692,82,304,1277,3441,1359,3745
270670,201905,15542,37154,13078,34143,520,1625,10890,27852,11410,29477
270680,201905,5267,13194,4726,12583,131,209,4403,11887,4534,12096
270690,201905,8967,22646,7470,20769,889,2346,5380,15053,6269,17399
270700,201905,534,1617,468,1500,25,107,348,1107,373,1214
270710,201905,5538,16832,5033,16084,259,1141,4109,12801,4368,13942
270720,201905,3414,10329,3036,9685,70,400,2650,8260,2720,8660
270730,201905,7963,18254,7120,17317,277,653,5639,14943,5916,15596
270740,201905,2335,6241,2078,5926,101,368,1712,4759,1813,5127
270750,201905,5530,15004,4884,14149,148,617,4193,12031,4341,12648
270760,201905,3312,9420,2883,8826,64,330,2427,7315,2491,7645
270770,201905,20966,51440,16536,45999,2972,7567,9598,28397,12570,35964
270780,201905,1739,5123,1626,4963,93,340,1351,4057,1444,4397
270790,201905,1539,4482,1306,4137,113,381,841,2623,954,3004
270800,201905,10590,29521,9502,27982,380,1518,8087,23229,8467,24747
270810,201905,3245,9408,2557,8215,193,782,1758,5507,1951,6289
270820,201905,1668,5041,1407,4605,63,279,1097,3495,1160,3774
270830,201905,5257,12878,4285,11674,197,677,3404,9151,3601,9828
270840,201905,8137,24327,7298,23135,195,1066,6352,19574,6547,20640
270850,201905,8818,21612,7926,20497,582,1787,6586,16618,7168,18405
270860,201905,12174,29430,10236,27091,427,1416,8467,21864,8894,23280
270870,201905,2081,6036,1781,5518,206,677,1229,3829,1435,4506
270880,201905,8090,24311,7262,23079,236,1070,5995,18666,6231,19736
270890,201905,2637,7318,2281,6828,180,619,1609,4731,1789,5350
270895,201905,2934,9491,2718,9194,77,428,2391,7901,2468,8329
270900,201905,1813,4735,1383,4057,50,165,1084,3134,1134,3299
270910,201905,3848,11364,3314,10464,118,469,2606,8104,2724,8573
270915,201905,9091,26968,7482,24200,734,2788,4986,15699,5720,18487
270920,201905,5251,16538,4782,15741,225,1070,3857,12236,4082,13306
270930,201905,17061,40675,13403,36338,1831,4474,9117,25602,10948,30076
270940,201905,6214,17233,5444,16270,248,1199,4315,12424,4563,13623
280010,201905,677,1864,549,1592,18,80,384,997,402,1077
280020,201905,4731,12340,4054,11265,532,1400,2667,7461,3199,8861
280030,201905,72760,174185,57057,151819,13321,35741,23793,65979,37114,101720
280040,201905,3018,8502,2637,7924,272,859,1754,5199,2026,6058
280050,201905,3897,11198,3355,10299,540,1745,1978,6067,2518,7812
280060,201905,5407,14687,4358,13062,767,2381,2158,6710,2925,9091
280067,201905,6909,17478,5880,15890,352,1012,4232,11144,4584,12156
280070,201905,1896,5773,1779,5561,89,323,1482,4548,1571,4871
280100,201905,3825,10498,3234,9527,342,1044,2233,6546,2575,7590
280110,201905,1356,3738,1183,3468,19,98,1021,2927,1040,3025
280120,201905,7478,22098,6724,20843,714,2043,4978,15693,5692,17736
280130,201905,9004,21521,7908,19948,509,1363,6242,15604,6751,16967
280140,201905,5488,13411,4845,12536,251,716,4034,10323,4285,11039
280150,201905,3947,10066,3450,9413,212,566,2799,7613,3011,8179
280160,201905,1243,3605,1029,3229,114,378,659,2015,773,2393
280170,201905,5131,13684,4573,12931,241,710,3645,10249,3886,10959
280190,201905,1206,2750,1031,2506,65,167,810,1924,875,2091
280200,201905,1319,3491,1068,3084,102,366,731,2042,833,2408
280210,201905,15854,40836,13828,37957,1730,5057,8554,23375,10284,28432
280220,201905,1751,4730,1494,4370,39,214,1212,3510,1251,3724
280230,201905,3963,10176,3467,9447,273,673,2503,6795,2776,7468
280240,201905,3378,9062,3034,8542,60,307,2568,7020,2628,7327
280250,201905,838,2134,679,1879,76,231,401,1063,477,1294
280260,201905,2121,5211,1901,4940,42,107,1741,4533,1783,4640
280270,201905,2292,6527,2035,6122,126,470,1686,4922,1812,5392
280280,201905,4051,12496,3622,11884,458,1402,2523,8556,2981,9958
280290,201905,17139,46706,14918,43484,1448,4576,10000,29293,11448,33869
280300,201905,11343,28355,9839,26712,262,871,7630,21995,7892,22866
280310,201905,1347,3522,1118,3133,36,130,828,2246,864,2376
280320,201905,8593,23692,7446,21923,859,2581,4893,14201,5752,16782
280330,201905,4711,11840,3962,10734,268,743,2913,7830,3181,8573
280340,201905,5475,11395,4646,10492,244,432,3996,9173,4240,9605
280350,201905,24574,59527,21500,55288,1323,3727,16523,41641,17846,45368
280360,201905,5880,16592,5146,15316,856,2578,2896,8699,3752,11277
280370,201905,2221,5472,1810,4751,66,186,1421,3639,1487,3825
280380,201905,984,2727,849,2540,94,290,537,1607,631,1897
280390,201905,3571,9074,2953,8058,131,363,2307,6217,2438,6580
280400,201905,3953,10293,3398,9472,473,1228,2117,6113,2590,7341
280410,201905,2169,6200,1742,5439,184,621,1037,3144,1221,3765
280420,201905,4295,11628,3910,11105,89,330,3529,9959,3618,10289
280430,201905,2042,5066,1783,4712,75,298,1426,3642,1501,3940
280440,201905,4350,11821,3813,10995,203,695,3104,8700,3307,9395
280445,201905,2281,5837,2013,5358,56,186,1497,3795,1553,3981
280450,201905,10285,23641,9018,21964,497,965,7336,18075,7833,19040
280460,201905,6746,16385,6111,15480,468,1118,4981,12563,5449,13681
280470,201905,1733,4945,1487,4492,59,229,1089,3203,1148,3432
280480,201905,39921,98908,34715,91633,2851,8247,24786,64072,27637,72319
280490,201905,3761,10817,3251,9951,91,414,2477,7317,2568,7731
280500,201905,973,2372,825,2165,35,134,678,1744,713,1878
280510,201905,2543,6718,2191,6196,82,320,1667,4602,1749,4922
280520,201905,1613,4137,1417,3874,76,217,1124,3024,1200,3241
280530,201905,2635,6497,2259,6018,316,726,1573,4296,1889,5022
280540,201905,8937,24179,8140,23006,236,888,7059,19561,7295,20449
280550,201905,6701,15807,5418,13943,239,773,4293,10655,4532,11428
280560,201905,7073,20136,6623,19457,150,577,5763,16704,5913,17281
280570,201905,6369,15850,5159,14289,216,787,3776,10283,3992,11070
280580,201905,5536,15202,4762,13986,534,1469,3298,9789,3832,11258
280590,201905,2970,6866,2486,6278,128,502,1875,4453,2003,4955
280600,201905,3464,9462,3063,8866,170,562,2184,6270,2354,6832
280610,201905,2490,6243,2250,5904,159,407,1807,4697,1966,5104
280620,201905,5321,13385,4527,12304,424,994,3182,8951,3606,9945
280630,201905,3762,10862,3428,10364,173,639,2759,8258,2932,8897
280640,201905,2408,6525,2152,6238,68,205,1903,5528,1971,5733
280650,201905,1245,3261,976,2847,104,337,671,1880,775,2217
280660,201905,3194,7495,2808,7030,97,268,2461,6092,2558,6360
280670,201905,19366,44277,16798,40980,957,2538,13294,32130,14251,34668
280680,201905,2719,6697,2320,6098,193,396,1669,4393,1862,4789
280690,201905,952,2443,792,2216,28,87,597,1632,625,1719
280700,201905,1131,2891,967,2632,22,88,757,2017,779,2105
280710,201905,14991,33923,12727,31328,494,969,10945,27402,11439,28371
280720,201905,2697,6038,2189,5444,90,267,1474,3854,1564,4121
280730,201905,1057,2726,940,2531,53,164,703,1826,756,1990
280740,201905,14143,34878,12059,31684,936,2591,8385,21541,9321,24132
280750,201905,3544,10099,3103,9313,175,632,2233,6560,2408,7192
280760,201905,6174,17101,5457,15966,559,1593,3662,10945,4221,12538
290010,201905,3113,6641,2068,4995,10,36,1677,3843,1687,3879
290020,201905,5393,14430,4932,13813,369,742,4118,11880,4487,12622
290030,201905,4280,10307,3571,9502,174,427,2982,7994,3156,8421
290035,201905,5211,11535,4239,10261,356,596,3334,8420,3690,9016
290040,201905,4280,10475,3639,9691,126,351,2852,7859,2978,8210
290050,201905,2090,6677,1739,5920,128,530,1170,3871,1298,4401
290060,201905,1308,3222,970,2657,84,293,650,1707,734,2000
290070,201905,35157,79830,30331,73654,2024,5166,22603,54238,24627,59404
290080,201905,5347,15931,4559,14735,486,1680,3108,10145,3594,11825
290090,201905,2155,4198,1552,3549,30,84,1397,3161,1427,3245
290100,201905,9795,26171,8062,23534,1150,3165,4617,13892,5767,17057
290110,201905,5058,13728,4549,12837,399,1170,3210,8967,3609,10137
290115,201905,4109,12027,3499,10955,232,802,2606,8091,2838,8893
290120,201905,6528,16235,5464,14861,132,497,4715,12572,4847,13069
290130,201905,4587,11256,3636,10070,141,474,2871,7847,3012,8321
290135,201905,4266,10146,3448,8786,224,581,2583,6390,2807,6971
290140,201905,4575,12296,3624,11008,111,436,3069,9248,3180,9684
290150,201905,2439,6512,2125,6109,165,514,1587,4528,1752,5042
290160,201905,3127,7514,2818,7111,295,666,2153,5457,2448,6123
290170,201905,3269,8518,2910,8106,107,322,2581,7225,2688,7547
290180,201905,2967,8077,2436,7236,78,285,1954,5740,2032,6025
290190,201905,4108,11931,3629,11272,165,696,2951,8997,3116,9693
290195,201905,2331,5902,1859,5231,33,160,1523,4249,1556,4409
290200,201905,4026,11348,3331,10193,225,758,2537,7696,2762,8454
290205,201905,3390,8788,2984,8182,138,528,2349,6215,2487,6743
290210,201905,13174,37105,11674,34846,951,2595,8899,27178,9850,29773
290220,201905,2751,7056,2450,6677,154,465,1964,5281,2118,5746
290225,201905,3339,7183,2634,6428,237,531,2148,5283,2385,5814
290230,201905,2494,6681,2270,6417,37,137,2023,5689,2060,5826
290240,201905,3618,9214,2955,8359,102,334,2449,6880,2551,7214
290250,201905,4039,11763,3456,10930,138,476,2796,8999,2934,9475
290260,201905,5396,13521,4423,12119,205,717,3557,9486,3762,10203
290265,201905,3513,10381,2844,9049,145,556,2098,6573,2243,7129
290270,201905,11200,38355,10582,37272,583,2599,8451,29314,9034,31913
290280,201905,5988,18054,5188,16486,333,1226,3705,11590,4038,12816
290290,201905,9979,29419,8187,26044,824,2877,5420,16961,6244,19838
290300,201905,4194,11542,3151,9555,184,620,2207,6687,2391,7307
290310,201905,1525,3928,1267,3594,84,335,953,2604,1037,2939
290320,201905,23885,64014,19352,56961,4366,12786,9236,28420,13602,41206
290323,201905,3717,10195,3248,9486,79,275,2619,7577,2698,7852
290327,201905,4245,12280,3593,11007,276,811,2510,7655,2786,8466
290330,201905,2079,4488,1659,4025,44,83,1468,3574,1512,3657
290340,201905,5604,14681,4431,13194,499,1556,3170,9553,3669,11109
290350,201905,4672,13117,3876,11757,292,967,2761,8362,3053,9329
290360,201905,5008,13339,4402,12534,127,392,3786,10771,3913,11163
290370,201905,5298,12902,3925,11133,198,485,2900,8386,3098,8871
290380,201905,5555,14910,4733,13771,123,357,4110,12050,4233,12407
290390,201905,14261,40713,12082,37427,1231,3787,8202,25763,9433,29550
290395,201905,2753,8202,2305,7414,71,352,1784,5632,1855,5984
290400,201905,3618,9918,2937,8797,91,387,2233,6512,2324,6899
290405,201905,4583,13576,3900,12360,257,876,2764,8886,3021,9762
290410,201905,5667,15794,4442,13742,115,549,3384,10107,3499,10656
290420,201905,2991,8453,2461,7604,86,325,1893,5811,1979,6136
290430,201905,3096,8697,2548,7824,267,857,1672,5107,1939,5964
290440,201905,2763,7082,2001,5873,44,140,1444,4295,1488,4435
290450,201905,3296,8765,2676,7842,152,502,2013,5857,2165,6359
290460,201905,11572,32764,9941,29671,2101,6329,4615,13717,6716,20046
290470,201905,4430,11213,3308,9630,337,1085,1913,5613,2250,6698
290475,201905,6411,18765,5435,16988,101,530,4400,13419,4501,13949
290480,201905,1744,4520,1474,4122,116,361,992,2644,1108,3005
290485,201905,4478,13320,3977,12556,124,644,3358,10361,3482,11005
290490,201905,9057,21589,8075,20242,508,1244,6338,15992,6846,17236
290500,201905,3893,11915,3045,10028,526,1815,1396,4473,1922,6288
290510,201905,3356,8603,2827,7909,80,281,2414,6667,2494,6948
290515,201905,3705,10107,3183,9428,64,190,2793,8439,2857,8629
290520,201905,11151,32414,8717,27654,512,1853,5498,17128,6010,18981
290530,201905,4965,14238,4255,13074,155,547,3528,10836,3683,11383
290540,201905,3454,9244,3099,8810,72,254,2811,7939,2883,8193
290550,201905,4298,11278,3751,10636,22,85,3459,9930,3481,10015
290560,201905,6544,17130,5042,14871,464,1651,3291,9366,3755,11017
290570,201905,42230,106469,38237,101307,2564,7024,30597,80475,33161,87499
290580,201905,7758,23209,6777,21748,635,2052,4916,16112,5551,18164
290590,201905,7022,21875,5998,20035,148,639,4870,16260,5018,16899
290600,201905,18425,51899,16490,48832,656,2153,13160,38814,13816,40967
290610,201905,2510,8007,1993,6940,104,443,1377,4717,1481,5160
290620,201905,6560,18413,5662,16913,203,623,4708,13984,4911,14607
290630,201905,8998,22177,7216,19842,599,1610,5549,15353,6148,16963
290640,201905,2729,7169,2083,6186,72,243,1540,4557,1612,4800
290650,201905,12337,32164,11152,30702,2843,7382,6280,18364,9123,25746
290660,201905,3677,9479,3083,8616,53,122,2296,6686,2349,6808
290670,201905,6603,18733,5690,17222,428,1250,4324,13244,4752,14494
290680,201905,10597,29852,9034,27515,225,1203,7368,21825,7593,23028
290682,201905,4618,12259,4073,11488,136,328,3432,9725,3568,10053
290685,201905,3380,7808,2405,6405,176,454,1529,4311,1705,4765
290687,201905,6593,18169,5374,16129,736,2118,3374,10425,4110,12543
290689,201905,2772,7936,2258,7011,127,403,1663,5175,1790,5578
290690,201905,5652,14705,4587,13206,376,1113,3257,9283,3633,10396
290700,201905,2603,7201,2317,6821,86,290,1886,5572,1972,5862
290710,201905,8485,23949,7228,22197,176,745,6110,18633,6286,19378
290720,201905,18831,51624,17147,49061,955,3137,13632,38463,14587,41600
290730,201905,7201,17452,6155,16206,293,653,4775,12650,5068,13303
290740,201905,1056,2891,803,2452,40,159,616,1876,656,2035
290750,201905,10892,27989,9445,25513,799,2326,6703,17524,7502,19850
290755,201905,2079,5896,1686,5161,101,340,1187,3619,1288,3959
290760,201905,3803,11204,3034,9707,249,743,1945,6413,2194,7156
290770,201905,2605,8462,2361,8160,55,288,1972,6863,2027,7151
290780,201905,8326,20728,7188,19196,321,722,5663,15342,5984,16064
290790,201905,4611,12704,4024,11905,146,466,3386,10098,3532,10564
290800,201905,7201,15006,5162,12613,342,790,3800,9401,4142,10191
290810,201905,5557,14909,4465,13251,116,409,3305,9895,3421,10304
290820,201905,4934,13398,4435,12629,215,666,3276,9412,3491,10078
290830,201905,4563,10454,4107,9855,55,162,3558,8397,3613,8559
290840,201905,16546,45114,14531,41931,1835,4512,9450,28613,11285,33125
290850,201905,6358,15916,5755,15242,320,768,4812,12958,5132,13726
290860,201905,5909,17522,5175,16636,219,751,4352,14200,4571,14951
290870,201905,4760,13263,3671,11243,118,419,2609,7887,2727,8306
290880,201905,1385,3518,1107,3145,73,196,771,2250,844,2446
290890,201905,8833,18376,7928,17327,155,382,7384,16013,7539,16395
290900,201905,2322,6186,1775,5258,99,288,1133,3286,1232,3574
290910,201905,5059,12456,3906,10696,49,198,3218,8695,3267,8893
290920,201905,5108,12747,4670,12226,61,144,4380,11507,4441,11651
290930,201905,7834,22115,6335,19484,199,925,4952,14746,5151,15671
290940,201905,3699,10450,3087,9573,171,649,2433,7534,2604,8183
290950,201905,1479,3785,1227,3414,64,173,878,2452,942,2625
290960,201905,5407,14525,4862,13843,142,420,4091,11622,4233,12042
290970,201905,3493,10192,2853,9070,138,477,2149,6804,2287,7281
290980,201905,11626,28607,9839,25809,867,2438,5997,15310,6864,17748
290990,201905,9287,25245,8141,23348,303,1190,6706,18582,7009,19772
291000,201905,3423,9082,2718,8191,173,476,2150,6597,2323,7073
291005,201905,14865,36765,13165,34561,873,2346,10647,27761,11520,30107
291010,201905,2974,9065,2423,7895,133,476,1605,5107,1738,5583
291020,201905,1286,3229,1021,2729,25,87,728,1841,753,1928
291030,201905,2409,6003,1677,4695,97,259,1088,2951,1185,3210
291040,201905,5279,14930,4516,13828,195,834,3549,10697,3744,11531
291050,201905,7380,20082,6385,18639,793,2507,4374,12574,5167,15081
291060,201905,5788,18579,5032,17478,400,1693,3694,12706,4094,14399
291070,201905,15603,42761,13188,38942,533,1887,10580,30927,11113,32814
291072,201905,23864,62919,17372,51136,3413,10400,7145,21208,10558,31608
291075,201905,5239,13498,4660,12549,130,387,3794,10000,3924,10387
291077,201905,1578,4164,1243,3559,50,142,879,2496,929,2638
291080,201905,87888,233985,71403,209540,24486,73552,16216,50756,40702,124308
291085,201905,5643,14392,4723,13008,201,641,3920,10689,4121,11330
291090,201905,1948,3706,1435,3138,30,79,1205,2588,1235,2667
291100,201905,3123,6987,2181,5842,116,356,1662,4367,1778,4723
291110,201905,5897,17815,5020,16279,327,1353,3755,11694,4082,13047
291120,201905,7680,19105,6568,17636,384,1101,4910,13138,5294,14239
291125,201905,2165,3827,1583,3178,127,179,1187,2491,1314,2670
291130,201905,3148,9184,2358,7616,89,396,1671,5220,1760,5616
291140,201905,4760,13102,3511,10756,420,1131,2237,6920,2657,8051
291150,201905,2260,5158,1883,4727,13,40,1761,4401,1774,4441
291160,201905,5047,14160,4239,12956,410,1362,2792,8434,3202,9796
291165,201905,2149,5962,1665,5037,42,180,1196,3472,1238,3652
291170,201905,20623,52869,17409,47426,1010,2981,11328,30467,12338,33448
291180,201905,5838,14054,4490,12149,395,1014,3318,9038,3713,10052
291185,201905,3164,8660,2752,7962,84,273,2114,6066,2198,6339
291190,201905,7574,18916,6288,17194,336,1033,4904,13364,5240,14397
291200,201905,2831,7899,2107,6511,91,317,1293,3888,1384,4205
291210,201905,6873,15217,5285,13354,166,554,3935,9923,4101,10477
291220,201905,3996,11588,3625,11004,233,849,2788,8341,3021,9190
291230,201905,4391,9649,3407,8556,59,131,3035,7717,3094,7848
291240,201905,4202,10962,3645,10014,64,224,3125,8451,3189,8675
291250,201905,3409,10120,2675,8778,171,567,1724,5688,1895,6255
291260,201905,1410,3327,1209,3070,33,103,982,2514,1015,2617
291270,201905,5061,13774,4069,12227,615,1822,2617,7992,3232,9814
291280,201905,2502,6462,1906,5514,151,512,1159,3223,1310,3735
291290,201905,5812,15608,4610,13712,402,1297,3116,9199,3518,10496
291300,201905,3930,10634,2961,9011,134,463,2180,6522,2314,6985
291310,201905,5085,13759,4358,12391,123,431,3629,10096,3752,10527
291320,201905,6025,17289,4718,14772,1077,3107,2300,7633,3377,10740
291330,201905,1800,4618,1510,4122,78,210,1100,2938,1178,3148
291340,201905,4158,10874,3468,9720,82,278,2681,7371,2763,7649
291345,201905,2961,9070,2711,8678,124,435,2220,7112,2344,7547
291350,201905,6750,17130,5275,15237,85,266,4491,13177,4576,13443
291360,201905,35142,83894,28296,75313,3395,9248,17434,47355,20829,56603
291370,201905,7832,21731,7056,20575,527,1694,5258,15135,5785,16829
291380,201905,3342,9485,2989,8957,93,441,2469,7247,2562,7688
291390,201905,12883,28520,10162,25480,390,1016,8407,21004,8797,22020
291400,201905,13426,35547,11299,32322,1559,4034,6752,20625,8311,24659
291410,201905,2849,7596,2192,6482,52,232,1609,4627,1661,4859
291420,201905,1928,4810,1531,4313,39,153,1303,3641,1342,3794
291430,201905,2888,8193,2497,7551,99,438,1969,5778,2068,6216
291440,201905,6282,18338,5423,16888,319,1103,4259,13257,4578,14360
291450,201905,8782,22687,7364,21020,118,234,6435,18935,6553,19169
291460,201905,15128,40937,13364,38280,701,2248,10008,28421,10709,30669
291465,201905,8871,22798,7119,20744,193,874,5980,17247,6173,18121
291470,201905,15428,36347,13150,33770,659,1637,9797,25830,10456,27467
291480,201905,40297,91298,29695,76635,3867,10512,15358,39476,19225,49988
291490,201905,5450,13969,4793,13159,184,601,4249,11592,4433,12193
291500,201905,4997,12335,4178,11222,65,270,3762,10046,3827,10316
291510,201905,3896,10242,3020,9069,81,389,2431,7255,2512,7644
291520,201905,4468,10370,3443,9012,171,485,2621,6829,2792,7314
291530,201905,2211,5210,1597,4383,283,699,941,2801,1224,3500
291535,201905,3173,9621,2935,9208,167,501,2272,7233,2439,7734
291540,201905,2251,5157,1584,4342,52,205,1304,3462,1356,3667
291550,201905,5491,12845,4318,11298,400,926,2924,7771,3324,8697
291560,201905,19117,44254,13474,37199,1038,2800,8787,25172,9825,27972
291570,201905,2375,5707,1903,5113,66,158,1565,4322,1631,4480
291580,201905,6168,16429,4877,14657,252,908,3582,10562,3834,11470
291590,201905,1912,5081,1706,4802,121,397,1417,3906,1538,4303
291600,201905,5018,12543,3789,10597,465,1438,2346,6341,2811,7779
291610,201905,5616,15311,5218,14863,89,326,4819,13706,4908,14032
291620,201905,3148,7058,2307,6115,115,305,1776,4793,1891,5098
291630,201905,3199,7361,2383,6301,208,623,1780,4622,1988,5245
291640,201905,15293,38971,11706,33609,1895,5293,4997,15134,6892,20427
291650,201905,9158,23721,8096,22408,491,1056,6802,19200,7293,20256
291660,201905,2050,5058,1493,4169,136,455,966,2539,1102,2994
291670,201905,2057,5408,1749,4980,109,270,1342,3870,1451,4140
291680,201905,4057,10234,3303,9077,301,858,2351,6390,2652,7248
291685,201905,4647,11226,3715,10020,231,484,2814,7880,3045,8364
291690,201905,4217,9399,2859,7441,203,460,2186,5670,2389,6130
291700,201905,8494,24903,7585,23296,415,1463,6140,18566,6555,20029
291710,201905,5172,12714,3878,10857,270,866,2745,7507,3015,8373
291720,201905,4366,13566,3668,12133,411,1463,2406,7748,2817,9211
291730,201905,6305,16532,5461,15406,265,827,4458,12529,4723,13356
291733,201905,2913,7501,2459,6886,67,206,1807,5280,1874,5486
291735,201905,2908,7588,2343,6639,80,231,1829,5147,1909,5378
291740,201905,3829,9989,2915,8381,103,304,2134,6015,2237,6319
291750,201905,19479,47323,15828,41846,1539,4143,10569,27966,12108,32109
291760,201905,10269,30332,8133,26723,2534,9401,2117,6962,4651,16363
291770,201905,6999,19276,5845,17203,446,1370,4208,12098,4654,13468
291780,201905,5029,13606,4541,12883,95,372,3943,11043,4038,11415
291790,201905,2622,7529,2409,7243,255,665,1785,5502,2040,6167
291800,201905,28782,74142,22035,63840,3365,9452,11546,34501,14911,43953
291810,201905,10535,25572,8815,23429,237,723,7596,20030,7833,20753
291820,201905,3800,10168,3315,9497,108,355,2607,7500,2715,7855
291830,201905,4216,10353,3585,9470,211,548,2853,7555,3064,8103
291835,201905,6347,19081,4935,16289,700,2389,2887,9710,3587,12099
291840,201905,46418,128468,40242,119301,4616,14470,27643,81939,32259,96409
291845,201905,2378,6447,1941,5902,95,306,1583,4854,1678,5160
291850,201905,3923,11292,3271,10187,265,756,2342,7500,2607,8256
291855,201905,2168,4377,1717,3855,50,129,1535,3421,1585,3550
291860,201905,2238,5890,1552,4554,41,138,1049,2958,1090,3096
291870,201905,1306,3317,870,2549,56,175,574,1637,630,1812
291875,201905,2684,8143,2354,7475,82,312,1778,5481,1860,5793
291880,201905,5552,16090,4791,14758,269,848,3517,10805,3786,11653
291890,201905,1561,3333,1019,2687,135,330,674,1767,809,2097
291900,201905,1166,2968,905,2541,23,89,714,1945,737,2034
291905,201905,2637,6634,2064,5695,86,292,1539,4111,1625,4403
291910,201905,2890,7402,2437,6861,73,259,2089,5885,2162,6144
291915,201905,7296,21010,6011,18791,241,890,4493,14022,4734,14912
291920,201905,25008,67601,21670,62922,2443,7634,14552,41510,16995,49144
291930,201905,2441,6799,2083,6247,248,795,1352,4012,1600,4807
291940,201905,3831,9990,2557,7795,211,640,1489,4463,1700,5103
291950,201905,9094,27705,7823,25221,421,1563,5285,16860,5706,18423
291955,201905,14560,37238,13123,35363,1209,3356,10153,27543,11362,30899
291960,201905,3096,8325,2533,7525,134,457,1939,5827,2073,6284
291970,201905,4292,11299,3681,10478,174,600,2751,7828,2925,8428
291980,201905,9952,28298,7916,25009,747,2244,5175,16607,5922,18851
291990,201905,2150,5675,1868,5357,21,96,1775,5084,1796,5180
291992,201905,3999,9838,3090,8602,243,575,2426,6877,2669,7452
291995,201905,2142,5780,1727,5166,54,254,1342,3895,1396,4149
292000,201905,2622,6340,2131,5719,115,427,1635,4313,1750,4740
292010,201905,5887,13752,4826,12248,203,602,3967,9856,4170,10458
292020,201905,4530,13276,3787,11937,220,816,2749,8399,2969,9215
292030,201905,1750,5514,1655,5349,72,290,1063,3335,1135,3625
292040,201905,4263,11221,3416,9968,251,676,2624,7832,2875,8508
292045,201905,4010,10631,2975,9087,48,130,2609,8125,2657,8255
292050,201905,6472,18457,5198,16091,276,980,3261,9921,3537,10901
292060,201905,11791,27434,10942,26381,574,1308,9408,22442,9982,23750
292070,201905,5734,15072,5046,14219,281,837,4327,12120,4608,12957
292080,201905,3201,8051,2645,7351,79,257,2336,6476,2415,6733
292090,201905,4531,9860,3279,8380,251,662,2493,6448,2744,7110
292100,201905,10240,25733,8727,23772,1047,3018,5674,15323,6721,18341
292105,201905,3385,8750,2976,8152,89,243,2418,6604,2507,6847
292110,201905,6054,15199,4305,12281,973,2823,1972,5621,2945,8444
292120,201905,6842,17852,5588,15674,399,1194,4151,11419,4550,12613
292130,201905,3364,8187,2761,7440,110,340,2153,5721,2263,6061
292140,201905,5141,12124,4249,10823,283,700,3380,8566,3663,9266
292145,201905,2332,6843,1960,6172,68,218,1480,4682,1548,4900
292150,201905,13502,37649,12000,35261,293,1234,9934,28725,10227,29959
292160,201905,2902,7245,2241,6394,58,175,1834,5377,1892,5552
292170,201905,8190,22177,6855,19925,444,1434,4955,14155,5399,15589
292180,201905,2817,7727,2064,6380,221,658,1248,3798,1469,4456
292190,201905,2874,7690,2464,7074,138,428,1841,5268,1979,5696
292200,201905,7840,20430,5941,17625,1081,3323,3089,9335,4170,12658
292205,201905,3858,10693,3333,9911,64,315,2912,8551,2976,8866
292210,201905,6289,15026,5131,13530,96,429,4542,11778,4638,12207
292220,201905,2067,5107,1826,4748,62,187,1420,3585,1482,3772
292225,201905,3195,9418,2822,8849,76,347,2371,7311,2447,7658
292230,201905,8440,20304,7545,19132,190,683,6401,15858,6591,16541
292240,201905,4737,13858,4082,12634,339,1028,2762,8551,3101,9579
292250,201905,5185,14200,4687,13409,544,1507,3178,9177,3722,10684
292260,201905,3328,8865,2990,8435,130,354,2569,7277,2699,7631
292265,201905,3313,9231,2802,8436,72,359,2188,6407,2260,6766
292270,201905,4300,9959,3446,8936,172,461,2780,7210,2952,7671
292273,201905,2637,5755,2102,5102,60,110,1580,4032,1640,4142
292275,201905,1640,4334,1309,3865,56,140,995,2980,1051,3120
292280,201905,2597,6219,2103,5644,97,209,1746,4838,1843,5047
292285,201905,2547,6230,2003,5473,90,223,1590,4380,1680,4603
292290,201905,7112,19442,5799,17499,185,697,4710,14171,4895,14868
292300,201905,9984,25906,7891,23139,810,2571,5287,15450,6097,18021
292303,201905,2887,8314,2536,7761,75,195,2139,6597,2214,6792
292305,201905,2462,6600,2273,6333,47,218,2010,5481,2057,5699
292310,201905,6673,17194,5739,16037,178,596,4880,13503,5058,14099
292320,201905,6140,16824,4937,14576,255,823,3644,10483,3899,11306
292330,201905,2758,6107,2164,5440,108,258,1673,4309,1781,4567
292335,201905,4714,12298,4206,11570,256,642,3519,9759,3775,10401
292340,201905,5719,16009,4802,14243,218,710,3578,10452,3796,11162
292350,201905,2553,6847,2092,6221,87,327,1697,5024,1784,5351
292360,201905,4856,13092,4054,11695,296,977,2820,7877,3116,8854
292370,201905,10805,24844,9327,22864,132,485,8578,20603,8710,21088
292380,201905,6824,19252,6102,17965,423,1244,4569,13357,4992,14601
292390,201905,4428,8631,3230,7237,104,229,2821,6311,2925,6540
292400,201905,21760,63216,19013,58689,1831,5957,13108,40350,14939,46307
292405,201905,4163,10426,3528,9458,130,335,2874,7649,3004,7984
292410,201905,2152,5157,1847,4779,61,178,1618,4174,1679,4352
292420,201905,3636,10992,3302,10440,143,667,2758,8515,2901,9182
292430,201905,4773,14553,3675,12571,296,1093,2412,8246,2708,9339
292440,201905,8405,26914,7764,25919,126,655,6966,23186,7092,23841
292450,201905,3819,11187,3085,9731,107,411,2388,7509,2495,7920
292460,201905,4852,13513,3994,12034,377,1090,2806,8471,3183,9561
292465,201905,2566,6788,2143,6209,94,235,1470,4548,1564,4783
292467,201905,1821,5208,1632,4951,231,637,1123,3531,1354,4168
292470,201905,2965,7571,2316,6532,68,149,1795,5071,1863,5220
292480,201905,6430,15286,5134,13712,75,287,4587,12091,4662,12378
292490,201905,2099,5573,1753,5059,107,288,1316,3855,1423,4143
292500,201905,6366,17794,5239,15722,567,1752,3411,10128,3978,11880
292510,201905,12418,33920,9901,30103,510,1910,7220,21821,7730,23731
292520,201905,6825,17194,6051,16053,552,1503,4543,11989,5095,13492
292525,201905,5696,13718,4757,12636,121,323,4122,11018,4243,11341
292530,201905,26590,71937,20760,62048,5524,16757,7549,23296,13073,40053
292540,201905,4169,8066,3307,7130,118,217,2910,6281,3028,6498
292550,201905,7817,21312,6075,19132,429,1442,4467,14495,4896,15937
292560,201905,4241,10816,3666,10037,85,281,3018,8234,3103,8515
292570,201905,3763,9784,3185,8843,70,252,2745,7466,2815,7718
292575,201905,6910,20023,6386,19318,301,953,5216,15791,5517,16744
292580,201905,7441,18997,6281,17272,143,478,5268,14329,5411,14807
292590,201905,7381,19578,6384,17937,266,834,5358,14736,5624,15570
292593,201905,2831,7039,2350,6241,81,203,1940,5128,2021,5331
292595,201905,5418,14415,4670,13494,170,567,3873,11058,4043,11625
292600,201905,11009,30016,9472,27686,394,1101,7427,21777,7821,22878
292610,201905,4132,10939,3497,9802,196,485,2547,7237,2743,7722
292620,201905,6368,17648,5362,16462,102,259,4995,15538,5097,15797
292630,201905,8434,20804,6924,18381,581,1572,4681,12398,5262,13970
292640,201905,8121,24300,7096,22592,211,929,5067,16107,5278,17036
292650,201905,4584,11274,4120,10666,129,383,3702,9422,3831,9805
292660,201905,11144,30534,9582,28233,483,1589,7420,21744,7903,23333
292665,201905,2178,6498,1939,6197,78,247,1634,5307,1712,5554
292670,201905,3541,9632,2731,8103,121,399,1875,5465,1996,5864
292680,201905,3962,10689,3175,9219,191,545,2300,6528,2491,7073
292690,201905,2642,6949,1856,5645,189,541,1113,3558,1302,4099
292700,201905,9773,26857,8542,24928,776,2152,5823,17463,6599,19615
292710,201905,2460,7748,2276,7497,49,193,2035,6748,2084,6941
292720,201905,9015,21819,7664,20283,273,761,6093,16329,6366,17090
292730,201905,4410,10413,4143,10085,202,322,3616,8948,3818,9270
292740,201905,317196,789595,280673,735398,42913,113676,171315,445617,214228,559293
292750,201905,6228,16696,5427,15497,261,767,4108,11854,4369,12621
292760,201905,3843,11198,3371,10355,241,806,2439,7425,2680,8231
292770,201905,5982,16189,4824,14517,770,2435,2927,9092,3697,11527
292780,201905,1991,4167,1493,3518,43,152,1189,2662,1232,2814
292790,201905,4105,8772,3171,7760,155,426,2673,6519,2828,6945
292800,201905,10973,27821,9499,25552,343,971,7822,20769,8165,21740
292805,201905,3415,8430,2697,7467,139,403,2079,5731,2218,6134
292810,201905,10525,28248,8348,24851,244,1009,6191,17951,6435,18960
292820,201905,7492,20652,5402,17235,504,1720,3621,11368,4125,13088
292830,201905,2897,6810,2468,6272,86,276,2116,5336,2202,5612
292840,201905,8720,23018,7512,21369,175,686,6452,17895,6627,18581
292850,201905,2519,6795,2118,6181,141,465,1472,4200,1613,4665
292860,201905,16697,37791,14932,35594,664,1620,12419,29262,13083,30882
292870,201905,17096,43764,14877,40606,1057,3207,9895,26584,10952,29791
292880,201905,11110,30372,9584,28067,320,1358,7467,21099,7787,22457
292890,201905,6648,18919,5890,17746,249,982,4959,14728,5208,15710
292895,201905,2957,6475,2169,5276,93,234,1718,4112,1811,4346
292900,201905,2588,7134,2378,6794,53,226,1929,5339,1982,5565
292905,201905,4355,11589,3424,10184,180,623,2456,7199,2636,7822
292910,201905,4896,13531,4473,12885,249,798,3374,9617,3623,10415
292920,201905,9699,26817,9101,25971,256,1010,7902,22091,8158,23101
292925,201905,5390,15296,4620,13949,230,714,3389,10065,3619,10779
292930,201905,6513,19499,5580,17666,493,1784,3462,10624,3955,12408
292935,201905,2334,6002,1822,5424,38,182,1606,4771,1644,4953
292937,201905,3010,7374,2649,6933,69,217,2350,6140,2419,6357
292940,201905,2904,7529,2369,6688,201,480,1682,4903,1883,5383
292950,201905,9653,24892,8463,23061,480,1259,6374,17201,6854,18460
292960,201905,5230,12714,4435,11604,124,350,3537,9098,3661,9448
292970,201905,3827,11211,3360,10499,114,522,2785,8680,2899,9202
292975,201905,4425,9678,3925,9108,167,326,3512,8228,3679,8554
292980,201905,3302,8065,2667,7097,97,304,2129,5551,2226,5855
292990,201905,11334,31160,9549,27976,684,2200,7032,20299,7716,22499
293000,201905,2565,6212,2227,5717,40,155,1744,4481,1784,4636
293010,201905,18074,46849,14639,41301,1949,5661,8902,24987,10851,30648
293015,201905,7963,24878,6330,21639,436,1776,4285,14589,4721,16365
293020,201905,9826,28785,8873,27430,141,659,7867,24562,8008,25221
293030,201905,5342,14412,4079,12457,120,407,2779,8690,2899,9097
293040,201905,3893,10841,3368,10120,80,307,2916,8718,2996,9025
293050,201905,21599,54083,19253,50673,1162,3259,14320,37210,15482,40469
293060,201905,3467,9168,2839,8073,239,730,1978,5492,2217,6222
293070,201905,24668,61025,21042,56160,2488,6876,14056,37717,16544,44593
293075,201905,3347,10750,2960,10107,206,869,2314,7860,2520,8729
293076,201905,3593,8917,3218,8447,84,225,2769,7321,2853,7546
293077,201905,6031,16961,4866,15137,472,1498,3099,9940,3571,11438
293080,201905,4780,14123,4136,13038,116,512,3290,10147,3406,10659
293090,201905,3199,9374,2452,8136,242,855,1577,5222,1819,6077
293100,201905,5642,15326,4606,13434,250,784,3569,10273,3819,11057
293105,201905,3631,11565,3208,10698,201,730,2339,7689,2540,8419
293110,201905,2427,6072,2056,5549,73,285,1686,4407,1759,4692
293120,201905,4322,11892,3858,11147,120,328,3201,9250,3321,9578
293130,201905,3779,10451,3335,9862,84,340,2855,8367,2939,8707
293135,201905,28944,69840,21560,59572,3670,11078,9761,27124,13431,38202
293140,201905,2351,5360,2031,4955,75,193,1684,4072,1759,4265
293150,201905,5342,16174,4471,14530,392,1352,3033,9853,3425,11205
293160,201905,3861,9425,3288,8767,266,469,2681,7509,2947,7978
293170,201905,4553,9992,3974,9234,132,294,3401,7844,3533,8138
293180,201905,4468,12432,3683,11065,114,474,2925,8534,3039,9008
293190,201905,14097,38726,12314,36174,202,870,10735,31318,10937,32188
293200,201905,8070,20298,6541,17866,226,863,5194,13834,5420,14697
293210,201905,5255,13891,4435,12581,308,846,3376,9616,3684,10462
293220,201905,5023,13385,3763,11156,871,2616,1502,4589,2373,7205
293230,201905,3889,10144,2917,8719,246,813,1971,5949,2217,6762
293240,201905,4462,11805,3589,10364,88,256,2737,8121,2825,8377
293245,201905,3857,10426,3469,9874,161,496,2917,8204,3078,8700
293250,201905,5550,13508,4732,12402,222,576,3865,10105,4087,10681
293260,201905,4390,12185,3625,10993,121,387,2537,7643,2658,8030
293270,201905,6950,15848,5597,14380,455,776,4349,11902,4804,12678
293280,201905,4701,12472,4108,11633,261,641,3162,9016,3423,9657
293290,201905,13688,41484,12238,39149,2187,7037,7290,23847,9477,30884
293300,201905,5701,13964,4962,12861,290,720,3649,9504,3939,10224
293305,201905,3964,9863,3492,9245,39,123,3112,8190,3151,8313
293310,201905,2156,5516,1773,4868,59,174,1373,3706,1432,3880
293315,201905,4099,9956,3346,8786,161,397,2718,7102,2879,7499
293317,201905,2523,6240,2223,5803,148,327,1727,4542,1875,4869
293320,201905,11021,28015,10124,26964,333,914,8933,23703,9266,24617
293325,201905,1692,4347,1347,3852,189,550,863,2478,1052,3028
293330,201905,45067,137849,38215,125445,8447,28072,16790,56567,25237,84639
293340,201905,2292,6476,1906,5804,117,424,1293,3866,1410,4290
293345,201905,3302,9225,2673,8281,311,751,1846,6110,2157,6861
293350,201905,6659,18991,5863,18094,59,235,5392,16890,5451,17125
293360,201905,15223,38811,13008,35957,394,1533,11324,30743,11718,32276
310010,201905,835,1979,569,1600,56,188,262,680,318,868
310020,201905,2303,6553,1666,5369,355,1257,284,853,639,2110
310030,201905,1977,5767,1542,4972,235,844,933,2890,1168,3734
310040,201905,936,2467,760,2175,41,165,512,1380,553,1545
310050,201905,1524,4719,1334,4410,177,704,802,2556,979,3260
310060,201905,3190,9158,2786,8632,122,512,2269,6941,2391,7453
310070,201905,350,793,242,630,6,14,182,468,188,482
310080,201905,795,2167,533,1631,82,286,207,586,289,872
310090,201905,4514,12323,3684,10942,285,945,2653,7710,2938,8655
310100,201905,3278,9365,2789,8545,96,437,2227,6592,2323,7029
310110,201905,4642,12516,3657,10766,779,2506,1565,4410,2344,6916
310120,201905,645,1610,406,1204,55,195,226,601,281,796
310130,201905,368,1014,313,928,40,146,203,564,243,710
310140,201905,238,722,173,600,39,150,56,169,95,319
310150,201905,4882,13398,3695,11182,611,2083,1590,4572,2201,6655
310160,201905,7138,18707,5243,15554,1165,3783,1679,4927,2844,8710
310163,201905,996,2961,789,2574,220,801,232,687,452,1488
310170,201905,8894,23268,7205,20616,669,1979,5064,14453,5733,16432
310180,201905,1706,4363,1284,3670,122,419,840,2298,962,2717
310190,201905,2849,8675,2269,7556,536,1976,321,1013,857,2989
310200,201905,1759,5339,1288,4354,232,884,524,1723,756,2607
310205,201905,1081,3015,806,2573,161,574,319,1020,480,1594
310210,201905,2639,7032,2157,6220,101,296,1618,4576,1719,4872
310220,201905,1121,3086,878,2661,86,290,600,1769,686,2059
310230,201905,2246,6421,1831,5608,233,806,1083,3097,1316,3903
310240,201905,887,2840,757,2602,56,237,517,1746,573,1983
310250,201905,1015,2754,826,2453,27,116,587,1706,614,1822
310260,201905,2786,7488,1736,5611,521,1952,382,908,903,2860
310270,201905,2694,6814,2108,5999,105,407,1711,4792,1816,5199
310280,201905,2309,5538,1788,4773,304,875,962,2433,1266,3308
310285,201905,1860,6086,1599,5629,174,712,950,3306,1124,4018
310290,201905,1135,3041,949,2710,209,686,505,1296,714,1982
310300,201905,1450,4411,1265,4083,170,678,684,2032,854,2710
310310,201905,301,775,197,583,33,98,101,296,134,394
310320,201905,503,1306,326,997,27,107,166,483,193,590
310330,201905,477,1133,281,777,37,123,119,292,156,415
310340,201905,7555,21028,6072,18465,941,2789,3002,9392,3943,12181
310350,201905,12245,30320,8310,23810,1840,5584,3091,8576,4931,14160
310360,201905,473,1133,357,982,12,39,261,699,273,738
310370,201905,1276,4062,1066,3649,221,817,328,1142,549,1959
310375,201905,835,2182,562,1761,101,335,240,745,341,1080
310380,201905,388,903,206,589,29,79,88,232,117,311
310390,201905,448,1372,356,1193,96,344,91,243,187,587
310400,201905,9372,23269,6560,18936,852,2837,3633,10172,4485,13009
310410,201905,813,2382,518,1832,102,386,159,516,261,902
310420,201905,4050,10582,2648,7792,410,1367,930,2452,1340,3819
310430,201905,1463,4069,946,3084,193,712,312,904,505,1616
310440,201905,568,1460,395,1156,27,114,234,658,261,772
310445,201905,1323,3867,992,3226,49,187,708,2240,757,2427
310450,201905,4681,11952,3521,10083,195,731,2609,7210,2804,7941
310460,201905,1591,4319,1104,3395,209,687,331,981,540,1668
310470,201905,3804,8342,3009,7295,296,775,2228,5366,2524,6141
310480,201905,968,2582,732,2152,106,338,455,1298,561,1636
310490,201905,2827,7920,2212,6833,293,1078,1144,3289,1437,4367
310500,201905,1378,3953,1003,3263,186,678,486,1541,672,2219
310510,201905,1943,5224,1227,3842,241,840,420,1319,661,2159
310520,201905,1264,3240,905,2615,132,357,502,1447,634,1804
310530,201905,756,1975,434,1332,64,231,124,302,188,533
310540,201905,3200,9277,2638,8270,619,2040,1113,3347,1732,5387
310550,201905,1245,3227,853,2548,72,275,500,1405,572,1680
310560,201905,13871,37364,10083,30680,1909,6562,3719,10202,5628,16764
310570,201905,1086,2923,862,2598,72,271,581,1699,653,1970
310590,201905,4067,11023,3267,9568,249,840,1864,5158,2113,5998
310600,201905,1387,4149,1121,3610,173,630,559,1666,732,2296
310610,201905,486,1301,303,983,57,204,156,471,213,675
310620,201905,162802,427662,119116,347817,21052,70287,51964,135818,73016,206105
310630,201905,4355,12173,3536,10584,277,962,2288,6604,2565,7566
310640,201905,989,3032,832,2711,189,693,309,931,498,1624
310650,201905,2401,7057,1767,5836,199,718,980,3118,1179,3836
310660,201905,1235,3409,1040,3160,40,143,869,2597,909,2740
310665,201905,1351,3549,1065,3129,40,158,875,2536,915,2694
310670,201905,51317,136515,43252,122258,4779,15635,28283,75657,33062,91292
310680,201905,682,1680,572,1521,21,69,460,1183,481,1252
310690,201905,1715,4674,1242,3846,126,448,685,2026,811,2474
310700,201905,491,1117,379,985,38,127,269,661,307,788
310710,201905,5318,15587,3805,13354,903,3689,503,1642,1406,5331
310720,201905,918,2292,723,2035,44,147,530,1445,574,1592
310730,201905,9402,26170,8093,23984,453,1726,5811,16791,6264,18517
310740,201905,5535,15662,3715,11740,652,2215,1172,3427,1824,5642
310750,201905,1207,2975,864,2474,130,424,377,989,507,1413
310760,201905,561,1501,406,1253,27,92,205,651,232,743
310770,201905,1072,3009,731,2463,98,383,351,1114,449,1497
310780,201905,4019,10130,3340,9070,104,329,2515,6744,2619,7073
310790,201905,1784,5687,1554,5194,434,1553,369,1173,803,2726
310800,201905,2212,6719,1608,5474,393,1556,99,306,492,1862
310810,201905,1135,2944,914,2536,48,158,628,1674,676,1832
310820,201905,1173,3079,704,2236,148,502,158,491,306,993
310825,201905,2441,7781,1985,6979,86,478,1554,5241,1640,5719
310830,201905,1541,4540,1044,3476,212,785,426,1319,638,2104
310840,201905,1869,5177,1319,4208,358,1246,313,890,671,2136
310850,201905,1497,4142,1272,3831,61,302,973,2781,1034,3083
310855,201905,3160,8541,2444,7378,199,707,1671,4894,1870,5601
310860,201905,6865,20101,5476,17303,520,1787,3343,10587,3863,12374
310870,201905,1034,2480,785,2113,78,214,558,1517,636,1731
310880,201905,1006,3025,775,2555,93,312,455,1460,548,1772
310890,201905,2261,6454,1449,4880,300,1082,198,575,498,1657
310900,201905,4103,11618,3009,9434,456,1523,1325,3838,1781,5361
310910,201905,1834,4703,1213,3625,124,454,214,561,338,1015
310920,201905,1833,4921,1398,4224,249,798,725,2171,974,2969
310925,201905,940,2680,776,2388,94,323,505,1483,599,1806
310930,201905,5695,15388,4096,12767,793,2585,1964,6260,2757,8845
310940,201905,6248,15703,5022,13857,249,914,3647,9694,3896,10608
310945,201905,1246,3296,1010,2943,117,395,573,1597,690,1992
310950,201905,1841,5542,1233,4162,244,904,425,1299,669,2203
310960,201905,708,1862,424,1333,60,200,145,455,205,655
310970,201905,1158,3492,803,2724,197,731,154,463,351,1194
310980,201905,317,768,212,602,26,77,128,350,154,427
310990,201905,1242,3566,937,2993,204,673,409,1262,613,1935
311000,201905,3971,11413,2953,9661,776,2708,1124,3525,1900,6233
311010,201905,799,2462,638,2103,243,865,202,634,445,1499
311020,201905,974,2589,640,1971,63,210,304,909,367,1119
311030,201905,1527,3952,1029,3059,230,774,424,1138,654,1912
311040,201905,320,1032,251,862,68,243,70,223,138,466
311050,201905,2529,6561,1921,5631,396,1289,890,2488,1286,3777
311060,201905,2872,7693,1990,5906,316,1096,787,2126,1103,3222
311070,201905,2104,5526,1521,4568,189,695,757,2143,946,2838
311080,201905,1026,2481,846,2173,43,167,639,1530,682,1697
311090,201905,2036,6598,1589,5765,361,1473,489,1721,850,3194
311100,201905,2049,5981,1244,4350,276,1084,190,608,466,1692
311110,201905,3604,7600,2003,5301,405,1143,739,1991,1144,3134
311115,201905,1273,3075,1042,2745,57,161,828,2140,885,2301
311120,201905,6419,17231,4769,14125,780,2622,1671,4385,2451,7007
311130,201905,1861,4995,1419,4365,132,527,766,2250,898,2777
311140,201905,1377,3440,1022,2930,73,243,651,1842,724,2085
311150,201905,1513,4833,1194,4205,194,771,622,2112,816,2883
311160,201905,3640,10678,2531,8601,678,2576,707,2326,1385,4902
311170,201905,863,2298,688,2047,43,130,430,1333,473,1463
311180,201905,1306,3006,827,2297,174,512,356,986,530,1498
311190,201905,983,2731,718,2199,111,388,285,778,396,1166
311200,201905,1811,4993,1254,3902,289,977,365,1013,654,1990
311205,201905,861,2656,708,2343,46,211,421,1326,467,1537
311210,201905,1001,2984,873,2819,113,344,642,2118,755,2462
311220,201905,727,2071,600,1845,66,230,339,967,405,1197
311230,201905,7582,23112,5660,19218,990,3555,2076,7217,3066,10772
311240,201905,963,2628,739,2315,175,593,335,1036,510,1629
311250,201905,859,2513,669,2171,156,520,289,909,445,1429
311260,201905,2449,6186,1549,4608,272,861,595,1667,867,2528
311265,201905,1239,3278,935,2782,44,166,664,1900,708,2066
311270,201905,2967,8994,2590,8361,178,796,1904,5837,2082,6633
311280,201905,1163,3102,527,1735,96,343,77,230,173,573
311290,201905,1869,5800,1720,5470,167,557,1160,3669,1327,4226
311300,201905,4618,13324,3813,11924,223,971,2939,8925,3162,9896
311310,201905,566,1616,478,1450,56,188,253,728,309,916
311320,201905,3056,9532,2590,8468,430,1595,1163,3498,1593,5093
311330,201905,4756,12969,3889,11520,446,1451,2137,6402,2583,7853
311340,201905,9956,28903,7865,25044,2304,7876,1974,6084,4278,13960
311350,201905,2227,5707,1546,4436,154,527,829,2123,983,2650
311360,201905,1091,2720,685,2071,210,714,191,534,401,1248
311370,201905,4415,11116,3270,9204,170,686,2058,5473,2228,6159
311380,201905,364,1117,287,967,74,259,97,341,171,600
311390,201905,1669,5258,1324,4784,555,2294,334,1046,889,3340
311400,201905,1383,3943,1009,3211,142,494,409,1167,551,1661
311410,201905,1583,4774,1300,4372,213,809,698,2376,911,3185
311420,201905,1514,4523,1025,3485,185,684,181,501,366,1185
311430,201905,3449,9457,2241,6999,446,1425,653,2062,1099,3487
311440,201905,2451,7169,1727,5873,363,1411,587,1960,950,3371
311450,201905,1696,5274,1248,4403,315,1245,303,914,618,2159
311455,201905,947,2219,645,1765,178,492,233,651,411,1143
311460,201905,480,1534,326,1215,70,330,89,294,159,624
311470,201905,436,1404,306,1094,76,321,54,174,130,495
311480,201905,1148,3205,987,2975,39,109,805,2465,844,2574
311490,201905,237,709,184,600,42,158,82,237,124,395
311500,201905,403,1038,300,876,28,95,181,515,209,610
311510,201905,2955,7975,1948,6101,317,1161,748,2129,1065,3290
311520,201905,557,1647,504,1537,95,335,278,805,373,1140
311530,201905,8547,20465,5361,15187,1326,4162,1344,3705,2670,7867
311535,201905,734,2034,490,1543,72,253,159,468,231,721
311540,201905,506,1607,443,1494,89,315,264,886,353,1201
311545,201905,2014,5793,1749,5420,97,386,1330,4038,1427,4424
311547,201905,1447,3770,1274,3499,44,137,904,2521,948,2658
311550,201905,2671,7654,2113,6579,330,1183,850,2512,1180,3695
311560,201905,279,628,190,506,27,81,105,251,132,332
311570,201905,1774,4184,1274,3488,53,156,984,2749,1037,2905
311580,201905,2166,4055,1392,3150,157,319,902,2092,1059,2411
311590,201905,480,1324,391,1195,64,220,205,606,269,826
311600,201905,1707,3895,1437,3566,61,159,1219,2972,1280,3131
311610,201905,2289,7711,1909,6835,281,1070,971,3431,1252,4501
311615,201905,2952,8823,2432,7936,159,598,1823,5843,1982,6441
311620,201905,414,1143,356,1068,22,84,281,829,303,913
311630,201905,1336,3721,1079,3218,88,287,706,2011,794,2298
311640,201905,527,1539,411,1320,74,285,198,591,272,876
311650,201905,1866,4935,1560,4447,125,429,1059,2895,1184,3324
311660,201905,2719,7890,1979,6494,370,1321,472,1320,842,2641
311670,201905,1518,4008,1114,3303,168,567,499,1486,667,2053
311680,201905,2141,6289,1599,5268,246,834,949,3106,1195,3940
311690,201905,564,1244,432,1076,48,112,305,804,353,916
311700,201905,2246,5454,1760,4762,34,147,1457,3817,1491,3964
311710,201905,1467,4331,1023,3469,248,920,372,1240,620,2160
311720,201905,410,1259,325,1095,33,141,178,578,211,719
311730,201905,4045,10371,2555,7627,779,2518,432,1309,1211,3827
311740,201905,801,2286,685,2132,32,89,605,1914,637,2003
311750,201905,3816,11807,3114,10564,461,1706,1662,5383,2123,7089
311760,201905,599,1758,498,1575,83,334,222,592,305,926
311770,201905,1958,5796,1512,4944,279,999,627,1944,906,2943
311780,201905,1261,3737,846,2863,165,639,234,692,399,1331
311783,201905,2157,6115,1770,5415,59,272,1394,4114,1453,4386
311787,201905,695,2027,502,1593,73,268,190,511,263,779
311790,201905,1428,3795,939,2924,236,820,270,782,506,1602
311800,201905,4759,14586,3875,12647,761,2683,668,1967,1429,4650
311810,201905,958,2978,752,2593,56,223,463,1583,519,1806
311820,201905,758,1935,566,1618,81,261,318,854,399,1115
311830,201905,8201,24195,5639,18495,1560,5472,671,2113,2231,7585
311840,201905,3202,8561,2715,7860,281,884,1969,5621,2250,6505
311850,201905,319,879,261,775,16,47,166,482,182,529
311860,201905,54948,142672,42097,120638,6651,20338,22966,63353,29617,83691
311870,201905,1934,5198,1263,3961,200,701,459,1284,659,1985
311880,201905,6126,16231,5155,14850,301,818,3917,11414,4218,12232
311890,201905,1529,3876,1184,3376,107,367,791,2152,898,2519
311900,201905,715,1890,543,1646,65,229,350,1026,415,1255
311910,201905,4091,10659,3080,9316,576,1710,1601,4983,2177,6693
311920,201905,1988,5594,1597,4984,141,416,953,3013,1094,3429
311930,201905,3193,7998,2414,6860,865,2634,714,1895,1579,4529
311940,201905,13890,37691,10257,30714,1496,4923,4655,13070,6151,17993
311950,201905,2119,5984,1567,5022,88,410,1031,3203,1119,3613
311960,201905,529,1330,430,1176,27,118,272,637,299,755
311970,201905,430,1413,285,1044,57,232,58,179,115,411
311980,201905,422,1194,223,772,32,126,60,202,92,328
311990,201905,539,1321,352,1053,74,265,146,397,220,662
311995,201905,983,2771,512,1669,19,67,61,135,80,202
312000,201905,580,1559,486,1421,36,128,336,977,372,1105
312010,201905,882,2509,675,2146,62,224,396,1201,458,1425
312015,201905,1309,3947,1167,3700,63,284,899,2763,962,3047
312020,201905,1147,3604,916,3158,230,842,296,974,526,1816
312030,201905,1998,4975,1749,4685,24,103,1614,4288,1638,4391
312040,201905,780,2492,589,2054,58,212,256,867,314,1079
312050,201905,1227,3957,962,3412,224,919,264,819,488,1738
312060,201905,836,2131,550,1753,140,455,248,789,388,1244
312070,201905,873,2577,626,2079,64,244,312,986,376,1230
312080,201905,2709,6816,2023,5782,132,440,1278,3488,1410,3928
312083,201905,854,2308,643,1976,64,231,406,1198,470,1429
312087,201905,2326,6311,1939,5707,67,225,1497,4423,1564,4648
312090,201905,9350,25488,7170,21862,1227,4193,3331,9880,4558,14073
312100,201905,1551,4679,1149,3927,122,551,560,1827,682,2378
312110,201905,1007,3201,846,2870,215,842,268,813,483,1655
312120,201905,737,2063,509,1658,160,594,150,409,310,1003
312125,201905,1628,4342,1368,3952,125,415,978,2709,1103,3124
312130,201905,917,2305,675,1898,59,180,281,750,340,930
312140,201905,733,2182,604,1916,133,460,242,693,375,1153
312150,201905,450,1282,382,1132,12,60,272,736,284,796
312160,201905,7855,22583,5967,19138,834,3090,2718,8189,3552,11279
312170,201905,891,2423,666,1994,36,139,460,1325,496,1464
312180,201905,1348,3759,1065,3185,153,488,530,1517,683,2005
312190,201905,571,1697,402,1352,85,300,94,314,179,614
312200,201905,4676,12660,3682,11053,1061,3202,1409,4350,2470,7552
312210,201905,1323,3120,948,2562,46,154,665,1740,711,1894
312220,201905,1789,5578,1532,5090,119,430,946,3140,1065,3570
312230,201905,11848,31886,7795,24306,2072,7136,1379,3746,3451,10882
312235,201905,1813,4888,1464,4331,92,336,1026,2957,1118,3293
312240,201905,657,2199,501,1855,108,433,145,526,253,959
312245,201905,2500,6733,2076,6075,79,284,1657,4812,1736,5096
312247,201905,900,2278,639,1875,131,399,307,911,438,1310
312250,201905,960,2560,621,1888,96,309,247,725,343,1034
312260,201905,862,2482,695,2203,45,194,489,1481,534,1675
312270,201905,699,1963,532,1633,30,134,287,799,317,933
312280,201905,419,1235,324,1058,102,337,36,108,138,445
312290,201905,718,2183,575,1900,120,450,193,608,313,1058
312300,201905,898,2721,621,2071,162,582,114,311,276,893
312310,201905,779,2556,641,2270,99,397,280,954,379,1351
312320,201905,1761,4674,1287,3836,346,1087,258,722,604,1809
312330,201905,854,2563,680,2211,67,232,438,1386,505,1618
312340,201905,253,667,179,542,39,133,62,170,101,303
312350,201905,261,552,194,478,19,53,128,303,147,356
312352,201905,1600,4816,1410,4477,110,370,860,2882,970,3252
312360,201905,2491,7468,1822,6071,386,1381,466,1487,852,2868
312370,201905,1712,4752,1427,4246,231,788,736,2072,967,2860
312380,201905,2157,4972,1794,4511,11,35,1591,3969,1602,4004
312385,201905,1256,3534,966,2988,146,519,467,1357,613,1876
312390,201905,1850,5488,1388,4607,219,802,474,1436,693,2238
312400,201905,2765,8334,2235,7308,711,2423,664,2229,1375,4652
312410,201905,11313,32352,9274,28758,1765,5680,4737,14493,6502,20173
312420,201905,3570,10122,3010,9143,564,1833,1575,4698,2139,6531
312430,201905,7913,21137,6316,18291,512,1685,4218,11934,4730,13619
312440,201905,896,2922,688,2426,354,1319,70,209,424,1528
312450,201905,1147,3476,869,2951,257,935,277,955,534,1890
312460,201905,429,1137,291,916,35,135,161,518,196,653
312470,201905,461,1153,306,889,46,156,118,292,164,448
312480,201905,1113,2846,775,2358,111,357,378,1109,489,1466
312490,201905,2024,5025,1520,4248,219,616,784,2123,1003,2739
312500,201905,886,2248,704,1977,48,171,476,1317,524,1488
312510,201905,3524,9611,2615,7885,683,1964,761,2345,1444,4309
312520,201905,159,495,136,450,36,116,64,209,100,325
312530,201905,554,1434,485,1346,18,63,427,1181,445,1244
312540,201905,1499,4366,990,3257,167,602,494,1569,661,2171
312550,201905,756,2052,562,1643,37,124,367,984,404,1108
312560,201905,1951,5083,1589,4545,64,227,1230,3506,1294,3733
312570,201905,2085,5446,1618,4823,490,1533,607,1842,1097,3375
312580,201905,587,1701,440,1380,64,231,196,568,260,799
312590,201905,1625,4860,1319,4258,109,463,764,2296,873,2759
312595,201905,1669,5173,1466,4805,304,939,847,2921,1151,3860
312600,201905,993,2469,518,1665,76,290,178,579,254,869
312610,201905,6183,16252,3954,11973,585,1935,1282,3650,1867,5585
312620,201905,2460,6408,1793,5482,55,241,1416,4391,1471,4632
312630,201905,264,835,199,710,38,163,79,277,117,440
312640,201905,553,1540,372,1226,48,160,126,434,174,594
312650,201905,2060,5427,1402,4139,78,251,948,2652,1026,2903
312660,201905,1337,3333,1013,2781,87,306,671,1735,758,2041
312670,201905,4898,13331,4040,11941,222,954,2830,7922,3052,8876
312675,201905,1202,3323,983,2968,59,241,774,2269,833,2510
312680,201905,1365,3900,1143,3570,64,289,902,2725,966,3014
312690,201905,2510,5746,1980,5074,91,263,1641,4124,1732,4387
312695,201905,931,2689,788,2438,46,124,594,1860,640,1984
312700,201905,2028,5437,1453,4366,150,512,812,2325,962,2837
312705,201905,1297,3344,1091,3014,25,93,932,2539,957,2632
312707,201905,1349,4069,1045,3494,70,363,640,1994,710,2357
312710,201905,6386,14786,3693,10506,1028,3176,969,2834,1997,6010
312720,201905,1009,2865,757,2440,99,359,428,1314,527,1673
312730,201905,1621,3931,1178,3318,90,283,691,1878,781,2161
312733,201905,1442,3831,1089,3174,37,142,724,2005,761,2147
312735,201905,624,1744,531,1563,71,244,340,897,411,1141
312737,201905,820,1930,553,1525,78,247,310,778,388,1025
312738,201905,581,1543,403,1219,55,187,197,559,252,746
312740,201905,426,1072,243,756,56,187,58,142,114,329
312750,201905,1365,4312,1090,3773,197,746,416,1362,613,2108
312760,201905,1814,5501,1309,4442,254,919,428,1386,682,2305
312770,201905,43063,104965,26657,76968,5998,18333,8309,23560,14307,41893
312780,201905,2414,7422,2035,6774,227,882,1291,4248,1518,5130
312790,201905,260,647,158,502,8,43,55,144,63,187
312800,201905,4796,14052,3739,11953,872,3006,1364,4218,2236,7224
312810,201905,1634,4443,1060,3460,258,956,338,957,596,1913
312820,201905,1764,4854,1438,4242,55,216,1036,2951,1091,3167
312825,201905,1315,3152,1128,2893,26,91,949,2386,975,2477
312830,201905,2562,7349,1514,5175,331,1266,358,1176,689,2442
312840,201905,1203,3460,926,2955,125,500,430,1267,555,1767
312850,201905,863,2182,606,1779,42,172,331,880,373,1052
312860,201905,1293,3310,848,2603,226,727,207,621,433,1348
312870,201905,6285,17451,3770,12305,639,2269,860,2660,1499,4929
312880,201905,1377,3532,1082,3049,46,181,589,1657,635,1838
312890,201905,2085,5488,1450,4351,138,432,672,2022,810,2454
312900,201905,1167,3108,937,2802,87,290,539,1703,626,1993
312910,201905,1599,2995,818,1963,143,297,306,696,449,993
312920,201905,1008,2802,680,2209,150,557,252,747,402,1304
312930,201905,2119,5526,1687,4866,358,1075,733,2087,1091,3162
312940,201905,904,2578,712,2273,90,343,345,1052,435,1395
312950,201905,3083,7808,2008,6026,522,1710,665,1897,1187,3607
312960,201905,1877,5000,1559,4517,109,299,1166,3476,1275,3775
312965,201905,1661,4837,1389,4360,142,466,897,2778,1039,3244
312970,201905,1160,3373,901,2927,171,663,440,1315,611,1978
312980,201905,21879,62434,17807,54938,3052,10435,9155,26648,12207,37083
312990,201905,443,1163,268,859,59,223,116,356,175,579
313000,201905,442,1310,335,1114,37,158,177,552,214,710
313005,201905,2513,7332,2130,6691,131,449,1554,4764,1685,5213
313010,201905,4604,13238,3743,11766,688,2432,2155,6527,2843,8959
313020,201905,921,2838,609,2107,108,410,107,312,215,722
313030,201905,1154,2809,777,2211,87,315,475,1271,562,1586
313040,201905,764,2437,611,2089,51,217,344,1105,395,1322
313050,201905,1750,5028,1224,4220,208,873,356,1074,564,1947
313055,201905,1835,5107,1652,4823,51,166,1393,4038,1444,4204
313060,201905,948,2410,636,1894,208,695,133,336,341,1031
313065,201905,1620,5023,1432,4698,71,307,1065,3372,1136,3679
313070,201905,963,2549,721,2116,69,216,423,1218,492,1434
313080,201905,360,993,260,803,61,214,83,207,144,421
313090,201905,4663,13037,4008,11891,520,1722,2442,7097,2962,8819
313100,201905,1352,3572,1034,3105,46,183,751,2219,797,2402
313110,201905,1456,3952,1034,3161,87,328,579,1630,666,1958
313115,201905,2418,7329,2010,6525,290,1048,997,3021,1287,4069
313120,201905,3600,8684,2676,7449,300,909,1618,4488,1918,5397
313130,201905,28086,75860,21741,63720,2763,9163,11660,32172,14423,41335
313140,201905,559,1276,346,953,26,86,228,616,254,702
313150,201905,1344,3884,986,3167,268,916,279,834,547,1750
313160,201905,984,2587,758,2194,42,151,548,1540,590,1691
313170,201905,11202,33175,7877,26611,1422,5174,2910,9273,4332,14447
313180,201905,2188,5948,1532,4619,204,668,801,2341,1005,3009
313190,201905,4245,12494,3072,10040,558,1934,1026,3115,1584,5049
313200,201905,1057,3044,916,2792,23,102,762,2230,785,2332
313210,201905,3668,10978,3031,9796,388,1411,1765,5494,2153,6905
313220,201905,1723,4646,1147,3526,184,633,408,1106,592,1739
313230,201905,2929,8283,2450,7705,71,259,2016,6416,2087,6675
313240,201905,8920,22598,5518,17008,1022,3582,2245,6377,3267,9959
313250,201905,5830,17477,4602,15074,663,2295,2305,7387,2968,9682
313260,201905,596,1584,414,1241,51,189,194,540,245,729
313270,201905,5474,14815,4396,13111,648,1988,2693,8100,3341,10088
313280,201905,431,1240,289,941,40,134,111,348,151,482
313290,201905,886,2845,684,2513,235,941,213,753,448,1694
313300,201905,1565,4439,1146,3648,307,1047,228,627,535,1674
313310,201905,1038,3171,822,2688,140,524,214,589,354,1113
313320,201905,2103,5648,1466,4603,286,1012,630,1975,916,2987
313330,201905,3901,10748,2992,9327,188,789,1936,5883,2124,6672
313340,201905,1294,2985,915,2434,99,270,638,1688,737,1958
313350,201905,2160,6200,1457,4658,217,782,548,1582,765,2364
313360,201905,1291,3299,870,2605,154,555,438,1207,592,1762
313370,201905,1289,3822,1126,3508,143,522,648,1881,791,2403
313375,201905,1657,4377,1024,3212,197,698,238,698,435,1396
313380,201905,5694,14821,4016,11654,798,2530,1717,4492,2515,7022
313390,201905,850,2779,745,2606,52,243,475,1580,527,1823
313400,201905,3633,9251,2835,8157,186,620,2158,6044,2344,6664
313410,201905,1265,3391,966,2855,66,218,698,2031,764,2249
313420,201905,15018,34185,7470,21243,1678,5234,980,2809,2658,8043
313430,201905,839,2498,639,2098,111,427,260,774,371,1201
313440,201905,5901,13001,3870,10306,288,810,2507,6650,2795,7460
313450,201905,607,1745,442,1408,93,325,141,388,234,713
313460,201905,2086,6215,1668,5546,346,1333,766,2407,1112,3740
313470,201905,2924,7513,2308,6628,247,694,1479,4319,1726,5013
313480,201905,895,2620,510,1740,83,301,132,397,215,698
313490,201905,1719,4068,825,2620,289,1038,85,280,374,1318
313500,201905,413,1246,324,1038,39,130,122,366,161,496
313505,201905,9495,25646,8111,23795,318,1170,6619,19290,6937,20460
313507,201905,1468,3883,1212,3485,30,128,972,2740,1002,2868
313510,201905,12425,34978,10156,30731,1272,4134,5110,15014,6382,19148
313520,201905,13369,38985,10872,34580,715,2682,7821,24368,8536,27050
313530,201905,520,1507,403,1282,23,81,193,577,216,658
313535,201905,2339,6464,2016,5865,139,351,1428,4100,1567,4451
313540,201905,776,2428,595,1963,111,365,231,721,342,1086
313545,201905,1176,3984,1003,3628,167,633,538,1872,705,2505
313550,201905,1705,5280,1420,4606,350,1266,655,2006,1005,3272
313560,201905,2563,5201,1895,4389,74,142,1597,3696,1671,3838
313570,201905,939,2860,761,2523,186,664,299,934,485,1598
313580,201905,5420,14606,4126,12418,522,1677,2295,7015,2817,8692
313590,201905,937,2751,738,2451,226,802,303,1039,529,1841
313600,201905,3728,10362,3121,9385,103,439,2569,7564,2672,8003
313610,201905,982,2545,786,2194,103,299,474,1264,577,1563
313620,201905,5289,14436,4221,12496,640,2080,2281,6506,2921,8586
313630,201905,8196,20550,5680,16668,662,2252,3143,9026,3805,11278
313640,201905,1006,2429,625,1910,202,636,177,561,379,1197
313650,201905,1724,5268,1418,4757,98,394,936,3148,1034,3542
313652,201905,768,2528,698,2369,120,463,416,1359,536,1822
313655,201905,1089,2891,876,2597,45,146,686,2021,731,2167
313657,201905,1231,3330,960,2887,45,199,697,1984,742,2183
313660,201905,859,2456,697,2148,97,371,394,1115,491,1486
313665,201905,4496,12390,3489,10606,512,1748,1978,5761,2490,7509
313670,201905,45054,114219,28809,85984,4836,15873,11792,33232,16628,49105
313680,201905,998,2727,838,2475,66,224,541,1540,607,1764
313690,201905,824,2665,638,2285,152,585,186,623,338,1208
313695,201905,1694,4773,1317,4147,92,325,898,2812,990,3137
313700,201905,2987,9810,2619,9335,253,964,1976,7019,2229,7983
313710,201905,1348,3247,952,2674,82,239,641,1806,723,2045
313720,201905,5202,14717,3775,11794,564,1978,1626,4700,2190,6678
313730,201905,1264,2981,965,2575,86,203,629,1666,715,1869
313740,201905,1642,5894,1331,5087,329,1418,217,717,546,2135
313750,201905,1877,5240,1452,4398,312,1048,598,1683,910,2731
313753,201905,2115,5151,1412,4016,147,449,807,2208,954,2657
313760,201905,4925,13901,3629,11338,841,2807,1382,4069,2223,6876
313770,201905,3739,10753,2995,9553,206,723,2141,6846,2347,7569
313780,201905,3974,10874,2910,9021,281,1023,778,2448,1059,3471
313790,201905,471,1498,417,1391,57,213,222,705,279,918
313800,201905,1303,3130,975,2634,136,422,517,1308,653,1730
313810,201905,1573,4134,1239,3646,67,257,905,2609,972,2866
313820,201905,14339,34931,9426,26062,1549,4659,3325,8891,4874,13550
313830,201905,346,1004,257,811,55,186,100,282,155,468
313835,201905,903,2728,732,2396,72,279,372,1151,444,1430
313840,201905,6464,17366,4660,14203,1232,3944,956,2980,2188,6924
313850,201905,916,2300,738,2043,116,394,391,970,507,1364
313860,201905,2555,7111,1889,5768,304,1031,722,2037,1026,3068
313862,201905,1463,3251,712,2080,56,179,345,955,401,1134
313865,201905,2244,6215,1928,5703,119,366,1456,4223,1575,4589
313867,201905,1104,3473,932,3136,202,707,525,1766,727,2473
313868,201905,1695,5306,1409,4726,59,281,1063,3449,1122,3730
313870,201905,782,2178,576,1796,117,386,192,541,309,927
313880,201905,1448,3909,1057,3249,180,613,466,1298,646,1911
313890,201905,1969,4498,1448,3817,77,246,1002,2591,1079,2837
313900,201905,3773,11382,2785,9358,731,2722,680,2117,1411,4839
313910,201905,587,1789,430,1484,99,369,86,285,185,654
313920,201905,2885,9205,2421,8235,507,1710,1185,4064,1692,5774
313925,201905,1561,4096,1254,3529,208,566,761,2133,969,2699
313930,201905,4749,14526,3850,12894,315,1225,2503,8226,2818,9451
313940,201905,8143,24336,5846,20212,1048,4280,1385,5199,2433,9479
313950,201905,4845,11165,3488,9416,458,1575,2076,5457,2534,7032
313960,201905,5301,13477,3601,10520,811,2631,1150,3107,1961,5738
313970,201905,1358,3847,1181,3537,27,99,751,2233,778,2332
313980,201905,1320,3516,862,2765,126,458,316,966,442,1424
313990,201905,1780,5904,1289,4712,344,1383,373,1217,717,2600
314000,201905,9314,24984,7820,22386,518,1920,5310,14883,5828,16803
314010,201905,1345,3396,1077,3021,48,170,799,2166,847,2336
314015,201905,1973,5564,1512,4823,215,838,792,2419,1007,3257
314020,201905,487,1359,290,969,59,244,51,178,110,422
314030,201905,748,2224,598,1927,72,246,300,949,372,1195
314040,201905,636,1745,512,1502,88,289,264,742,352,1031
314050,201905,1665,4552,1200,3687,166,604,603,1709,769,2313
314053,201905,1789,5403,1436,4685,266,850,714,2436,980,3286
314055,201905,2268,6237,1942,5745,52,212,1575,4662,1627,4874
314060,201905,1195,3260,901,2789,43,166,611,1860,654,2026
314070,201905,4447,12534,3483,10776,741,2331,1446,4370,2187,6701
314080,201905,2118,5723,1361,4307,208,786,498,1390,706,2176
314085,201905,2042,6090,1687,5526,304,1037,856,2845,1160,3882
314090,201905,4062,11688,3458,10714,248,1002,2267,6921,2515,7923
314100,201905,3099,7401,2419,6452,73,199,1851,4940,1924,5139
314110,201905,4174,12271,3445,10821,437,1588,1876,5499,2313,7087
314120,201905,817,1908,310,950,72,259,52,158,124,417
314130,201905,665,1774,382,1206,33,123,194,599,227,722
314140,201905,4541,13247,3495,11127,539,1827,1620,5001,2159,6828
314150,201905,1479,3768,1094,3090,99,300,714,1933,813,2233
314160,201905,2193,5959,1574,4832,240,783,635,1974,875,2757
314170,201905,964,2750,769,2355,64,221,463,1319,527,1540
314180,201905,5339,15244,4375,13651,398,1391,2531,7854,2929,9245
314190,201905,590,1532,417,1273,84,293,179,494,263,787
314200,201905,2819,8104,2306,7200,129,506,1643,4962,1772,5468
314210,201905,1945,5211,1536,4464,148,446,822,2327,970,2773
314220,201905,1291,3656,916,2983,216,824,312,928,528,1752
314225,201905,1089,3169,920,2908,77,239,654,2096,731,2335
314230,201905,750,1995,618,1830,81,260,380,1155,461,1415
314240,201905,1019,2781,786,2441,185,599,313,989,498,1588
314250,201905,514,1448,322,1041,49,180,119,345,168,525
314260,201905,924,2707,744,2417,171,618,377,1166,548,1784
314270,201905,3183,9159,2576,8195,98,398,1888,5919,1986,6317
314280,201905,3241,7573,2068,5726,279,854,985,2536,1264,3390
314290,201905,4373,11572,3654,10312,351,1007,2470,6851,2821,7858
314300,201905,1709,5080,1180,3882,258,929,364,1140,622,2069
314310,201905,4324,11727,3009,9416,929,3121,530,1527,1459,4648
314315,201905,900,3192,772,2912,60,294,526,1904,586,2198
314320,201905,2719,7478,1763,5692,334,1160,660,2081,994,3241
314330,201905,46614,132217,35128,112014,10053,33434,7743,25726,17796,59160
314340,201905,2229,5646,1225,3779,268,976,287,708,555,1684
314345,201905,1369,4166,1128,3731,157,539,657,2129,814,2668
314350,201905,881,2480,589,1940,129,464,140,425,269,889
314360,201905,569,1656,347,1173,63,228,98,300,161,528
314370,201905,680,1891,532,1655,29,123,381,1135,410,1258
314380,201905,1085,3092,741,2426,180,677,156,491,336,1168
314390,201905,11961,31736,7676,23570,1651,5427,2178,5970,3829,11397
314400,201905,3882,11674,3030,10101,832,2914,1063,3627,1895,6541
314410,201905,2713,7661,1839,5970,275,1000,632,2152,907,3152
314420,201905,786,1939,595,1680,16,77,442,1187,458,1264
314430,201905,6871,17785,4866,14238,820,2526,2057,5772,2877,8298
314435,201905,1562,4328,1258,3807,45,184,925,2752,970,2936
314437,201905,928,2421,649,1947,58,211,311,914,369,1125
314440,201905,584,1699,422,1381,112,397,91,258,203,655
314450,201905,1312,3622,1090,3260,104,355,666,1928,770,2283
314460,201905,3250,10161,2337,8103,584,2150,451,1516,1035,3666
314465,201905,2162,6405,1869,5820,50,225,1419,4239,1469,4464
314467,201905,812,2266,704,2077,28,90,560,1617,588,1707
314470,201905,2137,6308,1711,5384,325,1132,738,2152,1063,3284
314480,201905,6008,17804,4314,14117,757,2733,1335,3906,2092,6639
314490,201905,955,2682,708,2150,78,267,413,1211,491,1478
314500,201905,1600,4106,1163,3415,220,668,485,1404,705,2072
314505,201905,1917,4813,1584,4342,105,299,1137,3054,1242,3353
314510,201905,1814,4833,1241,3935,262,920,542,1668,804,2588
314520,201905,4352,13717,3086,10854,604,2300,377,1173,981,3473
314530,201905,5411,17851,4854,16755,405,1690,3407,11493,3812,13183
314535,201905,2550,6765,2068,6039,120,453,1538,4409,1658,4862
314537,201905,1086,3158,839,2726,58,235,583,1841,641,2076
314540,201905,413,1084,284,840,23,85,134,373,157,458
314545,201905,1731,4411,1527,4148,44,119,1272,3580,1316,3699
314550,201905,637,1604,479,1370,37,148,252,641,289,789
314560,201905,3959,12303,2966,10040,501,1818,958,3020,1459,4838
314570,201905,289,805,220,681,29,107,99,306,128,413
314580,201905,431,1316,323,1094,95,328,80,281,175,609
314585,201905,649,2067,491,1699,60,269,242,777,302,1046
314587,201905,1985,5536,1510,4775,203,582,837,2715,1040,3297
314590,201905,3548,10014,2458,7855,385,1367,936,2801,1321,4168
314600,201905,1796,5109,1058,3634,220,827,114,346,334,1173
314610,201905,8525,22408,5925,18518,1137,4099,2382,7286,3519,11385
314620,201905,2120,5094,1652,4480,54,213,1354,3574,1408,3787
314625,201905,1489,4263,1267,3943,52,292,1030,3103,1082,3395
314630,201905,5074,13390,4181,12134,123,499,3449,10010,3572,10509
314640,201905,626,1566,445,1265,73,239,220,564,293,803
314650,201905,868,2104,534,1571,48,166,257,665,305,831
314655,201905,1558,4355,1109,3530,184,581,520,1634,704,2215
314660,201905,329,788,212,562,10,17,125,316,135,333
314670,201905,1662,3860,1158,3144,33,114,720,1932,753,2046
314675,201905,1688,4611,1465,4227,100,364,1117,3107,1217,3471
314690,201905,2039,5906,1558,5135,465,1653,439,1460,904,3113
314700,201905,9774,28265,6246,21062,1287,4730,1616,5256,2903,9986
314710,201905,7428,21247,5306,16770,1137,3906,1323,3710,2460,7616
314720,201905,2075,6281,1407,4848,305,1173,355,1186,660,2359
314730,201905,2014,5712,1440,4565,344,1124,379,1167,723,2291
314740,201905,2741,7864,2168,6846,303,1060,1100,3392,1403,4452
314750,201905,308,863,243,735,20,71,130,355,150,426
314760,201905,1815,5585,1178,4083,176,694,293,836,469,1530
314770,201905,1064,3177,535,1758,56,196,139,405,195,601
314780,201905,340,828,222,650,47,163,113,292,160,455
314790,201905,9406,26153,6503,20715,1662,6000,1778,5224,3440,11224
314795,201905,1404,3823,1197,3469,40,174,937,2595,977,2769
314800,201905,10605,27433,6169,19002,1201,4030,1261,3484,2462,7514
314810,201905,8128,22527,5948,18630,1634,5386,1784,5609,3418,10995
314820,201905,1018,2598,791,2237,55,222,516,1385,571,1607
314830,201905,1422,4446,1203,3998,256,910,548,1810,804,2720
314840,201905,875,2859,682,2535,62,325,466,1646,528,1971
314850,201905,1918,4735,1557,4239,45,143,1339,3644,1384,3787
314860,201905,3093,9530,2567,8479,324,1261,1599,5091,1923,6352
314870,201905,6117,16159,4682,14151,333,1122,3369,10192,3702,11314
314875,201905,1703,5206,1517,4959,115,321,1212,4023,1327,4344
314880,201905,869,2126,680,1857,29,82,453,1277,482,1359
314890,201905,408,1219,297,963,52,191,111,326,163,517
314900,201905,627,1709,486,1465,105,341,182,531,287,872
314910,201905,1598,4686,1194,4023,256,1003,564,1773,820,2776
314915,201905,2220,6644,1869,6025,133,467,1242,3904,1375,4371
314920,201905,472,1235,301,967,10,38,203,648,213,686
314930,201905,5121,15099,3873,12699,759,2706,1417,4362,2176,7068
314940,201905,399,1050,337,940,37,98,203,534,240,632
314950,201905,444,1172,284,908,25,111,124,342,149,453
314960,201905,774,1976,603,1660,35,110,433,1124,468,1234
314970,201905,809,2356,641,2043,106,375,316,944,422,1319
314980,201905,1297,3494,937,2920,230,821,334,1005,564,1826
314990,201905,2303,6762,1552,5014,336,1206,324,888,660,2094
314995,201905,1615,4623,1290,4028,68,289,832,2476,900,2765
315000,201905,1076,2868,775,2383,62,205,502,1486,564,1691
315010,201905,379,1084,278,892,47,182,127,377,174,559
315015,201905,2172,6333,1911,5891,188,644,1226,3736,1414,4380
315020,201905,763,2324,551,1850,65,267,226,673,291,940
315030,201905,563,1574,370,1193,93,312,77,228,170,540
315040,201905,799,2371,682,2090,92,309,427,1300,519,1609
315050,201905,1101,2923,838,2533,66,262,461,1360,527,1622
315053,201905,1130,2994,863,2517,61,193,497,1391,558,1584
315057,201905,1592,5114,1375,4686,164,574,874,3006,1038,3580
315060,201905,558,1723,397,1386,76,278,99,328,175,606
315070,201905,549,1467,383,1166,98,335,97,261,195,596
315080,201905,2628,7963,2033,6716,361,1223,1022,3293,1383,4516
315090,201905,776,2438,561,1984,93,350,194,652,287,1002
315100,201905,1160,3588,729,2558,142,559,282,879,424,1438
315110,201905,1592,4134,1195,3471,139,404,572,1680,711,2084
315120,201905,11345,27331,8179,22420,1131,3004,4181,11889,5312,14893
315130,201905,1298,3803,1043,3308,147,551,416,1227,563,1778
315140,201905,2800,7950,2125,6697,394,1380,1043,3059,1437,4439
315150,201905,4164,10440,2883,8303,444,1431,1276,3555,1720,4986
315160,201905,1584,4040,1028,3117,213,661,442,1316,655,1977
315170,201905,1378,4459,933,3350,222,828,183,655,405,1483
315180,201905,16263,40809,8366,25550,1234,4278,2350,6265,3584,10543
315190,201905,2034,4661,1602,4077,218,554,1161,2943,1379,3497
315200,201905,3607,10689,2617,8851,798,2936,609,1966,1407,4902
315210,201905,7811,20930,5476,15867,691,2198,2556,6692,3247,8890
315213,201905,1111,2984,955,2760,23,78,768,2191,791,2269
315217,201905,2554,7838,1999,6870,102,500,1328,4389,1430,4889
315220,201905,7827,21854,6306,19156,1464,4689,2467,7478,3931,12167
315230,201905,3041,7245,2541,6627,138,270,2011,5472,2149,5742
315240,201905,2301,7077,1984,6493,487,1712,1021,3264,1508,4976
315250,201905,10715,30165,7776,24607,1329,4560,3246,9818,4575,14378
315260,201905,972,2789,512,1722,82,266,39,120,121,386
315270,201905,798,2377,532,1843,76,296,157,452,233,748
315280,201905,2827,7247,1641,4981,398,1303,243,729,641,2032
315290,201905,1165,2958,698,2206,198,686,181,575,379,1261
315300,201905,672,1621,432,1285,121,404,155,468,276,872
315310,201905,1286,3689,946,3030,82,280,522,1586,604,1866
315320,201905,689,2055,482,1644,64,275,206,638,270,913
315330,201905,741,2593,410,1662,75,335,116,413,191,748
315340,201905,2989,7487,2192,6320,150,496,1368,3901,1518,4397
315350,201905,1491,4174,1147,3596,173,614,608,1872,781,2486
315360,201905,1658,5089,1204,4064,185,663,474,1511,659,2174
315370,201905,436,1277,341,1076,66,199,138,428,204,627
315380,201905,172,529,129,423,33,112,21,45,54,157
315390,201905,1125,3334,860,2809,170,628,331,988,501,1616
315400,201905,3930,11167,3090,9597,436,1410,1588,4757,2024,6167
315410,201905,2249,5275,1738,4516,449,1251,338,893,787,2144
315415,201905,1209,3396,961,3006,224,819,394,1220,618,2039
315420,201905,1167,3428,748,2591,144,526,117,380,261,906
315430,201905,3490,8712,2427,7055,453,1562,984,2644,1437,4206
315440,201905,974,2658,789,2341,83,307,444,1216,527,1523
315445,201905,1988,4890,1426,4061,118,371,988,2774,1106,3145
315450,201905,2143,6207,1779,5623,231,717,1106,3521,1337,4238
315460,201905,32896,95709,27288,85373,5570,19164,12698,37390,18268,56554
315470,201905,452,1292,362,1128,29,104,213,638,242,742
315480,201905,1229,3636,856,2815,169,586,264,842,433,1428
315490,201905,2945,7416,1996,5952,268,822,717,2107,985,2929
315500,201905,494,1366,297,925,34,131,125,331,159,462
315510,201905,1218,3353,1052,3101,29,134,896,2573,925,2707
315520,201905,1044,2930,821,2546,57,214,591,1779,648,1993
315530,201905,590,1765,452,1488,151,541,180,556,331,1097
315540,201905,1314,3652,888,2832,107,405,366,1137,473,1542
315550,201905,1814,4857,1173,3696,262,924,296,906,558,1830
315560,201905,6200,19394,5325,17757,346,1178,3483,11704,3829,12882
315570,201905,1864,5300,1547,4748,96,414,922,2692,1018,3106
315580,201905,2312,5823,1757,4915,312,1003,630,1695,942,2698
315590,201905,883,2370,700,2076,90,325,344,955,434,1280
315600,201905,2374,7731,1731,6448,262,963,920,3545,1182,4508
315610,201905,879,2292,662,1876,125,431,290,699,415,1130
315620,201905,353,1088,303,996,42,151,194,639,236,790
315630,201905,871,2431,683,2106,148,494,252,703,400,1197
315640,201905,329,877,275,809,29,107,171,473,200,580
315645,201905,941,2500,626,1958,157,532,154,456,311,988
315650,201905,1703,4317,1365,3826,35,150,1113,2989,1148,3139
315660,201905,2422,5969,1809,4908,109,321,1269,3317,1378,3638
315670,201905,12923,36842,9960,31371,2131,7020,4208,12839,6339,19859
315680,201905,2991,9070,2183,7450,371,1389,972,3178,1343,4567
315690,201905,2556,6769,1658,5109,379,1180,505,1702,884,2882
315700,201905,7514,21452,5677,17746,963,3209,2528,7561,3491,10770
315710,201905,1844,4705,1326,3910,53,231,920,2583,973,2814
315720,201905,4172,11991,3517,10796,188,825,2447,7185,2635,8010
315725,201905,1843,5221,1418,4407,152,467,938,2973,1090,3440
315727,201905,533,1428,397,1195,60,200,154,438,214,638
315730,201905,610,1884,535,1734,70,258,238,733,308,991
315733,201905,1344,3504,923,2733,144,514,334,923,478,1437
315737,201905,1104,3253,872,2797,44,182,599,1864,643,2046
315740,201905,893,2577,698,2165,99,370,399,1142,498,1512
315750,201905,1219,3343,979,2934,80,259,628,1892,708,2151
315760,201905,1149,2797,1043,2663,42,123,895,2250,937,2373
315765,201905,1839,4998,1508,4568,42,157,1300,3893,1342,4050
315770,201905,926,2799,765,2566,294,1085,192,577,486,1662
315780,201905,26989,76730,22751,69058,1808,6730,14636,42267,16444,48997
315790,201905,3529,11103,3010,10106,259,912,1883,6447,2142,7359
315800,201905,1192,4398,837,3380,151,673,201,744,352,1417
315810,201905,1285,3250,1076,2912,48,175,848,2174,896,2349
315820,201905,2517,7149,2057,6427,204,734,1390,4264,1594,4998
315830,201905,1049,3080,767,2547,64,240,336,1067,400,1307
315840,201905,808,2009,512,1457,51,176,239,615,290,791
315850,201905,1111,3383,893,2990,178,649,446,1405,624,2054
315860,201905,491,1480,338,1188,80,304,85,282,165,586
315870,201905,457,1206,356,1056,32,111,233,641,265,752
315880,201905,1085,2825,714,2181,89,340,179,479,268,819
315890,201905,1565,4686,1254,4222,339,1232,580,1886,919,3118
315895,201905,5841,16204,4431,13382,484,1657,2232,6295,2716,7952
315900,201905,806,2118,695,1964,51,163,520,1424,571,1587
315910,201905,503,1482,420,1341,68,253,270,817,338,1070
315920,201905,1548,4095,825,2576,140,485,239,681,379,1166
315930,201905,1058,2479,701,1930,129,355,299,827,428,1182
315935,201905,763,2359,619,2078,119,421,207,703,326,1124
315940,201905,582,1691,465,1486,54,188,241,739,295,927
315950,201905,1150,3239,973,2947,98,284,743,2273,841,2557
315960,201905,3983,11394,2324,8023,757,3021,160,342,917,3363
315970,201905,625,1682,483,1490,62,210,320,984,382,1194
315980,201905,4151,9270,2232,6062,390,1106,743,1854,1133,2960
315990,201905,3499,9029,2727,7724,291,894,1591,4378,1882,5272
316000,201905,522,1410,397,1230,66,247,173,503,239,750
316010,201905,793,2138,597,1814,33,124,380,1065,413,1189
316020,201905,952,2932,773,2577,79,338,462,1409,541,1747
316030,201905,2808,7860,2061,6541,234,776,1282,4129,1516,4905
316040,201905,2459,7400,1786,6063,305,1123,421,1298,726,2421
316045,201905,2025,5382,1824,5116,83,185,1527,4394,1610,4579
316050,201905,367,1085,272,909,39,149,149,475,188,624
316060,201905,666,1814,498,1545,28,122,334,960,362,1082
316070,201905,5291,15226,4340,13353,793,2567,1957,5815,2750,8382
316080,201905,706,2232,543,1883,134,501,73,236,207,737
316090,201905,410,1245,291,976,35,151,133,380,168,531
316095,201905,1233,3906,1009,3368,234,825,380,1230,614,2055
316100,201905,2460,7485,1736,5835,322,1168,562,1707,884,2875
316105,201905,842,2273,648,1975,51,176,438,1358,489,1534
316110,201905,12660,37953,10632,34440,952,3481,7088,22734,8040,26215
316120,201905,1082,3217,671,2180,123,432,177,458,300,890
316130,201905,1199,2708,731,1953,56,177,415,1076,471,1253
316140,201905,1102,3014,727,2320,116,402,358,1120,474,1522
316150,201905,1737,3975,1434,3581,202,624,593,1371,795,1995
316160,201905,1011,2841,819,2502,62,224,523,1533,585,1757
316165,201905,889,2245,664,1881,103,346,341,908,444,1254
316170,201905,1063,2759,792,2346,69,250,504,1425,573,1675
316180,201905,1213,3544,807,2677,171,650,142,400,313,1050
316190,201905,2563,7467,1494,4875,233,774,519,1484,752,2258
316200,201905,3206,9514,2314,7768,534,1970,473,1508,1007,3478
316210,201905,4269,12769,3054,9965,1031,3610,317,933,1348,4543
316220,201905,603,1849,393,1352,91,350,47,183,138,533
316225,201905,1465,3420,1116,2826,40,158,835,1971,875,2129
316230,201905,401,1107,308,957,32,100,173,554,205,654
316240,201905,5586,16464,4933,15348,419,1412,3706,11347,4125,12759
316245,201905,2859,9703,2575,9215,148,882,1933,6559,2081,7441
316250,201905,9547,23958,6688,19290,1582,4923,2094,5900,3676,10823
316255,201905,2844,8100,2475,7498,170,583,1787,5427,1957,6010
316257,201905,1224,3025,863,2440,134,392,449,1249,583,1641
316260,201905,1832,4897,1383,4157,113,360,726,2282,839,2642
316265,201905,1131,3097,888,2679,37,136,617,1811,654,1947
316270,201905,3524,11238,2997,10031,544,1916,1375,4391,1919,6307
316280,201905,2883,8656,2470,7858,355,1248,1326,4073,1681,5321
316290,201905,3316,9385,2609,8014,334,1198,1068,3204,1402,4402
316292,201905,4739,12920,3890,11544,492,1634,2625,7558,3117,9192
316294,201905,783,2359,572,1992,104,421,123,405,227,826
316295,201905,2743,7883,2263,7020,130,522,1577,4638,1707,5160
316300,201905,942,2903,802,2657,51,202,548,1802,599,2004
316310,201905,853,2255,515,1658,92,352,97,265,189,617
316320,201905,569,1638,443,1416,51,198,211,639,262,837
316330,201905,1045,2903,773,2384,55,208,539,1591,594,1799
316340,201905,1007,2877,746,2369,76,319,394,1165,470,1484
316350,201905,1187,3518,1021,3240,100,335,691,2173,791,2508
316360,201905,635,1675,504,1460,50,166,358,1010,408,1176
316370,201905,4710,13170,3540,10924,712,2522,1171,3198,1883,5720
316380,201905,1608,3954,1270,3481,46,105,918,2538,964,2643
316390,201905,829,2279,596,1849,209,730,133,382,342,1112
316400,201905,1164,3373,761,2565,129,488,258,782,387,1270
316410,201905,1073,3205,901,2927,66,233,691,2211,757,2444
316420,201905,1816,5205,1593,4927,56,237,1320,3980,1376,4217
316430,201905,838,2315,522,1706,107,378,139,437,246,815
316440,201905,706,2234,553,1969,129,516,95,318,224,834
316443,201905,527,1529,405,1292,107,376,86,266,193,642
316447,201905,1806,5021,1573,4639,50,189,1275,3700,1325,3889
316450,201905,2189,6759,1653,5631,213,781,993,3328,1206,4109
316460,201905,958,2527,765,2208,172,537,410,1114,582,1651
316470,201905,6186,18168,4485,14627,807,3006,1605,4831,2412,7837
316480,201905,206,579,171,520,37,114,81,236,118,350
316490,201905,284,767,209,637,22,75,90,239,112,314
316500,201905,1173,3839,775,2825,160,637,147,496,307,1133
316510,201905,695,2355,554,2077,116,454,240,915,356,1369
316520,201905,1065,2816,837,2431,125,432,403,1076,528,1508
316530,201905,1040,2843,764,2333,97,411,368,977,465,1388
316540,201905,775,2131,624,1893,114,406,288,801,402,1207
316550,201905,1320,4010,1143,3654,74,291,849,2658,923,2949
316553,201905,3438,10529,2377,7949,488,1768,673,2005,1161,3773
316555,201905,2518,8317,2302,8003,153,606,1755,6168,1908,6774
316556,201905,562,1375,396,1097,23,64,220,553,243,617
316557,201905,927,3043,796,2802,296,1091,230,806,526,1897
316560,201905,277,843,207,742,59,245,55,176,114,421
316570,201905,1136,3448,977,3140,255,825,346,1105,601,1930
316580,201905,393,893,246,638,43,123,111,270,154,393
316590,201905,1287,3415,925,2703,142,402,506,1415,648,1817
316600,201905,952,3008,811,2703,136,473,420,1372,556,1845
316610,201905,577,1860,487,1716,55,257,298,994,353,1251
316620,201905,1971,5538,1702,5170,86,292,1257,3856,1343,4148
316630,201905,1527,4617,1229,4053,329,1090,478,1714,807,2804
316640,201905,137,369,107,326,18,58,52,139,70,197
316650,201905,1002,3273,803,2961,68,277,500,1876,568,2153
316660,201905,196,501,88,274,8,25,12,41,20,66
316670,201905,1827,4729,1355,3952,342,1074,459,1292,801,2366
316680,201905,2097,5476,1613,4636,125,398,1178,3304,1303,3702
316690,201905,1166,3508,934,3041,178,643,414,1310,592,1953
316695,201905,987,2929,814,2616,33,143,557,1760,590,1903
316700,201905,369,906,307,833,16,60,231,583,247,643
316710,201905,2845,9590,2163,8125,501,1986,814,3064,1315,5050
316720,201905,19902,56372,14547,45745,2857,9638,5657,16901,8514,26539
316730,201905,397,1138,315,970,52,180,144,394,196,574
316740,201905,690,2105,604,1955,60,257,386,1228,446,1485
316750,201905,391,1193,293,992,60,239,120,355,180,594
316760,201905,3594,11569,2929,10162,1207,4495,739,2464,1946,6959
316770,201905,1515,3672,1193,3230,29,100,1004,2750,1033,2850
316780,201905,541,1651,422,1424,147,560,66,195,213,755
316790,201905,688,1872,469,1437,114,360,129,364,243,724
316800,201905,5906,17091,4742,14964,439,1617,2608,7945,3047,9562
316805,201905,994,2206,814,2011,42,99,676,1699,718,1798
316810,201905,662,1872,443,1397,93,358,214,627,307,985
316820,201905,307,764,152,472,15,52,48,150,63,202
316830,201905,672,1950,548,1743,85,325,329,1001,414,1326
316840,201905,2671,7310,2201,6487,271,952,1374,3854,1645,4806
316850,201905,1969,5255,1409,4236,210,688,616,1812,826,2500
316860,201905,17270,46693,13045,40216,2340,8280,5978,17925,8318,26205
316870,201905,6977,19833,5217,16374,889,3124,2174,6284,3063,9408
316880,201905,770,2111,625,1906,129,451,282,827,411,1278
316890,201905,1096,2501,649,1889,114,402,351,903,465,1305
316900,201905,2197,6148,1708,5166,353,1192,555,1519,908,2711
316905,201905,508,1532,396,1306,91,330,159,528,250,858
316910,201905,857,2320,555,1794,137,509,55,165,192,674
316920,201905,1563,4059,1029,3188,200,656,395,1226,595,1882
316930,201905,7775,23528,5634,19370,1133,4128,1220,4046,2353,8174
316935,201905,3797,10617,2726,8603,534,1779,1012,3073,1546,4852
316940,201905,6463,19540,4914,16168,849,3077,1736,5292,2585,8369
316950,201905,1783,4287,1370,3711,57,181,1073,2857,1130,3038
316960,201905,4849,11415,3574,9568,424,1262,2319,6016,2743,7278
316970,201905,3376,9961,2938,9100,642,2059,1047,3112,1689,5171
316980,201905,701,2142,508,1746,156,602,69,254,225,856
316990,201905,10272,29023,7219,22473,1968,6525,878,2449,2846,8974
317000,201905,2498,7687,2226,7273,162,516,1637,5353,1799,5869
317005,201905,2559,7518,2032,6398,364,1177,1004,3077,1368,4254
317010,201905,22526,54074,13748,40628,3257,10497,4396,13452,7653,23949
317020,201905,60745,147404,34291,100438,6454,20525,9748,26363,16202,46888
317030,201905,645,1808,525,1639,25,108,399,1222,424,1330
317040,201905,10335,27089,7337,21847,1757,5501,2636,8034,4393,13535
317043,201905,808,1914,598,1622,71,194,400,1104,471,1298
317047,201905,1155,2818,778,2197,111,308,454,1274,565,1582
317050,201905,1173,3708,814,2853,111,406,321,998,432,1404
317052,201905,2334,6775,1891,6026,262,894,1166,3666,1428,4560
317057,201905,1636,4160,1153,3311,53,202,689,1930,742,2132
317060,201905,442,1201,266,824,42,147,105,297,147,444
317065,201905,1215,3592,987,3156,52,203,628,1866,680,2069
317070,201905,7314,20645,4983,16023,1079,3924,1131,3438,2210,7362
317075,201905,859,2364,594,1872,111,381,175,498,286,879
317080,201905,5838,14180,4274,11601,1292,3733,1233,3135,2525,6868
317090,201905,4294,13376,3892,12692,350,1120,2790,9068,3140,10188
317100,201905,2350,5721,1571,4504,401,1248,573,1574,974,2822
317103,201905,1820,5602,1586,5166,141,705,1084,3276,1225,3981
317107,201905,1319,3677,1030,3099,54,229,631,1669,685,1898
317110,201905,676,1514,332,999,47,177,109,331,156,508
317115,201905,1085,3149,916,2829,53,156,646,1997,699,2153
317120,201905,11819,34004,9295,29684,1296,4717,4958,15250,6254,19967
317130,201905,9972,23984,6145,17643,1146,3618,1973,5581,3119,9199
317140,201905,667,1855,523,1625,41,136,328,1040,369,1176
317150,201905,993,2456,764,2164,32,117,596,1644,628,1761
317160,201905,3510,8633,2347,6839,195,593,1342,3908,1537,4501
317170,201905,1892,4862,1316,3823,222,758,480,1182,702,1940
317180,201905,1753,5694,1305,4560,275,1021,339,1129,614,2150
317190,201905,1212,3354,904,2856,113,363,517,1629,630,1992
317200,201905,4821,12994,3600,10822,982,3221,699,1917,1681,5138
317210,201905,1135,2872,879,2513,43,162,622,1803,665,1965
317220,201905,273,881,236,804,62,217,83,292,145,509
320010,201905,4381,13078,3578,11476,383,1366,2287,7171,2670,8537
320013,201905,1556,4661,1115,3679,185,589,527,1780,712,2369
320016,201905,2960,7739,2335,6810,111,305,1851,5369,1962,5674
320020,201905,3829,10411,2844,8687,718,2351,951,3004,1669,5355
320030,201905,1507,4476,1043,3492,218,805,341,1068,559,1873
320035,201905,1724,4890,1429,4382,377,1254,610,1820,987,3074
320040,201905,3579,10648,2939,9419,444,1548,1571,4932,2015,6480
320050,201905,1758,4051,1511,3683,233,661,875,2062,1108,2723
320060,201905,10953,31415,8126,25667,1383,4790,3545,10611,4928,15401
320070,201905,1391,4038,980,3184,191,685,333,1036,524,1721
320080,201905,5372,14135,3829,11087,831,2520,1342,3734,2173,6254
320090,201905,7313,20077,5057,15427,1111,3647,2053,5873,3164,9520
320100,201905,2624,7658,2078,6645,418,1441,1007,3140,1425,4581
320110,201905,1398,3632,1046,3030,197,586,462,1313,659,1899
320115,201905,1743,5790,1513,5390,659,2436,462,1716,1121,4152
320120,201905,17905,47441,12313,37248,2046,6700,5050,14611,7096,21311
320130,201905,38349,111954,32194,100612,4955,16896,17990,54717,22945,71613
320140,201905,2911,8550,2170,6990,384,1408,879,2779,1263,4187
320150,201905,12826,34317,8961,26614,2463,7801,1559,4326,4022,12127
320160,201905,5293,15516,3976,12906,668,2311,1858,5950,2526,8261
320170,201905,1415,4239,1047,3480,289,967,403,1361,692,2328
320180,201905,692,2270,562,1996,186,706,139,460,325,1166
320190,201905,2730,8956,2084,7440,509,1917,502,1744,1011,3661
320200,201905,1084,3064,790,2511,202,725,255,805,457,1530
320210,201905,4322,11306,3359,9616,559,1736,1782,4887,2341,6623
320220,201905,2544,7130,1938,6047,363,1214,921,2807,1284,4021
320225,201905,1312,4206,901,3173,340,1278,139,482,479,1760
320230,201905,4534,13028,3435,11162,809,2866,1371,4375,2180,7241
320240,201905,13507,36151,10280,30772,2308,7333,4110,12192,6418,19525
320245,201905,2893,8944,2355,7825,943,3242,520,1693,1463,4935
320250,201905,1944,5630,1284,4028,301,1070,321,899,622,1969
320255,201905,1677,5469,1478,5109,523,1845,633,2289,1156,4134
320260,201905,1019,3075,719,2336,179,649,190,528,369,1177
320265,201905,2292,7269,1928,6538,916,3266,387,1284,1303,4550
320270,201905,2188,6430,1643,5297,362,1266,709,2279,1071,3545
320280,201905,5955,16720,4839,14722,1163,3714,1851,5615,3014,9329
320290,201905,1294,3954,855,2869,237,860,204,638,441,1498
320300,201905,3432,10895,2800,9504,875,3197,554,1767,1429,4964
320305,201905,4771,13997,3802,12035,818,2756,1773,5426,2591,8182
320310,201905,1853,5341,1286,4100,242,811,547,1696,789,2507
320313,201905,2250,5903,1419,4227,321,1044,298,832,619,1876
320316,201905,1433,4223,1208,3787,195,633,700,2183,895,2816
320320,201905,20416,55094,14501,44795,3541,11436,5384,16623,8925,28059
320330,201905,2848,7997,2253,6897,508,1531,1077,3399,1585,4930
320332,201905,5406,15861,4418,14090,1107,3801,2073,6533,3180,10334
320334,201905,1832,5441,1279,4229,293,1147,279,738,572,1885
320335,201905,1505,4487,974,3255,249,889,204,630,453,1519
320340,201905,4672,12218,3909,11022,540,1615,2188,6235,2728,7850
320350,201905,5026,12835,3501,10014,463,1412,1780,4859,2243,6271
320360,201905,1439,3724,1059,2985,139,377,513,1407,652,1784
320370,201905,2324,7515,1850,6428,544,1934,638,2175,1182,4109
320380,201905,2271,6360,1910,5745,269,886,1147,3366,1416,4252
320390,201905,7198,20127,5366,16322,1147,3657,2092,6094,3239,9751
320400,201905,3176,9266,2513,7851,682,2265,972,2929,1654,5194
320405,201905,4331,11736,3267,9888,529,1704,1554,4637,2083,6341
320410,201905,4695,12593,3574,10760,619,1861,1793,5638,2412,7499
320420,201905,2766,7595,2163,6588,647,2162,556,1662,1203,3824
320425,201905,1970,4807,1521,4066,101,300,1026,2643,1127,2943
320430,201905,2771,7144,2146,5943,309,926,1325,3521,1634,4447
320435,201905,2254,7228,1762,6207,639,2353,507,1817,1146,4170
320440,201905,1294,3710,945,3017,150,524,416,1276,566,1800
320450,201905,1559,4673,1242,4072,286,1042,543,1698,829,2740
320455,201905,3814,11812,2562,8829,718,2587,740,2460,1458,5047
320460,201905,2062,6331,1443,4931,365,1306,352,1124,717,2430
320465,201905,1190,3481,897,2892,123,433,495,1578,618,2011
320470,201905,3682,10324,2527,7891,607,2070,590,1693,1197,3763
320480,201905,1600,4644,1337,4147,222,780,711,2123,933,2903
320490,201905,19281,52002,14151,42773,2601,8709,5637,16742,8238,25451
320495,201905,1373,3815,930,2953,202,724,318,941,520,1665
320500,201905,47495,131021,38721,115506,6179,19812,21522,61772,27701,81584
320501,201905,4277,12653,3080,10443,855,3197,961,3209,1816,6406
320503,201905,1997,6221,1438,4999,441,1649,461,1469,902,3118
320506,201905,2640,8029,1824,6170,530,1931,172,562,702,2493
320510,201905,9493,26633,7704,23362,1039,3507,4479,13118,5518,16625
320515,201905,1705,4740,1322,3954,396,1268,420,1203,816,2471
320517,201905,2037,6362,1636,5493,547,1987,414,1364,961,3351
320520,201905,32886,88941,24627,74730,4621,15264,10288,30283,14909,45547
320530,201905,29068,80009,22930,68917,2609,9241,13685,38654,16294,47895
330010,201905,19878,55120,16309,48951,2694,8517,9623,28329,12317,36846
330015,201905,1440,3682,1116,3151,185,597,602,1605,787,2202
330020,201905,19447,49836,16927,46225,2242,7019,12163,32270,14405,39289
330022,201905,1895,5164,1436,4359,232,738,847,2519,1079,3257
330023,201905,4514,11043,3101,8961,598,1840,1492,4210,2090,6050
330025,201905,4641,11660,3127,9117,978,3041,930,2675,1908,5716
330030,201905,10075,27885,7579,23538,907,3317,4440,13038,5347,16355
330040,201905,13963,37573,11091,32521,1227,4056,7088,19894,8315,23950
330045,201905,79852,194802,66538,177290,6135,16269,51062,134835,57197,151104
330050,201905,2357,6406,1750,5364,395,1278,777,2265,1172,3543
330060,201905,4766,13054,3968,11669,849,2754,1720,4695,2569,7449
330070,201905,21436,57067,17662,51242,3246,10043,9663,27756,12909,37799
330080,201905,8398,22068,7310,20452,979,2838,4862,13407,5841,16245
330090,201905,3418,7257,2207,5614,169,463,1442,3623,1611,4086
330093,201905,2422,6174,1785,5186,151,474,1281,3710,1432,4184
330095,201905,1186,3492,918,2975,88,349,525,1568,613,1917
330100,201905,65901,180664,56081,165662,3842,13632,41543,120505,45385,134137
330110,201905,1931,5736,1691,5348,297,1032,857,2617,1154,3649
330115,201905,2057,5290,1557,4530,245,786,902,2537,1147,3323
330120,201905,3407,7881,2507,6650,220,648,1749,4497,1969,5145
330130,201905,3598,10255,3001,9334,461,1524,1822,5618,2283,7142
330140,201905,3418,9183,2742,8182,406,1384,1681,4830,2087,6214
330150,201905,2096,5763,1620,4962,327,1075,709,2099,1036,3174
330160,201905,1307,3658,1030,3189,184,631,546,1609,730,2240
330170,201905,94497,249780,78922,227974,11395,32797,51483,150214,62878,183011
330180,201905,2043,5184,1590,4479,113,376,1066,2908,1179,3284
330185,201905,9087,24177,7606,21848,712,2428,5625,15599,6337,18027
330187,201905,3774,9954,3020,8792,436,1407,1815,5259,2251,6666
330190,201905,30067,76091,26159,70577,2175,6299,20385,54182,22560,60481
330200,201905,14356,38565,12013,35564,2488,6990,7407,22598,9895,29588
330205,201905,2034,5168,1561,4355,100,338,1072,2879,1172,3217
330210,201905,3296,8539,2379,6845,380,1203,1019,2705,1399,3908
330220,201905,10789,27982,7719,22621,1791,5761,2435,6546,4226,12307
330225,201905,3401,9095,2667,7984,239,862,1823,5302,2062,6164
330227,201905,16238,41164,14031,38329,754,2398,11796,31667,12550,34065
330230,201905,1640,3841,1174,3242,76,213,814,2233,890,2446
330240,201905,21705,58170,17606,51438,2805,8904,10501,29803,13306,38707
330245,201905,1645,4162,940,2915,209,680,292,912,501,1592
330250,201905,34163,91823,28971,83855,6167,18142,15653,45717,21820,63859
330260,201905,3998,10642,3103,9329,438,1452,1855,5331,2293,6783
330270,201905,24644,52119,15068,38252,2764,7578,6340,15803,9104,23381
330280,201905,2334,6274,1736,5218,203,671,982,2825,1185,3496
330285,201905,20817,52107,16699,46106,1695,5303,11678,31192,13373,36495
330290,201905,3496,9050,2821,8058,394,1237,1751,4830,2145,6067
330300,201905,5410,13308,3840,10915,390,1256,2430,6749,2820,8005
330310,201905,2236,5820,1700,4907,98,268,1135,3279,1233,3547
330320,201905,14833,37164,11848,33261,1565,4471,8293,23326,9858,27797
330330,201905,31605,74060,25187,65041,2780,7898,17583,44262,20363,52160
330340,201905,13736,35291,10047,29246,1830,5870,4860,13470,6690,19340
330350,201905,108374,268634,91214,246902,7329,20852,71592,192917,78921,213769
330360,201905,7385,18325,6374,17114,295,832,5363,14316,5658,15148
330370,201905,4612,13516,3398,11337,801,2770,1342,4642,2143,7412
330380,201905,5037,14190,3849,12044,796,2764,1733,5210,2529,7974
330385,201905,3855,11585,3180,10555,788,2843,1438,4787,2226,7630
330390,201905,24008,68951,18796,59165,3089,10825,9763,29222,12852,40047
330395,201905,3081,7946,2553,7227,204,638,1751,4849,1955,5487
330400,201905,2976,8263,2602,7619,181,670,1902,5239,2083,5909
330410,201905,2854,7977,2124,6642,445,1528,922,2698,1367,4226
330411,201905,2713,7480,2146,6383,164,583,1481,4203,1645,4786
330412,201905,1451,4327,1188,3858,157,575,673,2035,830,2610
330414,201905,22472,58609,18356,52823,1999,5821,12759,36457,14758,42278
330415,201905,3614,10157,2829,8817,361,1128,1607,5059,1968,6187
330420,201905,9856,24911,6584,19455,928,3029,2939,8169,3867,11198
330430,201905,8757,22163,7553,20376,501,1660,5659,14677,6160,16337
330440,201905,2162,6047,1619,5141,346,1254,800,2411,1146,3665
330450,201905,1291,3845,1043,3383,149,520,519,1649,668,2169
330452,201905,14934,39199,11826,34303,1878,5989,7003,19687,8881,25676
330455,201905,530387,1300415,404396,1112127,64330,187617,242257,654538,306587,842155
330460,201905,1165,3308,884,2864,171,604,443,1387,614,1991
330470,201905,4615,11978,3417,10083,1035,3145,1174,3493,2209,6638
330475,201905,8743,23454,7068,21201,1277,4279,4303,12612,5580,16891
330480,201905,5745,15471,4922,14187,485,1555,3253,9101,3738,10656
330490,201905,110820,264212,92213,238180,10541,28774,65049,165443,75590,194217
330500,201905,6214,16352,5253,14995,639,2035,3712,10419,4351,12454
330510,201905,37293,97973,29057,86030,6454,19952,15648,45920,22102,65872
330513,201905,1245,3301,979,2908,210,672,490,1446,700,2118
330515,201905,2428,6760,2011,6088,522,1676,920,2681,1442,4357
330520,201905,10429,28924,8637,25940,1284,4296,4934,14326,6218,18622
330530,201905,1647,4162,1196,3412,271,836,506,1387,777,2223
330540,201905,2832,7739,2192,6582,610,1847,834,2485,1444,4332
330550,201905,7937,22806,6454,20536,2136,7277,2126,6640,4262,13917
330555,201905,14256,33031,11941,30118,1140,3240,8905,22445,10045,25685
330560,201905,4215,11546,3424,10173,521,1584,2003,5793,2524,7377
330570,201905,2823,7921,2313,7044,382,1265,1409,4221,1791,5486
330575,201905,5287,14108,4584,12870,342,1099,3516,9514,3858,10613
330580,201905,14536,40449,11068,33920,2357,7797,4877,14290,7234,22087
330590,201905,1446,4035,1257,3795,178,539,855,2617,1033,3156
330600,201905,11294,30888,8896,26801,1259,4036,5026,14957,6285,18993
330610,201905,8994,24803,7393,22225,713,2506,4905,14313,5618,16819
330615,201905,2015,5633,1534,4948,309,1065,919,2993,1228,4058
330620,201905,3777,11357,3045,10013,808,2892,1142,3495,1950,6387
330630,201905,23817,62025,18668,53544,1746,5941,12639,34724,14385,40665
350010,201905,2069,5482,1004,3124,224,721,123,285,347,1006
350020,201905,682,1809,358,1136,48,150,131,377,179,527
350030,201905,3713,10776,2726,8855,690,2377,950,2978,1640,5355
350040,201905,667,1974,394,1367,68,270,120,335,188,605
350050,201905,984,2603,687,2062,157,539,228,551,385,1090
350055,201905,880,2318,677,2006,84,289,404,1131,488,1420
350060,201905,107,289,74,233,13,43,37,113,50,156
350070,201905,3640,9727,2202,6984,436,1492,640,1829,1076,3321
350075,201905,587,1803,432,1481,188,676,49,154,237,830
350080,201905,603,1635,376,1183,48,168,162,462,210,630
350090,201905,627,1528,358,1038,77,235,119,314,196,549
350100,201905,2069,5669,1377,4368,146,566,743,2219,889,2785
350110,201905,461,1214,317,953,20,76,175,515,195,591
350115,201905,1290,3828,1036,3253,178,641,529,1503,707,2144
350120,201905,667,1645,355,1031,44,134,171,483,215,617
350130,201905,3048,8376,2419,7174,419,1304,1188,3356,1607,4660
350140,201905,734,2166,474,1619,49,219,217,685,266,904
350150,201905,504,1568,416,1398,94,314,97,301,191,615
350160,201905,10539,26539,6935,20110,866,2955,4130,11233,4996,14188
350170,201905,1843,5538,1423,4563,290,963,537,1637,827,2600
350180,201905,1076,2702,523,1587,119,359,127,364,246,723
350190,201905,2825,8176,1982,6423,409,1519,766,2050,1175,3569
350200,201905,406,1138,323,986,20,67,218,630,238,697
350210,201905,5175,12288,3474,9692,591,1735,1962,5294,2553,7029
350220,201905,2763,7602,1823,5749,431,1429,605,1725,1036,3154
350230,201905,969,2640,803,2373,163,517,414,1181,577,1698
350240,201905,698,2071,448,1474,83,263,138,435,221,698
350250,201905,2352,7184,1768,6119,622,2359,312,1115,934,3474
350260,201905,768,1923,500,1426,55,162,301,831,356,993
350270,201905,4558,12692,3603,10800,610,1963,1779,4973,2389,6936
350275,201905,2282,6378,1820,5555,312,1065,981,2810,1293,3875
350280,201905,18510,42100,10814,29526,2025,5864,3825,10126,5850,15990
350290,201905,3070,8586,2042,6462,395,1381,795,2345,1190,3726
350300,201905,659,1838,468,1433,81,271,208,595,289,866
350310,201905,803,2398,589,1922,96,381,221,616,317,997
350315,201905,553,1487,374,1154,38,141,163,450,201,591
350320,201905,12781,34175,9703,28679,2353,7593,3119,8700,5472,16293
350330,201905,13513,34213,9633,26486,1255,3706,5639,14619,6894,18325
350335,201905,347,994,252,804,20,76,148,457,168,533
350340,201905,1074,2845,622,2004,110,381,220,698,330,1079
350350,201905,743,1969,584,1789,87,310,304,897,391,1207
350360,201905,1094,3319,843,2776,224,726,231,774,455,1500
350370,201905,610,1578,416,1212,132,369,103,296,235,665
350380,201905,4403,12038,2903,9053,801,2522,705,2276,1506,4798
350390,201905,9330,25818,7398,22391,1852,5813,2971,8831,4823,14644
350395,201905,420,1087,202,657,21,63,64,191,85,254
350400,201905,7805,20002,5377,15823,1370,4360,1527,4277,2897,8637
350410,201905,9013,26023,6505,20988,1520,5439,2149,6396,3669,11835
350420,201905,659,1841,475,1493,92,316,108,318,200,634
350430,201905,655,1828,535,1627,61,227,336,929,397,1156
350440,201905,1760,4643,1408,4084,119,424,917,2561,1036,2985
350450,201905,6460,18460,5069,15909,1155,3896,1989,5906,3144,9802
350460,201905,1659,4295,809,2542,132,437,163,450,295,887
350470,201905,268,689,197,559,9,36,127,330,136,366
350480,201905,873,2363,556,1740,114,399,80,220,194,619
350490,201905,1833,4941,1298,4014,301,968,400,1151,701,2119
350500,201905,658,1785,504,1494,78,249,242,672,320,921
350510,201905,1060,2845,755,2268,108,351,385,1101,493,1452
350520,201905,1989,6305,1534,5349,261,1041,664,2108,925,3149
350530,201905,2601,6664,1896,5285,237,738,1095,2874,1332,3612
350535,201905,1415,3999,1221,3706,185,633,755,2209,940,2842
350540,201905,1724,4481,1259,3739,203,645,685,1985,888,2630
350550,201905,8302,20957,5719,16570,645,2204,3179,8581,3824,10785
350560,201905,3782,10910,3009,9449,291,970,1834,5565,2125,6535
350570,201905,22449,64676,17983,55720,3783,12814,8450,24854,12233,37668
350580,201905,1869,5271,998,3269,239,832,143,390,382,1222
350590,201905,4440,12502,3242,9758,506,1749,1798,4909,2304,6658
350600,201905,36673,87715,22601,62136,3287,9950,10570,26507,13857,36457
350610,201905,6386,18011,4619,14422,947,3145,1971,5908,2918,9053
350620,201905,409,1029,242,766,27,100,134,398,161,498
350630,201905,1442,3836,1039,3096,69,266,643,1792,712,2058
350635,201905,7660,19901,5812,16904,1048,3412,3196,8793,4244,12205
350640,201905,921,2527,495,1544,57,187,163,430,220,617
350650,201905,7641,21071,5054,15686,1021,3431,1637,4685,2658,8116
350660,201905,4405,11868,3399,10142,630,1878,1684,5065,2314,6943
350670,201905,1808,4943,1490,4477,164,535,961,2862,1125,3397
350680,201905,1114,3054,718,2287,148,501,285,862,433,1363
350690,201905,1211,3296,872,2685,150,502,452,1321,602,1823
350700,201905,4957,12613,3206,9868,529,1876,1383,3943,1912,5819
350710,201905,2654,7484,2214,6702,324,1132,1226,3515,1550,4647
350715,201905,854,2476,690,2156,71,276,328,919,399,1195
350720,201905,166,403,121,329,26,85,53,130,79,215
350730,201905,543,1563,428,1338,34,141,288,842,322,983
350740,201905,1581,4432,1041,3270,190,617,285,812,475,1429
350745,201905,559,1529,323,1024,32,117,144,409,176,526
350750,201905,9490,25702,7155,21461,1325,4486,2953,7846,4278,12332
350760,201905,13161,34134,9241,27239,2296,7391,2873,7567,5169,14958
350770,201905,920,2316,568,1689,48,146,331,960,379,1106
350775,201905,662,1652,459,1323,44,131,202,567,246,698
350780,201905,1935,5016,1366,4122,260,870,445,1516,705,2386
350790,201905,1664,4555,1021,3324,190,680,231,630,421,1310
350800,201905,3183,9535,2718,8673,385,1356,1569,4840,1954,6196
350810,201905,2437,6266,1937,5529,303,908,1032,2981,1335,3889
350820,201905,913,2160,491,1385,49,148,220,564,269,712
350830,201905,844,2404,458,1522,86,295,126,363,212,658
350840,201905,2840,8639,2067,7086,527,1956,766,2419,1293,4375
350850,201905,6526,18980,4959,15951,1197,4100,1802,5615,2999,9715
350860,201905,3287,9218,2896,8647,138,541,2164,6341,2302,6882
350870,201905,2628,7589,1914,6402,307,1157,974,3141,1281,4298
350880,201905,1192,3565,942,3015,227,735,294,919,521,1654
350890,201905,557,1479,342,1032,50,166,118,309,168,475
350900,201905,6480,18359,4079,12983,1097,3767,913,2651,2010,6418
350910,201905,859,2255,731,2032,103,319,490,1317,593,1636
350920,201905,11458,29552,9745,26615,508,1694,7646,19999,8154,21693
350925,201905,4342,12217,3098,9818,598,2019,1367,3965,1965,5984
350930,201905,1416,3697,941,2783,112,364,512,1445,624,1809
350940,201905,2050,5749,1629,4986,206,671,1005,3007,1211,3678
350945,201905,825,2356,618,1943,106,392,280,799,386,1191
350950,201905,80025,214172,61727,177959,8782,27836,36093,98904,44875,126740
350960,201905,5720,16181,4455,13743,637,2217,2538,7397,3175,9614
350970,201905,3532,10601,2619,8636,832,3026,406,1169,1238,4195
350980,201905,607,1706,481,1463,150,482,182,546,332,1028
350990,201905,1703,5035,1275,4297,304,1145,447,1427,751,2572
350995,201905,745,2403,669,2242,46,195,458,1467,504,1662
351000,201905,2715,7215,1910,5744,387,1248,621,1782,1008,3030
351010,201905,308,771,197,568,18,58,101,279,119,337
351015,201905,731,2256,591,1979,85,334,282,852,367,1186
351020,201905,8908,24879,6686,21021,1361,4457,3292,10090,4653,14547
351030,201905,2512,7694,2030,6687,313,1157,1064,3386,1377,4543
351040,201905,4594,11808,3861,10650,218,763,3078,8175,3296,8938
351050,201905,16941,42128,11386,33173,2443,7577,4512,12869,6955,20446
351060,201905,45211,116979,34532,98216,4220,13112,21974,60424,26194,73536
351070,201905,1329,3474,776,2473,227,777,113,345,340,1122
351080,201905,2597,6685,1887,5792,310,1112,1085,3116,1395,4228
351090,201905,329,991,227,789,46,162,54,189,100,351
351100,201905,2258,6239,1449,4587,352,1155,383,1268,735,2423
351110,201905,5711,14880,3682,11082,699,2284,1468,4117,2167,6401
351120,201905,746,1980,506,1540,74,236,214,618,288,854
351130,201905,1065,2799,453,1475,93,310,75,225,168,535
351140,201905,1845,5397,1307,4322,309,1131,438,1295,747,2426
351150,201905,2009,5958,1271,4271,266,960,417,1238,683,2198
351160,201905,1109,3600,872,3045,199,731,267,833,466,1564
351170,201905,1347,3874,1161,3498,117,393,754,2179,871,2572
351190,201905,1006,2837,618,1999,104,330,197,580,301,910
351200,201905,1601,3946,1212,3350,96,305,810,2128,906,2433
351210,201905,1527,3848,892,2546,84,274,500,1326,584,1600
351220,201905,3082,9008,2644,8255,327,1074,1691,5214,2018,6288
351230,201905,1758,4973,1291,4116,265,975,535,1509,800,2484
351240,201905,2063,5440,1349,3932,257,785,593,1599,850,2384
351250,201905,1085,2916,600,1898,77,253,221,708,298,961
351260,201905,913,2406,666,1948,151,427,226,672,377,1099
351270,201905,385,1118,317,1005,46,176,172,473,218,649
351280,201905,3828,10508,2918,8735,494,1611,1349,3844,1843,5455
351290,201905,1059,2757,715,2131,128,390,352,1017,480,1407
351300,201905,15069,42541,10291,33094,2056,7124,4026,12621,6082,19745
351310,201905,3101,8119,2360,6881,229,811,1559,4246,1788,5057
351320,201905,888,2677,645,2106,120,434,242,722,362,1156
351330,201905,588,1789,504,1633,42,128,383,1256,425,1384
351340,201905,6212,18367,4956,16104,1245,4182,2008,6528,3253,10710
351350,201905,11259,29580,9453,26500,1043,3141,6859,18616,7902,21757
351360,201905,3765,10351,3112,9288,797,2570,1087,2984,1884,5554
351370,201905,2124,6102,1410,4569,372,1264,445,1283,817,2547
351380,201905,44871,112920,31988,89418,4869,14449,17117,45824,21986,60273
351385,201905,275,692,146,430,26,71,42,113,68,184
351390,201905,1366,3459,838,2639,135,495,468,1368,603,1863
351400,201905,910,2617,724,2221,151,470,385,1150,536,1620
351410,201905,2458,6994,1759,5603,334,1073,699,2193,1033,3266
351420,201905,362,888,189,569,35,93,87,261,122,354
351430,201905,860,2486,716,2246,69,228,484,1484,553,1712
351440,201905,3298,8880,2129,6394,398,1301,557,1390,955,2691
351450,201905,1717,4581,1125,3471,234,784,219,578,453,1362
351460,201905,770,2103,601,1806,163,488,304,902,467,1390
351470,201905,1184,3103,901,2600,92,314,553,1500,645,1814
351480,201905,2537,7671,2031,6779,350,1284,894,2819,1244,4103
351490,201905,1861,5507,1602,5000,79,319,1211,3605,1290,3924
351492,201905,336,944,271,798,14,52,177,497,191,549
351495,201905,198,553,142,432,18,56,71,201,89,257
351500,201905,34822,89364,25825,73222,4603,13951,13882,37405,18485,51356
351510,201905,12066,31052,8746,25021,1215,3920,5224,14226,6439,18146
351512,201905,482,1343,317,963,49,147,103,285,152,432
351515,201905,3129,7181,1846,5065,353,1087,524,1450,877,2537
351518,201905,2310,5990,1465,4459,218,760,773,2117,991,2877
351519,201905,733,2043,408,1327,70,229,65,194,135,423
351520,201905,1152,2932,442,1404,61,213,166,466,227,679
351530,201905,347,972,196,621,36,120,67,166,103,286
351535,201905,2005,4914,1416,3911,198,606,755,1945,953,2551
351540,201905,2180,5602,1395,4206,374,1274,345,885,719,2159
351550,201905,6160,15912,4135,11949,441,1529,2327,6182,2768,7711
351560,201905,426,1254,343,1083,82,294,94,263,176,557
351565,201905,185,567,145,490,36,134,41,133,77,267
351570,201905,18852,52258,13999,41824,1727,5644,8410,23996,10137,29640
351580,201905,263,683,151,462,14,44,60,185,74,229
351590,201905,502,1161,259,719,31,107,131,317,162,424
351600,201905,1441,3820,1090,3162,113,370,650,1745,763,2115
351610,201905,754,1782,479,1305,28,89,249,610,277,699
351620,201905,20805,58051,15385,47827,2711,9592,6474,17982,9185,27574
351630,201905,25447,70175,20502,61232,3558,11126,12107,35089,15665,46215
351640,201905,15657,42953,12008,35885,1379,4660,7732,22119,9111,26779
351650,201905,405,1095,180,590,22,75,42,119,64,194
351660,201905,761,2216,461,1486,85,296,79,228,164,524
351670,201905,5263,14611,3699,11127,742,2252,1688,4742,2430,6994
351680,201905,408,1219,258,833,50,137,63,188,113,325
351685,201905,440,1308,350,1148,92,301,115,353,207,654
351690,201905,1043,2703,604,1776,103,332,245,650,348,982
351700,201905,1228,3178,890,2553,123,357,498,1358,621,1715
351710,201905,752,2054,509,1588,43,163,245,675,288,838
351720,201905,1458,3907,924,2906,168,582,325,948,493,1530
351730,201905,915,2498,752,2206,85,303,465,1276,550,1579
351740,201905,3550,9133,2737,7523,492,1441,1293,3269,1785,4710
351750,201905,1268,3508,783,2591,162,571,261,841,423,1412
351760,201905,3260,9361,2290,7300,479,1718,796,2312,1275,4030
351770,201905,1785,5418,1452,4739,343,1150,663,2126,1006,3276
351780,201905,1390,3612,723,2216,129,460,206,589,335,1049
351790,201905,1248,3068,988,2709,161,427,595,1657,756,2084
351800,201905,524,1224,258,726,31,94,87,204,118,298
351810,201905,988,2681,804,2370,49,146,576,1622,625,1768
351820,201905,2440,7062,1677,5508,447,1597,323,1011,770,2608
351830,201905,4193,11619,3216,9859,340,1228,1912,5565,2252,6793
351840,201905,7857,22790,5941,19133,992,3520,2783,8469,3775,11989
351850,201905,1745,4694,1073,3392,213,756,318,891,531,1647
351860,201905,2762,8227,2162,7041,392,1336,1150,3745,1542,5081
351870,201905,22267,59077,17032,50247,5219,15803,6130,18675,11349,34478
351880,201905,112173,306725,83897,254685,22791,74763,29633,85221,52424,159984
351885,201905,851,2402,666,2048,91,301,373,1093,464,1394
351890,201905,679,1909,495,1587,110,351,67,183,177,534
351900,201905,1039,2891,806,2518,145,462,391,1213,536,1675
351905,201905,382,1093,255,825,21,72,92,260,113,332
351907,201905,21487,57441,16496,48288,1860,5970,10634,30015,12494,35985
351910,201905,1234,3287,850,2479,88,283,455,1202,543,1485
351920,201905,838,2248,608,1788,73,263,293,785,366,1048
351925,201905,892,2504,687,2104,101,335,319,911,420,1246
351930,201905,3100,8937,2817,8394,424,1359,2042,5946,2466,7305
351940,201905,1072,2835,767,2292,110,362,393,1136,503,1498
351950,201905,1550,3685,1109,3018,74,222,708,1864,782,2086
351960,201905,5039,13206,3746,10905,841,2646,1596,4330,2437,6976
351970,201905,6183,19397,5130,17488,864,3311,2777,9123,3641,12434
351980,201905,1041,2496,656,1849,82,278,375,976,457,1254
351990,201905,1399,3420,973,2741,86,301,425,1077,511,1378
352000,201905,2466,7250,2094,6465,252,905,1332,3803,1584,4708
352010,201905,2114,5933,1714,5209,440,1454,314,1008,754,2462
352020,201905,1440,4051,1131,3513,198,655,534,1584,732,2239
352030,201905,5345,14609,4248,12800,865,2843,2162,6318,3027,9161
352040,201905,2536,7016,1592,5037,280,927,461,1273,741,2200
352042,201905,3118,7827,1869,5626,394,1278,730,2165,1124,3443
352044,201905,2084,5725,1155,3892,195,711,230,713,425,1424
352050,201905,12057,33048,7613,23945,1877,6627,1193,3247,3070,9874
352060,201905,733,2040,522,1621,69,230,235,681,304,911
352070,201905,737,1523,515,1229,66,178,293,656,359,834
352080,201905,465,1216,282,838,34,113,105,272,139,385
352090,201905,1432,4341,1150,3726,161,584,462,1331,623,1915
352100,201905,2994,8613,2481,7643,590,1942,1117,3260,1707,5202
352110,201905,571,1772,438,1480,104,379,159,486,263,865
352115,201905,516,1487,428,1346,62,216,245,765,307,981
352120,201905,855,2624,670,2219,78,292,382,1175,460,1467
352130,201905,1858,5323,1205,3678,232,722,462,1305,694,2027
352140,201905,1239,3367,817,2521,129,437,386,1149,515,1586
352150,201905,820,2266,609,1874,120,390,338,1011,458,1401
352160,201905,977,2458,709,2036,91,310,371,1012,462,1322
352170,201905,2943,8159,2301,6829,406,1338,1201,3259,1607,4597
352180,201905,2585,7152,2035,6090,514,1711,628,1640,1142,3351
352190,201905,1143,3119,857,2664,139,436,388,1236,527,1672
352200,201905,370,1135,254,885,35,135,84,276,119,411
352210,201905,18020,44305,14091,38839,1287,3863,10316,28016,11603,31879
352215,201905,527,1432,461,1348,54,167,319,913,373,1080
352220,201905,16732,43779,11176,33394,2822,8812,3721,10685,6543,19497
352230,201905,12539,38001,9531,32043,2335,8655,3248,10174,5583,18829
352240,201905,10692,28369,8049,23796,1821,6106,3247,8679,5068,14785
352250,201905,22386,64469,18003,56438,3617,11993,9766,30010,13383,42003
352260,201905,4771,12473,3303,9509,483,1647,1861,4839,2344,6486
352265,201905,909,2627,802,2451,56,216,583,1714,639,1930
352270,201905,1466,4551,1094,3725,239,889,357,1125,596,2014
352280,201905,2333,6109,1779,5268,181,678,1006,2743,1187,3421
352290,201905,1083,3288,887,2867,151,539,427,1233,578,1772
352300,201905,931,2557,638,1945,93,333,310,841,403,1174
352310,201905,44346,120160,32483,98741,8261,25502,13658,41728,21919,67230
352320,201905,6152,16870,4693,13875,745,2455,2344,6247,3089,8702
352330,201905,2118,5856,1614,5122,320,1173,771,2306,1091,3479
352340,201905,5081,13880,3672,11324,680,2358,1654,4687,2334,7045
352350,201905,2079,6179,1624,5103,205,800,845,2361,1050,3161
352360,201905,1211,3296,1030,2979,100,354,764,2115,864,2469
352370,201905,1044,3058,894,2775,32,140,692,2084,724,2224
352380,201905,800,2276,614,1911,136,451,210,621,346,1072
352390,201905,15415,38680,10385,29940,1672,5301,5561,15070,7233,20371
352400,201905,3353,9468,2858,8540,472,1722,1740,4824,2212,6546
352410,201905,2991,8018,2256,6734,238,850,1360,3864,1598,4714
352420,201905,855,2129,585,1692,112,340,199,547,311,887
352430,201905,7118,18578,5070,14931,1339,4370,2032,5575,3371,9945
352440,201905,16956,47515,12840,39385,2991,9552,5093,15086,8084,24638
352450,201905,808,2104,400,1321,56,193,119,364,175,557
352460,201905,2877,8157,1929,6330,411,1488,649,2011,1060,3499
352470,201905,3381,8567,2419,6972,295,967,1324,3545,1619,4512
352480,201905,3356,8303,2231,6239,372,1179,1055,2702,1427,3881
352490,201905,703,2146,552,1835,104,380,247,774,351,1154
352500,201905,10070,26717,6898,20661,3164,10284,800,1496,3964,11780
352510,201905,3384,9463,2512,7911,570,1974,1002,2948,1572,4922
352520,201905,2469,6922,1905,5895,431,1488,922,2582,1353,4070
352530,201905,9212,25226,5820,18197,1239,4345,1081,2647,2320,6992
352540,201905,532,1597,384,1248,71,239,104,308,175,547
352550,201905,957,2828,660,2206,131,486,197,596,328,1082
352560,201905,567,1618,417,1299,68,222,165,469,233,691
352570,201905,1972,5835,1269,4354,318,1146,163,488,481,1634
352580,201905,709,1936,575,1692,93,322,299,821,392,1143
352585,201905,242,710,181,579,19,73,99,294,118,367
352590,201905,13057,35110,9056,27280,2648,8587,3556,9882,6204,18469
352600,201905,1922,5391,1460,4472,225,741,774,2218,999,2959
352610,201905,2967,8480,2208,7104,484,1727,837,2524,1321,4251
352620,201905,5609,14923,4333,12942,1376,4134,1523,4635,2899,8769
352630,201905,825,2091,622,1781,101,334,282,734,383,1068
352640,201905,2916,7757,2105,6336,217,713,1235,3550,1452,4263
352650,201905,560,1624,396,1237,60,216,144,421,204,637
352660,201905,1010,3103,812,2675,173,601,355,1126,528,1727
352670,201905,8454,23792,5408,17469,1497,5121,786,2477,2283,7598
352680,201905,3205,9764,2246,7446,368,1434,1049,3177,1417,4611
352690,201905,26935,69720,20103,57293,1797,5901,12953,35077,14750,40978
352700,201905,549,1424,403,1212,157,527,86,223,243,750
352710,201905,4895,13031,3474,10372,887,2928,1405,3874,2292,6802
352720,201905,7755,22183,5988,18643,2805,8873,815,2239,3620,11112
352725,201905,524,1344,267,805,20,63,121,348,141,411
352730,201905,2692,7790,2259,6785,340,1151,1303,3570,1643,4721
352740,201905,2196,5298,1616,4416,202,631,911,2352,1113,2983
352750,201905,412,1047,218,680,41,135,78,211,119,346
352760,201905,1550,4418,1163,3614,149,497,571,1715,720,2212
352770,201905,903,2478,595,1855,121,386,216,631,337,1017
352780,201905,647,1914,447,1506,89,318,137,456,226,774
352790,201905,507,1372,336,1020,34,105,122,323,156,428
352800,201905,1250,3955,890,3085,227,835,140,437,367,1272
352810,201905,1088,2629,673,1858,90,269,383,994,473,1263
352820,201905,510,1350,329,1036,72,235,73,241,145,476
352830,201905,589,1516,255,793,33,105,47,120,80,225
352840,201905,3790,11254,3129,10004,1097,3784,968,2949,2065,6733
352850,201905,10104,25675,6691,20026,1915,6151,1957,5466,3872,11617
352860,201905,1002,2791,704,2216,142,477,220,661,362,1138
352870,201905,886,2264,607,1660,43,145,392,1017,435,1162
352880,201905,1800,4422,1247,3397,180,526,715,1797,895,2323
352885,201905,289,827,212,685,31,109,116,353,147,462
352890,201905,710,1708,435,1137,47,134,236,538,283,672
352900,201905,17564,46904,11663,35097,2003,6480,5106,14309,7109,20789
352910,201905,459,1223,216,679,25,76,51,145,76,221
352920,201905,2591,6909,1882,5606,167,562,1208,3438,1375,4000
352930,201905,5582,15587,4088,12575,748,2454,1808,5201,2556,7655
352940,201905,22085,63367,16249,50480,3945,13448,5433,15869,9378,29317
352950,201905,467,1242,256,826,60,194,27,85,87,279
352960,201905,720,1994,368,1203,64,228,71,223,135,451
352965,201905,266,719,150,494,42,142,31,87,73,229
352970,201905,3001,7278,2249,6031,262,734,1450,3845,1712,4579
352980,201905,1366,3781,1061,3283,263,859,491,1471,754,2330
352990,201905,3992,11388,3223,10118,638,2237,1642,4939,2280,7176
353000,201905,463,1287,222,718,33,114,51,141,84,255
353010,201905,2498,6391,1617,4775,401,1295,557,1499,958,2794
353020,201905,3658,9579,2057,6190,301,1022,703,1926,1004,2948
353030,201905,4129,10956,2799,8464,695,2265,654,1927,1349,4192
353040,201905,599,1456,436,1199,61,187,246,628,307,815
353050,201905,5005,14895,3639,12015,781,2796,1569,4914,2350,7710
353060,201905,46304,121498,37877,107651,3003,10319,27531,75016,30534,85335
353070,201905,9085,26489,6403,20790,1410,4899,2236,6785,3646,11684
353080,201905,4083,11723,2815,9163,582,2113,969,2785,1551,4898
353090,201905,572,1761,424,1433,44,169,231,740,275,909
353100,201905,309,851,127,413,28,95,31,83,59,178
353110,201905,7354,20651,5971,18545,1075,3443,3417,10812,4492,14255
353120,201905,460,1177,293,862,42,135,116,312,158,447
353130,201905,2269,5667,1509,4430,427,1375,481,1310,908,2685
353140,201905,2525,6424,1820,5106,154,493,1151,3012,1305,3505
353150,201905,1460,3753,1031,3035,210,641,423,1171,633,1812
353160,201905,575,1517,408,1233,85,289,163,437,248,726
353170,201905,503,1442,397,1281,80,299,179,537,259,836
353180,201905,9520,24175,7413,20603,855,2673,5195,14002,6050,16675
353190,201905,3246,8925,2550,7540,276,913,1561,4282,1837,5195
353200,201905,2025,5495,924,3070,139,490,210,638,349,1128
353205,201905,330,1042,279,914,57,199,129,413,186,612
353210,201905,973,2344,613,1734,34,110,384,1063,418,1173
353215,201905,393,1124,303,932,44,138,137,373,181,511
353220,201905,791,2164,463,1458,101,310,62,178,163,488
353230,201905,770,2210,626,1978,171,600,255,713,426,1313
353240,201905,2213,6190,1778,5393,249,867,1047,3039,1296,3906
353250,201905,1281,2926,746,2016,102,282,378,979,480,1261
353260,201905,1048,2500,593,1730,109,357,231,635,340,992
353270,201905,675,1830,552,1598,45,145,368,1013,413,1158
353280,201905,724,1996,499,1551,98,313,155,445,253,758
353282,201905,1765,5115,1497,4585,173,604,879,2517,1052,3121
353284,201905,353,858,175,499,25,91,69,165,94,256
353286,201905,161,425,96,307,22,73,37,116,59,189
353290,201905,1551,4114,933,2838,95,329,448,1247,543,1576
353300,201905,1728,4749,1264,3797,210,740,561,1479,771,2219
353310,201905,392,992,273,770,25,93,166,439,191,532
353320,201905,620,1615,528,1456,17,54,439,1203,456,1257
353325,201905,630,1893,422,1424,94,321,145,469,239,790
353330,201905,552,1456,345,1018,44,135,172,480,216,615
353340,201905,2719,7540,1876,5891,473,1601,730,2183,1203,3784
353350,201905,3218,8778,2170,6530,477,1588,493,1260,970,2848
353360,201905,576,1658,450,1421,50,163,234,728,284,891
353370,201905,540,1643,443,1472,37,128,291,931,328,1059
353380,201905,266,824,209,705,36,136,95,295,131,431
353390,201905,5542,14239,4063,11608,587,1842,2083,5601,2670,7443
353400,201905,392,1129,293,927,50,188,80,203,130,391
353410,201905,530,1453,407,1226,76,253,222,661,298,914
353420,201905,458,1253,271,834,55,160,20,40,75,200
353430,201905,2191,6262,1580,5095,379,1345,606,1795,985,3140
353440,201905,61781,173338,43580,136416,7998,26763,21438,63670,29436,90433
353450,201905,381,1006,257,789,42,149,110,306,152,455
353460,201905,3271,9001,2336,7096,174,622,1086,3198,1260,3820
353470,201905,7523,20310,5243,15955,961,3301,2013,5579,2974,8880
353475,201905,1395,3743,960,2794,139,437,448,1201,587,1638
353480,201905,1649,4482,1279,3788,82,286,834,2377,916,2663
353490,201905,964,2637,634,1936,117,392,277,794,394,1186
353500,201905,981,2374,761,2039,183,494,413,1118,596,1612
353510,201905,829,2515,602,1947,137,469,139,391,276,860
353520,201905,1102,2939,695,2167,86,302,318,942,404,1244
353530,201905,2427,6581,1854,5492,239,790,923,2537,1162,3327
353540,201905,1992,5626,1630,5005,307,974,877,2617,1184,3591
353550,201905,5712,15255,4521,13213,846,2578,2308,6485,3154,9063
353560,201905,1981,5687,1458,4809,475,1706,345,1054,820,2760
353570,201905,558,1482,408,1218,57,166,241,680,298,846
353580,201905,1998,5360,1568,4563,376,1074,691,1961,1067,3035
353590,201905,708,1989,449,1427,114,407,135,420,249,827
353600,201905,1757,4454,1339,3700,173,472,692,1865,865,2337
353610,201905,550,1698,395,1368,88,343,101,325,189,668
353620,201905,2591,7124,1803,5675,369,1297,554,1565,923,2862
353625,201905,500,1253,316,922,26,87,198,566,224,653
353630,201905,1185,3847,949,3281,224,857,282,878,506,1735
353640,201905,1357,3596,1063,3125,130,408,618,1794,748,2202
353650,201905,8697,24056,6215,18902,765,2588,3386,9576,4151,12164
353657,201905,367,988,256,784,28,100,119,326,147,426
353660,201905,1170,2555,795,2028,321,819,229,550,550,1369
353670,201905,3846,11069,3008,9376,634,2190,1453,4140,2087,6330
353680,201905,698,1936,519,1662,93,316,277,857,370,1173
353690,201905,448,1166,168,543,9,25,17,44,26,69
353700,201905,1909,5291,1600,4716,150,499,1112,3145,1262,3644
353710,201905,4281,9658,2346,6221,257,711,1360,3276,1617,3987
353715,201905,470,1250,268,853,17,67,70,205,87,272
353720,201905,1847,5127,1446,4520,184,667,905,2736,1089,3403
353730,201905,4216,11663,3115,9504,501,1687,1428,4031,1929,5718
353740,201905,1927,5212,1322,4087,333,1137,402,1144,735,2281
353750,201905,808,2519,566,2030,142,530,94,376,236,906
353760,201905,11820,28859,9218,25169,1555,4453,5471,14577,7026,19030
353770,201905,724,2201,355,1224,64,222,42,116,106,338
353780,201905,4952,14548,3781,12069,841,2962,1520,4446,2361,7408
353790,201905,2462,7692,1812,6301,508,1990,390,1199,898,3189
353800,201905,16693,45761,12784,39072,2075,6808,6595,19984,8670,26792
353810,201905,1095,3027,726,2269,101,355,295,857,396,1212
353820,201905,1702,4846,1179,3727,269,900,382,1175,651,2075
353830,201905,629,1579,439,1253,67,189,186,509,253,698
353850,201905,1611,4622,1223,3844,310,980,390,1246,700,2226
353860,201905,2544,7391,1988,6312,509,1789,826,2398,1335,4187
353870,201905,28131,75768,19314,58308,2780,9406,9339,25704,12119,35110
353880,201905,2868,8304,2258,7059,218,797,1320,3942,1538,4739
353890,201905,2356,5313,1520,4105,157,444,988,2553,1145,2997
353900,201905,682,1904,486,1514,95,321,190,553,285,874
353910,201905,1846,5458,1541,4938,206,767,1032,3244,1238,4011
353920,201905,2033,5654,1368,4335,293,1061,323,862,616,1923
353930,201905,4105,11157,2712,8602,556,1962,879,2481,1435,4443
353940,201905,1085,3240,720,2446,146,500,225,719,371,1219
353950,201905,2945,8322,2316,7148,449,1526,1229,3475,1678,5001
353960,201905,740,2018,480,1499,101,329,168,505,269,834
353970,201905,700,1722,507,1434,45,133,307,834,352,967
353980,201905,14365,37739,11009,31499,1073,3405,7333,20184,8406,23589
353990,201905,867,2159,518,1501,69,227,256,694,325,921
354000,201905,2499,6192,1339,3932,289,884,205,603,494,1487
354010,201905,338,911,247,762,27,91,148,444,175,535
354020,201905,3381,9843,2647,8206,695,2307,950,2674,1645,4981
354025,201905,734,2049,460,1499,85,317,79,221,164,538
354030,201905,485,1063,232,624,43,116,91,227,134,343
354040,201905,778,1860,488,1360,24,80,333,888,357,968
354050,201905,942,2789,657,2236,164,575,179,628,343,1203
354060,201905,3536,10396,2390,7881,561,1940,715,2189,1276,4129
354070,201905,3325,9339,2282,7234,478,1674,748,2038,1226,3712
354075,201905,2393,7231,1814,6109,255,1023,972,3166,1227,4189
354080,201905,1411,3966,907,2937,168,577,231,691,399,1268
354085,201905,404,877,318,768,2,5,223,504,225,509
354090,201905,1447,4168,1277,3813,97,318,955,2798,1052,3116
354100,201905,17417,49896,12129,40169,2771,9810,4642,15211,7413,25021
354105,201905,1510,3841,980,2849,123,365,444,1230,567,1595
354110,201905,486,1345,325,1045,58,204,102,324,160,528
354120,201905,1513,4151,988,3012,192,612,332,898,524,1510
354130,201905,5636,15155,3642,11244,1016,3388,214,402,1230,3790
354140,201905,18896,47008,12242,34815,2367,7291,4758,12492,7125,19783
354150,201905,3098,7601,2265,6208,517,1460,873,2351,1390,3811
354160,201905,3051,9073,2230,7335,649,2278,647,1981,1296,4259
354165,201905,589,1790,443,1491,80,309,219,688,299,997
354170,201905,1520,4385,1236,3796,87,302,748,2186,835,2488
354180,201905,436,1240,308,959,61,199,117,324,178,523
354190,201905,1454,4188,1020,3291,94,335,391,1247,485,1582
354200,201905,871,2239,675,1925,87,264,386,1023,473,1287
354210,201905,656,1876,537,1650,47,163,356,1019,403,1182
354220,201905,3029,8404,2179,6643,420,1374,988,2853,1408,4227
354230,201905,697,1803,541,1601,48,188,367,1020,415,1208
354240,201905,1539,4385,997,3214,181,636,293,831,474,1467
354250,201905,507,1301,321,1006,88,285,94,303,182,588
354260,201905,8047,21973,6081,18500,1394,4398,2273,6784,3667,11182
354270,201905,1021,3161,808,2732,186,629,279,920,465,1549
354280,201905,747,1945,627,1772,70,259,380,974,450,1233
354290,201905,876,2838,727,2504,118,409,359,1259,477,1668
354300,201905,3489,10576,2963,9573,955,3157,928,2937,1883,6094
354310,201905,593,1853,477,1587,117,427,137,391,254,818
354320,201905,890,2258,560,1657,76,275,225,584,301,859
354323,201905,478,1203,310,884,36,90,124,339,160,429
354325,201905,1204,3675,840,2857,140,483,333,1095,473,1578
354330,201905,8163,21388,5367,15497,756,2592,3043,8093,3799,10685
354340,201905,27689,72788,18856,56792,3750,12397,8485,24331,12235,36728
354350,201905,1162,3078,922,2631,108,325,597,1615,705,1940
354360,201905,588,1549,325,1078,58,195,52,170,110,365
354370,201905,978,2988,804,2677,137,475,429,1412,566,1887
354380,201905,750,2018,518,1621,92,345,120,301,212,646
354390,201905,13196,33057,8193,24032,1583,4881,2806,7848,4389,12729
354400,201905,1558,5108,1200,4250,208,774,436,1544,644,2318
354410,201905,5266,14927,3934,12148,933,3073,1628,4812,2561,7885
354420,201905,1432,3882,1044,3118,141,448,619,1772,760,2220
354425,201905,2570,6472,1803,5078,428,1241,697,2003,1125,3244
354430,201905,1514,4173,1169,3573,158,556,633,1774,791,2330
354440,201905,574,1574,356,1102,42,148,163,459,205,607
354450,201905,415,1110,226,744,35,116,60,171,95,287
354460,201905,909,2366,588,1787,90,298,296,853,386,1151
354470,201905,502,1292,309,887,21,66,142,361,163,427
354480,201905,1068,2470,720,1918,66,194,480,1210,546,1404
354490,201905,789,2381,574,1901,117,395,222,672,339,1067
354500,201905,1983,5724,1649,5208,524,1810,374,1177,898,2987
354510,201905,741,2081,590,1746,63,192,317,860,380,1052
354515,201905,295,897,217,732,38,151,83,253,121,404
354520,201905,6441,18339,4235,13292,663,2334,2198,6404,2861,8738
354530,201905,4034,12006,3086,10048,733,2520,1173,3712,1906,6232
354540,201905,1277,3492,923,2835,230,742,307,955,537,1697
354550,201905,523,1407,400,1170,58,172,235,661,293,833
354560,201905,2005,5044,1075,3149,146,445,529,1464,675,1909
354570,201905,1159,3013,479,1428,89,269,73,216,162,485
354580,201905,9076,24202,5814,17918,944,3188,2700,7884,3644,11072
354600,201905,1699,4841,1303,4056,153,556,808,2397,961,2953
354610,201905,407,1099,214,679,32,109,78,242,110,351
354620,201905,435,1273,277,950,46,177,100,298,146,475
354625,201905,325,910,178,598,26,92,43,117,69,209
354630,201905,1816,5558,1460,4825,558,1924,204,666,762,2590
354640,201905,3096,9146,2237,7300,393,1451,705,2095,1098,3546
354650,201905,892,2383,710,2064,68,203,432,1231,500,1434
354660,201905,2932,7377,1742,5276,157,569,1001,2891,1158,3460
354670,201905,1039,2960,710,2262,155,542,267,783,422,1325
354680,201905,4608,12749,3662,11135,894,2810,1816,5613,2710,8423
354690,201905,567,1798,382,1363,89,342,105,361,194,703
354700,201905,874,2363,609,1812,97,326,272,725,369,1051
354710,201905,493,1358,346,1056,51,176,146,386,197,562
354720,201905,326,800,138,411,45,132,26,81,71,213
354730,201905,9446,27252,6998,22400,1018,3575,3807,11753,4825,15328
354740,201905,320,883,123,432,15,62,21,67,36,129
354750,201905,2426,6595,1528,4802,297,1021,581,1599,878,2620
354760,201905,1897,5332,1301,4141,343,1181,360,1059,703,2240
354765,201905,343,922,134,443,19,69,25,70,44,139
354770,201905,2292,5797,1640,4685,332,1014,718,1907,1050,2921
354780,201905,52480,137114,39484,110532,5125,16006,22925,59937,28050,75943
354790,201905,965,2766,764,2411,99,340,447,1355,546,1695
354800,201905,2563,6921,1971,5894,507,1552,778,2207,1285,3759
354805,201905,1306,3138,865,2418,117,335,428,1075,545,1410
354810,201905,657,1917,353,1253,51,197,74,232,125,429
354820,201905,920,2739,648,2171,128,483,152,426,280,909
354830,201905,479,1194,305,873,69,197,99,263,168,460
354840,201905,921,2348,491,1460,47,139,253,725,300,864
354850,201905,20621,55497,14216,43420,1953,6890,7976,22758,9929,29648
354860,201905,1579,4539,1016,3347,197,713,312,896,509,1609
354870,201905,52652,135903,40874,113883,5085,15511,24250,63958,29335,79469
354880,201905,5689,14519,2588,7620,315,1049,849,2013,1164,3062
354890,201905,16285,41856,12541,35340,1755,5569,7288,19707,9043,25276
354900,201905,408,1093,267,829,41,135,70,193,111,328
354910,201905,5075,13823,2926,9675,660,2322,353,1094,1013,3416
354920,201905,437,1173,178,613,23,91,30,93,53,184
354925,201905,286,842,152,527,26,96,29,87,55,183
354930,201905,402,975,215,648,17,63,87,225,104,288
354940,201905,2020,6320,1414,4921,465,1744,217,695,682,2439
354950,201905,1451,3990,1150,3515,72,323,779,2219,851,2542
354960,201905,871,2352,668,2051,78,280,365,1048,443,1328
354970,201905,3992,11601,3099,9941,416,1443,1826,5699,2242,7142
354980,201905,30057,73230,19359,54257,2378,7890,10705,27754,13083,35644
354990,201905,59023,154199,43375,125050,4438,14452,26319,71829,30757,86281
354995,201905,2531,6113,1890,5228,233,724,1251,3272,1484,3996
355000,201905,1479,3930,1158,3426,183,615,487,1317,670,1932
355010,201905,3566,9964,2091,6798,669,2241,172,578,841,2819
355020,201905,3389,9875,2420,8049,728,2662,651,2023,1379,4685
355030,201905,1301529,3275925,924802,2515563,155380,460694,442046,1107787,597426,1568481
355040,201905,2734,7327,2194,6555,356,1099,1393,4166,1749,5265
355050,201905,962,2349,680,1893,189,533,223,582,412,1115
355060,201905,5631,15956,4113,12929,723,2601,1960,5562,2683,8163
355070,201905,7944,21420,6285,18634,782,2705,3807,10561,4589,13266
355080,201905,867,2531,527,1841,110,419,61,158,171,577
355090,201905,1128,3324,844,2806,220,725,239,814,459,1539
355100,201905,21116,56872,16402,49776,2953,9517,9607,28753,12560,38270
355110,201905,939,2713,699,2304,221,785,122,404,343,1189
355120,201905,672,1821,459,1472,52,183,152,454,204,637
355130,201905,833,1863,359,963,20,57,210,524,230,581
355140,201905,1619,3961,1399,3641,111,366,1119,2791,1230,3157
355150,201905,4137,11344,3265,9742,390,1278,1943,5554,2333,6832
355160,201905,1815,5185,1313,4277,330,1208,294,923,624,2131
355170,201905,9205,24309,7150,20778,1658,5120,3475,9832,5133,14952
355180,201905,2692,7465,1894,6053,431,1566,634,1806,1065,3372
355190,201905,1833,4916,1438,4287,322,1001,749,2327,1071,3328
355200,201905,815,2581,682,2355,198,772,241,756,439,1528
355210,201905,2796,7987,2251,6794,338,1157,1215,3446,1553,4603
355220,201905,42840,117557,33545,99043,8664,26907,12747,34688,21411,61595
355230,201905,1136,2881,592,1779,110,329,172,480,282,809
355240,201905,22085,59172,15135,45304,2305,7499,7507,21426,9812,28925
355250,201905,35520,97619,25687,78169,6578,21206,9116,26326,15694,47532
355255,201905,801,2092,418,1311,81,270,131,391,212,661
355260,201905,1367,3573,980,2888,122,439,579,1581,701,2020
355270,201905,1201,3583,896,2909,228,757,268,822,496,1579
355280,201905,27527,73299,19170,56671,3141,9920,8703,24321,11844,34241
355290,201905,864,2447,632,1989,135,390,257,775,392,1165
355300,201905,1223,3628,958,3088,161,547,314,971,475,1518
355310,201905,1016,2832,752,2375,95,300,410,1313,505,1613
355320,201905,532,1443,391,1167,66,230,154,388,220,618
355330,201905,2268,6189,1735,5210,142,530,1207,3433,1349,3963
355340,201905,3592,8028,2838,6986,374,839,1833,4577,2207,5416
355350,201905,1332,3972,981,3242,212,731,329,1076,541,1807
355360,201905,1238,3316,960,2872,126,389,578,1712,704,2101
355365,201905,369,1010,183,643,38,118,30,106,68,224
355370,201905,5614,14478,4245,12380,1011,2828,1866,5904,2877,8732
355380,201905,2896,7957,2131,6430,371,1216,714,1858,1085,3074
355385,201905,1391,3833,1138,3454,121,450,685,1899,806,2349
355390,201905,795,2235,563,1718,125,393,221,624,346,1017
355395,201905,2014,5734,1369,4355,192,650,494,1410,686,2060
355400,201905,8879,26842,7079,23070,1926,6977,2278,6672,4204,13649
355410,201905,21340,59462,13796,44766,3253,11571,3229,10398,6482,21969
355420,201905,660,2190,540,1935,144,587,129,425,273,1012
355430,201905,3662,9443,2749,7817,698,1937,1181,3373,1879,5310
355440,201905,825,2296,476,1523,91,316,140,411,231,727
355450,201905,3348,8907,2075,6349,367,1199,791,2202,1158,3401
355460,201905,529,1322,322,963,42,143,152,412,194,555
355465,201905,385,1089,287,894,46,152,115,347,161,499
355470,201905,1137,3010,616,1913,174,586,178,492,352,1078
355475,201905,322,775,259,679,19,43,179,460,198,503
355480,201905,3575,10335,2931,9297,456,1640,1816,5572,2272,7212
355490,201905,960,2630,512,1617,43,141,240,712,283,853
355495,201905,781,2282,563,1869,77,284,197,618,274,902
355500,201905,6615,17644,3785,11776,584,1975,1148,3261,1732,5236
355510,201905,1308,3389,811,2444,115,396,301,797,416,1193
355520,201905,379,857,177,505,31,82,47,118,78,200
355530,201905,426,982,141,417,23,82,52,133,75,215
355535,201905,502,1397,380,1194,80,295,152,424,232,719
355540,201905,9602,25625,7850,22950,1439,4535,4565,12963,6004,17498
355550,201905,642,1964,526,1744,75,272,253,799,328,1071
355560,201905,1121,2976,598,1927,124,441,43,133,167,574
355570,201905,227,664,120,408,24,82,21,61,45,143
355580,201905,1191,2966,776,2270,115,383,383,1049,498,1432
355590,201905,177,445,134,378,16,47,80,214,96,261
355600,201905,1460,3669,960,2795,213,651,388,1095,601,1746
355610,201905,1716,4415,1137,3342,149,450,529,1488,678,1938
355620,201905,4420,12399,3232,9946,446,1645,1661,4636,2107,6281
355630,201905,2255,6372,1539,4948,274,926,732,2294,1006,3220
355635,201905,892,2683,662,2220,122,465,222,701,344,1166
355640,201905,2656,7825,1810,6068,407,1432,426,1400,833,2832
355645,201905,4183,12156,3137,10239,385,1378,1809,5804,2194,7182
355650,201905,6416,17886,5167,15541,1454,4539,2114,5847,3568,10386
355660,201905,1279,3455,869,2642,119,447,294,881,413,1328
355670,201905,3311,9425,2177,6740,304,1130,1045,2824,1349,3954
355680,201905,3082,8778,1220,4109,337,1162,127,447,464,1609
355690,201905,764,2364,495,1803,130,488,10,20,140,508
355695,201905,231,686,133,449,12,54,19,38,31,92
355700,201905,6794,20062,5468,17029,1045,3339,2665,7858,3710,11197
355710,201905,8171,19577,4994,13667,842,2477,2108,5211,2950,7688
355715,201905,462,1220,235,741,47,165,42,103,89,268
355720,201905,1463,4298,1134,3656,199,695,563,1662,762,2357
355730,201905,928,2705,727,2282,177,589,265,761,442,1350
410010,201905,1241,3473,928,2807,211,703,196,567,407,1270
410020,201905,979,3081,769,2577,272,853,195,666,467,1519
410030,201905,1442,4132,1225,3771,176,620,653,1995,829,2615
410040,201905,11169,32266,8317,26625,1808,6212,2673,8005,4481,14217
410045,201905,916,2430,603,1846,87,294,199,569,286,863
410050,201905,2460,6245,1548,4581,336,1096,395,1056,731,2152
410060,201905,2053,6111,1561,5027,384,1258,429,1343,813,2601
410070,201905,1764,4662,1254,3664,218,698,460,1280,678,1978
410080,201905,1357,3676,960,2917,147,456,392,1214,539,1670
410090,201905,1000,2748,886,2553,91,259,519,1565,610,1824
410100,201905,1913,5687,1316,4215,175,663,230,703,405,1366
410105,201905,474,1260,252,782,41,150,60,170,101,320
410110,201905,3065,8077,2106,6109,309,959,856,2345,1165,3304
410115,201905,547,1402,381,1111,62,196,130,371,192,567
410120,201905,2319,7075,2018,6547,593,2078,757,2371,1350,4449
410130,201905,1114,3093,962,2792,237,764,425,1126,662,1890
410140,201905,14122,35023,8429,24555,1665,5222,1881,4988,3546,10210
410150,201905,16091,38895,7526,21531,1341,4141,1579,4206,2920,8347
410160,201905,2885,8182,2338,7194,485,1642,836,2568,1321,4210
410165,201905,719,2022,588,1727,55,190,347,954,402,1144
410170,201905,2534,6777,1631,4769,389,1232,143,427,532,1659
410180,201905,14093,40597,10926,33734,1646,5549,5671,16381,7317,21930
410185,201905,439,1226,309,948,50,168,102,289,152,457
410190,201905,2190,5643,1591,4538,341,989,432,1206,773,2195
410200,201905,4821,11628,2577,7548,449,1524,530,1542,979,3066
410210,201905,2830,7355,1759,5334,307,1080,587,1516,894,2596
410220,201905,519,1376,326,986,47,159,48,140,95,299
410230,201905,1576,4425,1230,3679,174,629,663,1837,837,2466
410240,201905,4470,12323,3156,9726,846,2877,224,654,1070,3531
410250,201905,2525,6227,1809,4983,167,579,833,2212,1000,2791
410260,201905,1803,4627,1137,3365,229,711,447,1288,676,1999
410270,201905,455,1201,321,950,60,214,110,292,170,506
410275,201905,659,1923,421,1367,60,213,195,574,255,787
410280,201905,2231,6089,1432,4430,228,770,545,1570,773,2340
410290,201905,2963,8599,2081,6647,473,1526,641,2055,1114,3581
410300,201905,627,1599,495,1369,54,171,227,583,281,754
410302,201905,359,945,184,578,33,105,84,247,117,352
410304,201905,1143,3146,974,2801,142,401,528,1495,670,1896
410305,201905,1661,4124,1135,3336,172,545,628,1784,800,2329
410310,201905,2505,7400,1954,6224,385,1322,767,2430,1152,3752
410315,201905,709,1748,356,1146,123,405,75,232,198,637
410320,201905,1097,3087,707,2232,104,380,110,336,214,716
410322,201905,552,1527,281,883,26,98,119,345,145,443
410330,201905,1472,3717,1013,2809,164,510,291,788,455,1298
410335,201905,822,2345,655,2007,86,283,291,832,377,1115
410337,201905,801,1984,548,1475,50,138,239,603,289,741
410340,201905,483,1325,317,916,31,108,163,398,194,506
410345,201905,2285,6076,1163,3567,251,780,286,798,537,1578
410347,201905,693,1789,494,1409,54,199,137,380,191,579
410350,201905,1304,3435,905,2717,94,314,385,1087,479,1401
410360,201905,4032,10033,3145,8502,205,651,2048,5294,2253,5945
410370,201905,11754,32158,7711,22830,1011,3342,2979,7803,3990,11145
410380,201905,1388,3718,1021,2976,112,373,430,1154,542,1527
410390,201905,2534,6734,1613,4940,403,1357,391,1080,794,2437
410395,201905,847,2499,691,2159,141,471,296,902,437,1373
410400,201905,5241,14495,3904,11860,673,2154,1668,4835,2341,6989
410405,201905,795,1971,609,1693,133,415,258,671,391,1086
410410,201905,1160,3241,1103,3159,169,602,687,2012,856,2614
410420,201905,7926,23149,6098,19358,1158,4086,1969,5602,3127,9688
410425,201905,2880,8434,2053,6720,374,1326,702,2078,1076,3404
410430,201905,12637,32504,8515,24630,1461,4569,2826,7753,4287,12322
410440,201905,2368,7252,2001,6524,336,1225,1013,3243,1349,4468
410442,201905,2171,6840,1812,5992,533,1748,531,1767,1064,3515
410445,201905,2251,6749,1753,5758,351,1293,472,1633,823,2926
410450,201905,1443,3835,1040,3074,204,681,309,842,513,1523
410460,201905,1813,4667,1417,4059,176,530,670,1864,846,2394
410465,201905,2594,7831,1989,6507,399,1332,625,1946,1024,3278
410470,201905,1854,5402,1321,4295,333,1212,262,888,595,2100
410480,201905,34973,85011,18696,55538,3073,10211,3923,10029,6996,20240
410490,201905,10594,30215,7429,23345,1464,4960,2622,7733,4086,12693
410500,201905,1692,4692,1168,3597,246,885,316,830,562,1715
410510,201905,1969,4976,1276,3606,239,655,378,1095,617,1750
410520,201905,3007,9703,2701,9078,854,2897,1035,3549,1889,6446
410530,201905,1584,4077,730,2171,109,332,139,319,248,651
410540,201905,2514,7012,1795,5563,293,977,877,2684,1170,3661
410550,201905,6777,18549,4295,12890,758,2484,1123,2957,1881,5441
410560,201905,1421,3826,1069,3103,221,676,398,1028,619,1704
410570,201905,2461,7014,1838,5849,528,1955,138,475,666,2430
410580,201905,23404,62874,17269,51192,3662,11541,7106,19671,10768,31212
410590,201905,1439,4249,946,2973,164,537,249,672,413,1209
410600,201905,1778,4875,1337,3988,288,815,473,1462,761,2277
410610,201905,733,1979,520,1554,55,196,223,636,278,832
410620,201905,2075,6278,1317,4417,315,1153,211,642,526,1795
410630,201905,2343,6411,1494,4576,303,1009,258,650,561,1659
410640,201905,4532,11000,2872,8086,682,2184,385,1097,1067,3281
410645,201905,1001,2987,824,2731,275,936,329,1101,604,2037
410650,201905,1973,5628,1336,4248,301,1038,414,1172,715,2210
410655,201905,898,2246,625,1746,32,111,307,812,339,923
410657,201905,623,1690,393,1207,61,227,158,416,219,643
410660,201905,3162,8368,1718,5112,323,1009,361,1028,684,2037
410670,201905,1053,2667,599,1736,122,359,257,695,379,1054
410680,201905,2653,8186,1895,6293,471,1533,435,1474,906,3007
410685,201905,555,1445,426,1211,91,291,188,488,279,779
410690,201905,118433,302377,77233,223107,13358,43610,26427,66771,39785,110381
410700,201905,2338,6033,1975,5470,298,868,1030,2742,1328,3610
410710,201905,767,1984,503,1504,52,167,265,763,317,930
410712,201905,642,1959,539,1721,137,476,192,577,329,1053
410715,201905,858,2595,516,1772,102,348,154,513,256,861
410720,201905,3137,8283,2314,6591,336,1132,468,1191,804,2323
410725,201905,1101,2806,636,1907,126,409,106,265,232,674
410730,201905,598,1615,442,1325,89,310,97,278,186,588
410740,201905,918,2610,657,2111,102,347,258,823,360,1170
410750,201905,1698,4436,1361,3832,219,688,558,1500,777,2188
410752,201905,351,909,155,483,19,73,65,185,84,258
410753,201905,229,714,158,554,20,87,33,109,53,196
410754,201905,1113,2923,908,2606,63,169,597,1812,660,1981
410755,201905,582,1525,412,1176,55,183,189,473,244,656
410760,201905,3241,8593,2319,6920,653,2174,513,1430,1166,3604
410765,201905,12374,36052,9573,30327,1634,5671,1661,4833,3295,10504
410770,201905,984,2417,667,1863,70,216,334,913,404,1129
410773,201905,1257,3377,1084,3094,127,410,676,1857,803,2267
410775,201905,1416,3703,1233,3426,80,255,726,1969,806,2224
410780,201905,597,1513,373,1049,60,173,92,257,152,430
410785,201905,724,2062,572,1769,96,325,213,632,309,957
410790,201905,647,1887,516,1618,138,479,59,141,197,620
410800,201905,3180,7296,2535,6278,69,228,1569,3766,1638,3994
410810,201905,369,1036,284,865,39,131,122,343,161,474
410820,201905,771,2274,408,1289,91,292,74,206,165,498
410830,201905,30222,76436,20376,59333,4660,15327,6662,18263,11322,33590
410832,201905,969,2604,785,2270,106,360,433,1160,539,1520
410840,201905,7249,19228,4316,13357,916,3156,920,2516,1836,5672
410845,201905,1111,3000,881,2615,181,568,337,983,518,1551
410850,201905,2234,6655,1930,6075,329,1115,900,2779,1229,3894
410855,201905,726,1866,467,1364,37,114,210,569,247,683
410860,201905,3919,10179,3077,8633,493,1549,1353,3562,1846,5111
410865,201905,1347,4174,1180,3818,171,618,672,2212,843,2830
410870,201905,1270,3488,1073,3154,46,140,767,2236,813,2376
410880,201905,4125,11675,2940,9327,522,1881,439,1522,961,3403
410890,201905,949,2724,679,2159,160,554,179,553,339,1107
410895,201905,957,3186,790,2790,292,1113,125,420,417,1533
410900,201905,900,2450,581,1805,96,302,114,291,210,593
410910,201905,371,909,211,589,9,31,129,331,138,362
410920,201905,842,2055,566,1601,87,285,249,691,336,976
410930,201905,1459,3997,1073,3262,279,985,234,694,513,1679
410940,201905,21303,60617,15313,49224,3334,11716,4248,13579,7582,25295
410950,201905,1897,5642,1691,5307,65,255,1376,4225,1441,4480
410960,201905,6935,18236,4451,13733,1025,3468,1561,4760,2586,8228
410965,201905,951,2594,711,2135,104,326,385,1134,489,1460
410970,201905,3754,10396,2626,8182,610,2295,368,972,978,3267
410975,201905,1267,3289,954,2744,139,455,365,1024,504,1479
410980,201905,6618,17195,4166,12570,542,1818,1690,4797,2232,6615
410990,201905,1266,3244,815,2473,251,878,190,494,441,1372
411000,201905,521,1432,353,1092,56,204,96,251,152,455
411005,201905,407,1108,254,768,54,174,52,141,106,315
411007,201905,2147,6246,1757,5508,394,1301,570,1812,964,3113
411010,201905,4161,12724,3246,10737,853,3028,328,952,1181,3980
411020,201905,2294,6699,1876,5946,546,1817,520,1594,1066,3411
411030,201905,725,1810,485,1308,41,139,250,603,291,742
411040,201905,913,2356,413,1224,54,166,123,315,177,481
411050,201905,1804,5851,1480,5063,406,1455,209,623,615,2078
411060,201905,1699,4559,1080,3309,245,881,178,507,423,1388
411065,201905,343,941,245,752,41,127,105,319,146,446
411070,201905,6370,16971,5033,14574,815,2626,2274,6340,3089,8966
411080,201905,2124,5806,1679,4974,470,1536,363,996,833,2532
411090,201905,836,2231,517,1586,42,151,127,364,169,515
411095,201905,1534,3684,1033,2861,114,356,359,936,473,1292
411100,201905,1087,2873,734,2234,85,298,215,666,300,964
411110,201905,617,1627,259,812,38,103,20,43,58,146
411120,201905,1201,3497,956,2973,328,1135,200,512,528,1647
411125,201905,4986,14980,4408,13794,960,3061,2053,6630,3013,9691
411130,201905,673,1862,474,1449,83,253,180,570,263,823
411140,201905,2212,6929,1829,6037,507,1784,546,1791,1053,3575
411150,201905,3665,9753,2512,7304,523,1749,222,478,745,2227
411155,201905,956,2498,549,1688,52,162,238,679,290,841
411160,201905,334,781,210,585,28,91,41,112,69,203
411170,201905,695,2136,509,1684,111,352,171,561,282,913
411180,201905,5168,14220,3955,11955,673,2231,1698,4835,2371,7066
411190,201905,1500,3992,1104,3266,185,575,379,1062,564,1637
411200,201905,4941,13637,3310,10399,903,3040,623,1765,1526,4805
411210,201905,2680,6142,1770,4703,353,1087,499,1222,852,2309
411220,201905,846,2297,618,1817,130,408,180,518,310,926
411230,201905,824,2264,563,1742,115,370,204,623,319,993
411240,201905,1571,3847,917,2563,103,334,436,1127,539,1461
411250,201905,2054,5602,1527,4628,326,1139,460,1373,786,2512
411260,201905,326,880,210,640,28,83,82,222,110,305
411270,201905,1902,5317,1451,4377,230,721,664,1888,894,2609
411275,201905,1312,3167,909,2474,145,467,393,984,538,1451
411280,201905,1314,3659,849,2725,215,697,117,371,332,1068
411290,201905,727,1983,486,1507,50,144,246,779,296,923
411295,201905,1159,2942,854,2334,89,251,415,1095,504,1346
411300,201905,1016,2569,623,1783,66,204,243,608,309,812
411310,201905,851,2025,638,1707,41,110,279,732,320,842
411320,201905,5199,14007,3740,11268,776,2448,1398,3871,2174,6319
411325,201905,1460,4216,1216,3777,211,642,664,2119,875,2761
411330,201905,3203,8929,2337,7296,574,1950,662,2098,1236,4048
411340,201905,858,2394,507,1586,74,260,173,515,247,775
411342,201905,963,2380,572,1582,93,259,251,688,344,947
411345,201905,1076,2863,793,2384,79,258,530,1598,609,1856
411350,201905,2458,6943,1618,5159,431,1472,180,549,611,2021
411360,201905,648,1585,458,1288,51,145,162,450,213,595
411370,201905,48706,123128,34754,98815,2933,10085,19937,52931,22870,63016
411373,201905,1334,3475,1082,3074,105,350,569,1624,674,1974
411375,201905,1065,2743,764,2160,121,356,297,774,418,1130
411380,201905,1055,2507,729,1859,38,107,467,1115,505,1222
411390,201905,1584,4457,1208,3600,189,621,462,1194,651,1815
411400,201905,2175,5611,1664,4636,227,755,799,2098,1026,2853
411410,201905,2126,6092,1575,4815,358,1205,330,960,688,2165
411420,201905,3905,9925,2143,6438,333,1165,379,890,712,2055
411430,201905,3276,9121,2525,7660,550,1837,932,2572,1482,4409
411435,201905,414,1202,270,886,47,150,93,259,140,409
411440,201905,2507,7350,2036,6382,423,1470,693,2142,1116,3612
411450,201905,2518,6809,1915,5784,274,806,1000,3056,1274,3862
411460,201905,3723,9995,2131,6706,390,1396,352,1021,742,2417
411470,201905,720,1968,526,1566,84,272,175,473,259,745
411480,201905,4330,12108,3060,9620,651,2352,880,2518,1531,4870
411490,201905,1576,4174,1201,3510,162,555,447,1152,609,1707
411500,201905,1342,3652,876,2645,128,442,205,550,333,992
411510,201905,2208,5893,1758,5062,393,1310,375,1086,768,2396
411520,201905,28814,71251,15962,45972,2122,6850,5644,14558,7766,21408
411530,201905,913,2425,555,1724,113,390,102,289,215,679
411535,201905,466,1388,231,793,22,85,43,115,65,200
411540,201905,2727,7005,1830,5185,251,804,765,2092,1016,2896
411545,201905,924,2739,765,2451,73,239,494,1594,567,1833
411550,201905,691,1818,486,1402,82,259,89,259,171,518
411560,201905,1907,5169,1081,3371,159,569,79,193,238,762
411570,201905,6750,16391,4411,12553,945,2943,962,2730,1907,5673
411573,201905,761,2105,637,1889,79,254,350,1008,429,1262
411575,201905,1798,5057,1339,4089,278,916,318,921,596,1837
411580,201905,4259,10094,2380,7081,323,1145,362,939,685,2084
411585,201905,661,1976,276,942,71,250,40,116,111,366
411590,201905,384,1114,265,829,22,80,144,400,166,480
411600,201905,282,747,169,548,39,131,55,167,94,298
411605,201905,1542,3670,921,2570,128,448,468,1262,596,1710
411610,201905,2334,5924,1612,4468,105,361,979,2539,1084,2900
411620,201905,2787,7652,2362,6966,401,1299,1311,3779,1712,5078
411630,201905,739,1944,498,1471,83,296,158,401,241,697
411640,201905,533,1485,358,1072,47,152,125,329,172,481
411650,201905,216,636,140,467,29,103,29,88,58,191
411660,201905,903,2297,639,1811,48,139,313,856,361,995
411670,201905,1230,3174,849,2363,100,291,365,940,465,1231
411680,201905,1493,4072,1139,3377,142,486,546,1590,688,2076
411690,201905,3488,9261,2627,7744,537,1648,793,2426,1330,4074
411695,201905,670,2103,426,1425,50,181,165,546,215,727
411700,201905,1557,4151,1016,3096,247,829,127,339,374,1168
411705,201905,1842,5844,1549,5322,326,1117,819,3006,1145,4123
411710,201905,1814,4756,1255,3686,329,1005,172,506,501,1511
411720,201905,1056,2543,725,1930,123,349,301,740,424,1089
411721,201905,881,2309,650,1865,127,371,148,429,275,800
411722,201905,733,2014,390,1165,57,191,141,353,198,544
411725,201905,1169,3447,789,2632,184,636,161,552,345,1188
411727,201905,1468,4164,947,3036,245,817,134,393,379,1210
411729,201905,697,1713,436,1209,55,195,156,380,211,575
411730,201905,5173,14215,3829,11454,953,2953,1387,4089,2340,7042
411740,201905,530,1391,265,813,49,152,58,148,107,300
411745,201905,763,2236,484,1558,57,186,92,234,149,420
411750,201905,4836,13048,3415,10148,459,1485,1617,4491,2076,5976
411760,201905,6862,18694,5266,15827,1792,5548,1023,3410,2815,8958
411770,201905,2992,8907,2142,6961,547,1910,279,830,826,2740
411780,201905,2858,8317,2412,7383,668,2177,807,2457,1475,4634
411790,201905,2860,7110,1513,4555,346,1169,188,458,534,1627
411800,201905,989,2824,668,2064,106,335,138,403,244,738
411810,201905,1580,4192,1154,3336,172,529,557,1518,729,2047
411820,201905,10458,31562,8603,27939,2438,8397,3243,10234,5681,18631
411830,201905,588,1467,393,1119,70,210,86,264,156,474
411840,201905,11438,31022,7431,22409,1299,4243,1963,5452,3262,9695
411845,201905,463,1345,246,806,36,137,39,116,75,253
411850,201905,7238,19234,5030,15155,1394,4636,741,2015,2135,6651
411860,201905,713,2097,512,1653,94,332,133,380,227,712
411870,201905,644,1973,432,1449,94,342,85,250,179,592
411880,201905,2038,5364,1474,4388,263,848,388,1120,651,1968
411885,201905,1030,2690,726,2128,96,316,251,714,347,1030
411890,201905,1142,3161,777,2420,138,473,63,163,201,636
411900,201905,794,2299,475,1560,109,382,56,183,165,565
411910,201905,949,2930,678,2303,182,658,183,567,365,1225
411915,201905,15335,38471,9620,27856,1592,5079,3212,8309,4804,13388
411920,201905,1021,3143,848,2761,202,724,270,829,472,1553
411925,201905,479,1279,321,971,72,239,113,327,185,566
411930,201905,5013,15973,4229,14380,1867,6875,229,930,2096,7805
411940,201905,3193,9819,2435,8028,607,2101,693,2068,1300,4169
411950,201905,13042,36333,10611,32149,1834,6083,5565,16269,7399,22352
411960,201905,5555,15471,4501,13240,935,3026,1568,4323,2503,7349
411965,201905,426,1191,298,928,42,146,115,323,157,469
411970,201905,1018,2481,789,2150,169,431,332,1034,501,1465
411980,201905,1441,3769,1044,3054,268,818,364,1000,632,1818
411990,201905,35859,97922,23183,73335,4697,16322,7728,23199,12425,39521
411995,201905,2820,7350,2100,6181,608,1983,587,1598,1195,3581
412000,201905,1966,4593,1396,3612,48,156,957,2310,1005,2466
412010,201905,616,1941,427,1490,56,210,103,293,159,503
412015,201905,547,1576,452,1401,58,196,254,784,312,980
412020,201905,440,1258,263,859,32,122,109,341,141,463
412030,201905,628,1812,429,1414,78,261,113,371,191,632
412033,201905,844,2298,580,1715,72,204,209,569,281,773
412035,201905,779,2117,492,1594,66,246,249,760,315,1006
412040,201905,582,1618,362,1135,67,218,65,193,132,411
412050,201905,1689,4358,1142,3332,210,698,271,781,481,1479
412060,201905,6985,21490,5840,19161,1745,6375,1448,4470,3193,10845
412065,201905,613,1744,424,1314,89,291,121,387,210,678
412070,201905,1128,2943,859,2371,120,350,359,942,479,1292
412080,201905,1938,5652,1191,3952,192,668,152,418,344,1086
412085,201905,287,750,94,317,15,46,12,31,27,77
412090,201905,5617,14936,4334,12524,1224,3636,1602,4744,2826,8380
412100,201905,1663,4686,1236,3878,356,1203,240,808,596,2011
412110,201905,844,2305,602,1783,92,276,206,593,298,869
412120,201905,1865,5656,1451,4782,300,1115,410,1177,710,2292
412125,201905,653,1905,472,1509,99,313,142,437,241,750
412130,201905,691,1824,482,1403,66,204,117,352,183,556
412135,201905,602,1621,263,796,45,136,88,241,133,377
412140,201905,1569,3994,1011,2959,211,721,177,466,388,1187
412150,201905,2800,7576,2320,6694,344,1110,1368,3769,1712,4879
412160,201905,994,3114,594,2050,128,474,89,275,217,749
412170,201905,4166,11956,3502,10790,738,2433,1445,4151,2183,6584
412175,201905,1248,3832,1034,3418,250,835,416,1400,666,2235
412180,201905,1657,4670,1202,3791,177,670,510,1438,687,2108
412190,201905,3324,8480,2445,6882,319,983,1080,3029,1399,4012
412200,201905,1747,5355,1241,4106,345,1213,200,627,545,1840
412210,201905,615,1557,338,1009,64,218,86,234,150,452
412215,201905,3481,9512,2779,8161,750,2143,1117,3733,1867,5876
412217,201905,949,2546,792,2276,65,193,524,1465,589,1658
412220,201905,5728,16322,4616,14167,1168,3534,1464,4755,2632,8289
412230,201905,2608,7995,2087,6916,398,1492,556,1568,954,3060
412240,201905,6573,17184,4145,12375,742,2415,1191,3298,1933,5713
412250,201905,1974,5147,1493,4250,361,1038,342,937,703,1975
412260,201905,1214,3315,845,2512,143,416,241,667,384,1083
412265,201905,803,2343,679,2098,139,467,288,851,427,1318
412270,201905,825,2347,535,1690,71,241,210,585,281,826
412280,201905,451,1309,351,1133,79,262,96,285,175,547
412290,201905,979,2538,656,1922,103,324,208,587,311,911
412300,201905,1406,3934,1100,3317,253,782,254,791,507,1573
412310,201905,751,2066,617,1820,47,201,332,921,379,1122
412320,201905,832,2174,557,1623,74,284,196,567,270,851
412330,201905,1438,3997,975,3055,188,623,340,1097,528,1720
412340,201905,1090,3148,660,2128,111,392,123,369,234,761
412350,201905,2751,7366,1755,5364,359,1107,361,1106,720,2213
412360,201905,253,720,158,498,8,28,81,249,89,277
412370,201905,795,2303,525,1724,106,389,33,115,139,504
412380,201905,1549,4299,1052,3236,303,979,150,509,453,1488
412382,201905,523,1326,340,995,55,189,115,279,170,468
412385,201905,2118,5961,1741,5221,582,1666,497,1636,1079,3302
412390,201905,2353,5966,1893,5231,330,935,774,2133,1104,3068
412395,201905,710,2066,481,1530,62,188,194,606,256,794
412400,201905,880,2390,629,1883,140,439,157,494,297,933
412402,201905,1817,4612,1255,3647,304,940,140,412,444,1352
412405,201905,3081,8402,1979,6148,493,1791,56,154,549,1945
412410,201905,5405,14677,3873,11931,778,2754,1097,3140,1875,5894
412420,201905,502,1336,309,921,31,103,125,327,156,430
412430,201905,535,1408,351,1044,30,97,157,441,187,538
412440,201905,2675,7555,1774,5729,489,1695,266,859,755,2554
412450,201905,378,1141,248,804,51,158,20,40,71,198
412460,201905,987,2684,784,2327,147,491,330,958,477,1449
412470,201905,1551,5106,1245,4373,329,1212,298,1087,627,2299
412480,201905,931,2601,589,1809,105,345,153,420,258,765
412490,201905,1168,3016,929,2555,98,258,536,1420,634,1678
412500,201905,1852,4803,1385,3886,327,913,381,1009,708,1922
412510,201905,1953,6071,1343,4453,303,1067,104,293,407,1360
412520,201905,1291,3441,680,2052,162,489,40,109,202,598
412530,201905,646,1765,467,1386,72,241,110,317,182,558
412535,201905,792,2149,547,1651,115,370,112,307,227,677
412540,201905,1203,3210,825,2429,92,339,262,793,354,1132
412545,201905,685,1801,466,1339,78,243,130,330,208,573
412550,201905,29538,81896,20216,62282,3711,12337,7104,20197,10815,32534
412555,201905,255,696,160,476,18,59,46,105,64,164
412560,201905,4699,14037,3430,10986,590,2014,1040,3343,1630,5357
412570,201905,4071,10691,2291,7106,535,1805,308,1057,843,2862
412575,201905,952,2506,759,2131,72,232,454,1196,526,1428
412580,201905,1370,3712,940,2846,119,416,455,1322,574,1738
412590,201905,409,1093,208,669,31,115,14,32,45,147
412600,201905,1377,3917,1021,3168,181,637,393,1163,574,1800
412610,201905,793,2174,525,1556,51,164,260,687,311,851
412620,201905,1239,3428,921,2847,194,681,278,795,472,1476
412625,201905,8349,22754,5179,16249,787,2786,304,868,1091,3654
412627,201905,1030,2953,676,2211,148,542,179,576,327,1118
412630,201905,2815,8344,1998,6478,392,1296,630,1838,1022,3134
412635,201905,348,928,233,674,35,114,71,176,106,290
412640,201905,1041,2862,568,1769,83,278,140,379,223,657
412650,201905,1549,4400,1228,3703,219,720,436,1153,655,1873
412660,201905,2474,6651,1724,5128,298,961,498,1337,796,2298
412665,201905,406,1106,296,867,57,171,108,297,165,468
412667,201905,1696,4539,1239,3611,169,549,507,1388,676,1937
412670,201905,776,1932,516,1462,101,335,155,405,256,740
412680,201905,1595,4440,1051,3322,135,496,428,1212,563,1708
412690,201905,893,2482,665,1995,106,342,242,685,348,1027
412700,201905,2026,5489,1622,4826,237,858,799,2245,1036,3103
412710,201905,5777,17421,4426,14459,945,3389,1253,3786,2198,7175
412720,201905,1199,3598,892,2871,147,505,178,477,325,982
412730,201905,2086,5789,1233,3921,246,851,295,885,541,1736
412740,201905,1748,4953,1149,3650,215,762,169,549,384,1311
412750,201905,3772,10302,3167,9373,370,1300,2028,5674,2398,6974
412760,201905,2853,7948,2359,7065,395,1304,1237,3509,1632,4813
412770,201905,10033,25907,5257,16229,765,2501,1081,2891,1846,5392
412780,201905,1190,3258,895,2708,195,627,335,972,530,1599
412785,201905,1940,4955,1339,3848,187,567,759,2126,946,2693
412788,201905,1300,3783,1054,3294,273,846,440,1354,713,2200
412790,201905,1259,3374,668,2098,109,400,203,547,312,947
412795,201905,1318,3528,682,2130,114,391,123,366,237,757
412796,201905,2309,6924,1901,6029,390,1319,612,1812,1002,3131
412800,201905,3366,8454,2262,6322,289,903,958,2368,1247,3271
412810,201905,10633,27494,6391,18639,886,2971,2210,5648,3096,8619
412820,201905,6251,17553,4437,13834,1038,3392,1293,4017,2331,7409
412830,201905,341,992,223,717,29,87,47,145,76,232
412840,201905,1809,4669,1286,3636,177,539,447,1201,624,1740
412850,201905,2839,7684,2059,6260,341,1097,771,2260,1112,3357
412853,201905,1619,4276,1344,3709,175,525,678,1710,853,2235
412855,201905,1192,3254,746,2253,158,538,198,560,356,1098
412860,201905,802,2092,548,1656,72,241,263,753,335,994
412862,201905,704,1705,462,1285,72,212,208,553,280,765
412863,201905,1188,3706,1097,3552,133,442,770,2488,903,2930
412865,201905,720,2031,523,1644,97,315,177,551,274,866
412870,201905,862,2310,632,1923,179,609,128,408,307,1017
412880,201905,831,2341,532,1696,99,335,73,203,172,538
420005,201905,460,1386,247,879,36,134,107,389,143,523
420010,201905,3340,8357,2169,6278,173,544,1531,4446,1704,4990
420020,201905,487,1532,302,1059,54,219,51,150,105,369
420030,201905,91,316,67,265,22,93,16,61,38,154
420040,201905,561,1751,330,1221,52,215,19,60,71,275
420050,201905,663,1616,408,1144,42,144,258,670,300,814
420055,201905,166,510,87,316,18,77,30,101,48,178
420060,201905,108,304,64,191,11,42,16,27,27,69
420070,201905,740,2374,546,1914,118,430,188,650,306,1080
420075,201905,78,211,36,117,8,26,7,11,15,37
420080,201905,336,1024,263,860,86,310,79,243,165,553
420090,201905,421,1360,252,925,63,243,56,204,119,447
420100,201905,1120,3101,950,2839,48,166,754,2226,802,2392
420110,201905,248,820,225,775,46,181,93,295,139,476
420120,201905,446,1291,289,934,56,200,117,338,173,538
420125,201905,310,1015,236,847,60,229,106,366,166,595
420127,201905,276,791,92,325,18,69,20,70,38,139
420130,201905,2398,6904,1802,5812,278,1112,925,2807,1203,3919
420140,201905,3339,9270,2409,7623,654,2357,315,987,969,3344
420150,201905,556,1474,357,1123,55,187,179,538,234,725
420160,201905,225,578,100,325,10,39,33,101,43,140
420165,201905,157,463,91,307,25,87,25,76,50,163
420170,201905,259,791,160,552,21,71,31,86,52,157
420180,201905,180,564,101,370,16,64,31,105,47,169
420190,201905,167,549,101,376,33,135,22,74,55,209
420195,201905,1318,3583,964,2982,289,1005,119,310,408,1315
420200,201905,3417,8912,1966,6063,307,1184,713,1872,1020,3056
420205,201905,1417,3928,999,3148,157,493,559,1790,716,2283
420207,201905,1614,4401,1012,3213,203,745,387,1156,590,1901
420208,201905,344,980,200,714,36,143,80,276,116,419
420209,201905,137,459,84,295,22,91,27,85,49,176
420210,201905,2436,6495,1578,5075,347,1223,685,2151,1032,3374
420213,201905,746,2383,613,2093,134,487,298,1003,432,1490
420215,201905,210,638,143,491,42,158,16,42,58,200
420220,201905,229,702,137,482,28,118,59,185,87,303
420230,201905,4249,11995,3204,10004,472,1621,1708,5149,2180,6770
420240,201905,11576,32172,7133,22269,948,3445,3548,9798,4496,13243
420243,201905,368,1073,299,936,48,162,165,489,213,651
420245,201905,1239,3336,857,2645,81,321,486,1413,567,1734
420250,201905,415,1240,362,1140,71,262,186,537,257,799
420253,201905,510,1303,369,1088,33,102,198,575,231,677
420257,201905,183,474,105,326,22,74,52,157,74,231
420260,201905,1068,2948,770,2489,135,487,438,1404,573,1891
420270,201905,456,1230,203,623,28,99,73,204,101,303
420280,201905,1177,3405,806,2669,164,607,235,757,399,1364
420285,201905,86,230,47,148,6,29,9,21,15,50
420287,201905,451,1111,310,891,89,263,98,284,187,547
420290,201905,3895,11307,2942,9136,441,1633,1574,4414,2015,6047
420300,201905,6520,18771,3728,12209,741,2667,956,2804,1697,5471
420310,201905,824,1980,390,1116,59,174,189,491,248,665
420315,201905,810,2406,550,1882,121,454,215,732,336,1186
420320,201905,4080,11909,3149,10216,971,3471,701,2119,1672,5590
420325,201905,239,728,182,629,39,131,62,211,101,342
420330,201905,848,2597,551,1930,116,456,171,528,287,984
420340,201905,942,2767,674,2224,173,586,64,200,237,786
420350,201905,1292,3475,888,2696,97,329,570,1689,667,2018
420360,201905,2468,7082,1319,4459,263,956,127,416,390,1372
420370,201905,1019,2867,817,2508,95,350,544,1594,639,1944
420380,201905,4545,12357,2955,9309,642,2174,991,2968,1633,5142
420390,201905,1048,2652,689,1878,109,374,310,613,419,987
420395,201905,961,2825,622,2104,102,365,70,188,172,553
420400,201905,886,2611,583,1930,106,391,187,579,293,970
420410,201905,499,1406,370,1135,39,143,226,647,265,790
420415,201905,295,904,223,745,61,221,79,271,140,492
420417,201905,613,1880,497,1628,128,427,179,603,307,1030
420419,201905,144,507,111,421,42,171,10,30,52,201
420420,201905,10192,27495,6768,21103,2119,7299,1644,4681,3763,11980
420425,201905,664,1798,450,1376,45,170,196,574,241,744
420430,201905,2861,8110,1763,5589,456,1552,508,1431,964,2983
420435,201905,262,679,111,378,18,68,50,164,68,232
420440,201905,665,1948,393,1298,121,435,112,318,233,753
420445,201905,300,776,173,514,34,110,60,163,94,273
420450,201905,642,1928,456,1511,86,354,158,457,244,811
420455,201905,1924,4957,1406,4117,193,684,710,1967,903,2651
420460,201905,8276,22831,6194,18946,1030,3584,2977,8676,4007,12260
420470,201905,583,1584,322,1048,66,249,74,212,140,461
420475,201905,53,153,27,93,10,33,3,13,13,46
420480,201905,5159,13230,3177,9758,655,2165,974,2961,1629,5126
420490,201905,355,1067,241,817,56,224,80,263,136,487
420500,201905,1308,3847,893,3011,178,640,345,1154,523,1794
420510,201905,164,467,87,289,14,52,28,86,42,138
420515,201905,44,128,29,95,1,1,13,47,14,48
420517,201905,749,2100,645,1920,44,134,491,1455,535,1589
420519,201905,308,742,201,578,25,78,105,307,130,385
420520,201905,358,964,162,558,20,67,15,48,35,115
420530,201905,792,2353,544,1812,108,404,165,475,273,879
420535,201905,214,632,83,286,19,77,21,65,40,142
420540,201905,28279,69219,17621,50372,2972,9497,6136,14939,9108,24436
420543,201905,217,663,164,529,26,79,82,259,108,338
420545,201905,1051,3189,799,2616,166,581,308,943,474,1524
420550,201905,3336,9455,2131,7220,405,1520,871,2985,1276,4505
420555,201905,296,877,199,662,31,119,103,320,134,439
420560,201905,405,1038,275,833,65,200,140,413,205,613
420570,201905,2029,5902,1528,4909,313,1108,558,1690,871,2798
420580,201905,1687,4447,1183,3646,268,861,467,1464,735,2325
420590,201905,2816,7680,1635,5084,318,1155,382,868,700,2023
420600,201905,936,2806,715,2347,131,478,329,1032,460,1510
420610,201905,358,1058,191,669,46,155,56,206,102,361
420620,201905,592,1514,378,1144,95,293,145,433,240,726
420630,201905,875,2634,625,1992,112,400,315,904,427,1304
420640,201905,504,1433,236,835,60,209,22,64,82,273
420650,201905,3003,8302,1780,5587,293,1038,676,1824,969,2862
420660,201905,341,934,228,698,49,158,64,186,113,344
420665,201905,525,1411,321,1039,60,212,129,371,189,583
420670,201905,1375,3802,887,2848,145,574,336,942,481,1516
420675,201905,136,396,80,286,24,103,23,72,47,175
420680,201905,325,776,167,552,29,114,74,237,103,351
420690,201905,826,2558,500,1715,73,295,118,322,191,617
420700,201905,2624,7202,1997,6094,268,930,1056,3093,1324,4023
420710,201905,718,2185,539,1773,74,307,299,894,373,1201
420720,201905,1252,3525,894,2912,206,654,393,1260,599,1914
420730,201905,2619,7130,2007,6137,325,1042,1123,3336,1448,4378
420740,201905,562,1741,348,1251,98,369,35,145,133,514
420750,201905,1804,5421,1176,3920,198,747,442,1335,640,2082
420757,201905,60,166,29,107,3,14,11,36,14,50
420760,201905,356,1073,149,483,37,136,29,76,66,212
420765,201905,383,1190,207,722,27,100,87,301,114,401
420768,201905,1178,3581,1012,3272,155,510,699,2232,854,2742
420770,201905,417,1145,189,675,28,112,84,285,112,397
420775,201905,356,1056,224,768,47,185,41,115,88,300
420780,201905,910,2588,532,1768,114,405,94,276,208,681
420785,201905,187,511,131,395,12,34,57,150,69,184
420790,201905,1004,3197,737,2612,154,625,364,1213,518,1838
420800,201905,700,1800,325,1025,91,296,70,230,161,526
420810,201905,1424,4681,1162,4112,347,1379,332,1017,679,2396
420820,201905,10107,26153,7082,21061,1450,4892,3138,8385,4588,13277
420830,201905,3005,8360,2250,6969,501,1686,880,2638,1381,4324
420840,201905,532,1635,246,908,66,252,39,135,105,387
420845,201905,1973,5269,1175,3807,234,880,423,1319,657,2199
420850,201905,1049,3471,638,2363,138,554,91,309,229,863
420860,201905,279,730,157,504,41,144,35,109,76,253
420870,201905,800,2199,614,1874,171,613,265,748,436,1361
420880,201905,915,2869,717,2462,154,603,249,780,403,1383
420890,201905,7472,20360,4243,13594,688,2443,1325,3638,2013,6081
420895,201905,158,473,95,305,26,85,26,83,52,168
420900,201905,1342,3445,796,2461,108,410,338,914,446,1324
420910,201905,25462,68876,15767,49773,2564,9128,5713,16198,8277,25326
420915,201905,539,1987,381,1526,57,229,178,725,235,954
420917,201905,336,891,175,512,24,79,77,215,101,294
420920,201905,73,202,24,89,0,0,4,10,4,10
420930,201905,16649,44344,11689,35519,2110,7072,5221,15056,7331,22128
420940,201905,2328,5901,1400,4265,336,1151,208,486,544,1637
420945,201905,128,384,100,317,24,87,38,105,62,192
420950,201905,306,905,168,574,27,111,34,97,61,208
420960,201905,960,2451,659,1917,117,405,274,699,391,1104
420970,201905,2376,6917,1575,5248,453,1554,253,867,706,2421
420980,201905,280,891,238,825,110,381,73,282,183,663
420985,201905,316,927,156,554,30,115,49,149,79,264
420990,201905,377,1161,192,703,38,143,32,89,70,232
421000,201905,491,1610,321,1185,77,317,77,240,154,557
421003,201905,465,1091,145,433,13,37,24,64,37,101
421005,201905,58,184,51,174,14,46,22,74,36,120
421010,201905,3237,9102,2325,7421,494,1744,568,1597,1062,3341
421020,201905,372,1140,290,995,38,153,164,541,202,694
421030,201905,739,2341,581,2001,170,646,164,516,334,1162
421040,201905,678,1613,404,1190,35,112,246,710,281,822
421050,201905,1052,2978,651,2059,120,414,222,634,342,1048
421055,201905,171,474,81,257,13,45,30,77,43,122
421060,201905,548,1651,343,1126,63,227,123,359,186,586
421070,201905,527,1638,300,1070,70,266,52,183,122,449
421080,201905,448,1315,385,1196,49,168,246,768,295,936
421085,201905,373,1120,136,509,24,100,22,61,46,161
421090,201905,289,774,168,515,17,53,57,170,74,223
421100,201905,919,2101,376,1123,91,305,60,160,151,465
421105,201905,1450,4071,1040,3267,172,526,493,1554,665,2080
421110,201905,1014,2914,853,2669,41,117,604,1970,645,2087
421120,201905,885,2847,628,2218,90,352,205,663,295,1015
421125,201905,252,696,204,619,71,242,68,162,139,404
421130,201905,4023,12236,3362,10919,707,2567,1876,5840,2583,8407
421140,201905,286,803,187,597,32,110,70,201,102,311
421145,201905,435,1241,270,866,49,171,127,378,176,549
421150,201905,533,1484,285,956,62,224,82,266,144,490
421160,201905,516,1391,353,1101,42,148,218,662,260,810
421165,201905,188,577,119,404,27,91,48,164,75,255
421170,201905,1022,2766,797,2403,126,365,501,1545,627,1910
421175,201905,1024,2711,665,2124,132,487,268,789,400,1276
421180,201905,365,961,197,612,38,143,65,183,103,326
421185,201905,296,798,192,580,33,108,103,303,136,411
421187,201905,290,874,179,589,34,111,63,192,97,303
421189,201905,345,1019,259,836,40,126,99,308,139,434
421190,201905,9161,25372,5960,19330,1251,4438,1579,4816,2830,9254
421200,201905,643,1972,515,1705,91,336,259,821,350,1157
421205,201905,187,510,138,429,27,90,69,208,96,298
421210,201905,1034,2748,616,2001,156,513,192,624,348,1137
421220,201905,1303,4152,1032,3512,250,939,260,781,510,1720
421223,201905,346,1004,220,751,55,176,93,324,148,500
421225,201905,866,2669,746,2443,149,543,417,1363,566,1906
421227,201905,943,2510,546,1707,94,321,241,757,335,1078
421230,201905,580,1561,361,1150,94,311,107,345,201,656
421240,201905,294,906,120,457,13,66,15,56,28,122
421250,201905,1555,4094,1041,3223,170,565,461,1397,631,1962
421260,201905,168,493,43,162,10,43,10,36,20,79
421265,201905,576,1669,537,1613,13,44,500,1505,513,1549
421270,201905,387,1031,172,614,27,94,64,222,91,316
421280,201905,1518,4499,1142,3779,225,897,535,1609,760,2506
421290,201905,787,2190,410,1299,82,280,78,239,160,519
421300,201905,245,670,136,446,23,77,30,105,53,182
421310,201905,160,488,122,402,25,87,55,189,80,276
421315,201905,206,603,126,405,35,107,27,85,62,192
421320,201905,612,1821,301,1017,45,153,42,103,87,256
421330,201905,609,1831,430,1465,89,332,115,378,204,710
421335,201905,359,1114,290,989,57,217,110,370,167,587
421340,201905,1273,3740,920,3032,194,719,361,1142,555,1861
421350,201905,1165,3221,797,2545,162,629,336,990,498,1619
421360,201905,2181,6114,1302,4293,270,1074,461,1325,731,2399
421370,201905,481,1584,285,1057,58,228,81,271,139,499
421380,201905,805,2218,687,2001,84,276,417,1177,501,1453
421390,201905,171,465,62,210,14,41,17,48,31,89
421400,201905,252,825,175,635,34,144,80,261,114,405
421410,201905,242,658,100,343,18,60,31,111,49,171
421415,201905,219,676,118,394,33,111,24,67,57,178
421420,201905,487,1398,403,1239,53,184,249,726,302,910
421430,201905,117,386,92,328,11,40,31,96,42,136
421440,201905,582,1552,368,1185,72,228,174,557,246,785
421450,201905,368,1144,234,804,33,127,35,136,68,263
421460,201905,307,905,190,665,31,109,43,127,74,236
421470,201905,245,742,139,493,25,103,53,186,78,289
421480,201905,2602,7161,1702,5428,384,1390,591,1693,975,3083
421490,201905,96,310,57,204,8,32,15,43,23,75
421500,201905,2047,6246,1431,4939,406,1604,304,948,710,2552
421505,201905,284,849,250,790,34,116,156,474,190,590
421507,201905,385,1157,221,769,62,227,62,206,124,433
421510,201905,262,756,150,481,31,103,64,187,95,290
421520,201905,508,1374,314,937,39,135,176,486,215,621
421530,201905,318,1013,188,682,41,182,42,119,83,301
421535,201905,393,1084,244,796,38,147,130,392,168,539
421540,201905,260,637,131,415,18,66,44,127,62,193
421545,201905,672,2022,493,1674,104,407,239,762,343,1169
421550,201905,1864,5358,1524,4813,311,1067,779,2403,1090,3470
421555,201905,196,617,72,276,12,54,10,24,22,78
421560,201905,79,264,49,187,10,37,15,55,25,92
421565,201905,874,2348,603,1898,157,543,180,573,337,1116
421567,201905,439,1525,279,1039,119,452,56,189,175,641
421568,201905,324,995,232,773,32,124,109,345,141,469
421569,201905,185,538,73,250,19,70,30,97,49,167
421570,201905,909,2583,651,2086,187,662,143,448,330,1110
421575,201905,267,824,208,664,41,148,78,205,119,353
421580,201905,2980,8601,1996,6541,392,1522,702,1940,1094,3462
421590,201905,133,436,104,359,36,131,27,79,63,210
421600,201905,506,1418,343,1066,85,280,85,219,170,499
421605,201905,714,1920,492,1536,99,292,188,606,287,898
421610,201905,1061,2965,655,2145,129,440,170,552,299,992
421620,201905,3758,10351,2152,7271,528,1913,530,1739,1058,3652
421625,201905,184,516,76,248,12,38,16,49,28,87
421630,201905,2307,6309,1358,4332,239,900,389,1068,628,1968
421635,201905,221,626,148,459,18,62,79,221,97,283
421640,201905,666,1867,471,1536,106,363,142,474,248,837
421650,201905,2126,6037,1350,4529,347,1328,318,887,665,2215
421660,201905,7747,22456,5687,18474,957,3555,2265,6709,3222,10264
421670,201905,734,2169,511,1644,92,338,250,776,342,1114
421680,201905,942,2766,720,2329,196,673,296,885,492,1558
421690,201905,1165,3497,820,2717,158,594,268,894,426,1488
421700,201905,453,1404,244,871,43,172,69,221,112,393
421710,201905,217,689,92,308,24,85,20,62,44,147
421715,201905,99,286,73,226,21,60,42,128,63,188
421720,201905,1866,5231,1059,3487,288,1059,277,774,565,1833
421725,201905,208,510,103,327,20,68,39,99,59,167
421730,201905,368,1108,187,581,19,62,89,260,108,322
421740,201905,611,1807,424,1390,120,401,105,325,225,726
421750,201905,833,2036,392,1184,83,275,148,410,231,685
421755,201905,173,478,94,286,16,63,43,114,59,177
421760,201905,836,2315,511,1679,96,354,158,441,254,795
421770,201905,2168,5943,1591,4909,401,1256,554,1856,955,3112
421775,201905,216,572,134,401,19,64,65,175,84,239
421780,201905,759,2359,505,1793,104,406,192,641,296,1047
421790,201905,677,1796,390,1277,82,280,185,587,267,867
421795,201905,215,635,134,423,25,89,46,135,71,224
421800,201905,2358,6773,1742,5580,283,1022,889,2705,1172,3727
421810,201905,611,1716,413,1326,53,207,224,685,277,892
421820,201905,850,2543,460,1570,87,336,118,337,205,673
421825,201905,1274,3659,1133,3440,139,463,783,2315,922,2778
421830,201905,1885,5963,1594,5397,324,1180,679,2223,1003,3403
421835,201905,207,551,115,372,18,82,42,110,60,192
421840,201905,210,681,136,503,30,120,32,106,62,226
421850,201905,379,1126,210,749,43,177,65,169,108,346
421860,201905,284,845,178,615,22,92,63,187,85,279
421870,201905,3461,9027,2407,6977,461,1511,1104,2929,1565,4440
421875,201905,222,675,108,390,20,78,25,72,45,150
421880,201905,486,1383,337,1093,97,362,66,221,163,583
421885,201905,204,564,126,409,32,109,33,91,65,200
421890,201905,722,2327,566,1992,115,458,253,815,368,1273
421895,201905,383,1014,315,923,35,124,210,626,245,750
421900,201905,929,2439,627,1834,104,360,269,692,373,1052
421910,201905,310,940,213,723,46,180,43,116,89,296
421915,201905,371,1058,200,648,44,143,26,74,70,217
421917,201905,531,1331,306,1012,110,395,68,224,178,619
421920,201905,415,1291,297,1053,128,476,90,319,218,795
421930,201905,2306,6127,1073,3617,286,1056,183,577,469,1633
421935,201905,407,1335,317,1122,62,235,171,577,233,812
421940,201905,308,933,116,388,17,70,31,91,48,161
421950,201905,2923,7432,1445,4559,297,1056,339,930,636,1986
421960,201905,159,415,90,296,22,84,17,51,39,135
421970,201905,1832,4890,1036,3239,226,771,313,857,539,1628
421985,201905,243,633,142,431,17,58,44,133,61,191
422000,201905,1636,4478,1330,3947,156,528,847,2498,1003,3026
430003,201905,521,1497,344,1142,64,235,139,456,203,691
430005,201905,258,707,158,517,40,134,72,230,112,364
430010,201905,1608,4199,1292,3639,152,470,880,2388,1032,2858
430020,201905,569,1337,433,1153,65,208,263,650,328,858
430030,201905,1001,2438,562,1650,158,489,160,443,318,932
430040,201905,9377,23438,5537,16382,1479,4758,475,1531,1954,6289
430045,201905,537,1392,361,1050,32,105,209,586,241,691
430047,201905,246,538,94,270,20,63,24,71,44,134
430050,201905,940,2467,525,1597,119,393,116,338,235,731
430055,201905,258,659,113,345,16,59,58,161,74,220
430057,201905,94,213,31,87,8,28,6,14,14,42
430060,201905,15617,43811,12181,38203,2799,9404,5349,16739,8148,26143
430063,201905,857,2424,671,2022,130,393,358,1061,488,1454
430064,201905,965,2763,729,2240,196,629,268,778,464,1407
430066,201905,96,221,68,174,4,11,48,108,52,119
430070,201905,705,1802,93,309,5,20,11,27,16,47
430080,201905,723,1855,438,1277,74,244,199,509,273,753
430085,201905,855,2009,510,1435,85,249,214,588,299,837
430087,201905,499,1380,402,1238,75,232,223,706,298,938
430090,201905,563,1475,181,587,17,75,55,167,72,242
430100,201905,618,1548,334,990,71,230,116,298,187,528
430105,201905,1014,2756,633,2084,121,428,297,1000,418,1428
430107,201905,179,526,112,360,20,69,30,79,50,148
430110,201905,2045,5142,1489,4305,225,679,837,2389,1062,3068
430120,201905,1312,3991,801,2651,156,540,345,1155,501,1695
430130,201905,3320,8067,2507,6902,981,2709,494,1591,1475,4300
430140,201905,880,2540,593,1951,149,488,246,802,395,1290
430150,201905,548,1431,296,924,66,221,93,281,159,502
430155,201905,246,650,115,361,18,55,22,61,40,116
430160,201905,17319,43602,13767,38260,2402,7117,6806,19040,9208,26157
430163,201905,2462,6195,1695,4943,117,359,1140,3340,1257,3699
430165,201905,333,808,78,253,12,26,13,34,25,60
430170,201905,898,2417,325,1117,61,213,60,190,121,403
430175,201905,649,2015,532,1751,139,449,253,821,392,1270
430180,201905,632,1641,501,1404,66,195,341,930,407,1125
430185,201905,428,1028,258,721,48,130,96,238,144,368
430187,201905,640,1602,450,1332,76,245,214,650,290,895
430190,201905,1383,3813,1107,3352,251,822,481,1364,732,2186
430192,201905,125,364,53,159,8,27,14,39,22,66
430195,201905,400,1203,55,193,9,29,5,20,14,49
430200,201905,1071,3276,870,2901,284,998,255,863,539,1861
430205,201905,482,1302,401,1134,16,53,333,916,349,969
430210,201905,4611,11983,3123,8916,632,1921,1010,2356,1642,4277
430215,201905,300,792,184,547,38,117,70,207,108,324
430220,201905,648,1609,169,571,31,134,40,106,71,240
430222,201905,179,528,135,435,19,73,56,175,75,248
430223,201905,237,660,194,577,25,76,114,329,139,405
430225,201905,15,38,12,33,1,2,8,15,9,17
430230,201905,1705,4884,1489,4560,140,422,1143,3532,1283,3954
430235,201905,260,788,179,601,43,159,53,160,96,319
430237,201905,523,1298,358,1005,21,74,237,630,258,704
430240,201905,1087,2469,622,1697,77,247,353,906,430,1153
430245,201905,645,1969,502,1671,159,530,222,751,381,1281
430250,201905,943,2511,730,2166,239,766,33,83,272,849
430258,201905,102,282,77,231,5,10,40,129,45,139
430260,201905,617,1683,445,1334,78,239,232,690,310,929
430265,201905,200,581,143,469,31,108,43,128,74,236
430270,201905,2619,6759,2105,5927,366,1124,1272,3460,1638,4584
430280,201905,4804,11805,3391,9249,731,2041,1420,3837,2151,5878
430290,201905,2034,4932,1749,4571,52,167,1487,3808,1539,3975
430300,201905,8627,23233,6746,19745,1184,3779,3388,9724,4572,13503
430310,201905,9919,25711,6561,19055,929,3116,3073,8257,4002,11373
430320,201905,937,2528,505,1600,69,187,271,891,340,1078
430330,201905,603,1547,389,1100,75,220,173,446,248,666
430340,201905,679,1544,354,1029,56,176,198,556,254,732
430350,201905,6423,17425,4756,14185,1007,3125,2168,6305,3175,9430
430355,201905,326,844,108,356,26,77,16,52,42,129
430360,201905,798,1997,533,1534,120,383,200,530,320,913
430367,201905,330,813,176,512,43,135,64,186,107,321
430370,201905,475,1327,210,687,37,133,53,150,90,283
430380,201905,660,1692,328,1051,83,310,70,217,153,527
430390,201905,2938,7345,1580,4743,298,969,123,278,421,1247
430400,201905,1063,2314,818,1955,71,184,590,1359,661,1543
430410,201905,550,1345,365,1036,58,185,205,555,263,740
430420,201905,2652,7441,2006,5972,572,1785,729,2056,1301,3841
430430,201905,654,1712,308,952,70,208,69,215,139,423
430435,201905,1479,3840,1108,3213,237,728,494,1425,731,2153
430440,201905,3506,10066,2620,8291,400,1431,1422,4410,1822,5841
430450,201905,6594,17214,5239,14734,667,2131,2980,8117,3647,10248
430460,201905,28104,74305,19878,60362,4056,13609,8692,25105,12748,38714
430461,201905,388,984,104,326,13,41,32,90,45,131
430462,201905,240,655,140,463,20,70,46,160,66,230
430463,201905,4639,13155,3570,11222,689,2377,1742,5355,2431,7732
430465,201905,454,1225,373,1066,57,177,226,623,283,800
430466,201905,3739,9688,2939,8299,762,2242,1337,3580,2099,5822
430467,201905,495,1246,346,1001,51,175,174,466,225,641
430468,201905,1294,3256,1015,2833,116,341,606,1655,722,1996
430469,201905,649,1827,76,263,12,41,11,15,23,56
430470,201905,5287,14119,3569,10986,1140,3744,858,2522,1998,6266
430471,201905,513,1548,433,1389,72,240,211,648,283,888
430480,201905,815,2174,425,1336,59,198,86,230,145,428
430485,201905,166,456,65,217,15,45,8,30,23,75
430490,201905,409,1070,220,648,26,80,105,286,131,366
430495,201905,358,999,205,679,32,115,75,228,107,343
430500,201905,999,2640,700,2113,212,694,219,591,431,1285
430510,201905,22755,61020,16021,47393,3183,10589,6448,17351,9631,27940
430511,201905,320,948,122,427,14,52,16,46,30,98
430512,201905,900,2116,703,1813,174,451,243,644,417,1095
430513,201905,778,1986,364,1055,52,154,174,490,226,644
430515,201905,382,1098,270,859,41,121,130,417,171,538
430517,201905,1010,3165,770,2588,145,490,379,1313,524,1803
430520,201905,1282,3412,659,2044,117,354,134,392,251,746
430530,201905,1047,2718,391,1221,83,265,90,268,173,533
430535,201905,2982,7979,2126,6365,325,1018,1040,3028,1365,4046
430537,201905,307,1101,278,1008,31,102,213,772,244,874
430540,201905,563,1387,341,1026,52,147,160,476,212,623
430543,201905,649,1255,387,941,64,132,196,513,260,645
430544,201905,626,1866,437,1421,97,341,201,636,298,977
430545,201905,1939,5243,1442,4470,293,922,699,2231,992,3153
430550,201905,402,1142,252,805,43,135,78,235,121,370
430558,201905,111,257,48,137,8,21,14,39,22,60
430560,201905,323,721,137,408,12,43,43,124,55,167
430570,201905,746,1785,542,1463,78,233,333,848,411,1081
430580,201905,895,2248,616,1813,148,483,265,737,413,1220
430583,201905,195,480,35,110,4,12,7,20,11,32
430585,201905,221,541,113,308,15,43,54,125,69,168
430587,201905,196,571,138,437,23,73,58,187,81,260
430590,201905,1352,3301,1149,2984,52,147,969,2476,1021,2623
430593,201905,19,70,13,48,2,8,6,21,8,29
430595,201905,424,1037,89,298,6,24,17,41,23,65
430597,201905,349,951,207,628,24,78,75,173,99,251
430600,201905,1787,4706,799,2413,152,479,220,624,372,1103
430605,201905,1090,3092,796,2489,117,437,331,980,448,1417
430607,201905,549,1294,414,1073,25,71,295,767,320,838
430610,201905,5437,13519,3649,10673,1058,3332,650,1983,1708,5315
430613,201905,257,609,70,204,8,27,18,45,26,72
430620,201905,527,1384,398,1123,67,210,203,540,270,750
430630,201905,410,1156,119,389,20,69,23,62,43,131
430632,201905,518,1400,235,726,30,97,103,305,133,402
430635,201905,517,1337,375,1064,49,144,262,741,311,885
430637,201905,451,1149,355,999,44,138,206,556,250,694
430640,201905,1052,2739,597,1801,94,299,203,581,297,880
430642,201905,335,929,253,741,46,134,133,374,179,508
430645,201905,218,493,76,212,16,44,14,44,30,88
430650,201905,1522,4619,1265,4169,340,1137,584,1986,924,3123
430655,201905,254,621,145,405,20,58,67,168,87,226
430660,201905,4718,12644,3575,10586,833,2631,1572,4582,2405,7213
430670,201905,609,1523,469,1274,28,81,312,847,340,928
430673,201905,556,1286,213,638,41,126,78,224,119,350
430675,201905,202,583,55,194,17,67,18,59,35,126
430676,201905,4351,11228,3398,9683,460,1432,2060,5711,2520,7143
430680,201905,943,2555,568,1778,158,516,141,419,299,935
430690,201905,2928,8143,2339,7034,772,2423,614,1785,1386,4208
430692,201905,209,649,157,557,11,44,111,397,122,441
430693,201905,994,2666,566,1762,112,401,127,363,239,764
430695,201905,478,1255,271,815,34,97,146,419,180,516
430697,201905,386,983,289,829,68,185,138,422,206,607
430700,201905,6483,16461,3515,10816,846,2783,449,1358,1295,4141
430705,201905,391,973,187,572,29,96,72,208,101,304
430710,201905,1625,3640,1133,2920,163,458,630,1600,793,2058
430720,201905,728,1752,380,1137,57,154,173,510,230,664
430730,201905,1040,2878,711,2230,109,317,351,1114,460,1431
430740,201905,590,1657,302,1015,47,171,85,298,132,469
430745,201905,434,1214,234,745,40,145,65,175,105,320
430750,201905,1290,3423,911,2737,194,608,467,1332,661,1940
430755,201905,446,1090,278,743,15,50,158,388,173,438
430760,201905,1831,4822,1473,4237,371,1121,628,1742,999,2863
430770,201905,5725,14733,4416,12731,652,2100,2698,7534,3350,9634
430780,201905,1983,5012,1131,3515,235,752,353,1100,588,1852
430781,201905,412,1160,220,700,44,140,53,138,97,278
430783,201905,410,953,235,674,26,91,134,355,160,446
430786,201905,33,112,17,67,3,10,0,0,3,10
430790,201905,4292,10959,2887,8348,409,1360,1590,4263,1999,5623
430800,201905,711,1779,537,1472,46,142,344,932,390,1074
430805,201905,413,1135,246,744,24,89,145,396,169,485
430807,201905,312,685,195,511,11,37,115,272,126,309
430810,201905,800,1959,264,847,34,124,78,232,112,356
430820,201905,1320,3537,701,2300,150,514,153,524,303,1038
430825,201905,265,686,90,252,16,44,23,53,39,97
430830,201905,1637,4833,1340,4255,70,266,929,2923,999,3189
430840,201905,894,2385,690,2018,100,311,451,1302,551,1613
430843,201905,118,291,38,114,4,12,18,47,22,59
430845,201905,382,938,245,700,74,222,72,191,146,413
430850,201905,2211,5930,1589,4704,274,869,716,2100,990,2969
430860,201905,811,1870,426,1204,62,212,201,482,263,694
430865,201905,498,1289,384,1083,60,187,202,543,262,730
430870,201905,629,1678,260,838,44,159,84,238,128,397
430880,201905,1211,2901,824,2291,162,476,403,1067,565,1543
430885,201905,195,484,88,288,8,37,51,155,59,192
430890,201905,995,2658,672,2062,58,272,109,302,167,574
430900,201905,2843,6499,1946,5147,165,520,1227,3038,1392,3558
430905,201905,751,1955,468,1404,87,291,174,492,261,783
430910,201905,1375,3789,943,2892,161,567,410,1142,571,1709
430912,201905,470,1307,317,1018,33,97,202,666,235,763
430915,201905,484,1504,355,1258,97,357,116,414,213,771
430920,201905,22118,57429,16917,48712,2445,7843,9860,27477,12305,35320
430925,201905,134,303,48,141,11,32,16,50,27,82
430930,201905,9373,22513,5703,16764,1244,3854,2132,6517,3376,10371
430940,201905,1081,3010,611,1909,190,625,94,222,284,847
430950,201905,696,1729,438,1246,47,168,262,671,309,839
430955,201905,223,603,68,222,13,38,19,55,32,93
430957,201905,173,607,162,579,29,108,91,321,120,429
430960,201905,1309,3122,756,2141,167,524,322,881,489,1405
430965,201905,1645,4049,1243,3406,71,219,936,2548,1007,2767
430970,201905,370,952,186,571,29,99,82,230,111,329
430975,201905,474,1481,358,1191,84,295,155,498,239,793
430980,201905,390,931,207,607,38,118,82,216,120,334
430990,201905,559,1643,335,1072,41,145,174,547,215,692
430995,201905,560,1477,406,1222,61,195,188,551,249,746
431000,201905,1308,3139,514,1534,84,270,37,92,121,362
431010,201905,2042,5419,1215,3932,224,782,152,429,376,1211
431020,201905,8087,18100,4772,12890,1123,3344,1534,3696,2657,7040
431030,201905,317,867,140,483,28,99,20,66,48,165
431033,201905,3175,7753,1966,5806,498,1510,624,1902,1122,3412
431036,201905,352,778,76,227,8,19,19,46,27,65
431040,201905,906,2384,586,1773,91,309,256,714,347,1023
431041,201905,452,1064,332,889,27,71,193,508,220,579
431043,201905,385,946,197,624,50,171,72,227,122,398
431046,201905,106,282,44,135,2,5,11,33,13,38
431050,201905,1356,3419,968,2798,166,496,512,1489,678,1985
431053,201905,557,1571,307,1015,61,212,97,301,158,513
431055,201905,577,1446,484,1306,40,105,361,960,401,1065
431057,201905,263,762,122,414,18,63,35,106,53,169
431060,201905,4928,13428,3400,10665,940,3169,710,2284,1650,5453
431065,201905,455,1209,305,938,64,198,105,322,169,520
431070,201905,437,1288,244,826,62,233,39,117,101,350
431075,201905,219,664,140,473,26,86,37,130,63,216
431080,201905,593,1661,402,1259,91,311,116,345,207,656
431085,201905,688,1883,474,1386,70,200,240,680,310,880
431087,201905,451,1288,355,1075,27,75,236,733,263,808
431090,201905,414,969,151,476,28,96,41,119,69,215
431100,201905,3087,7103,2199,5884,338,957,1077,2893,1415,3850
431110,201905,1348,3212,925,2462,245,648,402,1042,647,1690
431112,201905,506,1534,420,1355,83,289,213,661,296,950
431113,201905,336,982,294,896,59,191,168,509,227,700
431115,201905,1026,2964,807,2553,121,428,454,1363,575,1791
431120,201905,2248,6477,1568,5050,529,1886,359,1051,888,2937
431123,201905,374,1073,233,767,45,125,122,426,167,551
431125,201905,1030,3103,776,2544,296,961,230,809,526,1770
431127,201905,251,665,57,189,8,24,6,15,14,39
431130,201905,2933,7898,2115,6381,397,1315,988,2896,1385,4211
431140,201905,4806,11641,2670,7533,345,1033,1104,2803,1449,3836
431142,201905,479,1316,348,1069,48,153,202,620,250,773
431150,201905,989,2717,685,2117,148,483,271,827,419,1310
431160,201905,676,1933,469,1492,92,309,151,475,243,784
431162,201905,504,1243,242,734,23,92,117,321,140,413
431164,201905,196,457,41,128,9,28,4,12,13,40
431170,201905,517,1442,351,1102,97,286,89,272,186,558
431171,201905,619,1537,510,1395,84,211,315,869,399,1080
431173,201905,399,1065,287,883,88,304,103,297,191,601
431175,201905,1013,2531,614,1823,129,385,177,516,306,901
431177,201905,684,1997,519,1717,148,534,248,801,396,1335
431179,201905,325,704,72,215,14,47,16,36,30,83
431180,201905,2212,5787,1355,4089,363,1080,306,934,669,2014
431190,201905,447,1230,232,738,28,83,60,169,88,252
431198,201905,311,961,267,879,103,353,70,252,173,605
431200,201905,369,948,69,214,12,32,4,12,16,44
431205,201905,180,524,87,308,23,86,30,108,53,194
431210,201905,604,1577,484,1398,121,333,235,717,356,1050
431213,201905,242,687,180,568,14,55,87,274,101,329
431215,201905,537,1313,236,722,28,93,98,273,126,366
431217,201905,155,430,101,321,7,27,61,176,68,203
431220,201905,585,1553,333,1041,29,116,180,517,209,633
431225,201905,1492,3662,1136,3055,125,371,735,1957,860,2328
431230,201905,660,1948,480,1496,66,223,271,802,337,1025
431235,201905,147,376,24,79,3,12,4,12,7,24
431237,201905,310,995,260,876,43,159,144,464,187,623
431238,201905,25,65,19,51,6,14,6,15,12,29
431240,201905,3782,9816,2948,8460,567,1791,1426,3955,1993,5746
431242,201905,283,787,233,692,62,193,108,318,170,511
431244,201905,328,793,152,425,21,80,54,114,75,194
431245,201905,1296,3098,795,2193,100,292,384,1011,484,1303
431247,201905,224,628,116,379,28,103,27,67,55,170
431250,201905,1554,4185,1165,3604,259,800,558,1798,817,2598
431260,201905,212,599,123,417,20,83,39,118,59,201
431261,201905,232,744,187,660,19,77,96,319,115,396
431262,201905,383,1084,173,574,13,45,107,351,120,396
431265,201905,1435,3423,557,1644,76,266,185,459,261,725
431267,201905,263,728,145,442,5,21,98,271,103,292
431270,201905,2580,6054,1374,3951,351,1095,380,1095,731,2190
431275,201905,141,404,73,238,18,58,9,21,27,79
431280,201905,236,650,62,210,8,29,6,14,14,43
431290,201905,296,866,203,654,32,111,54,142,86,253
431295,201905,73,198,26,81,2,5,7,20,9,25
431300,201905,366,930,58,195,4,14,12,38,16,52
431301,201905,266,795,65,230,9,22,4,11,13,33
431303,201905,564,1522,322,982,29,109,126,354,155,463
431306,201905,2110,5096,1214,3546,202,643,458,1197,660,1840
431308,201905,25,81,22,71,13,44,6,17,19,61
431310,201905,541,1558,360,1128,42,148,165,486,207,634
431320,201905,572,1598,268,908,42,137,44,132,86,269
431330,201905,1634,3957,748,2290,193,643,209,576,402,1219
431333,201905,222,622,108,320,21,56,36,102,57,158
431335,201905,39,110,22,74,6,15,3,4,9,19
431337,201905,2499,6884,1782,5616,434,1548,711,2126,1145,3674
431339,201905,403,1065,295,862,71,207,131,379,202,586
431340,201905,19150,47936,13113,37436,2573,8016,5076,13615,7649,21631
431342,201905,443,996,322,815,17,48,281,704,298,752
431344,201905,389,1007,224,667,10,33,139,400,149,433
431346,201905,256,646,99,324,13,44,30,97,43,141
431349,201905,650,1727,353,1056,78,240,129,360,207,600
431350,201905,3848,10391,2813,8544,417,1403,1378,4120,1795,5523
431360,201905,558,1354,306,871,77,230,99,277,176,507
431365,201905,1625,4158,1362,3772,138,448,996,2727,1134,3175
431370,201905,3990,10323,2919,8443,764,2347,1225,3629,1989,5976
431380,201905,754,2135,635,1925,40,144,421,1265,461,1409
431390,201905,2457,6127,1413,4183,208,717,570,1461,778,2178
431395,201905,1178,3147,840,2603,203,651,348,1095,551,1746
431400,201905,341,979,174,564,32,105,38,111,70,216
431402,201905,816,1922,576,1519,73,211,371,923,444,1134
431403,201905,175,501,139,434,21,76,75,195,96,271
431405,201905,4260,11511,3328,10021,561,1937,1694,4801,2255,6738
431406,201905,458,1392,353,1157,86,267,166,554,252,821
431407,201905,456,1273,294,915,59,194,135,408,194,602
431410,201905,15470,40533,9852,29978,1697,5929,4281,12028,5978,17957
431413,201905,211,553,54,171,5,15,6,17,11,32
431415,201905,666,1692,406,1250,67,239,167,464,234,703
431417,201905,550,1258,376,996,59,167,200,518,259,685
431420,201905,1418,3396,1091,2921,181,508,550,1481,731,1989
431430,201905,519,1360,242,792,37,133,65,190,102,323
431440,201905,25862,63377,18522,51364,3705,11050,6662,17708,10367,28758
431442,201905,110,319,52,184,6,20,9,25,15,45
431445,201905,419,1190,133,462,14,39,14,49,28,88
431446,201905,300,839,206,644,47,162,86,255,133,417
431447,201905,608,1677,403,1237,87,288,151,468,238,756
431449,201905,718,1904,426,1264,73,213,181,518,254,731
431450,201905,2039,4433,1656,3887,102,262,1265,2857,1367,3119
431454,201905,40,125,36,116,7,25,13,42,20,67
431455,201905,579,1422,280,774,37,113,140,345,177,458
431460,201905,2814,7197,2044,5767,544,1609,608,1729,1152,3338
431470,201905,1420,4037,1009,3144,190,603,444,1392,634,1995
431475,201905,246,714,30,121,2,9,2,9,4,18
431477,201905,416,1085,256,758,39,116,115,307,154,423
431478,201905,277,723,58,185,15,45,4,11,19,56
431480,201905,2950,7600,2284,6534,469,1391,1210,3451,1679,4842
431490,201905,98733,243226,78770,211979,6706,21113,57288,148712,63994,169825
431500,201905,480,1266,353,1012,63,175,185,515,248,690
431505,201905,318,775,206,596,18,52,130,376,148,428
431507,201905,344,821,144,416,39,126,44,111,83,237
431510,201905,1464,3920,1026,3032,239,767,381,1121,620,1888
431513,201905,225,533,118,339,10,27,78,226,88,253
431514,201905,88,223,49,146,5,13,29,84,34,97
431515,201905,482,1260,333,978,68,206,164,461,232,667
431517,201905,71,198,55,159,10,28,20,55,30,83
431520,201905,429,1066,163,529,32,120,57,159,89,279
431530,201905,3828,8293,2284,6108,606,1658,435,1156,1041,2814
431531,201905,193,520,121,369,13,39,51,153,64,192
431532,201905,541,1294,333,919,73,217,132,354,205,571
431535,201905,245,661,98,320,23,79,15,43,38,122
431540,201905,1733,5648,1614,5464,60,240,1299,4402,1359,4642
431545,201905,347,912,61,191,8,22,14,41,22,63
431550,201905,1885,5030,1505,4285,266,818,751,2045,1017,2863
431555,201905,664,1547,408,1103,28,90,246,653,274,743
431560,201905,20364,51938,13427,40546,2835,9157,4029,12808,6864,21965
431570,201905,4618,11381,3598,9931,492,1546,2303,6103,2795,7649
431575,201905,224,623,165,506,31,82,38,105,69,187
431580,201905,548,1479,322,994,46,172,157,444,203,616
431590,201905,649,1792,459,1394,97,299,185,575,282,874
431595,201905,332,934,214,671,43,141,86,249,129,390
431600,201905,1269,3116,924,2612,259,769,331,967,590,1736
431610,201905,1312,3484,881,2642,139,393,449,1385,588,1778
431620,201905,539,1451,227,700,39,129,99,282,138,411
431630,201905,1273,3258,566,1764,112,389,192,527,304,916
431640,201905,5744,14836,5060,13878,597,1699,3602,9916,4199,11615
431642,201905,486,1185,320,864,28,66,178,460,206,526
431643,201905,345,865,148,440,15,41,51,150,66,191
431645,201905,1708,4131,1355,3595,98,318,1018,2642,1116,2960
431647,201905,219,570,100,295,12,39,23,58,35,97
431650,201905,158,445,106,344,17,63,40,112,57,175
431660,201905,854,2344,440,1465,75,288,103,314,178,602
431670,201905,1121,2758,730,2050,104,304,391,1055,495,1359
431673,201905,236,614,85,292,15,45,15,51,30,96
431675,201905,562,1402,115,369,8,31,28,69,36,100
431680,201905,7012,18669,5111,14959,1299,3944,2023,5857,3322,9801
431690,201905,20387,52017,13818,40131,3188,9820,4958,14527,8146,24347
431695,201905,144,378,86,270,15,60,37,91,52,151
431697,201905,456,1104,338,909,56,145,180,500,236,645
431700,201905,1379,3663,1152,3234,160,446,662,1835,822,2281
431710,201905,10980,28439,8182,24255,1778,5526,3622,11143,5400,16669
431720,201905,5532,14520,3416,10194,904,2848,525,1421,1429,4269
431725,201905,24,67,17,51,5,14,4,11,9,25
431730,201905,3583,9043,2273,6819,565,1814,678,2136,1243,3950
431740,201905,4890,12138,3199,9127,930,2992,661,1601,1591,4593
431750,201905,6783,18223,5609,16342,1136,3581,2753,8015,3889,11596
431755,201905,310,850,68,247,9,35,12,46,21,81
431760,201905,5370,12395,3452,9292,346,1144,2063,5148,2409,6292
431770,201905,1741,4303,1390,3828,99,311,1014,2733,1113,3044
431775,201905,205,540,96,295,24,71,16,40,40,111
431780,201905,1865,4787,1203,3535,218,688,450,1295,668,1983
431790,201905,838,2297,598,1814,112,338,257,745,369,1083
431795,201905,226,588,103,317,24,77,29,84,53,161
431800,201905,7076,18396,4820,14550,1422,4777,606,1897,2028,6674
431805,201905,294,692,78,259,4,14,32,100,36,114
431810,201905,3220,7873,2026,5622,365,1102,850,2223,1215,3325
431820,201905,2081,5914,1678,5229,471,1531,600,1932,1071,3463
431830,201905,8505,19307,6282,16115,1581,4599,2123,5441,3704,10040
431840,201905,2380,6578,1967,5856,353,1076,1154,3451,1507,4527
431842,201905,668,1652,223,691,29,101,68,190,97,291
431843,201905,302,831,232,685,30,98,115,314,145,412
431844,201905,188,515,66,220,18,72,21,61,39,133
431845,201905,507,1344,353,1026,28,86,212,607,240,693
431846,201905,263,714,229,667,17,50,189,552,206,602
431848,201905,150,380,79,245,8,29,11,26,19,55
431849,201905,398,957,56,163,5,11,3,6,8,17
431850,201905,3884,10827,3034,9091,726,2336,943,2780,1669,5116
431860,201905,667,1694,388,1126,69,209,199,544,268,753
431861,201905,105,279,44,136,10,31,14,37,24,68
431862,201905,424,1348,345,1210,75,289,175,600,250,889
431870,201905,16358,44195,13344,39065,2016,6589,7426,20921,9442,27510
431880,201905,3908,10313,2762,8225,499,1680,1175,3339,1674,5019
431890,201905,3935,10380,2447,7323,761,2463,362,1166,1123,3629
431900,201905,972,2543,609,1826,98,338,304,847,402,1185
431910,201905,776,1906,270,779,55,164,69,154,124,318
431912,201905,443,1297,355,1124,67,227,207,651,274,878
431915,201905,953,2515,774,2203,40,127,561,1556,601,1683
431920,201905,1097,2784,928,2531,38,120,779,2090,817,2210
431930,201905,656,1826,459,1460,120,348,218,721,338,1069
431935,201905,80,233,47,160,14,45,7,26,21,71
431936,201905,289,871,159,535,36,124,53,171,89,295
431937,201905,180,459,113,310,23,77,46,100,69,177
431940,201905,2786,6788,1592,4553,212,691,759,2060,971,2751
431950,201905,1725,4749,1431,4269,438,1307,574,1737,1012,3044
431960,201905,2708,6895,1991,5552,581,1675,524,1459,1105,3134
431970,201905,431,1119,156,486,33,96,38,106,71,202
431971,201905,58,149,32,102,4,16,5,10,9,26
431973,201905,446,1463,362,1295,44,156,255,920,299,1076
431975,201905,94,193,18,59,3,10,5,13,8,23
431980,201905,1042,2794,789,2354,175,570,351,993,526,1563
431990,201905,5581,13912,3657,10943,596,2004,1546,4431,2142,6435
432000,201905,10109,25338,7385,20949,1851,5394,3126,8944,4977,14338
432010,201905,1870,4948,1400,4043,207,649,791,2188,998,2837
432020,201905,1723,4296,1163,3297,254,757,527,1401,781,2158
432023,201905,501,1229,260,744,48,149,121,317,169,466
432026,201905,1025,2922,733,2342,179,559,281,895,460,1454
432030,201905,327,860,186,571,24,77,98,297,122,374
432032,201905,384,1016,259,770,31,105,131,355,162,460
432035,201905,656,1886,579,1753,204,638,200,622,404,1260
432040,201905,1096,2537,368,1162,67,243,115,320,182,563
432045,201905,179,492,105,337,26,85,37,121,63,206
432050,201905,473,1260,355,1044,89,254,136,409,225,663
432055,201905,661,1779,410,1273,135,447,99,284,234,731
432057,201905,233,614,169,459,31,75,75,184,106,259
432060,201905,461,1108,138,439,27,100,45,119,72,219
432065,201905,220,626,151,471,31,89,54,162,85,251
432067,201905,711,2111,603,1856,63,208,397,1180,460,1388
432070,201905,1732,4645,1084,3334,231,799,303,835,534,1634
432080,201905,3926,10046,3033,8493,617,1995,1319,3518,1936,5513
432085,201905,372,971,250,778,84,257,88,291,172,548
432090,201905,1253,3322,894,2639,184,589,421,1177,605,1766
432100,201905,971,2608,428,1407,85,300,48,117,133,417
432110,201905,2065,5712,1383,4418,349,1267,100,317,449,1584
432120,201905,2570,7385,2097,6512,547,1854,630,1907,1177,3761
432130,201905,2363,6350,2012,5837,660,1980,804,2379,1464,4359
432132,201905,178,512,105,352,21,71,42,119,63,190
432135,201905,961,2389,619,1752,49,179,432,1188,481,1367
432140,201905,1515,4685,1126,3885,183,664,631,2195,814,2859
432143,201905,1298,3528,1032,3103,86,291,668,1982,754,2273
432145,201905,1315,3602,740,2323,123,417,202,539,325,956
432146,201905,106,306,67,229,22,84,15,43,37,127
432147,201905,469,1410,287,993,86,314,60,188,146,502
432149,201905,423,1084,213,644,18,55,102,296,120,351
432150,201905,2765,7477,2047,6111,478,1608,667,1915,1145,3523
432160,201905,4727,13190,3572,11228,995,3369,1171,3583,2166,6952
432162,201905,273,615,38,114,6,18,5,14,11,32
432163,201905,133,343,25,72,0,0,3,6,3,6
432166,201905,538,1562,409,1278,66,221,160,455,226,676
432170,201905,1273,3562,801,2634,166,587,249,785,415,1372
432180,201905,2570,6511,1361,4089,259,831,423,1130,682,1961
432183,201905,335,973,214,683,52,194,64,187,116,381
432185,201905,774,2040,451,1387,32,108,247,722,279,830
432190,201905,1902,4765,1161,3448,251,842,475,1308,726,2150
432195,201905,935,2347,586,1728,160,452,224,681,384,1133
432200,201905,2997,8119,2126,6594,414,1307,1021,3240,1435,4547
432210,201905,340,934,215,688,40,157,99,282,139,439
432215,201905,629,1873,562,1769,48,140,404,1280,452,1420
432218,201905,253,642,113,324,19,58,51,136,70,194
432220,201905,3598,8764,2660,7239,408,1222,1539,4043,1947,5265
432225,201905,93,274,71,224,15,47,34,108,49,155
432230,201905,708,1753,385,1126,52,151,163,445,215,596
432232,201905,479,1214,302,895,63,205,117,334,180,539
432234,201905,291,766,129,388,32,84,15,40,47,124
432235,201905,81,230,28,90,7,21,7,26,14,47
432237,201905,352,901,302,812,17,45,226,581,243,626
432240,201905,13394,36223,10251,31627,840,2972,6431,20572,7271,23544
432250,201905,4154,13014,3499,11730,1062,3622,1269,4349,2331,7971
432252,201905,432,1100,263,761,40,125,120,330,160,455
432253,201905,1005,3134,582,2026,160,606,30,88,190,694
432254,201905,828,2057,158,528,31,108,16,46,47,154
432255,201905,120,300,58,177,6,21,25,63,31,84
432260,201905,4627,12174,3382,9791,940,2829,982,2796,1922,5625
432270,201905,1858,5386,1488,4622,451,1477,263,797,714,2274
432280,201905,1083,2834,603,1858,104,355,229,606,333,961
432285,201905,188,583,23,83,0,0,2,5,2,5
432290,201905,341,1003,179,604,58,198,33,82,91,280
432300,201905,24700,65401,18846,55569,2806,9212,10954,31222,13760,40434
432310,201905,733,2059,530,1677,64,207,337,1075,401,1282
432320,201905,200,475,63,186,8,32,24,59,32,91
432330,201905,214,547,73,240,9,21,19,63,28,84
432335,201905,183,520,57,206,6,23,13,49,19,72
432340,201905,312,753,127,400,19,67,35,94,54,161
432345,201905,588,1414,521,1330,20,55,411,1043,431,1098
432350,201905,329,892,166,554,27,91,58,194,85,285
432360,201905,219,638,39,126,4,15,13,36,17,51
432370,201905,307,778,200,586,16,43,129,369,145,412
432375,201905,486,1242,365,1010,68,163,193,541,261,704
432377,201905,200,635,36,129,5,17,4,7,9,24
432380,201905,1472,4131,935,3069,185,693,426,1332,611,2025
500020,201905,2269,6081,1581,4873,244,843,837,2503,1081,3346
500025,201905,1181,2793,726,2015,70,206,412,1098,482,1304
500060,201905,6313,18027,4654,15149,653,2191,2720,9240,3373,11431
500070,201905,3891,10348,2736,8362,544,1695,1197,3767,1741,5462
500080,201905,1293,3388,863,2617,161,560,377,1044,538,1604
500085,201905,1999,5012,1323,3904,315,997,631,1776,946,2773
500090,201905,1870,5114,1267,4031,240,795,492,1633,732,2428
500100,201905,3366,8782,2542,7413,449,1435,1171,3248,1620,4683
500110,201905,7170,19325,4578,14981,1052,3790,1292,4902,2344,8692
500124,201905,1924,5896,1562,5243,280,887,846,2995,1126,3882
500150,201905,1198,2802,735,2080,185,545,232,618,417,1163
500190,201905,4060,10052,2808,8125,708,2096,926,2675,1634,4771
500200,201905,2118,5144,1539,4159,195,550,893,2311,1088,2861
500210,201905,4314,11428,3232,9873,852,2678,1399,4344,2251,7022
500215,201905,1327,3811,938,3061,92,336,480,1567,572,1903
500220,201905,2571,7308,1755,5842,300,1101,593,1941,893,3042
500230,201905,2057,4996,1532,4199,191,516,983,2639,1174,3155
500240,201905,3425,10508,2375,8252,393,1508,846,3017,1239,4525
500260,201905,3012,6573,1822,4894,247,657,930,2406,1177,3063
500270,201905,130252,313882,75260,216725,14034,44017,25548,69371,39582,113388
500280,201905,1202,3085,820,2473,99,328,496,1457,595,1785
500290,201905,3514,8235,1928,5696,354,1173,667,1829,1021,3002
500295,201905,3001,7518,1757,5150,304,986,658,1697,962,2683
500310,201905,863,1918,599,1578,102,224,316,859,418,1083
500315,201905,3263,9647,2649,8649,281,934,1804,6050,2085,6984
500320,201905,17104,49091,12092,40437,3212,11328,3965,14077,7177,25405
500325,201905,4087,9432,2766,7538,271,792,1700,4637,1971,5429
500330,201905,6570,15326,4187,11661,338,1079,2344,6623,2682,7702
500345,201905,1942,4841,1243,3722,329,1032,408,1177,737,2209
500348,201905,2470,6367,1870,5354,254,737,1070,3148,1324,3885
500350,201905,1254,3451,666,2146,79,277,263,823,342,1100
500370,201905,22771,60740,15511,48376,2407,8480,7432,23126,9839,31606
500375,201905,2328,6348,1595,4803,337,1108,534,1532,871,2640
500380,201905,3397,8664,2324,6821,659,2041,707,2093,1366,4134
500390,201905,489,1055,298,801,49,141,159,425,208,566
500400,201905,1178,3137,774,2327,152,514,274,748,426,1262
500410,201905,2277,5884,1639,4892,210,616,932,2867,1142,3483
500430,201905,2455,6343,1677,5144,259,911,667,2152,926,3063
500440,201905,1100,2727,676,2028,105,325,254,814,359,1139
500450,201905,1335,3434,727,2259,149,485,139,411,288,896
500460,201905,3424,9501,2114,6904,402,1466,629,2086,1031,3552
500470,201905,2296,6352,1410,4502,455,1588,264,723,719,2311
500480,201905,2116,6337,1815,5883,169,598,1226,4144,1395,4742
500490,201905,958,2302,545,1660,138,500,154,457,292,957
500500,201905,4118,11351,2660,8935,930,3596,522,1788,1452,5384
500510,201905,689,1761,438,1273,29,93,255,715,284,808
500515,201905,1810,4588,1402,3956,146,415,898,2483,1044,2898
500520,201905,2930,9754,2352,8571,660,2472,946,3566,1606,6038
500525,201905,844,2558,687,2311,62,230,427,1458,489,1688
500540,201905,4175,11120,2527,8160,736,2860,227,622,963,3482
500560,201905,5014,14649,4145,13441,314,1136,3137,10274,3451,11410
500568,201905,4189,9372,2504,6869,610,1839,802,2176,1412,4015
500570,201905,7220,17368,4135,11923,874,2776,1149,3089,2023,5865
500580,201905,3012,8186,2253,6876,474,1546,1090,3276,1564,4822
500600,201905,2981,7603,2088,6250,421,1282,903,2782,1324,4064
500620,201905,7138,19558,4780,14931,1078,3472,1673,5160,2751,8632
500625,201905,481,1330,265,849,51,176,99,295,150,471
500627,201905,714,1851,422,1301,57,171,142,437,199,608
500630,201905,5973,14442,3471,10142,747,2361,1048,3090,1795,5451
500635,201905,2728,8935,2127,8101,162,678,1525,6206,1687,6884
500640,201905,1613,3680,1078,2922,38,131,735,1912,773,2043
500660,201905,15663,43830,11037,36432,3850,14098,2554,8498,6404,22596
500690,201905,2094,5898,1450,4874,586,2247,91,210,677,2457
500710,201905,2823,7928,2154,6683,641,2094,636,1859,1277,3953
500720,201905,4840,12571,3027,9499,712,2417,781,2495,1493,4912
500730,201905,889,2338,549,1707,75,210,207,658,282,868
500740,201905,4483,10896,3100,8600,344,1009,1755,4890,2099,5899
500750,201905,934,2454,631,1910,93,290,235,647,328,937
500755,201905,856,2356,479,1609,95,339,68,201,163,540
500769,201905,4752,12043,2454,7457,467,1598,348,804,815,2402
500770,201905,1454,4033,913,3015,173,642,283,930,456,1572
500780,201905,1237,3094,791,2321,178,564,207,569,385,1133
500790,201905,7336,19537,5784,17001,1102,3507,3057,9015,4159,12522
500793,201905,1799,4689,1221,3684,412,1296,255,677,667,1973
500795,201905,2394,6364,1986,5823,107,302,1670,5029,1777,5331
500797,201905,691,1829,458,1385,114,356,163,478,277,834
500800,201905,2722,6525,1749,5073,594,1974,242,769,836,2743
500830,201905,17133,43942,11639,33773,2158,6766,4817,13219,6975,19985
500840,201905,1367,3443,779,2283,96,296,317,880,413,1176
510010,201905,1821,4279,1187,3403,134,387,770,2220,904,2607
510020,201905,3538,9221,1836,5670,431,1398,352,956,783,2354
510025,201905,6617,17032,4044,12470,679,2321,1460,4304,2139,6625
510030,201905,2181,4998,1420,3902,332,915,508,1433,840,2348
510035,201905,1176,3060,712,2305,88,306,422,1436,510,1742
510040,201905,2107,4920,1525,4124,151,400,955,2630,1106,3030
510050,201905,1944,4463,1287,3523,196,610,800,2076,996,2686
510060,201905,1336,3435,984,2879,192,620,335,931,527,1551
510080,201905,1170,3186,767,2465,233,793,223,634,456,1427
510100,201905,637,1546,421,1175,52,149,215,570,267,719
510120,201905,252,471,139,335,6,17,103,255,109,272
510125,201905,2081,5278,1623,4580,203,757,776,2012,979,2769
510130,201905,1413,3618,982,2911,215,719,297,873,512,1592
510140,201905,2842,7716,1975,6583,753,2895,642,1953,1395,4848
510160,201905,1673,4410,1217,3805,203,615,825,2611,1028,3226
510170,201905,4405,12066,3255,10169,796,2559,1296,4153,2092,6712
510180,201905,13094,31289,7915,23021,1893,5971,2264,7438,4157,13409
510185,201905,1627,4416,1070,3602,425,1424,312,1290,737,2714
510190,201905,1959,5693,1303,4519,392,1492,261,950,653,2442
510250,201905,13771,37071,11222,33450,2198,6768,6270,19330,8468,26098
510260,201905,2018,8337,1632,7621,272,1357,957,4906,1229,6263
510263,201905,2810,8090,1715,5801,319,1166,201,604,520,1770
510267,201905,4588,13378,2736,9225,606,2155,327,1051,933,3206
510268,201905,1259,3199,895,2582,112,326,524,1471,636,1797
510269,201905,1020,2842,631,2084,160,564,205,637,365,1201
510270,201905,2824,8395,1991,6861,385,1430,757,2574,1142,4004
510279,201905,1702,4610,1132,3576,211,739,504,1517,715,2256
510285,201905,1068,2954,746,2390,224,796,168,499,392,1295
510300,201905,3508,9086,2601,7828,392,1135,1508,4806,1900,5941
510305,201905,1455,4112,878,2957,190,669,233,860,423,1529
510310,201905,916,2359,639,1888,184,574,194,596,378,1170
510320,201905,3559,9298,2527,7479,572,1812,667,2016,1239,3828
510325,201905,4312,13084,3361,11435,948,3309,1268,4469,2216,7778
510330,201905,2771,8559,1881,6933,384,1426,675,2823,1059,4249
510335,201905,4430,12944,3321,11279,476,1730,1865,6571,2341,8301
510336,201905,457,1361,338,1165,65,213,153,574,218,787
510337,201905,1596,4822,1067,3833,418,1626,184,675,602,2301
510340,201905,84960,194106,50945,142624,13704,44803,13197,34130,26901,78933
510343,201905,1015,2854,695,2218,127,457,274,833,401,1290
510345,201905,1217,3565,898,2929,174,591,381,1201,555,1792
510350,201905,2706,7285,1748,5637,414,1387,674,2134,1088,3521
510360,201905,1818,3905,1152,3099,65,172,825,2318,890,2490
510370,201905,1647,4936,1173,4039,183,689,640,2232,823,2921
510380,201905,484,1256,265,842,68,249,83,249,151,498
510385,201905,1032,3673,762,3122,84,383,483,2067,567,2450
510390,201905,1075,3153,778,2731,203,695,347,1347,550,2042
510395,201905,712,1626,466,1257,29,92,264,760,293,852
510410,201905,4337,12646,3232,10570,669,2262,1731,5833,2400,8095
510420,201905,2125,4727,1453,3795,122,367,902,2333,1024,2700
510450,201905,489,1218,280,813,69,195,46,158,115,353
510452,201905,659,1862,431,1421,72,237,203,675,275,912
510454,201905,891,2535,669,2135,73,208,409,1396,482,1604
510455,201905,901,2600,636,2015,107,401,240,700,347,1101
510460,201905,1780,4522,1267,3745,108,381,798,2253,906,2634
510480,201905,4542,11423,2955,8305,606,1863,1110,2984,1716,4847
510490,201905,1610,4450,1191,3867,213,706,663,2190,876,2896
510500,201905,1551,4005,926,2927,181,619,319,1000,500,1619
510510,201905,3197,9763,2415,8252,698,2616,665,2420,1363,5036
510515,201905,5173,13850,3318,10304,762,2614,865,2424,1627,5038
510517,201905,1055,3111,799,2651,244,900,134,378,378,1278
510520,201905,1993,4123,1162,3097,71,199,639,1826,710,2025
510523,201905,973,2584,718,2144,145,416,396,1195,541,1611
510525,201905,5870,16701,4354,13638,734,2587,1913,5597,2647,8184
510530,201905,537,1388,396,1182,33,112,249,713,282,825
510550,201905,2492,7519,1806,6277,464,1657,716,2545,1180,4202
510558,201905,2042,5621,1508,4769,154,499,771,2611,925,3110
510560,201905,1560,4591,912,3289,209,826,233,892,442,1718
510562,201905,5046,13742,3588,10958,928,3078,1106,3410,2034,6488
510590,201905,2983,7693,2164,6622,226,721,1468,4558,1694,5279
510600,201905,1479,3456,934,2596,175,487,378,1048,553,1535
510610,201905,2705,6651,1825,5412,175,593,1098,3254,1273,3847
510615,201905,2130,5868,1520,4753,276,873,838,2678,1114,3551
510617,201905,940,2766,680,2326,118,447,385,1377,503,1824
510618,201905,1204,3300,831,2617,171,590,405,1253,576,1843
510619,201905,707,1825,423,1306,76,255,86,250,162,505
510620,201905,1388,3207,633,2015,154,580,41,97,195,677
510621,201905,1419,3914,870,2847,208,741,249,771,457,1512
510622,201905,4057,11750,2793,8893,1029,3508,401,1134,1430,4642
510623,201905,2582,6677,1795,5394,421,1507,462,1322,883,2829
510624,201905,1599,4183,690,2361,84,302,145,434,229,736
510625,201905,2595,6427,1406,4271,293,1018,289,855,582,1873
510626,201905,1445,3533,880,2637,261,899,195,582,456,1481
510627,201905,582,1527,336,1038,92,297,70,225,162,522
510628,201905,1505,3497,988,2799,182,531,461,1333,643,1864
510629,201905,1536,4563,1150,3822,261,935,393,1303,654,2238
510630,201905,3181,9148,1839,6468,422,1586,307,1167,729,2753
510631,201905,548,1341,392,1114,16,45,301,864,317,909
510637,201905,3242,8116,2329,6696,658,2088,621,1754,1279,3842
510642,201905,5016,15080,3976,13467,1074,3839,1585,5596,2659,9435
510645,201905,831,1818,489,1349,110,311,204,527,314,838
510650,201905,6744,18089,5436,16651,659,1881,3839,12657,4498,14538
510665,201905,1759,4045,1024,2839,151,446,420,1215,571,1661
510670,201905,407,867,232,607,29,85,126,330,155,415
510675,201905,5599,16023,3923,12811,1184,4165,674,2203,1858,6368
510677,201905,2070,5449,1423,4456,199,667,724,2252,923,2919
510680,201905,665,1792,389,1256,89,314,60,179,149,493
510682,201905,1571,4823,1155,4077,382,1485,246,861,628,2346
510685,201905,609,1810,446,1472,65,226,204,658,269,884
510700,201905,3695,9428,2621,7811,339,1118,1739,5156,2078,6274
510704,201905,9600,23474,6285,17622,1258,3848,1784,4775,3042,8623
510706,201905,1789,5470,1270,4633,228,864,676,2663,904,3527
510710,201905,2455,6517,1668,4965,361,1121,587,1671,948,2792
510715,201905,599,1391,446,1175,46,127,211,578,257,705
510718,201905,2378,5306,1329,4000,532,1619,291,1136,823,2755
510719,201905,404,867,243,657,33,96,136,345,169,441
510720,201905,917,2269,602,1767,129,409,229,631,358,1040
510724,201905,723,1998,481,1552,80,279,222,697,302,976
510726,201905,1154,2108,578,1380,68,171,290,686,358,857
510729,201905,606,1456,270,825,36,125,66,209,102,334
510730,201905,2879,7169,1927,5641,357,1150,805,2306,1162,3456
510735,201905,999,2972,749,2600,78,308,533,1846,611,2154
510740,201905,904,2303,569,1653,83,238,288,852,371,1090
510757,201905,544,1769,440,1595,157,628,147,499,304,1127
510760,201905,40213,89833,23108,63393,5254,16582,6810,17059,12064,33641
510770,201905,3963,9328,2855,7947,285,747,1912,5548,2197,6295
510774,201905,333,932,227,722,33,108,118,389,151,497
510775,201905,595,1647,412,1348,94,354,88,264,182,618
510776,201905,448,1164,306,867,86,254,90,269,176,523
510777,201905,1551,4219,1119,3631,144,590,719,2264,863,2854
510779,201905,563,1575,435,1367,50,146,257,849,307,995
510780,201905,3551,9568,2623,8171,633,1992,1100,3811,1733,5803
510785,201905,2014,5409,1123,3720,299,1053,166,632,465,1685
510787,201905,2452,7158,1597,5308,628,2213,93,286,721,2499
510788,201905,654,1573,448,1253,70,191,179,584,249,775
510790,201905,15665,41806,9284,29314,2083,7361,1431,3910,3514,11271
510792,201905,8264,22573,5170,16651,1081,3888,1051,3168,2132,7056
510794,201905,1178,3254,771,2527,250,905,157,442,407,1347
510795,201905,7423,20388,5004,15973,1214,4229,1277,4126,2491,8355
510800,201905,1716,4559,1104,3451,350,1116,176,490,526,1606
510805,201905,1559,4340,1019,3296,226,799,302,860,528,1659
510810,201905,631,1356,412,1045,118,322,176,446,294,768
510820,201905,760,1487,411,1041,36,111,191,494,227,605
510830,201905,817,2044,571,1702,67,201,380,1181,447,1382
510835,201905,549,1381,362,1102,51,174,192,569,243,743
510840,201905,46942,105261,33171,87888,6130,15544,17361,49906,23491,65450
510850,201905,1843,4491,1023,3151,319,1102,113,269,432,1371
510860,201905,2428,6621,1549,5109,501,1936,148,482,649,2418
510880,201905,642,1906,490,1604,127,432,193,645,320,1077
510885,201905,553,1394,379,1131,64,220,131,381,195,601
510890,201905,624,1870,470,1603,108,396,208,713,316,1109
510895,201905,1193,3133,793,2448,198,701,309,863,507,1564
520005,201905,2149,5761,1695,5198,466,1382,766,2644,1232,4026
520010,201905,2137,6340,1535,5091,405,1474,398,1155,803,2629
520013,201905,2590,6927,1783,5384,421,1326,461,1510,882,2836
520015,201905,526,1350,393,1164,93,297,134,424,227,721
520017,201905,1077,2879,815,2467,107,344,508,1511,615,1855
520020,201905,372,876,285,757,34,117,190,468,224,585
520025,201905,31788,90552,27676,84750,2851,9413,19882,60642,22733,70055
520030,201905,5102,13729,4148,12342,406,1329,2726,8075,3132,9404
520050,201905,399,945,255,690,16,38,150,426,166,464
520055,201905,1364,3555,951,2736,52,153,545,1530,597,1683
520060,201905,1381,3994,1033,3331,279,974,250,810,529,1784
520080,201905,1828,4770,1367,4133,245,749,625,2079,870,2828
520082,201905,887,2303,717,2004,75,190,414,1204,489,1394
520085,201905,766,2140,592,1844,114,373,250,740,364,1113
520090,201905,836,1685,567,1384,78,153,411,1058,489,1211
520110,201905,37181,103166,26192,84829,8685,31557,1937,5748,10622,37305
520120,201905,200,490,113,342,14,50,38,116,52,166
520130,201905,3621,9196,2870,7973,558,1604,1256,3514,1814,5118
520140,201905,37759,105395,27176,86920,10097,34815,3179,10628,13276,45443
520145,201905,529,1265,354,1000,70,211,168,433,238,644
520150,201905,550,1301,399,1099,65,174,216,616,281,790
520160,201905,806,1875,572,1509,100,250,275,748,375,998
520170,201905,4923,10223,3394,8438,201,566,2601,6330,2802,6896
520180,201905,1985,5589,1629,5031,364,1220,771,2349,1135,3569
520215,201905,1869,4507,1339,3679,313,924,517,1372,830,2296
520235,201905,592,1421,362,1063,39,124,145,412,184,536
520250,201905,1488,3915,1077,3240,340,1139,200,609,540,1748
520260,201905,820,1936,495,1377,100,289,198,549,298,838
520280,201905,662,1724,512,1469,128,376,221,673,349,1049
520310,201905,1152,2604,742,1985,177,506,276,779,453,1285
520320,201905,1665,4621,1286,3986,148,505,670,2049,818,2554
520330,201905,3584,10116,2618,8464,455,1743,1229,3853,1684,5596
520340,201905,2256,5137,1437,3975,181,466,846,2429,1027,2895
520350,201905,2811,6957,2037,5715,627,1868,712,1970,1339,3838
520355,201905,1756,4925,1291,4004,348,1179,408,1188,756,2367
520357,201905,747,1909,580,1640,42,119,414,1190,456,1309
520360,201905,688,1833,515,1533,159,500,141,457,300,957
520380,201905,1263,3233,755,2276,73,251,381,1062,454,1313
520390,201905,965,2144,552,1619,175,557,144,445,319,1002
520393,201905,532,1277,358,1004,49,164,172,431,221,595
520396,201905,777,2128,653,1908,64,217,427,1204,491,1421
520400,201905,1568,4016,1228,3543,201,628,782,2248,983,2876
520410,201905,1790,3978,1055,2886,161,454,481,1273,642,1727
520420,201905,381,908,287,734,29,82,202,484,231,566
520425,201905,1410,3467,896,2574,220,642,293,839,513,1481
520430,201905,2181,5100,1194,3560,225,782,43,120,268,902
520440,201905,2944,7201,1829,5245,448,1377,486,1350,934,2727
520450,201905,11449,28251,7540,22036,2425,7673,985,3004,3410,10677
520455,201905,645,1815,468,1535,123,420,135,455,258,875
520460,201905,886,2248,755,2066,99,226,567,1604,666,1830
520465,201905,788,2060,625,1817,104,329,400,1120,504,1449
520470,201905,1890,5280,1552,4836,376,1163,767,2561,1143,3724
520480,201905,874,2487,588,1981,187,648,116,420,303,1068
520485,201905,1525,4339,1287,4004,195,607,839,2603,1034,3210
520490,201905,3869,10914,2935,9450,856,2759,1245,4184,2101,6943
520495,201905,1490,3363,1138,2886,62,178,890,2244,952,2422
520500,201905,1342,3576,920,2774,207,685,336,1008,543,1693
520505,201905,711,1692,505,1414,74,208,286,791,360,999
520510,201905,7268,18800,4843,14951,1148,3951,1290,4268,2438,8219
520520,201905,1129,2942,845,2483,196,602,271,816,467,1418
520530,201905,1986,5961,1481,5066,487,1714,418,1618,905,3332
520540,201905,2808,7622,1721,5360,335,1094,395,1179,730,2273
520545,201905,880,2412,683,2094,136,409,258,801,394,1210
520547,201905,744,2085,591,1812,155,482,253,775,408,1257
520549,201905,11881,33441,9846,30191,1631,5260,6080,18522,7711,23782
520551,201905,4289,12010,3626,11031,416,1531,2503,7387,2919,8918
520552,201905,799,2128,671,1965,126,365,414,1276,540,1641
520570,201905,553,1299,370,1034,101,263,131,397,232,660
520580,201905,2240,5240,1697,4587,135,411,1184,3167,1319,3578
520590,201905,1191,3185,833,2542,235,725,153,471,388,1196
520620,201905,7951,22000,6313,19572,1643,5197,2797,8925,4440,14122
520630,201905,752,1967,470,1460,82,268,111,349,193,617
520640,201905,2404,5993,1837,5015,470,1271,724,2058,1194,3329
520650,201905,871,2114,613,1716,111,312,287,843,398,1155
520660,201905,520,1258,247,759,50,174,53,167,103,341
520670,201905,917,2596,780,2398,68,223,521,1545,589,1768
520680,201905,704,1766,514,1467,98,272,247,717,345,989
520690,201905,348,813,238,660,80,218,71,215,151,433
520710,201905,470,1118,301,829,8,21,200,533,208,554
520725,201905,1548,3753,1091,2996,129,383,681,1804,810,2187
520735,201905,697,1777,483,1416,104,283,182,578,286,861
520740,201905,1954,4602,1498,4020,260,679,838,2346,1098,3025
520750,201905,646,1617,460,1315,88,246,209,622,297,868
520753,201905,1347,3602,1041,3018,194,591,441,1215,635,1806
520760,201905,1070,2373,964,2237,60,114,815,1959,875,2073
520780,201905,1493,3620,1091,3043,118,343,546,1478,664,1821
520790,201905,3343,7954,2324,6366,258,733,1337,3874,1595,4607
520800,201905,14709,39128,11732,34832,2151,6539,6718,20582,8869,27121
520810,201905,1291,2748,922,2325,168,458,535,1398,703,1856
520815,201905,597,1784,433,1450,90,309,104,363,194,672
520830,201905,1825,3995,1274,3357,51,137,1010,2605,1061,2742
520840,201905,2297,6358,1871,5802,794,2586,530,1771,1324,4357
520850,201905,661,1791,469,1490,170,618,99,319,269,937
520860,201905,5868,16357,4481,14096,1111,3770,1713,5365,2824,9135
520870,201905,91117,218636,62355,175584,15909,48654,19979,54836,35888,103490
520880,201905,6132,17852,4792,15507,1268,4262,1600,5229,2868,9491
520890,201905,3681,9253,2528,7425,540,1705,1063,3118,1603,4823
520910,201905,4413,11376,2810,8516,729,2407,560,1688,1289,4095
520915,201905,620,1724,387,1222,67,232,122,368,189,600
520920,201905,4443,10353,3011,8398,402,1196,1597,4497,1999,5693
520929,201905,715,1731,499,1367,81,196,237,697,318,893
520940,201905,980,2663,773,2362,42,155,575,1705,617,1860
520945,201905,479,1100,385,954,33,79,266,642,299,721
520960,201905,1020,2640,797,2257,117,345,494,1348,611,1693
520970,201905,2401,6864,1944,6098,534,1825,479,1599,1013,3424
520980,201905,790,1977,585,1680,123,378,229,623,352,1001
520990,201905,2948,8225,2394,7461,304,983,1556,4881,1860,5864
520993,201905,1043,2493,692,1920,63,205,435,1161,498,1366
520995,201905,2211,5714,1678,4981,287,872,666,2007,953,2879
521000,201905,8122,21795,5576,17244,1270,4096,1579,4861,2849,8957
521010,201905,3685,9669,2764,8071,310,915,1574,4556,1884,5471
521015,201905,696,1766,517,1462,57,181,320,863,377,1044
521020,201905,2876,7531,1732,5301,513,1660,155,497,668,2157
521030,201905,467,1027,321,824,43,89,150,427,193,516
521040,201905,7458,18317,5521,15278,1231,3543,2305,6502,3536,10045
521056,201905,880,2395,685,2100,209,651,201,669,410,1320
521060,201905,969,2569,725,2146,59,183,367,1085,426,1268
521080,201905,1080,2428,555,1567,68,204,220,539,288,743
521090,201905,3307,8805,2244,6808,640,2041,294,942,934,2983
521100,201905,1737,4125,1251,3427,208,566,708,1966,916,2532
521120,201905,4665,11005,3265,9236,266,691,1608,5192,1874,5883
521130,201905,902,2108,557,1523,30,105,302,852,332,957
521140,201905,1227,3232,887,2632,152,483,384,1122,536,1605
521150,201905,11873,26682,7546,20570,1442,4504,3367,9306,4809,13810
521160,201905,623,1371,439,1085,55,135,263,622,318,757
521170,201905,1040,2489,748,2023,71,199,500,1322,571,1521
521180,201905,6645,19278,5530,17257,1051,3546,2560,7734,3611,11280
521190,201905,10211,26451,5847,18653,1466,4973,1142,3859,2608,8832
521200,201905,718,1803,490,1410,46,134,274,774,320,908
521205,201905,606,1537,456,1291,17,42,326,894,343,936
521210,201905,702,1805,406,1216,103,332,64,148,167,480
521220,201905,3805,9524,2455,7281,543,1774,637,1744,1180,3518
521225,201905,319,722,242,633,35,97,155,396,190,493
521230,201905,1255,3464,1151,3322,414,1179,565,1747,979,2926
521250,201905,29668,82345,23487,73353,8961,29186,7066,23553,16027,52739
521260,201905,579,1355,419,1094,62,164,237,609,299,773
521270,201905,1804,4624,1554,4316,86,214,1192,3335,1278,3549
521280,201905,1841,5036,1378,4228,359,1182,512,1577,871,2759
521290,201905,463,1137,322,948,49,163,178,511,227,674
521295,201905,1056,2319,824,2061,81,185,623,1642,704,1827
521300,201905,1864,4708,1482,4184,298,796,884,2566,1182,3362
521305,201905,701,1750,479,1391,61,165,272,793,333,958
521308,201905,4645,12696,3330,10136,402,1230,1817,5430,2219,6660
521310,201905,8000,20912,5384,16362,1266,4128,1896,5548,3162,9676
521340,201905,412,957,290,774,18,54,212,550,230,604
521350,201905,2026,5237,1540,4491,159,529,1026,2884,1185,3413
521370,201905,1172,3098,711,2287,191,703,103,342,294,1045
521375,201905,1339,3418,940,2841,219,667,307,980,526,1647
521377,201905,1449,3145,1063,2662,78,148,862,2243,940,2391
521380,201905,5896,16040,3905,12235,431,1523,938,3090,1369,4613
521385,201905,627,1534,484,1353,73,197,268,807,341,1004
521390,201905,682,1720,483,1414,156,485,164,506,320,991
521400,201905,2486,5758,1925,5077,203,529,1376,3769,1579,4298
521405,201905,1270,3293,942,2744,193,564,422,1227,615,1791
521410,201905,754,2057,604,1812,117,340,301,968,418,1308
521440,201905,1284,3348,935,2791,284,917,256,752,540,1669
521450,201905,3809,11605,2824,9586,698,2392,767,2755,1465,5147
521460,201905,5627,15267,4092,12503,1486,4722,832,2568,2318,7290
521470,201905,653,1806,397,1258,60,191,118,351,178,542
521480,201905,344,874,199,587,36,109,51,132,87,241
521483,201905,2441,5969,1689,4770,415,1249,594,1616,1009,2865
521486,201905,1666,3995,1262,3427,77,219,942,2528,1019,2747
521487,201905,439,1099,313,910,61,179,141,425,202,604
521490,201905,840,2312,617,1938,35,139,443,1346,478,1485
521500,201905,2004,5141,1468,4242,84,309,1042,2932,1126,3241
521520,201905,744,1721,509,1369,89,247,209,571,298,818
521523,201905,11080,35765,9446,33035,3087,11525,2563,9206,5650,20731
521525,201905,1034,2401,756,2001,80,222,531,1390,611,1612
521530,201905,2268,5935,1305,3945,277,896,318,1010,595,1906
521540,201905,847,2169,545,1644,82,294,236,732,318,1026
521550,201905,1246,3234,745,2232,148,488,215,679,363,1167
521560,201905,4155,11396,2913,9691,535,2112,1441,4960,1976,7072
521565,201905,616,1542,486,1352,82,212,296,816,378,1028
521570,201905,3585,9650,2383,7363,470,1638,299,991,769,2629
521580,201905,516,1286,290,874,37,126,71,177,108,303
521590,201905,608,1494,457,1263,104,311,230,612,334,923
521600,201905,386,1063,235,738,44,115,68,215,112,330
521630,201905,1619,3656,974,2650,204,586,314,827,518,1413
521640,201905,1843,4391,1296,3597,290,880,437,1154,727,2034
521645,201905,552,1460,358,1108,82,237,109,340,191,577
521680,201905,1126,3487,879,2984,253,933,110,404,363,1337
521690,201905,501,1328,436,1217,59,179,263,713,322,892
521710,201905,2917,7608,1932,5911,368,1283,430,1251,798,2534
521720,201905,2141,5152,1444,4076,174,551,808,2215,982,2766
521730,201905,3564,10422,2765,8970,849,3087,570,1574,1419,4661
521740,201905,3866,10342,2936,8947,847,2756,991,3154,1838,5910
521760,201905,14154,40559,11231,35946,3299,11587,3789,12538,7088,24125
521770,201905,2868,7141,1974,5661,610,1880,459,1312,1069,3192
521800,201905,5913,16553,4531,14218,1180,3807,1560,5350,2740,9157
521805,201905,519,1248,380,1043,127,324,151,432,278,756
521810,201905,681,1610,465,1296,73,206,238,677,311,883
521830,201905,5150,14629,4191,13180,358,1330,2898,8953,3256,10283
521839,201905,668,1707,477,1367,93,284,218,568,311,852
521850,201905,4967,12609,3253,9699,516,1695,278,758,794,2453
521860,201905,1678,4468,1147,3523,195,644,363,1092,558,1736
521870,201905,679,1920,466,1503,105,350,124,367,229,717
521878,201905,616,1650,452,1343,68,229,210,557,278,786
521880,201905,17848,43779,11998,34873,3091,9485,3909,11666,7000,21151
521890,201905,3066,8265,2030,6309,537,1777,308,889,845,2666
521900,201905,1588,3806,955,2854,283,806,177,564,460,1370
521910,201905,1149,2605,775,2144,76,202,447,1292,523,1494
521920,201905,447,1260,323,1022,64,218,126,403,190,621
521925,201905,739,2026,550,1712,102,320,243,734,345,1054
521930,201905,4701,11974,3301,9843,924,2647,1182,3895,2106,6542
521935,201905,880,2176,617,1712,60,174,364,955,424,1129
521940,201905,1270,2921,827,2307,184,561,325,878,509,1439
521945,201905,518,1463,411,1265,89,277,199,632,288,909
521950,201905,710,1719,510,1426,130,390,235,604,365,994
521960,201905,721,1973,479,1476,70,236,223,639,293,875
521970,201905,2473,6328,2067,5835,145,397,1615,4622,1760,5019
521971,201905,739,1796,521,1476,145,406,126,358,271,764
521973,201905,1162,3155,912,2750,56,212,627,1843,683,2055
521975,201905,11587,31349,9734,28782,1553,4777,6069,17925,7622,22702
521980,201905,2503,6039,1923,5262,173,435,1404,3902,1577,4337
521990,201905,1120,3122,891,2733,153,477,407,1269,560,1746
522000,201905,2764,7558,2146,6781,244,754,1407,4634,1651,5388
522005,201905,327,802,245,690,49,127,120,344,169,471
522010,201905,3809,9548,2699,7749,719,2201,778,2183,1497,4384
522015,201905,937,2527,672,2097,155,493,260,827,415,1320
522020,201905,5155,12466,3407,9690,720,2153,1374,4021,2094,6174
522026,201905,640,1818,471,1499,89,309,166,513,255,822
522028,201905,469,1255,340,1001,60,176,137,378,197,554
522040,201905,2915,6685,2051,5533,257,760,1343,3539,1600,4299
522045,201905,16586,47617,12340,39720,2979,10258,3080,9575,6059,19833
522050,201905,989,2619,677,2094,149,493,272,809,421,1302
522060,201905,2480,6875,1946,6023,217,685,1127,3610,1344,4295
522068,201905,1742,4645,1369,4180,162,452,973,3057,1135,3509
522070,201905,605,1557,494,1388,26,86,390,1057,416,1143
522100,201905,616,1659,437,1360,52,167,237,738,289,905
522108,201905,894,2431,698,2124,46,209,556,1616,602,1825
522119,201905,1518,3944,1169,3467,183,567,602,1843,785,2410
522130,201905,358,905,256,768,51,164,140,441,191,605
522140,201905,15894,43335,11584,35661,3277,10794,2615,7713,5892,18507
522145,201905,820,2037,575,1672,152,417,239,734,391,1151
522150,201905,1009,2518,724,2044,201,568,210,622,411,1190
522155,201905,898,2361,702,2037,123,352,383,1108,506,1460
522157,201905,532,1357,453,1249,30,106,350,956,380,1062
522160,201905,5710,15242,3790,11653,1066,3562,287,940,1353,4502
522170,201905,2610,6805,1912,5739,377,1167,956,2899,1333,4066
522180,201905,452,1115,285,826,64,186,25,92,89,278
522185,201905,16009,40947,11889,35440,5134,16389,2683,8720,7817,25109
522190,201905,731,1793,514,1410,96,264,197,547,293,811
522200,201905,1608,4768,1019,3473,193,701,69,212,262,913
522205,201905,1578,3741,1203,3222,115,334,836,2222,951,2556
522220,201905,1269,3319,954,2830,138,409,498,1502,636,1911
522230,201905,1114,2958,917,2665,218,760,470,1275,688,2035
530010,201905,154278,436836,128032,395307,23212,78784,69120,209605,92332,288389
110001,201906,3674,10666,2540,8499,660,2336,962,3242,1622,5578
110002,201906,11376,30581,8025,24762,2328,7629,2363,7372,4691,15001
110003,201906,631,1906,446,1503,123,444,96,309,219,753
110004,201906,9677,26745,6593,20938,1613,5513,1763,5784,3376,11297
110005,201906,2470,6561,1542,4852,358,1219,432,1458,790,2677
110006,201906,1781,5056,1084,3568,228,843,181,534,409,1377
110007,201906,1053,2965,795,2542,289,949,208,778,497,1727
110008,201906,3138,9032,2317,7750,267,863,1557,5481,1824,6344
110009,201906,4099,11842,2650,9116,682,2413,947,3354,1629,5767
110010,201906,6432,22013,4963,19151,1145,4335,2317,9906,3462,14241
110011,201906,6350,17556,4513,14169,1621,5253,726,2412,2347,7665
110012,201906,13993,36382,8575,26621,2215,7221,952,3157,3167,10378
110013,201906,5134,15408,3902,12877,1695,5752,553,2048,2248,7800
110014,201906,3665,10010,2505,7784,683,2180,929,2851,1612,5031
110015,201906,4928,13301,2776,8906,746,2561,422,1256,1168,3817
110018,201906,3444,8988,2043,6486,428,1528,569,1765,997,3293
110020,201906,73249,181232,50730,149259,11242,34122,20605,65279,31847,99401
110025,201906,4865,12130,3158,9121,689,2110,1396,3984,2085,6094
110026,201906,480,1320,359,1135,102,341,145,466,247,807
110028,201906,6149,16405,3899,12226,1081,3600,577,1800,1658,5400
110029,201906,1377,3399,791,2400,189,577,310,983,499,1560
110030,201906,12514,29710,7991,23128,1709,5738,2083,6366,3792,12104
110032,201906,2881,8527,1922,6463,628,2121,453,1568,1081,3689
110033,201906,3649,11840,2904,10410,1080,3939,677,2723,1757,6662
110034,201906,3323,8110,2200,6527,672,2128,865,2702,1537,4830
110037,201906,1605,5017,1266,4368,308,1064,563,1985,871,3049
110040,201906,2953,8494,2122,6922,650,2258,560,1783,1210,4041
110045,201906,4913,14542,3812,12541,1023,3646,1436,4740,2459,8386
110050,201906,1725,4944,1244,4031,518,1777,228,752,746,2529
110060,201906,775,2362,536,1827,216,766,67,237,283,1003
110070,201906,1671,5371,1287,4501,434,1622,264,846,698,2468
110080,201906,6013,14352,4367,12398,524,1374,2996,9028,3520,10402
110090,201906,576,1579,404,1268,102,349,160,486,262,835
110092,201906,1175,3546,858,2926,154,549,439,1573,593,2122
110094,201906,2736,8287,2091,7101,853,3016,453,1616,1306,4632
110100,201906,1681,5144,1376,4495,350,1196,633,2055,983,3251
110110,201906,1713,4904,1188,3947,405,1399,256,909,661,2308
110120,201906,1259,3812,946,3180,247,855,291,974,538,1829
110130,201906,2549,6647,1615,4928,359,1200,558,1698,917,2898
110140,201906,2029,6247,1426,4977,384,1373,364,1306,748,2679
110143,201906,1309,3608,887,2761,299,923,187,593,486,1516
110145,201906,854,2333,549,1760,140,466,181,604,321,1070
110146,201906,427,1155,295,949,57,176,144,494,201,670
110147,201906,766,2039,477,1433,73,234,187,481,260,715
110148,201906,799,2328,481,1647,124,466,51,175,175,641
110149,201906,2960,8402,2089,6996,794,2713,438,1624,1232,4337
110150,201906,2558,6546,1718,5353,560,1880,451,1578,1011,3458
110155,201906,654,2000,492,1615,117,400,165,519,282,919
110160,201906,1474,4679,1093,3821,344,1192,264,970,608,2162
110170,201906,2167,5731,1334,4071,266,850,664,1962,930,2812
110175,201906,1555,4519,1115,3744,194,689,503,1778,697,2467
110180,201906,1322,3744,895,2863,167,547,426,1346,593,1893
120001,201906,3099,9676,2619,8981,436,1467,1708,6076,2144,7543
120005,201906,1938,7446,1744,7146,155,721,1366,5675,1521,6396
120010,201906,5187,16038,4427,14813,513,1687,3130,10745,3643,12432
120013,201906,2161,7989,2004,7768,494,1833,1206,4969,1700,6802
120017,201906,2154,7159,1918,6795,322,1186,1202,4426,1524,5612
120020,201906,14533,59037,13551,57040,1219,5801,10440,44330,11659,50131
120025,201906,2936,8780,2415,8111,430,1474,1599,5495,2029,6969
120030,201906,6535,25797,6169,25119,411,2199,4892,19968,5303,22167
120032,201906,1650,7578,1581,7416,97,624,1307,6052,1404,6676
120033,201906,4079,15156,3808,14670,131,725,3280,12544,3411,13269
120034,201906,2614,9606,2229,8893,114,691,1810,7060,1924,7751
120035,201906,3474,14522,3305,14193,289,1396,2673,11568,2962,12964
120038,201906,2693,8858,2332,8251,550,2068,1227,4379,1777,6447
120039,201906,1962,8660,1836,8390,150,927,1439,6503,1589,7430
120040,201906,41907,137095,36883,128643,5922,21831,22761,80334,28683,102165
120042,201906,3388,12770,3084,12151,148,802,2491,9759,2639,10561
120043,201906,1402,5634,1274,5414,42,241,1139,4854,1181,5095
120045,201906,5988,16098,5267,15287,136,544,4820,13844,4956,14388
120050,201906,9203,33501,8423,32284,462,2361,6880,26420,7342,28781
120060,201906,9411,36899,8726,35826,413,2412,7510,30710,7923,33122
120070,201906,3074,10131,2686,9592,280,1035,1875,6961,2155,7996
120080,201906,4312,14396,3862,13672,578,2203,2639,9464,3217,11667
130002,201906,3095,12389,2766,11897,201,928,2340,10163,2541,11091
130006,201906,2351,8969,1933,8219,172,813,1440,6119,1612,6932
130008,201906,2550,9087,2288,8683,78,410,1939,7344,2017,7754
130010,201906,3920,11433,3308,10735,60,196,3085,10124,3145,10320
130014,201906,3023,9222,2373,8107,451,1562,1430,4996,1881,6558
130020,201906,2669,10658,2424,10264,150,889,1911,8061,2061,8950
130030,201906,9750,32247,8913,31263,249,946,7995,28423,8244,29369
130040,201906,3739,11365,3165,10583,169,587,2567,8650,2736,9237
130050,201906,7510,27744,6283,26155,185,965,5661,23768,5846,24733
130060,201906,7494,30115,6464,28738,531,3000,5159,22816,5690,25816
130063,201906,6161,20516,5506,19788,155,693,5056,18277,5211,18970
130068,201906,3548,13199,3066,12376,254,1414,2242,8866,2496,10280
130070,201906,7595,21913,6322,20492,290,953,5351,17695,5641,18648
130080,201906,6835,25875,6065,24932,297,1717,5039,20938,5336,22655
130083,201906,2658,8971,2408,8658,188,801,2028,7253,2216,8054
130090,201906,3441,10831,3065,10336,67,303,2655,9118,2722,9421
130100,201906,7682,23484,6593,22332,69,177,6156,21441,6225,21618
130110,201906,8349,24222,6940,22467,902,2397,5222,17993,6124,20390
130115,201906,5435,17206,4749,16390,108,435,4188,14627,4296,15062
130120,201906,14424,51938,13040,50111,1211,5148,10568,40931,11779,46079
130130,201906,5172,16974,4080,15542,447,1876,3071,11732,3518,13608
130140,201906,6924,24998,6356,24354,216,1150,5624,21609,5840,22759
130150,201906,3629,13714,3404,13442,98,616,3082,12171,3180,12787
130160,201906,5104,18431,4423,17548,316,1426,3676,14798,3992,16224
130165,201906,3235,12426,3069,12193,123,609,2739,10912,2862,11521
130170,201906,11688,35273,9479,32613,777,3095,7561,26099,8338,29194
130180,201906,4487,14209,4238,13929,40,217,4082,13384,4122,13601
130185,201906,18369,45553,14972,41901,879,1583,12817,37669,13696,39252
130190,201906,18971,63282,15491,58063,1905,7375,10821,41780,12726,49155
130195,201906,2415,8913,1962,8326,76,411,1739,7379,1815,7790
130200,201906,2530,7359,2112,6787,115,472,1728,5505,1843,5977
130210,201906,1306,4977,1175,4823,97,575,945,3787,1042,4362
130220,201906,2267,8116,2019,7761,74,378,1745,6728,1819,7106
130230,201906,4379,18618,3839,17837,285,1718,3209,14902,3494,16620
130240,201906,11668,35680,9535,32770,196,1146,8456,28972,8652,30118
130250,201906,25811,78604,22422,74769,1750,5483,18122,62682,19872,68165
130255,201906,4274,14676,3783,13789,182,840,3034,11056,3216,11896
130260,201906,254494,736096,211087,670904,58477,198330,96163,310549,154640,508879
130270,201906,8759,32584,7500,30584,1125,4636,5086,21486,6211,26122
130280,201906,3495,14126,3217,13816,103,500,2971,12940,3074,13440
130290,201906,13029,44119,11490,42220,622,2491,9920,37035,10542,39526
130300,201906,4701,16744,4293,16153,176,971,3664,13694,3840,14665
130310,201906,5947,20854,5264,19904,351,1558,4332,16490,4683,18048
130320,201906,3407,11245,2928,10653,325,1150,2238,8400,2563,9550
130330,201906,4595,14767,3749,13721,201,924,3200,11676,3401,12600
130340,201906,22647,73794,19730,70387,1543,5190,16328,60057,17871,65247
130350,201906,3924,14473,3549,13977,153,888,3080,12010,3233,12898
130353,201906,6862,19465,5662,17912,919,2819,3834,12580,4753,15399
130356,201906,5006,16590,4281,15412,672,2426,2739,10266,3411,12692
130360,201906,3150,9652,2698,9132,67,231,2500,8525,2567,8756
130370,201906,5683,22366,5029,21467,312,1612,4157,17689,4469,19301
130380,201906,7269,30533,6815,29855,415,2372,5724,24812,6139,27184
130390,201906,5984,25177,5274,23927,578,3124,3814,17242,4392,20366
130395,201906,2328,7559,2009,7018,206,769,1487,5171,1693,5940
130400,201906,2708,8719,2348,8238,109,377,2079,7407,2188,7784
130406,201906,10955,39522,9430,37559,1778,7169,6336,26030,8114,33199
130410,201906,4069,14729,3523,13799,1103,4482,1601,6524,2704,11006
130420,201906,13517,48265,11451,45721,1016,5177,8985,35849,10001,41026
130423,201906,4229,13574,3725,12990,181,891,3266,11216,3447,12107
130426,201906,2833,11142,2686,10933,85,452,2468,10080,2553,10532
130430,201906,4187,12217,3667,11501,325,1183,2934,9045,3259,10228
130440,201906,4790,15193,4187,14477,116,500,3849,13345,3965,13845
140002,201906,2228,6660,1940,6281,96,371,1625,5234,1721,5605
140005,201906,3194,9003,2887,8655,145,402,2508,7630,2653,8032
140010,201906,55531,148574,43798,130863,11270,35335,17437,53532,28707,88867
140015,201906,3494,10884,3033,10316,210,726,2615,9027,2825,9753
140017,201906,4007,11763,3529,11143,309,977,2748,8927,3057,9904
140020,201906,5177,15469,4430,14449,277,1183,3498,11330,3775,12513
140023,201906,2364,7190,1927,6568,222,806,1381,4773,1603,5579
140028,201906,2093,5420,1773,5001,114,371,1386,3867,1500,4238
140030,201906,5017,13245,4459,12581,328,730,3796,11026,4124,11756
140040,201906,2329,9572,2142,9289,110,684,1891,8053,2001,8737
140045,201906,2652,9718,2253,9153,402,1530,1500,6467,1902,7997
140047,201906,5765,16916,4898,15600,739,2512,3300,10609,4039,13121
140050,201906,1391,4162,1185,3855,146,495,844,2785,990,3280
140060,201906,1648,4443,1392,4061,133,354,1077,3220,1210,3574
140070,201906,1836,9716,1778,9567,144,972,1420,7540,1564,8512
150010,201906,45445,113950,41280,108560,999,2634,36696,96069,37695,98703
150013,201906,1947,5107,1611,4735,156,341,1227,3828,1383,4169
150020,201906,14146,43181,13228,41974,1139,2873,11181,36515,12320,39388
150030,201906,8621,32785,7906,31893,401,1919,6902,27915,7303,29834
150034,201906,4346,11029,3613,10078,265,714,2960,8402,3225,9116
150040,201906,16197,42083,14184,39827,1369,2293,11542,35400,12911,37693
150050,201906,6856,24332,6311,23557,143,664,5767,21689,5910,22353
150060,201906,21197,59195,17447,53535,2900,9060,10905,34246,13805,43306
150070,201906,6616,25290,5874,24390,201,1074,5281,22158,5482,23232
150080,201906,93949,214451,80006,195561,18777,49567,26204,77790,44981,127357
150085,201906,7127,21532,6545,20812,166,553,6078,19434,6244,19987
150090,201906,9970,37350,9382,36216,639,2765,7607,29445,8246,32210
150095,201906,5503,16645,4885,15842,276,693,4065,13703,4341,14396
150100,201906,3001,10628,2652,10013,203,765,2050,7819,2253,8584
150110,201906,4211,18070,4001,17810,219,1046,3620,16218,3839,17264
150120,201906,7739,24985,7472,24637,321,858,6613,22548,6934,23406
150125,201906,743,2055,562,1808,113,416,316,1001,429,1417
150130,201906,22906,66983,20048,62687,2796,7777,14169,46109,16965,53886
150140,201906,235925,559956,203729,515260,32541,80560,119455,315749,151996,396309
150145,201906,4460,13542,3809,12603,857,2597,2337,8321,3194,10918
150150,201906,15619,41091,13870,38853,716,2167,11473,32150,12189,34317
150157,201906,3356,9433,2785,8693,285,933,1989,6422,2274,7355
150160,201906,2943,9032,2755,8734,614,1928,1614,5283,2228,7211
150170,201906,24389,80983,21331,75774,4001,13477,12946,48907,16947,62384
150172,201906,4594,12910,3732,11686,264,754,2808,9066,3072,9820
150175,201906,1627,5144,1372,4654,250,896,810,2772,1060,3668
150178,201906,10467,29139,8749,27111,295,875,7605,23934,7900,24809
150180,201906,21414,78598,19878,76706,1002,3844,17427,68432,18429,72276
150190,201906,6793,23097,6375,22537,270,1202,5579,19638,5849,20840
150195,201906,5263,17144,5040,16812,87,468,4678,15441,4765,15909
150200,201906,5744,16987,5275,16472,63,167,4956,15616,5019,15783
150210,201906,25713,91339,24132,89087,1978,7266,19666,74375,21644,81641
150215,201906,7308,21350,6285,19847,1349,4203,3452,11432,4801,15635
150220,201906,11749,34407,10439,32491,1258,3854,6979,22129,8237,25983
150230,201906,12424,35807,10842,33695,1258,3631,7482,24235,8740,27866
150240,201906,32318,91246,26781,81596,8062,25015,8446,26336,16508,51351
150250,201906,4148,16553,3951,16283,565,2317,3026,12730,3591,15047
150260,201906,2629,8881,2421,8542,186,649,1867,6674,2053,7323
150270,201906,8767,25527,6222,21185,2041,7275,1911,6911,3952,14186
150275,201906,6753,21958,6244,21203,230,919,5403,18241,5633,19160
150276,201906,2271,6174,1943,5778,234,634,1350,4387,1584,5021
150277,201906,5259,13949,4287,12818,356,967,3302,10501,3658,11468
150280,201906,6541,27040,6340,26671,530,2238,5267,22388,5797,24626
150285,201906,3238,11531,2853,10929,294,1177,2015,7860,2309,9037
150290,201906,10667,29169,9767,28186,345,763,8789,25964,9134,26727
150293,201906,9553,24003,7104,20723,1230,3527,3994,12411,5224,15938
150295,201906,7896,21520,5739,18594,2012,7134,1864,6642,3876,13776
150300,201906,2307,7057,2069,6737,57,227,1843,6001,1900,6228
150304,201906,4043,12337,3353,11194,638,2030,2025,7046,2663,9076
150307,201906,6248,20250,5824,19573,403,1313,4749,16173,5152,17486
150309,201906,6218,19169,5016,17020,971,3222,2709,9624,3680,12846
150310,201906,7230,28553,6889,28139,234,1322,6074,25028,6308,26350
150320,201906,9520,25951,8674,24776,463,1423,6718,19149,7181,20572
150330,201906,13867,45471,12841,43732,1473,4773,9535,33385,11008,38158
150340,201906,2572,7536,2310,7148,335,943,1628,5189,1963,6132
150345,201906,7792,23412,7093,22478,395,1326,6067,19339,6462,20665
150350,201906,8914,23400,8225,22490,818,1580,6683,18990,7501,20570
150360,201906,23995,68052,19425,62126,2216,6274,13318,44996,15534,51270
150370,201906,10334,32807,8679,30507,981,3152,6345,23617,7326,26769
150375,201906,3348,13899,3031,13417,252,1238,2496,11134,2748,12372
150380,201906,10888,28593,9070,26151,202,727,7901,22805,8103,23532
150390,201906,7889,32256,7162,31041,1141,4525,4958,22687,6099,27212
150400,201906,6340,23212,6089,22724,285,1147,5265,19685,5550,20832
150405,201906,9139,24597,8132,23352,514,1183,6566,19521,7080,20704
150410,201906,1907,6179,1626,5682,206,687,1060,3781,1266,4468
150420,201906,41014,117683,31708,103354,9467,32321,10077,38042,19544,70363
150430,201906,8412,25012,7749,24122,854,2081,6049,19666,6903,21747
150440,201906,5548,18281,5179,17708,652,2042,3825,13475,4477,15517
150442,201906,25301,62907,21060,57288,2336,6208,14342,39904,16678,46112
150445,201906,6193,19427,5510,18363,233,809,4679,15656,4912,16465
150450,201906,5001,21859,4707,21451,378,1876,3982,18194,4360,20070
150460,201906,8404,27762,7771,26947,249,1024,6704,24025,6953,25049
150470,201906,21299,55554,18981,52901,521,1333,17581,49198,18102,50531
150475,201906,4652,15181,4110,14323,191,723,3394,11964,3585,12687
150480,201906,13706,45319,12342,43213,2174,7090,8277,30642,10451,37732
150490,201906,8105,28714,7591,28043,250,1128,6753,25053,7003,26181
150495,201906,5188,18302,5032,18056,119,598,4604,16433,4723,17031
150497,201906,2815,9213,2278,8246,560,2108,1128,4307,1688,6415
150500,201906,3305,8649,2947,8130,258,655,2292,6339,2550,6994
150503,201906,4559,12372,3235,10560,1010,3520,1012,3724,2022,7244
150506,201906,10178,31639,8752,29609,1863,5578,5518,20438,7381,26016
150510,201906,9876,36386,8619,33951,1175,4439,5804,23925,6979,28364
150520,201906,7254,27739,6934,27332,215,1250,6302,24735,6517,25985
150530,201906,12300,42242,10789,40060,1563,4731,7750,30567,9313,35298
150540,201906,4941,13758,4231,12682,158,469,3616,10813,3774,11282
150543,201906,7184,19573,5904,17924,612,1909,4323,13676,4935,15585
150548,201906,9930,31343,8990,30065,295,1052,7911,26580,8206,27632
150549,201906,2034,6160,1754,5777,48,205,1523,5009,1571,5214
150550,201906,19745,59227,16782,54278,4008,13222,7504,25876,11512,39098
150553,201906,24419,74837,19314,65511,6169,21410,6152,22706,12321,44116
150555,201906,1885,5150,1491,4523,134,328,1041,3260,1175,3588
150560,201906,1827,5668,1622,5258,280,860,928,3130,1208,3990
150563,201906,2484,7784,2122,7131,459,1639,1156,3863,1615,5502
150565,201906,4253,13897,3777,13115,113,543,3092,10776,3205,11319
150570,201906,6177,20398,5904,19982,268,1063,5113,17205,5381,18268
150580,201906,10173,41375,9177,40239,648,3253,7543,33919,8191,37172
150590,201906,7520,27130,6804,26215,220,1238,6131,23482,6351,24720
150600,201906,9366,31705,8747,30914,240,971,8025,28487,8265,29458
150610,201906,2805,8414,2520,7925,119,448,2074,6449,2193,6897
150611,201906,3116,9068,2805,8609,93,388,2466,7472,2559,7860
150613,201906,13245,37101,10063,31617,1853,6216,4955,15643,6808,21859
150616,201906,3322,9268,2436,7792,598,1984,950,3001,1548,4985
150618,201906,6894,20352,5579,18270,616,1943,3493,12001,4109,13944
150619,201906,6189,17962,5157,16423,199,795,4216,13420,4415,14215
150620,201906,6588,21998,5744,20623,774,2716,3984,14710,4758,17426
150630,201906,6124,16982,5637,16369,457,1228,4637,13723,5094,14951
150635,201906,4618,13064,3942,11949,573,1717,2509,7758,3082,9475
150640,201906,2202,6444,2016,6222,34,110,1879,5876,1913,5986
150650,201906,11433,32566,10120,30331,3114,8775,4431,14422,7545,23197
150655,201906,5842,16806,5292,15978,224,699,4527,13635,4751,14334
150658,201906,4455,12726,3530,11333,586,1979,2123,7142,2709,9121
150660,201906,5723,16620,5143,15782,527,1535,3554,11120,4081,12655
150670,201906,8275,19568,6516,17544,654,1500,5099,14362,5753,15862
150680,201906,66117,199301,50742,174574,12750,43355,22557,86652,35307,130007
150690,201906,2788,7695,2502,7330,124,307,2191,6539,2315,6846
150700,201906,6199,18626,5574,17811,395,1152,4413,14431,4808,15583
150710,201906,3760,12639,3452,12133,255,933,2665,9486,2920,10419
150715,201906,5106,15080,4273,13763,362,1125,3318,10860,3680,11985
150720,201906,6806,24872,6361,24111,436,1850,5255,19991,5691,21841
150730,201906,11458,36019,10059,33906,1125,3962,7592,26079,8717,30041
150740,201906,3913,11150,3463,10400,350,906,2562,7858,2912,8764
150745,201906,5154,14900,4166,13417,846,2876,2634,8526,3480,11402
150746,201906,1626,5117,1491,4905,84,265,1220,4026,1304,4291
150747,201906,4826,15697,4301,14814,756,2321,2823,10239,3579,12560
150750,201906,3679,11676,3106,10764,232,848,2361,8384,2593,9232
150760,201906,11963,35313,10910,33915,1415,4089,7882,25131,9297,29220
150770,201906,6282,22980,6013,22644,209,687,5492,21255,5701,21942
150775,201906,898,2639,717,2371,135,500,390,1292,525,1792
150780,201906,4561,13733,4114,13193,122,339,3750,12249,3872,12588
150790,201906,5570,16284,4880,15535,218,543,4045,13988,4263,14531
150795,201906,13384,43038,12117,40932,3154,10100,6788,24465,9942,34565
150796,201906,3705,9440,3230,8867,181,460,2733,7587,2914,8047
150797,201906,3923,12368,3390,11565,146,432,2828,9801,2974,10233
150800,201906,13250,42265,12239,40971,1547,4766,9334,32324,10881,37090
150803,201906,6961,23009,6568,22399,366,1274,5612,19234,5978,20508
150805,201906,3454,10843,2938,10042,258,910,2238,7747,2496,8657
150808,201906,6130,17705,4474,14909,1699,6162,610,2278,2309,8440
150810,201906,20781,56398,15918,50428,3293,10591,8317,28580,11610,39171
150812,201906,5469,15676,4842,14570,460,1461,3546,10460,4006,11921
150815,201906,9195,28110,7867,26429,706,2354,6272,21427,6978,23781
150820,201906,11918,32880,10063,30600,1007,2690,7749,24407,8756,27097
150830,201906,11441,43264,10872,42540,394,2005,9478,37688,9872,39693
150835,201906,2209,7540,1937,7032,376,1350,992,3627,1368,4977
150840,201906,7313,21412,5819,18793,1098,3780,2976,9502,4074,13282
160005,201906,1176,3243,1060,3080,41,142,943,2727,984,2869
160010,201906,2446,6311,2322,6180,20,100,2255,5930,2275,6030
160015,201906,2503,7736,2284,7443,77,263,2087,6822,2164,7085
160020,201906,2012,6737,1784,6428,215,791,1366,4980,1581,5771
160021,201906,1098,4336,1021,4227,78,454,820,3302,898,3756
160023,201906,1248,4440,1102,4193,110,386,792,3163,902,3549
160025,201906,1953,5597,1887,5517,15,48,1852,5421,1867,5469
160027,201906,8745,24612,7903,23558,582,1655,6452,19552,7034,21207
160030,201906,65806,191909,53779,175796,11867,36849,28819,103475,40686,140324
160040,201906,5410,19028,4942,18402,100,491,4560,17043,4660,17534
160050,201906,4560,14541,3670,13253,1470,5043,1278,5664,2748,10707
160053,201906,3681,11809,3400,11446,274,868,2795,9639,3069,10507
160055,201906,860,2637,838,2612,28,98,787,2441,815,2539
160060,201906,23445,64820,19497,60240,1067,3411,15560,50114,16627,53525
160070,201906,2878,10926,2593,10457,201,783,2043,8499,2244,9282
160080,201906,3156,10434,2898,10132,58,304,2631,9241,2689,9545
170025,201906,613,1666,451,1426,88,273,237,762,325,1035
170030,201906,1185,3660,897,3103,155,524,424,1498,579,2022
170035,201906,1484,3868,1068,3181,102,331,626,1867,728,2198
170040,201906,1819,5332,1447,4811,110,425,854,2968,964,3393
170070,201906,1787,4251,1250,3567,87,295,737,2140,824,2435
170100,201906,2441,7088,2008,6343,174,519,1312,4218,1486,4737
170105,201906,738,2160,504,1646,125,372,178,588,303,960
170110,201906,927,2922,709,2496,122,468,299,1043,421,1511
170130,201906,1328,4064,944,3302,185,659,437,1587,622,2246
170190,201906,1393,4013,944,3256,326,1131,172,786,498,1917
170200,201906,1834,4582,1121,3363,241,779,344,1029,585,1808
170210,201906,24592,68254,18696,58079,6671,22359,1985,7299,8656,29658
170215,201906,1324,3619,1099,3314,55,230,841,2519,896,2749
170220,201906,5883,18459,4954,16705,1265,4058,2209,8051,3474,12109
170230,201906,1274,3835,959,3189,269,903,188,675,457,1578
170240,201906,2677,7583,2053,6576,166,659,1385,4292,1551,4951
170255,201906,4025,11847,2814,9512,517,1814,1251,4353,1768,6167
170270,201906,1000,2454,646,1951,23,74,407,1217,430,1291
170290,201906,2954,8686,2519,8157,118,369,2014,6772,2132,7141
170300,201906,1925,5394,1571,4846,186,605,1042,3250,1228,3855
170305,201906,701,1982,552,1707,67,236,267,799,334,1035
170307,201906,943,3266,762,2894,114,462,416,1596,530,2058
170310,201906,1629,4169,1123,3322,190,621,504,1494,694,2115
170320,201906,1052,2767,782,2341,69,227,491,1475,560,1702
170330,201906,918,2860,822,2704,47,213,665,2125,712,2338
170360,201906,474,1316,331,1065,32,118,204,615,236,733
170370,201906,1297,3507,925,2880,293,878,230,832,523,1710
170380,201906,1776,5245,1319,4518,118,445,722,2558,840,3003
170382,201906,550,1690,444,1496,45,195,305,983,350,1178
170384,201906,1566,5740,1274,5152,290,1215,592,2431,882,3646
170386,201906,861,2389,534,1739,73,295,176,513,249,808
170388,201906,631,1814,448,1483,63,243,200,657,263,900
170389,201906,1046,3411,895,3147,46,200,692,2464,738,2664
170390,201906,1646,3873,1214,3335,74,187,952,2690,1026,2877
170410,201906,556,1659,398,1351,21,95,256,856,277,951
170460,201906,377,1018,297,881,44,130,179,539,223,669
170510,201906,898,2685,645,2191,53,226,391,1274,444,1500
170550,201906,6541,17820,4708,14716,1267,4259,1044,3478,2311,7737
170555,201906,1327,3736,1037,3270,61,209,547,1784,608,1993
170560,201906,1047,2999,776,2601,76,297,463,1669,539,1966
170600,201906,1335,3673,1071,3275,221,528,611,2051,832,2579
170610,201906,1752,4772,1263,3989,78,282,770,2398,848,2680
170625,201906,431,1199,261,830,31,92,89,276,120,368
170650,201906,1295,3918,1004,3415,157,538,518,1840,675,2378
170700,201906,3397,10084,2547,8470,507,1730,1109,3772,1616,5502
170710,201906,1531,4117,1158,3468,173,569,675,1997,848,2566
170720,201906,1840,4690,1462,4129,82,180,1106,3255,1188,3435
170730,201906,1022,2857,752,2410,157,475,333,1135,490,1610
170740,201906,2069,6979,1759,6379,220,842,1177,4264,1397,5106
170755,201906,870,2486,598,1969,58,215,287,915,345,1130
170765,201906,1230,3224,839,2595,179,560,347,1122,526,1682
170770,201906,1799,5372,1496,4875,196,594,956,3212,1152,3806
170820,201906,3436,10793,2829,9651,481,1717,1425,4991,1906,6708
170825,201906,961,2311,773,2043,83,221,535,1423,618,1644
170830,201906,1392,3802,1146,3408,26,99,913,2705,939,2804
170900,201906,2664,8723,2277,8117,196,769,1754,6341,1950,7110
170930,201906,3682,10323,2847,8797,642,2098,1073,3286,1715,5384
170950,201906,11192,31448,7694,25082,2257,8305,985,3444,3242,11749
170980,201906,429,1208,343,1067,17,83,245,712,262,795
171050,201906,1580,5119,1371,4722,53,260,1113,3799,1166,4059
171070,201906,1337,3947,1141,3652,275,873,566,2018,841,2891
171090,201906,1041,2603,836,2303,75,203,572,1588,647,1791
171110,201906,569,1588,406,1279,60,210,188,527,248,737
171150,201906,1085,2745,642,1966,82,282,384,1160,466,1442
171180,201906,760,2133,496,1615,85,261,201,678,286,939
171190,201906,1666,5839,1463,5467,248,983,865,3298,1113,4281
171195,201906,827,2714,680,2431,105,434,403,1412,508,1846
171200,201906,539,1569,404,1322,77,265,180,589,257,854
171215,201906,384,1100,300,950,50,176,175,535,225,711
171240,201906,753,2581,619,2305,41,207,400,1478,441,1685
171245,201906,638,1956,490,1631,49,187,288,919,337,1106
171250,201906,1072,2835,769,2357,137,440,381,1176,518,1616
171270,201906,384,1520,329,1383,73,327,126,576,199,903
171280,201906,856,2608,665,2263,89,283,367,1316,456,1599
171320,201906,4013,11444,3120,9872,622,1965,1257,4153,1879,6118
171330,201906,2693,7439,2071,6377,429,1263,973,3107,1402,4370
171360,201906,1437,4256,1165,3858,90,335,826,2782,916,3117
171370,201906,671,1757,523,1547,56,172,349,1052,405,1224
171380,201906,1490,4343,1237,3958,108,316,861,2850,969,3166
171395,201906,953,2768,640,2135,67,248,361,1174,428,1422
171420,201906,1909,5798,1380,4721,238,907,605,2066,843,2973
171430,201906,1036,3109,858,2751,71,273,572,1767,643,2040
171488,201906,2338,7002,1804,6090,303,1067,870,3027,1173,4094
171500,201906,974,2461,738,2089,42,121,548,1552,590,1673
171510,201906,774,2636,679,2441,47,211,467,1662,514,1873
171515,201906,466,1268,337,1049,37,153,199,579,236,732
171525,201906,658,1949,520,1704,38,164,314,953,352,1117
171550,201906,341,1007,243,836,34,146,135,438,169,584
171570,201906,1118,3416,929,3063,159,523,523,1778,682,2301
171575,201906,1810,4849,1131,3597,150,495,488,1533,638,2028
171610,201906,5764,16438,4302,13931,973,3467,1190,4102,2163,7569
171620,201906,2673,7638,2249,7011,129,501,1763,5490,1892,5991
171630,201906,976,2688,786,2417,124,390,511,1616,635,2006
171650,201906,2093,6112,1569,5153,405,1424,473,1653,878,3077
171660,201906,2344,6078,1612,4813,247,719,822,2485,1069,3204
171665,201906,1332,3791,1000,3234,167,630,465,1519,632,2149
171670,201906,1841,5018,1409,4299,211,727,793,2370,1004,3097
171700,201906,1210,3509,885,2927,113,365,495,1639,608,2004
171720,201906,816,2137,628,1828,58,197,444,1271,502,1468
171750,201906,1260,3604,877,2889,215,723,128,515,343,1238
171780,201906,1218,3162,882,2667,70,246,609,1802,679,2048
171790,201906,1432,4827,1147,4211,240,897,508,1935,748,2832
171800,201906,745,2091,553,1788,68,269,309,988,377,1257
171820,201906,11053,31525,8219,26491,1977,6606,2693,9250,4670,15856
171830,201906,1486,4991,1248,4547,125,561,793,2840,918,3401
171840,201906,746,2017,590,1772,29,85,398,1191,427,1276
171845,201906,631,1628,459,1374,60,221,260,775,320,996
171850,201906,858,2967,731,2674,71,337,517,1817,588,2154
171855,201906,1057,3271,901,2981,75,244,566,1841,641,2085
171865,201906,385,1238,313,1109,51,197,151,505,202,702
171870,201906,782,2225,546,1775,59,192,290,972,349,1164
171875,201906,1261,3797,1011,3385,53,234,748,2471,801,2705
171880,201906,1124,3537,998,3360,33,131,805,2741,838,2872
171884,201906,830,2308,606,1944,114,433,224,768,338,1201
171886,201906,1440,4090,1010,3334,291,1036,201,686,492,1722
171888,201906,742,2104,502,1646,36,125,312,1011,348,1136
171889,201906,418,1309,353,1192,75,273,146,497,221,770
171890,201906,1142,3199,844,2709,180,536,453,1508,633,2044
171900,201906,510,1787,356,1385,82,321,132,535,214,856
172000,201906,578,1790,482,1595,47,178,281,892,328,1070
172010,201906,1055,3681,893,3334,84,388,546,1959,630,2347
172015,201906,358,1280,266,1084,65,259,107,466,172,725
172020,201906,2469,7360,2210,7013,168,640,1658,5338,1826,5978
172025,201906,748,2077,541,1735,41,158,360,1149,401,1307
172030,201906,1233,3685,1055,3407,37,158,839,2699,876,2857
172049,201906,1285,3151,857,2527,205,590,451,1404,656,1994
172065,201906,1501,3737,1171,3334,109,229,948,2864,1057,3093
172080,201906,2316,6999,1877,6175,126,480,1237,4050,1363,4530
172085,201906,474,1324,301,944,53,159,106,316,159,475
172090,201906,3970,10236,3041,8978,134,470,2297,6792,2431,7262
172093,201906,489,1455,353,1205,34,138,190,624,224,762
172097,201906,604,1639,434,1347,60,184,212,675,272,859
172100,201906,49387,124593,33341,98134,6529,21143,10915,32963,17444,54106
172110,201906,1616,6014,1396,5659,161,666,1009,4299,1170,4965
172120,201906,4857,14707,3842,13018,556,1913,2104,7383,2660,9296
172125,201906,300,846,221,711,23,80,119,373,142,453
172130,201906,706,1915,581,1714,27,97,417,1187,444,1284
172208,201906,2482,6292,1994,5636,196,498,1388,4012,1584,4510
172210,201906,2747,7274,2087,6417,417,1333,1094,3477,1511,4810
210005,201906,19486,57326,15246,50273,4524,15483,5731,19719,10255,35202
210010,201906,1920,5969,1736,5713,65,289,1482,4915,1547,5204
210015,201906,3355,10084,2981,9570,125,337,2568,8391,2693,8728
210020,201906,7488,17260,6518,16133,83,229,6051,14980,6134,15209
210030,201906,4784,16015,4494,15585,199,957,3900,13430,4099,14387
210040,201906,1898,4684,1716,4464,28,48,1599,4213,1627,4261
210043,201906,6441,18093,5316,16625,561,1719,3936,12670,4497,14389
210047,201906,6635,21349,5565,19822,178,879,4803,17042,4981,17921
210050,201906,2272,7787,1783,6875,198,877,1187,4543,1385,5420
210055,201906,1851,6050,1692,5784,67,277,1425,4840,1492,5117
210060,201906,7088,26548,6304,25068,796,3277,4331,17755,5127,21032
210070,201906,7234,20567,6827,20074,41,154,6520,19260,6561,19414
210080,201906,4092,14107,3920,13904,40,240,3694,13167,3734,13407
210083,201906,5603,16220,4643,15198,64,342,4374,14260,4438,14602
210087,201906,3007,8325,2645,7843,122,301,2249,6853,2371,7154
210090,201906,9475,29756,8880,28712,376,1253,7728,24934,8104,26187
210095,201906,6309,20686,5841,20115,250,1062,4901,17340,5151,18402
210100,201906,6812,20821,6159,19784,310,1104,5049,16234,5359,17338
210110,201906,3089,10934,2884,10668,66,471,2651,9657,2717,10128
210120,201906,22821,63733,19210,58991,2209,5742,12875,41924,15084,47666
210125,201906,4263,11859,3792,11266,776,1854,2670,8508,3446,10362
210130,201906,4308,11601,3589,10668,149,372,3057,9141,3206,9513
210135,201906,1465,4462,1278,4158,64,218,1033,3398,1097,3616
210140,201906,17689,48875,13846,43817,2709,8418,7727,25504,10436,33922
210150,201906,4488,10965,3977,10236,124,341,3461,8797,3585,9138
210160,201906,16450,49163,14466,46522,1346,4518,10281,34090,11627,38608
210170,201906,14883,47345,13912,46046,709,2301,12217,40603,12926,42904
210173,201906,2325,8780,2135,8439,67,428,1910,7525,1977,7953
210177,201906,3339,9378,2995,8949,109,202,2695,8333,2804,8535
210180,201906,1472,4042,1305,3822,36,107,1167,3403,1203,3510
210190,201906,5051,14455,4435,13531,93,476,3764,11234,3857,11710
210193,201906,1257,3788,1122,3573,39,149,892,2884,931,3033
210197,201906,1992,6508,1856,6307,156,541,1499,5182,1655,5723
210200,201906,7542,24740,6859,23614,561,2027,5446,18872,6007,20899
210203,201906,6986,20956,6109,19760,492,1655,4907,16103,5399,17758
210207,201906,3422,9424,2998,8905,148,361,2483,7561,2631,7922
210210,201906,8215,26835,7621,26026,126,749,6984,23739,7110,24488
210215,201906,2232,7404,2025,7096,62,316,1794,6262,1856,6578
210220,201906,6111,21286,5795,20786,224,1366,5015,17564,5239,18930
210230,201906,5205,15936,4716,15207,342,908,3999,13164,4341,14072
210232,201906,11429,36489,9473,33576,1538,5552,6018,22672,7556,28224
210235,201906,3482,10385,3041,9789,76,346,2683,8651,2759,8997
210237,201906,2567,8894,2338,8601,32,184,2169,7984,2201,8168
210240,201906,2681,8516,2466,8141,86,363,2133,6950,2219,7313
210250,201906,5566,17175,5099,16587,78,441,4549,14764,4627,15205
210255,201906,2518,7827,2138,7109,241,832,1409,4637,1650,5469
210260,201906,5461,16599,4838,15665,256,954,4088,13186,4344,14140
210270,201906,4795,13501,4298,12849,99,494,3842,11368,3941,11862
210275,201906,3611,9105,3206,8608,48,114,2950,8015,2998,8129
210280,201906,5526,16129,4450,14415,295,1273,3176,10047,3471,11320
210290,201906,7032,19668,6385,18850,142,449,5800,17122,5942,17571
210300,201906,33596,91939,27703,83775,1862,5780,20481,64258,22343,70038
210310,201906,3047,7940,2690,7415,122,292,2333,6472,2455,6764
210312,201906,2666,6981,2351,6624,46,190,2155,5991,2201,6181
210315,201906,3025,8474,2571,7947,75,199,2321,7337,2396,7536
210317,201906,4111,13115,3765,12708,122,621,3376,11306,3498,11927
210320,201906,19023,58800,17465,56717,462,2216,15384,49690,15846,51906
210325,201906,3471,10194,3054,9639,84,295,2741,8760,2825,9055
210330,201906,24137,71215,20623,66306,5764,16982,10273,37454,16037,54436
210340,201906,9945,30215,8981,28787,759,2474,6862,22442,7621,24916
210350,201906,9437,27463,8291,26040,170,657,7279,22959,7449,23616
210355,201906,4311,14811,3807,14013,117,603,3251,12027,3368,12630
210360,201906,13425,42285,12100,40352,551,2484,9641,31715,10192,34199
210370,201906,10616,24211,8333,21778,243,450,7593,20297,7836,20747
210375,201906,3273,8810,2481,7754,611,1934,1191,4095,1802,6029
210380,201906,5533,14472,4840,13622,236,592,4107,11641,4343,12233
210390,201906,2545,9260,2381,8949,130,629,1960,7308,2090,7937
210400,201906,4459,13973,4015,13415,150,485,3562,12010,3712,12495
210405,201906,7095,19407,5730,17444,1056,3048,3224,10404,4280,13452
210407,201906,1983,6638,1648,5995,86,384,1318,4728,1404,5112
210408,201906,2453,9359,2308,9127,145,741,1853,7337,1998,8078
210409,201906,3768,13169,3467,12753,112,629,2863,10529,2975,11158
210410,201906,3510,10904,2982,9998,210,791,2182,7284,2392,8075
210420,201906,3962,12712,3571,12029,202,623,2981,10142,3183,10765
210430,201906,2281,6670,2058,6391,89,260,1812,5654,1901,5914
210440,201906,4170,11699,3790,11177,67,259,3518,10322,3585,10581
210450,201906,2483,7525,2179,7052,106,393,1796,5791,1902,6184
210455,201906,4209,11230,3217,9963,914,2794,1583,5130,2497,7924
210460,201906,3548,10489,3086,9871,83,362,2695,8565,2778,8927
210462,201906,1568,4987,1370,4655,38,178,1104,3735,1142,3913
210465,201906,2611,7724,2298,7282,67,257,1992,6312,2059,6569
210467,201906,5667,18870,5135,18160,297,1234,4379,15573,4676,16807
210470,201906,2102,5515,1443,4563,84,199,1082,3549,1166,3748
210480,201906,15920,47939,13403,44770,1253,3841,9832,34971,11085,38812
210490,201906,3726,9510,3031,8523,80,248,2614,7340,2694,7588
210500,201906,6177,24417,5793,23730,360,1874,4722,19123,5082,20997
210510,201906,6024,20402,5395,19697,120,586,4815,17802,4935,18388
210515,201906,3785,11030,3297,10490,108,388,2891,9274,2999,9662
210520,201906,2509,7250,2277,6955,80,302,2005,6052,2085,6354
210530,201906,54270,133016,42677,115772,6865,23475,11482,39788,18347,63263
210535,201906,3095,10570,2880,10230,110,446,2429,8692,2539,9138
210540,201906,14428,42487,12139,39338,1448,4442,8564,28845,10012,33287
210542,201906,6364,15366,5236,14104,370,658,4372,12505,4742,13163
210545,201906,2236,7033,2107,6810,50,210,1852,5902,1902,6112
210547,201906,3542,12759,3132,11942,302,1150,2266,8887,2568,10037
210550,201906,6198,18821,5000,16957,338,1286,3759,13049,4097,14335
210560,201906,3499,10874,3163,10317,119,410,2666,8652,2785,9062
210565,201906,1473,4980,1233,4610,67,350,962,3642,1029,3992
210570,201906,10751,29678,9602,28290,310,922,8542,25509,8852,26431
210580,201906,2977,8185,2553,7677,193,365,2051,6501,2244,6866
210590,201906,4303,13035,3771,12321,87,449,3334,10843,3421,11292
210592,201906,2589,7691,2401,7367,29,141,2161,6559,2190,6700
210594,201906,2554,6940,1971,6042,90,241,1467,4643,1557,4884
210596,201906,2488,8930,2231,8398,147,601,1769,6719,1916,7320
210598,201906,1876,5433,1723,5208,33,145,1568,4710,1601,4855
210600,201906,3025,8215,2451,7382,76,200,1996,6125,2072,6325
210610,201906,2604,7582,2272,7171,69,330,1951,6096,2020,6426
210620,201906,2622,7280,2236,6808,49,146,2042,6339,2091,6485
210630,201906,3080,10494,2803,10051,140,710,2290,8064,2430,8774
210632,201906,4359,14329,3904,13661,267,1150,3045,10547,3312,11697
210635,201906,1789,6367,1685,6182,142,507,1367,5129,1509,5636
210637,201906,2314,7935,2077,7580,166,725,1557,5720,1723,6445
210640,201906,4687,16878,4450,16590,53,279,4211,15668,4264,15947
210650,201906,7321,20973,6695,20155,83,366,6214,18717,6297,19083
210660,201906,8256,24335,7310,22825,295,1117,6293,19435,6588,20552
210663,201906,2574,7714,2413,7527,115,285,2104,6739,2219,7024
210667,201906,1890,6227,1764,6039,49,201,1591,5485,1640,5686
210670,201906,4500,15521,4147,14949,143,712,3567,12760,3710,13472
210675,201906,5043,13840,4382,12949,238,586,3658,11065,3896,11651
210680,201906,4206,10783,3561,9981,123,225,3159,9068,3282,9293
210690,201906,7468,23799,6624,22824,266,1210,5796,20031,6062,21241
210700,201906,2732,7490,2215,6804,148,408,1711,5544,1859,5952
210710,201906,5037,15786,4436,14895,120,623,3875,12877,3995,13500
210720,201906,2842,9489,2639,9235,53,301,2384,8291,2437,8592
210725,201906,1348,4580,1161,4285,46,200,804,3079,850,3279
210730,201906,1202,3242,1008,2972,68,178,803,2392,871,2570
210735,201906,4620,13890,3971,12995,266,866,3317,11084,3583,11950
210740,201906,5306,14385,4651,13657,118,424,3862,11265,3980,11689
210745,201906,4486,12421,4155,11980,138,377,3755,10860,3893,11237
210750,201906,22486,57537,19690,54073,1561,4135,13837,39927,15398,44062
210760,201906,5809,15603,5088,14829,31,98,4841,14196,4872,14294
210770,201906,6110,15898,5281,14952,49,212,4949,13966,4998,14178
210780,201906,7152,23446,6394,22139,561,1764,5001,17680,5562,19444
210790,201906,4414,13902,4045,13426,228,669,3217,11287,3445,11956
210800,201906,4983,13333,4275,12389,69,274,3842,10990,3911,11264
210805,201906,3919,14448,3767,14219,116,640,3348,12535,3464,13175
210810,201906,4919,14589,4505,14048,214,504,3857,12366,4071,12870
210820,201906,7051,20327,5962,18548,760,2381,3675,11702,4435,14083
210825,201906,6707,20920,6161,20200,245,858,5340,17692,5585,18550
210830,201906,7609,21925,7115,21317,435,1022,6117,18830,6552,19852
210840,201906,3217,8612,2887,8146,88,296,2522,6997,2610,7293
210845,201906,6464,17649,5871,16995,27,91,5701,16546,5728,16637
210850,201906,5868,20280,5045,18998,276,1361,3925,14789,4201,16150
210860,201906,20371,53658,17259,49675,775,2046,14037,42204,14812,44250
210870,201906,6838,18867,5809,17611,233,707,5039,15312,5272,16019
210880,201906,4391,13514,3969,13025,225,850,3266,10727,3491,11577
210890,201906,4023,12081,3642,11623,242,634,2967,9785,3209,10419
210900,201906,4567,13497,3514,11565,1416,4946,574,2112,1990,7058
210905,201906,1931,5450,1633,5048,50,98,1472,4653,1522,4751
210910,201906,7278,22309,6191,20567,833,2866,4088,13620,4921,16486
210920,201906,3279,10835,2855,10263,82,457,2537,9036,2619,9493
210923,201906,1431,4479,1274,4219,58,220,964,3190,1022,3410
210927,201906,5221,16493,4607,15791,189,709,3950,13757,4139,14466
210930,201906,2466,8603,2218,8148,160,733,1703,6171,1863,6904
210940,201906,3983,11472,3746,11179,124,508,3404,10016,3528,10524
210945,201906,6131,18222,5627,17618,246,748,4829,15346,5075,16094
210950,201906,5118,14791,3989,13150,603,1650,2641,9307,3244,10957
210955,201906,1556,5041,1380,4734,144,489,987,3448,1131,3937
210960,201906,8872,26981,7786,25361,1270,3759,5017,17264,6287,21023
210970,201906,1276,4029,1034,3615,60,267,782,2656,842,2923
210975,201906,1679,5430,1509,5139,100,354,1192,4076,1292,4430
210980,201906,10186,23483,8930,22192,106,222,8466,21173,8572,21395
210990,201906,15303,44547,12383,40673,833,3019,9414,31277,10247,34296
211000,201906,14373,43315,12302,40887,620,2434,10040,34132,10660,36566
211003,201906,5454,16821,4658,15839,136,522,4026,14000,4162,14522
211010,201906,6358,22920,5756,22148,86,514,5211,20220,5297,20734
211020,201906,7710,23889,7090,23138,252,1055,6137,20059,6389,21114
211023,201906,1982,6619,1893,6494,98,402,1594,5416,1692,5818
211027,201906,2911,9572,2814,9409,165,628,2460,8130,2625,8758
211030,201906,3876,10859,3485,10380,248,573,2840,8712,3088,9285
211040,201906,4539,16577,4242,16065,132,777,3744,14041,3876,14818
211050,201906,9248,23955,8430,22904,149,400,7759,21093,7908,21493
211060,201906,6883,21409,6372,20714,152,611,5856,19030,6008,19641
211065,201906,2133,6123,1794,5665,87,277,1484,4777,1571,5054
211070,201906,7302,24166,6372,22697,498,1825,4987,17906,5485,19731
211080,201906,1290,3628,1034,3223,35,193,796,2338,831,2531
211085,201906,1984,5809,1721,5449,87,226,1496,4840,1583,5066
211090,201906,3243,9016,2918,8601,39,200,2657,7758,2696,7958
211100,201906,6679,17106,6215,16522,45,136,5708,15241,5753,15377
211102,201906,2976,10524,2757,10191,148,714,2365,8646,2513,9360
211105,201906,2346,7559,1962,6820,191,686,1376,4755,1567,5441
211107,201906,4509,14436,3907,13538,151,632,3184,11271,3335,11903
211110,201906,5929,16541,4610,14522,450,1308,3278,10564,3728,11872
211120,201906,41778,107226,37036,101736,4855,12380,24044,70603,28899,82983
211125,201906,2013,6084,1707,5607,46,179,1431,4712,1477,4891
211130,201906,193898,469106,175326,445515,25384,64872,76210,221984,101594,286856
211140,201906,4940,14938,4374,14163,199,624,3733,12109,3932,12733
211150,201906,9371,26082,8057,24349,335,1034,6773,20592,7108,21626
211153,201906,2550,7481,2055,6859,297,1042,1359,4742,1656,5784
211157,201906,1082,3473,901,3149,35,191,648,2239,683,2430
211160,201906,3910,11546,3147,10365,164,698,2345,7570,2509,8268
211163,201906,1716,5461,1577,5262,21,104,1439,4866,1460,4970
211167,201906,1555,5005,1455,4845,35,167,1330,4386,1365,4553
211170,201906,6325,15745,5957,15319,45,156,5668,14518,5713,14674
211172,201906,2431,6751,2095,6227,97,305,1711,4940,1808,5245
211174,201906,2804,8360,2578,8084,58,298,2339,7281,2397,7579
211176,201906,4265,12382,3321,10998,181,746,2606,8587,2787,9333
211178,201906,4671,10952,4033,10242,34,142,3794,9544,3828,9686
211180,201906,3994,13372,3714,12948,195,786,3165,11029,3360,11815
211190,201906,3030,9091,2614,8451,39,210,2256,7227,2295,7437
211195,201906,1345,3917,1156,3630,49,128,975,3122,1024,3250
211200,201906,2108,6214,1715,5691,207,704,1187,4003,1394,4707
211210,201906,6468,19813,5882,19040,273,1033,5068,16333,5341,17366
211220,201906,35798,92878,29728,85343,2872,8057,21867,64251,24739,72308
211223,201906,4941,13599,4300,12694,445,1274,3166,9460,3611,10734
211227,201906,1749,5927,1594,5697,40,197,1396,5052,1436,5249
211230,201906,7132,21677,6379,20495,402,1212,5140,16700,5542,17912
211240,201906,8161,26267,7681,25633,158,856,7019,23172,7177,24028
211245,201906,6700,17316,6265,16867,81,219,6083,16392,6164,16611
211250,201906,13282,40765,12086,39282,490,2128,10216,32771,10706,34899
211260,201906,7793,25624,7123,24700,201,909,6411,22322,6612,23231
211270,201906,10318,33533,9030,31750,389,1810,7422,26144,7811,27954
211280,201906,12822,36293,11468,34575,952,2347,9180,28880,10132,31227
211285,201906,1738,5926,1532,5607,188,736,983,3682,1171,4418
211290,201906,7261,22536,6722,21765,174,780,5796,18624,5970,19404
211300,201906,8054,22875,7230,21776,149,532,6544,19638,6693,20170
211400,201906,11226,33001,9285,30248,1233,4033,6062,20740,7295,24773
220005,201906,1805,4891,1646,4655,40,159,1363,3778,1403,3937
220010,201906,1480,4249,1234,3811,31,135,955,2904,986,3039
220020,201906,3434,9983,3021,9340,198,706,2375,7222,2573,7928
220025,201906,2219,5106,1893,4606,27,75,1594,3770,1621,3845
220027,201906,1253,3234,1083,3012,25,83,899,2450,924,2533
220030,201906,3302,8550,3126,8302,91,273,2741,7149,2832,7422
220040,201906,6917,21214,6173,19806,1326,3969,3545,11829,4871,15798
220045,201906,1468,4546,1230,4127,35,180,984,3235,1019,3415
220050,201906,4573,12805,3898,11844,86,417,3505,10485,3591,10902
220060,201906,2394,5099,2021,4668,23,57,1892,4349,1915,4406
220070,201906,2498,6403,2138,5873,79,169,1755,4823,1834,4992
220080,201906,700,1992,600,1842,28,115,514,1542,542,1657
220090,201906,1783,4360,1478,3940,21,81,1243,3394,1264,3475
220095,201906,644,1668,610,1630,17,28,556,1491,573,1519
220100,201906,1372,3842,1110,3401,49,183,879,2614,928,2797
220105,201906,2004,6315,1748,5781,144,481,1307,4345,1451,4826
220110,201906,3420,9490,3202,9084,45,221,2860,7987,2905,8208
220115,201906,2678,8020,2480,7724,65,264,2233,6845,2298,7109
220117,201906,1350,3297,1044,2863,13,54,882,2373,895,2427
220120,201906,12322,34158,11323,32898,104,401,10611,30770,10715,31171
220130,201906,1092,3021,913,2770,13,86,818,2426,831,2512
220140,201906,2007,4320,1736,3991,135,362,1482,3324,1617,3686
220150,201906,6396,19126,5959,18425,137,679,5035,15219,5172,15898
220155,201906,1101,3242,878,2822,26,101,625,1973,651,2074
220157,201906,1033,2566,877,2320,18,83,706,1793,724,1876
220160,201906,2745,7805,2367,7115,43,217,1956,5729,1999,5946
220170,201906,1507,4009,1279,3668,11,60,1134,3213,1145,3273
220173,201906,2041,5795,1628,5031,41,181,1312,3942,1353,4123
220177,201906,1942,5593,1862,5500,15,50,1822,5388,1837,5438
220180,201906,1121,2842,908,2463,3,18,685,1740,688,1758
220190,201906,6401,16912,5408,15510,381,1229,4076,11631,4457,12860
220191,201906,1403,4444,1288,4238,73,294,954,3059,1027,3353
220192,201906,1849,5012,1451,4305,28,104,1174,3407,1202,3511
220194,201906,1695,4891,1515,4593,68,281,1244,3674,1312,3955
220196,201906,1934,5228,1755,4940,30,136,1490,4095,1520,4231
220198,201906,1294,3550,1075,3267,10,34,991,3039,1001,3073
220200,201906,4954,14627,4386,13866,185,693,3634,11486,3819,12179
220202,201906,2200,6217,1879,5677,29,155,1597,4730,1626,4885
220205,201906,2539,7222,2270,6767,55,241,1917,5588,1972,5829
220207,201906,772,2343,639,2110,56,205,414,1363,470,1568
220208,201906,1669,5252,1358,4637,202,741,733,2461,935,3202
220209,201906,1580,4555,1375,4198,22,114,1116,3359,1138,3473
220210,201906,1604,4126,1388,3774,15,66,1164,3096,1179,3162
220211,201906,1562,4078,1443,3912,16,60,1268,3455,1284,3515
220213,201906,1744,4729,1513,4296,28,105,1221,3361,1249,3466
220217,201906,2068,6271,1956,6148,33,102,1830,5813,1863,5915
220220,201906,10210,27168,8505,24474,534,1405,5989,17743,6523,19148
220225,201906,1071,2816,871,2559,9,45,791,2296,800,2341
220230,201906,5792,14376,4990,13266,206,517,4253,11341,4459,11858
220240,201906,2875,8503,2645,8063,105,343,2142,6527,2247,6870
220245,201906,1632,4008,1305,3591,10,52,1188,3294,1198,3346
220250,201906,2996,8374,2618,7885,21,116,2412,7225,2433,7341
220253,201906,1625,4459,1398,4058,82,273,1146,3222,1228,3495
220255,201906,1827,4520,1554,4113,46,205,1273,3205,1319,3410
220260,201906,4223,13192,3709,12295,166,645,2966,9770,3132,10415
220265,201906,1193,3970,1099,3821,49,216,902,3077,951,3293
220270,201906,6375,20117,5978,19380,245,1126,4984,15599,5229,16725
220271,201906,1455,3759,1264,3492,30,108,1115,3069,1145,3177
220272,201906,1735,4975,1548,4630,68,210,1144,3323,1212,3533
220273,201906,1220,3513,1011,3125,40,158,769,2321,809,2479
220275,201906,2241,5451,1758,4780,30,104,1533,4163,1563,4267
220277,201906,2118,5451,1840,5015,33,116,1562,4164,1595,4280
220280,201906,1624,3898,1335,3503,28,97,1142,2928,1170,3025
220285,201906,1443,3739,1211,3447,14,68,1084,3048,1098,3116
220290,201906,6069,17872,4875,16172,371,1342,3553,11984,3924,13326
220300,201906,1972,5814,1610,5316,41,246,1328,4304,1369,4550
220310,201906,3003,8223,2362,7479,49,241,1958,6137,2007,6378
220320,201906,3019,9020,2332,7689,109,488,1763,5623,1872,6111
220323,201906,1618,4881,1295,4337,61,254,1059,3475,1120,3729
220325,201906,1288,3792,1093,3456,29,132,901,2789,930,2921
220327,201906,1456,4257,1295,3986,49,220,1054,3161,1103,3381
220330,201906,4308,10545,3578,9629,84,264,3135,8316,3219,8580
220335,201906,1749,5228,1563,5002,23,82,1415,4526,1438,4608
220340,201906,1836,4879,1434,4211,47,163,1002,2824,1049,2987
220342,201906,1170,3467,1032,3253,49,231,802,2467,851,2698
220345,201906,3092,7073,2452,6144,17,53,2231,5566,2248,5619
220350,201906,3294,8549,2647,7560,130,401,1925,5470,2055,5871
220360,201906,1231,3168,975,2757,19,65,785,2195,804,2260
220370,201906,8739,25144,7948,23940,182,767,6957,20701,7139,21468
220375,201906,1560,4537,1397,4334,7,31,1326,4134,1333,4165
220380,201906,1514,3664,1241,3266,17,44,1073,2785,1090,2829
220385,201906,830,2011,659,1706,9,29,565,1439,574,1468
220390,201906,9228,25010,7269,21849,1880,5545,2897,9455,4777,15000
220400,201906,1489,3612,1128,3058,21,70,867,2285,888,2355
220410,201906,1150,3173,933,2811,45,139,752,2222,797,2361
220415,201906,816,2129,685,1915,18,50,535,1474,553,1524
220420,201906,1970,5475,1602,4778,50,153,1246,3659,1296,3812
220430,201906,2494,6799,2369,6614,84,270,2054,5641,2138,5911
220435,201906,1701,4508,1476,4162,51,174,1184,3251,1235,3425
220440,201906,2367,7561,2054,7046,110,458,1684,5682,1794,6140
220450,201906,2419,6428,1991,5884,106,370,1621,4784,1727,5154
220455,201906,1317,4063,1246,3969,22,104,1111,3528,1133,3632
220460,201906,947,2375,883,2299,29,87,767,1965,796,2052
220465,201906,2334,7316,2059,6880,166,583,1532,5191,1698,5774
220470,201906,3429,9697,3060,9091,85,261,2472,7240,2557,7501
220480,201906,2546,6732,2028,5876,155,401,1425,4096,1580,4497
220490,201906,2411,6245,2133,5878,39,173,1884,5114,1923,5287
220500,201906,2572,6866,2344,6503,46,182,1954,5242,2000,5424
220510,201906,2488,7123,1993,6240,87,267,1554,4858,1641,5125
220515,201906,1644,3994,1503,3799,37,74,1307,3293,1344,3367
220520,201906,4925,12846,4418,12119,105,322,3871,10554,3976,10876
220525,201906,1287,3332,1144,3139,19,85,1029,2767,1048,2852
220527,201906,1336,3733,1143,3440,18,66,973,2975,991,3041
220530,201906,1375,3504,1189,3263,24,87,1098,2969,1122,3056
220535,201906,798,2249,741,2174,42,164,597,1718,639,1882
220540,201906,3277,10452,3083,10090,110,422,2636,8563,2746,8985
220545,201906,1361,4257,1263,4089,77,311,1043,3311,1120,3622
220550,201906,8642,26668,7746,25157,559,2015,5811,18635,6370,20650
220551,201906,1422,4141,1245,3828,33,134,996,3005,1029,3139
220552,201906,1592,4633,1297,4084,39,185,1027,3121,1066,3306
220553,201906,1587,4315,1395,4050,49,108,1118,3340,1167,3448
220554,201906,869,2304,627,1896,47,107,416,1257,463,1364
220555,201906,2106,6606,1961,6371,55,249,1581,5244,1636,5493
220556,201906,1219,3603,1049,3246,57,232,747,2200,804,2432
220557,201906,1612,4915,1365,4425,70,262,991,3111,1061,3373
220558,201906,1402,3664,1091,3220,23,104,919,2676,942,2780
220559,201906,1584,4126,1338,3737,5,29,1082,3061,1087,3090
220560,201906,1764,4009,1408,3545,31,65,1266,3197,1297,3262
220570,201906,7138,21626,6519,20737,438,1457,5189,16483,5627,17940
220580,201906,6879,19222,6349,18351,108,418,5707,16301,5815,16719
220585,201906,1946,6264,1690,5782,48,176,1378,4746,1426,4922
220590,201906,1303,3616,1075,3263,90,281,759,2301,849,2582
220595,201906,2479,6847,2260,6547,19,85,2029,5827,2048,5912
220600,201906,1401,3149,1173,2857,110,159,958,2417,1068,2576
220605,201906,1651,4809,1393,4357,22,122,1102,3348,1124,3470
220610,201906,2791,8577,2613,8329,31,138,2419,7712,2450,7850
220620,201906,7954,24749,7343,23926,216,1093,6594,21176,6810,22269
220630,201906,360,1081,279,933,27,91,173,589,200,680
220635,201906,1614,5159,1427,4743,54,240,1078,3504,1132,3744
220640,201906,2579,7101,2213,6561,85,334,1785,5227,1870,5561
220650,201906,2048,5709,1768,5258,36,135,1412,4177,1448,4312
220660,201906,2642,8315,2292,7712,95,468,1853,6067,1948,6535
220665,201906,1269,3881,1085,3574,36,183,877,2827,913,3010
220667,201906,1603,5052,1434,4724,72,280,1139,3732,1211,4012
220669,201906,1661,5102,1592,4987,78,343,1359,4150,1437,4493
220670,201906,2194,5803,1759,5193,26,92,1510,4441,1536,4533
220672,201906,3163,7818,2557,7084,128,379,2213,6083,2341,6462
220675,201906,1218,3341,1107,3140,39,123,894,2512,933,2635
220680,201906,2663,7368,2534,7178,107,258,2289,6516,2396,6774
220690,201906,1490,3982,1329,3742,85,216,1046,2969,1131,3185
220695,201906,867,2456,810,2346,17,63,694,1997,711,2060
220700,201906,9484,23850,7540,21104,349,1042,5768,15969,6117,17011
220710,201906,877,2463,662,2047,28,106,496,1493,524,1599
220720,201906,2146,5077,1931,4777,21,82,1653,4022,1674,4104
220730,201906,1264,3610,1086,3324,20,104,927,2771,947,2875
220735,201906,963,2282,740,1924,21,69,612,1527,633,1596
220740,201906,1390,3749,1104,3380,41,116,915,2841,956,2957
220750,201906,3767,9783,3334,9149,227,522,2859,7914,3086,8436
220755,201906,1224,3094,1019,2770,31,115,809,2112,840,2227
220760,201906,3044,8710,2669,8187,101,335,2316,7180,2417,7515
220770,201906,21292,65316,18120,59697,6006,20598,6381,21696,12387,42294
220775,201906,1117,2924,1039,2826,13,54,1002,2710,1015,2764
220777,201906,1652,4222,1254,3582,33,82,943,2676,976,2758
220779,201906,1328,3289,1169,3065,27,86,1014,2632,1041,2718
220780,201906,5500,14152,4824,13068,204,670,3968,10442,4172,11112
220785,201906,1474,3270,1308,3044,10,23,1260,2921,1270,2944
220790,201906,10002,28800,9043,27409,256,1193,7583,22598,7839,23791
220793,201906,875,2325,713,2043,17,42,579,1683,596,1725
220795,201906,1379,3619,1234,3433,23,82,1084,3000,1107,3082
220800,201906,17150,39971,14443,36139,728,1843,10846,26838,11574,28681
220810,201906,2972,8366,2525,7558,51,188,2087,6138,2138,6326
220820,201906,5105,13248,4377,12228,373,911,3241,9108,3614,10019
220830,201906,7218,19331,6508,18309,254,826,5454,15154,5708,15980
220840,201906,12047,37208,10154,33279,2386,7423,4826,16493,7212,23916
220850,201906,3156,9780,2801,9329,68,359,2447,8112,2515,8471
220855,201906,641,1694,563,1569,12,57,493,1345,505,1402
220860,201906,1017,2544,870,2302,21,78,769,2008,790,2086
220865,201906,2514,6687,1958,5726,74,257,1487,4249,1561,4506
220870,201906,2898,8272,2414,7626,38,190,2192,6879,2230,7069
220880,201906,5262,12614,4571,11759,84,292,4191,10643,4275,10935
220885,201906,1368,4279,1133,3887,56,242,904,3108,960,3350
220887,201906,1503,3314,1241,2965,8,26,1155,2726,1163,2752
220890,201906,1432,4501,1233,4157,58,209,993,3355,1051,3564
220900,201906,2022,4888,1682,4429,34,76,1461,3813,1495,3889
220910,201906,1484,4157,1261,3823,43,158,1056,3175,1099,3333
220915,201906,957,2605,758,2214,7,27,585,1654,592,1681
220920,201906,1352,4475,1168,4218,70,306,938,3375,1008,3681
220930,201906,1634,4565,1425,4245,25,93,1306,3851,1331,3944
220935,201906,1055,3029,848,2603,27,104,572,1660,599,1764
220937,201906,1355,3671,1174,3383,22,89,960,2711,982,2800
220940,201906,1462,4208,1171,3658,40,153,881,2699,921,2852
220945,201906,432,1497,376,1377,19,103,277,985,296,1088
220950,201906,1416,3300,915,2497,15,51,717,1892,732,1943
220955,201906,1579,4116,1341,3702,43,130,1105,3011,1148,3141
220960,201906,831,2117,632,1791,11,46,477,1295,488,1341
220965,201906,1757,4856,1530,4523,21,132,1314,3788,1335,3920
220970,201906,1853,4625,1387,3898,38,107,1133,3145,1171,3252
220975,201906,690,2093,602,1986,21,135,526,1645,547,1780
220980,201906,1160,3296,1032,3117,33,145,870,2583,903,2728
220985,201906,1186,3233,1053,3036,45,156,833,2303,878,2459
220987,201906,1476,4401,1273,4044,60,252,1016,3165,1076,3417
220990,201906,1721,4747,1504,4420,23,131,1244,3565,1267,3696
220995,201906,1128,3396,900,2986,47,183,651,2147,698,2330
220997,201906,2427,7158,2231,6863,50,237,1995,6045,2045,6282
221000,201906,4169,11732,3820,11234,94,470,3274,9427,3368,9897
221005,201906,1472,3927,1348,3718,38,172,1156,3055,1194,3227
221010,201906,1190,2816,966,2529,29,79,833,2131,862,2210
221020,201906,1527,4678,1410,4447,26,113,1065,3315,1091,3428
221030,201906,1593,4108,1365,3813,29,107,1188,3317,1217,3424
221035,201906,1461,3808,1263,3540,23,42,1108,3192,1131,3234
221037,201906,623,1793,521,1610,10,56,352,1035,362,1091
221038,201906,508,1456,410,1266,17,62,282,857,299,919
221039,201906,869,2364,751,2158,18,78,614,1691,632,1769
221040,201906,4057,12224,3568,11338,167,596,2822,8926,2989,9522
221050,201906,3787,10142,3357,9579,55,221,3036,8581,3091,8802
221060,201906,8426,23383,6942,21067,229,676,5609,17094,5838,17770
221062,201906,1162,3807,985,3486,40,198,792,2753,832,2951
221063,201906,1084,3093,919,2853,68,235,669,2027,737,2262
221065,201906,2610,6778,2291,6212,24,109,2005,5327,2029,5436
221070,201906,3259,10336,2746,9285,310,1035,1728,5959,2038,6994
221080,201906,3515,8599,2842,7595,56,218,2348,6155,2404,6373
221090,201906,1397,3675,1138,3220,14,53,972,2674,986,2727
221093,201906,1333,3782,1232,3566,121,353,851,2420,972,2773
221095,201906,894,2328,747,2099,8,25,608,1676,616,1701
221097,201906,817,2155,627,1808,21,70,463,1272,484,1342
221100,201906,106729,289782,90884,263607,11367,34762,58495,165714,69862,200476
221110,201906,9890,29621,9100,28607,182,947,8099,25080,8281,26027
221120,201906,4642,13127,4167,12328,193,620,3532,10372,3725,10992
221130,201906,5079,13510,3783,10937,813,2226,1787,5236,2600,7462
221135,201906,1581,4324,1419,4098,43,154,1247,3576,1290,3730
221140,201906,1291,3133,1099,2871,10,42,967,2463,977,2505
221150,201906,1094,2708,865,2310,22,98,673,1678,695,1776
221160,201906,760,1907,667,1780,21,39,543,1456,564,1495
221170,201906,969,2837,894,2709,23,75,762,2301,785,2376
230010,201906,3171,8362,2537,7241,74,253,1963,5468,2037,5721
230015,201906,2963,9738,2645,9100,192,767,1839,6262,2031,7029
230020,201906,13018,41341,12288,40172,399,1706,10308,33278,10707,34984
230030,201906,12600,32344,10809,29896,202,655,9458,26048,9660,26703
230040,201906,4454,11624,3720,10407,76,325,3063,8425,3139,8750
230050,201906,2793,8791,2073,7034,341,1120,888,2919,1229,4039
230060,201906,2307,6352,1849,5492,39,179,1479,4291,1518,4470
230070,201906,3860,10562,3154,9143,169,541,2152,6158,2321,6699
230075,201906,9123,29629,8374,28299,380,1873,6790,22379,7170,24252
230080,201906,3007,6339,2297,5449,7,25,2071,4913,2078,4938
230090,201906,4184,10544,3578,9548,152,446,2813,7435,2965,7881
230100,201906,17643,47148,15745,44457,1365,4005,10953,30973,12318,34978
230110,201906,12320,37050,10601,33576,1731,5468,5758,18271,7489,23739
230120,201906,7370,20235,6500,18768,549,1432,4724,13850,5273,15282
230125,201906,3107,8333,2550,7415,82,294,1944,5581,2026,5875
230130,201906,5662,17731,4622,15420,335,1252,3045,9953,3380,11205
230140,201906,3412,10375,2919,9344,116,478,2199,6832,2315,7310
230150,201906,1604,4812,1347,4228,207,555,782,2555,989,3110
230160,201906,6490,17129,5602,15729,157,606,4647,12754,4804,13360
230170,201906,6045,17539,5059,15527,302,960,3653,10980,3955,11940
230180,201906,1656,4623,1405,4123,24,114,1115,3151,1139,3265
230185,201906,4218,12307,3593,11243,277,963,2623,8186,2900,9149
230190,201906,12974,38358,11098,34807,1658,5329,6066,18959,7724,24288
230195,201906,5123,15261,4665,14394,317,1024,3592,11006,3909,12030
230200,201906,4985,13815,4240,12362,150,499,3236,9216,3386,9715
230205,201906,3953,12235,3557,11581,153,649,2714,8657,2867,9306
230210,201906,10343,25279,8755,23062,389,1262,6773,17496,7162,18758
230220,201906,13525,34621,12073,32447,529,1482,10042,26686,10571,28168
230230,201906,6883,20916,6171,19427,407,1326,4518,14103,4925,15429
230240,201906,12510,33834,11096,31525,309,1158,9187,25657,9496,26815
230250,201906,9018,25945,8640,25332,292,1065,6767,19241,7059,20306
230260,201906,14320,43880,12602,40721,1558,5118,7371,24122,8929,29240
230270,201906,7402,20394,5746,17248,501,1479,3821,11507,4322,12986
230280,201906,20484,55086,16765,48755,560,2371,13168,36825,13728,39196
230290,201906,4761,13372,4020,11921,322,853,2986,8901,3308,9754
230300,201906,4664,12801,4297,12267,79,298,3754,10562,3833,10860
230310,201906,4653,13347,3958,12131,140,598,2830,8444,2970,9042
230320,201906,7661,22244,6597,20239,297,1174,5013,15055,5310,16229
230330,201906,4664,12866,3804,11211,175,571,2800,8090,2975,8661
230340,201906,3580,11344,3048,10233,296,1026,2004,6671,2300,7697
230350,201906,17982,50531,15951,47230,1022,3527,10264,30581,11286,34108
230360,201906,2787,7735,2241,6713,145,451,1489,4431,1634,4882
230365,201906,3052,7608,2546,6820,45,220,2145,5658,2190,5878
230370,201906,55676,159493,47679,147036,8031,25080,26618,83883,34649,108963
230380,201906,6426,17981,5084,15443,158,596,3709,11057,3867,11653
230390,201906,3287,9868,2887,9208,113,471,2212,6984,2325,7455
230393,201906,3071,9366,2517,8235,94,523,1932,6036,2026,6559
230395,201906,5791,15791,5054,14532,375,1035,3486,10051,3861,11086
230400,201906,5705,15966,5068,14899,132,649,3967,11258,4099,11907
230410,201906,14311,42850,11764,37976,1035,3597,7779,25014,8814,28611
230420,201906,27717,78059,22892,69181,2955,9234,12632,38010,15587,47244
230423,201906,4767,14249,4149,12977,92,412,3320,10166,3412,10578
230425,201906,5535,17271,5048,16251,430,1453,3569,11434,3999,12887
230426,201906,2651,7132,1955,5741,33,126,1475,4229,1508,4355
230427,201906,1853,5264,1302,4045,67,228,880,2637,947,2865
230428,201906,9508,26158,8313,24269,1160,3424,4884,14126,6044,17550
230430,201906,4761,13642,3836,12033,162,603,2876,8846,3038,9449
230435,201906,5603,15122,4769,13680,580,1668,3004,8576,3584,10244
230440,201906,399527,1015597,333826,915696,39728,115165,204177,553796,243905,668961
230445,201906,4270,11422,3497,10066,193,533,2399,6779,2592,7312
230450,201906,3640,10650,3163,9891,251,993,2281,6923,2532,7916
230460,201906,2117,5974,1852,5542,76,287,1516,4509,1592,4796
230465,201906,3979,11265,3415,10202,101,435,2510,7184,2611,7619
230470,201906,11119,37205,10019,35117,830,3534,7224,24830,8054,28364
230480,201906,1406,4126,1196,3744,101,395,845,2537,946,2932
230490,201906,2439,6909,2073,6211,176,584,1302,3684,1478,4268
230495,201906,5814,17453,5119,16151,381,1494,3345,10352,3726,11846
230500,201906,9125,29890,8343,28414,309,1273,6707,22734,7016,24007
230510,201906,1643,5111,1223,4142,203,726,554,1852,757,2578
230520,201906,4477,12914,3918,11870,314,959,2747,8268,3061,9227
230523,201906,14614,43797,11940,37949,2803,8876,3176,10662,5979,19538
230526,201906,3880,11113,3262,9994,162,564,2399,7272,2561,7836
230530,201906,5292,16582,4488,15022,346,1268,3184,10570,3530,11838
230533,201906,4185,10590,3584,9556,92,261,2934,7730,3026,7991
230535,201906,5251,14753,4472,13411,217,679,3184,9613,3401,10292
230540,201906,15985,44190,13987,41156,253,1079,11687,33902,11940,34981
230550,201906,20336,55207,16574,48558,1661,5093,10225,29701,11886,34794
230560,201906,7888,19784,6468,17437,69,284,5494,14662,5563,14946
230565,201906,3034,8511,2534,7575,84,368,1918,5615,2002,5983
230570,201906,3519,8951,3022,8296,71,217,2545,6942,2616,7159
230580,201906,10489,27933,9145,26001,338,1063,7615,21483,7953,22546
230590,201906,8912,25785,7412,22948,457,1636,5300,15867,5757,17503
230600,201906,3642,9620,2813,8072,84,266,1919,5535,2003,5801
230610,201906,6625,18420,5871,17179,481,1372,4527,13221,5008,14593
230620,201906,2083,5693,1584,4693,127,420,962,2759,1089,3179
230625,201906,7816,22753,6651,20542,2047,6539,1765,5824,3812,12363
230630,201906,10583,31972,9226,29097,1786,5357,4802,15725,6588,21082
230640,201906,27824,84794,25109,80305,1498,5888,19491,61356,20989,67244
230650,201906,5120,14118,4337,12700,159,671,3438,9764,3597,10435
230655,201906,9346,32218,8860,31324,681,2612,6901,24512,7582,27124
230660,201906,6115,18262,4982,16187,173,905,4020,12756,4193,13661
230670,201906,6081,14755,4498,12131,146,454,3564,9388,3710,9842
230680,201906,2577,7214,2214,6557,160,479,1547,4581,1707,5060
230690,201906,6872,20650,6035,18935,423,1505,3797,11662,4220,13167
230700,201906,9655,25137,8164,22418,347,1047,6110,16318,6457,17365
230710,201906,6769,21410,5870,19499,555,1976,4057,13215,4612,15191
230720,201906,1955,5795,1583,5015,125,379,1047,3242,1172,3621
230725,201906,3870,11899,3434,11041,448,1582,1806,5689,2254,7271
230730,201906,55261,153233,44523,136049,10406,34315,14764,47318,25170,81633
230740,201906,6039,17073,5206,15679,139,586,4156,12376,4295,12962
230750,201906,8373,22696,7020,20411,176,684,5486,15472,5662,16156
230760,201906,11022,29780,9755,27757,628,2092,7192,19918,7820,22010
230763,201906,4560,12888,3897,11627,140,611,3081,8899,3221,9510
230765,201906,40835,113761,34237,102639,5931,18533,15730,46943,21661,65476
230770,201906,25266,64137,21378,58805,2407,6874,13765,37820,16172,44694
230780,201906,6008,21525,5623,20692,817,3059,3338,12561,4155,15620
230790,201906,2968,8696,2637,8131,116,501,1966,5872,2082,6373
230800,201906,7853,25505,7015,23746,801,3038,4192,13847,4993,16885
230810,201906,11732,35391,10455,33264,439,1677,7974,24829,8413,26506
230820,201906,3265,10803,2750,9601,275,1146,1667,5526,1942,6672
230830,201906,7649,21034,6500,19007,160,689,5285,15050,5445,15739
230835,201906,4169,10072,3200,8527,79,256,2606,6809,2685,7065
230837,201906,3095,9647,2675,8866,114,540,2106,6780,2220,7320
230840,201906,8885,26507,7723,24572,614,2031,5649,18045,6263,20076
230850,201906,9392,27687,8002,24899,419,1505,5669,17414,6088,18919
230860,201906,5098,13358,4305,12173,83,291,3701,10352,3784,10643
230870,201906,16451,40800,14253,37155,450,1263,11495,29605,11945,30868
230880,201906,2083,6427,1894,6088,50,269,1478,4618,1528,4887
230890,201906,4455,14520,4129,13861,343,1283,2993,9864,3336,11147
230900,201906,3010,8875,2590,8032,212,741,1706,5133,1918,5874
230910,201906,2934,8105,2421,7230,75,380,1927,5624,2002,6004
230920,201906,4452,12858,3795,11773,156,618,2862,8681,3018,9299
230930,201906,6463,18419,5443,16477,345,1078,3753,11310,4098,12388
230940,201906,7661,20145,6736,18714,190,541,5679,15637,5869,16178
230945,201906,6528,18913,5619,17088,358,1251,3879,11665,4237,12916
230950,201906,6240,15806,5631,15024,137,324,4957,13394,5094,13718
230960,201906,12874,38192,11526,35625,1775,5564,5892,18430,7667,23994
230970,201906,13349,36361,11293,33108,1963,5825,5910,17498,7873,23323
230980,201906,2725,8067,2382,7423,436,1295,1397,4488,1833,5783
230990,201906,1681,4799,1413,4251,78,321,954,2720,1032,3041
231000,201906,2451,6613,2040,5806,76,213,1466,4081,1542,4294
231010,201906,3379,8102,2723,6972,64,225,2304,5704,2368,5929
231020,201906,7984,25629,7167,23925,1275,4015,4137,14308,5412,18323
231025,201906,7405,20996,6491,19469,800,2364,4386,13243,5186,15607
231030,201906,7164,21662,5697,18492,943,3027,2991,9735,3934,12762
231040,201906,3013,8847,2620,8102,103,372,2028,6137,2131,6509
231050,201906,11786,30891,9506,26723,679,1903,6923,19059,7602,20962
231060,201906,2728,7890,2426,7383,78,283,1949,5893,2027,6176
231070,201906,8035,23712,6799,21465,847,2716,4083,12820,4930,15536
231080,201906,3968,11491,3463,10648,147,655,2597,7779,2744,8434
231085,201906,6400,16099,5188,14601,227,636,3973,11187,4200,11823
231090,201906,4333,11489,3246,9335,106,416,2254,6264,2360,6680
231095,201906,2161,6589,1740,5645,136,468,1183,3815,1319,4283
231100,201906,2999,8811,2488,7840,133,466,1870,5841,2003,6307
231110,201906,3496,10561,3235,10057,130,508,2424,7397,2554,7905
231120,201906,2183,6516,1850,5922,91,356,1280,4023,1371,4379
231123,201906,1903,5030,1591,4480,78,210,1141,3181,1219,3391
231126,201906,5558,15561,4462,13406,235,740,3217,9488,3452,10228
231130,201906,20456,54141,17188,49835,1173,4311,12332,34978,13505,39289
231135,201906,4164,11781,3469,10441,157,566,2486,7320,2643,7886
231140,201906,16528,47314,13410,41693,704,2994,9237,27784,9941,30778
231150,201906,5482,15553,4338,13204,749,2298,1946,6015,2695,8313
231160,201906,5955,18468,5324,17246,897,2745,3000,9997,3897,12742
231170,201906,4406,13098,3608,11485,216,790,2440,7488,2656,8278
231180,201906,14062,40671,11652,35407,3060,9121,4217,13057,7277,22178
231190,201906,3821,10940,3239,9839,101,448,2517,7421,2618,7869
231195,201906,4746,14677,3992,13080,214,845,2931,9391,3145,10236
231200,201906,7828,24827,6843,22743,261,1313,5216,16770,5477,18083
231210,201906,4778,14255,4096,13071,192,726,3050,9505,3242,10231
231220,201906,11950,31880,9401,26917,491,1539,6724,18492,7215,20031
231230,201906,9106,29225,8133,27522,476,1899,6032,20413,6508,22312
231240,201906,11554,34328,10199,31662,1609,4930,5884,18423,7493,23353
231250,201906,2059,5387,1336,3752,107,289,789,2170,896,2459
231260,201906,3213,9279,2807,8629,292,868,1859,5857,2151,6725
231270,201906,6431,16939,5324,15102,137,543,4034,11154,4171,11697
231280,201906,1663,5299,1562,5104,113,381,1148,3719,1261,4100
231290,201906,37192,112852,31502,100970,5508,17728,14370,45846,19878,63574
231300,201906,4012,11260,3164,9504,254,796,2014,5952,2268,6748
231310,201906,7208,19125,5820,16486,501,1442,3895,10826,4396,12268
231320,201906,7718,21478,6081,18482,93,431,4697,14078,4790,14509
231325,201906,2490,6768,2035,6029,200,528,1313,3967,1513,4495
231330,201906,9584,29314,7997,26094,1473,4661,4223,14214,5696,18875
231335,201906,5764,15192,4853,13690,83,378,4233,11731,4316,12109
231340,201906,17686,55371,15838,52083,1354,4547,11291,37497,12645,42044
231350,201906,15708,42958,14265,40920,345,1178,12692,36075,13037,37253
231355,201906,4388,13270,3929,12433,225,814,3008,9436,3233,10250
231360,201906,7355,22552,6406,20844,392,1417,4860,15749,5252,17166
231370,201906,2229,6090,1778,5266,36,122,1373,4018,1409,4140
231375,201906,4424,13889,4040,13227,152,700,3307,10665,3459,11365
231380,201906,5901,16109,5421,15476,200,555,4406,12746,4606,13301
231390,201906,3370,9907,3019,9324,157,593,2183,6537,2340,7130
231395,201906,3984,11949,3336,10885,522,1675,1848,6159,2370,7834
231400,201906,9247,26987,7898,24446,311,1283,5997,18154,6308,19437
231410,201906,14643,46066,13226,43698,760,2860,10349,33717,11109,36577
240010,201906,2497,6761,1935,5702,203,643,1153,3297,1356,3940
240020,201906,11699,33650,10089,30780,759,2778,6617,19771,7376,22549
240030,201906,2766,7040,2544,6705,112,341,2213,5735,2325,6076
240040,201906,818,2334,667,2059,18,74,492,1468,510,1542
240050,201906,3113,8403,2594,7453,48,141,2054,5799,2102,5940
240060,201906,1378,3734,1169,3351,37,121,936,2636,973,2757
240070,201906,2101,6226,1959,5939,205,665,1449,4299,1654,4964
240080,201906,2819,7733,2377,6906,57,232,1830,5179,1887,5411
240090,201906,2241,5585,1817,4861,21,71,1517,4001,1538,4072
240100,201906,9582,24275,7828,20977,279,863,6099,15780,6378,16643
240110,201906,4364,12680,3765,11571,203,760,2714,8165,2917,8925
240120,201906,3521,9550,2610,8494,206,779,1751,5838,1957,6617
240130,201906,3577,7579,3022,6835,40,117,2747,6105,2787,6222
240140,201906,1890,5688,1619,5174,179,643,1061,3310,1240,3953
240145,201906,6462,18389,5352,16389,758,2374,3102,9586,3860,11960
240150,201906,870,2564,795,2413,51,180,621,1823,672,2003
240160,201906,1437,4376,1217,3940,54,261,883,2843,937,3104
240165,201906,946,2605,801,2321,53,172,617,1746,670,1918
240170,201906,2342,6575,1996,5935,214,721,1309,3753,1523,4474
240180,201906,3042,9033,2434,7810,543,1686,1161,3878,1704,5564
240185,201906,1242,3987,1129,3802,64,259,919,3055,983,3314
240190,201906,1015,3027,894,2821,28,128,734,2292,762,2420
240200,201906,10650,28039,8737,24688,977,2967,4842,13412,5819,16379
240210,201906,2955,7532,2576,6954,29,138,2174,5670,2203,5808
240220,201906,7344,22302,6586,21107,399,1751,5046,15794,5445,17545
240230,201906,5810,14891,4710,13026,236,653,3698,10193,3934,10846
240240,201906,1926,5855,1218,4080,126,417,481,1588,607,2005
240250,201906,2832,7675,2553,7257,134,347,2089,5981,2223,6328
240260,201906,13645,40857,11890,37768,1713,5231,7333,24327,9046,29558
240270,201906,2219,6633,1961,6228,117,363,1479,4792,1596,5155
240280,201906,1664,4304,1417,3907,51,154,1132,3068,1183,3222
240290,201906,1198,3520,986,3048,33,149,682,1969,715,2118
240300,201906,2159,5630,1551,4451,73,224,998,2775,1071,2999
240310,201906,8658,23206,6945,20131,893,2689,3679,10526,4572,13215
240320,201906,2038,5562,1478,4458,27,129,1122,3236,1149,3365
240325,201906,29726,81799,23298,70251,4849,15286,8940,27446,13789,42732
240330,201906,1671,4581,1306,3877,45,161,912,2589,957,2750
240340,201906,1951,4600,1601,4044,49,123,1306,3213,1355,3336
240350,201906,2057,5436,1916,5272,29,129,1718,4710,1747,4839
240360,201906,8167,23271,7346,21955,949,2813,4840,14844,5789,17657
240370,201906,1923,5169,1504,4294,79,227,1024,2858,1103,3085
240375,201906,895,2290,749,2006,28,108,598,1523,626,1631
240380,201906,2245,6391,1648,5052,145,422,973,2922,1118,3344
240390,201906,988,2485,677,1864,28,70,431,1108,459,1178
240400,201906,1369,3446,1075,2911,33,126,751,1913,784,2039
240410,201906,556,1745,469,1550,53,225,284,890,337,1115
240420,201906,4587,16411,4049,15177,522,2342,2252,8240,2774,10582
240430,201906,3329,8966,2816,7960,215,688,2006,5453,2221,6141
240440,201906,2570,5762,2158,5175,142,324,1703,4018,1845,4342
240450,201906,4293,12047,3465,10506,329,1156,2084,6064,2413,7220
240460,201906,2928,8438,2678,8032,278,894,2065,6160,2343,7054
240470,201906,3536,10771,2754,9146,398,1303,1509,5092,1907,6395
240480,201906,552,1543,384,1172,29,96,173,513,202,609
240485,201906,2084,6025,1713,5293,146,468,1148,3548,1294,4016
240490,201906,1688,4292,1331,3638,71,167,1028,2819,1099,2986
240500,201906,2108,5724,1861,5343,68,222,1554,4419,1622,4641
240510,201906,1666,4443,1495,4202,76,261,1234,3368,1310,3629
240520,201906,1317,3380,1059,3011,44,148,833,2336,877,2484
240530,201906,2018,6076,1855,5795,106,355,1474,4563,1580,4918
240540,201906,2234,5616,1944,5163,68,163,1674,4412,1742,4575
240550,201906,682,1927,623,1818,24,99,489,1367,513,1466
240560,201906,3264,8641,2793,7998,269,697,2054,5978,2323,6675
240570,201906,2844,7514,1908,5417,278,827,797,2080,1075,2907
240580,201906,7785,22937,7032,21573,549,1687,5620,17253,6169,18940
240590,201906,697,1872,613,1726,11,45,468,1293,479,1338
240600,201906,1788,4835,1312,3839,54,184,872,2451,926,2635
240610,201906,4213,11573,3560,10360,139,492,2681,7642,2820,8134
240615,201906,1130,3087,898,2620,56,204,624,1714,680,1918
240620,201906,1829,5167,1561,4687,88,253,1249,3722,1337,3975
240630,201906,2038,5928,1841,5570,124,324,1296,4038,1420,4362
240640,201906,912,2471,726,2150,30,136,531,1527,561,1663
240650,201906,3926,10933,3453,10067,210,619,2647,7659,2857,8278
240660,201906,2931,7714,2622,7300,55,194,2380,6580,2435,6774
240670,201906,2392,6767,1975,5917,135,429,1288,3767,1423,4196
240680,201906,1610,4345,1292,3783,59,199,961,2725,1020,2924
240690,201906,937,2416,742,2082,12,52,599,1620,611,1672
240700,201906,2352,6853,1977,6174,63,253,1555,4749,1618,5002
240710,201906,16035,42081,13498,37605,2119,5726,7882,22152,10001,27878
240720,201906,5150,13184,4481,12150,512,1476,3079,8195,3591,9671
240725,201906,1080,3130,834,2616,36,129,555,1685,591,1814
240730,201906,2108,6007,1780,5363,81,263,1356,4015,1437,4278
240740,201906,1821,4932,1499,4328,51,209,1096,2990,1147,3199
240750,201906,2218,7419,1855,6627,256,1024,1013,3625,1269,4649
240760,201906,1522,3727,1083,3051,53,116,841,2412,894,2528
240770,201906,3183,8816,2707,8131,139,553,2120,6195,2259,6748
240780,201906,5143,14145,4104,12388,512,1565,2494,7668,3006,9233
240790,201906,845,2433,708,2159,15,58,530,1583,545,1641
240800,201906,44305,110770,35225,96584,4921,14095,17514,47861,22435,61956
240810,201906,82799,221294,71642,202278,11467,32798,42314,118534,53781,151332
240820,201906,5692,17320,4910,15866,737,2417,2918,9557,3655,11974
240830,201906,8645,25272,7862,24030,289,1292,6400,19151,6689,20443
240840,201906,1132,2865,896,2461,43,116,624,1650,667,1766
240850,201906,1251,3504,909,2758,42,139,523,1551,565,1690
240860,201906,1234,3360,925,2789,16,75,694,1988,710,2063
240870,201906,1127,2863,873,2418,111,327,530,1430,641,1757
240880,201906,1278,4037,1144,3771,81,340,913,2936,994,3276
240890,201906,4529,12463,3431,10305,505,1647,1690,4874,2195,6521
240895,201906,2679,8518,2435,8143,159,579,2058,6859,2217,7438
240910,201906,3177,8906,2757,8084,61,212,2242,6468,2303,6680
240920,201906,813,2330,692,2113,67,187,388,1236,455,1423
240930,201906,3683,8502,3071,7749,191,275,2358,6194,2549,6469
240933,201906,1780,4314,1455,3820,47,186,1242,3196,1289,3382
240940,201906,6100,15213,4861,13087,337,960,3368,8736,3705,9696
240950,201906,957,2896,843,2672,25,112,697,2162,722,2274
240960,201906,688,2104,613,1948,31,115,473,1463,504,1578
240970,201906,1854,4840,1519,4258,55,205,1267,3455,1322,3660
240980,201906,3099,9492,2815,8957,146,605,2219,6887,2365,7492
240990,201906,2560,7319,2323,6838,279,901,1631,4640,1910,5541
241000,201906,941,2498,753,2133,39,91,539,1532,578,1623
241010,201906,2789,8944,2562,8435,173,690,1881,6065,2054,6755
241020,201906,2046,5525,1506,4409,156,464,951,2717,1107,3181
241025,201906,1730,4969,1367,4249,57,234,962,2933,1019,3167
241030,201906,2495,7895,2044,6932,231,814,1335,4508,1566,5322
241040,201906,2255,7169,2021,6767,93,436,1626,5386,1719,5822
241050,201906,1289,3595,1048,3138,42,146,794,2307,836,2453
241060,201906,716,2055,641,1891,36,116,448,1264,484,1380
241070,201906,647,1788,570,1654,18,61,443,1233,461,1294
241080,201906,1116,3189,863,2675,10,42,635,1949,645,1991
241090,201906,2029,5871,1628,5190,51,260,1280,4004,1331,4264
241100,201906,1148,3256,903,2713,57,178,622,1809,679,1987
241105,201906,1022,3111,827,2733,262,858,258,893,520,1751
241110,201906,909,2620,684,2124,39,140,454,1344,493,1484
241120,201906,7499,21511,6419,19578,1041,3119,3613,11369,4654,14488
241140,201906,3237,8664,2616,7398,157,448,1906,5256,2063,5704
241142,201906,759,2064,556,1660,33,119,310,848,343,967
241150,201906,5838,15525,5203,14439,169,595,4247,11495,4416,12090
241160,201906,1279,3612,1072,3237,137,404,712,2128,849,2532
241170,201906,1311,3359,1142,3072,39,149,943,2403,982,2552
241180,201906,1014,2640,734,2091,75,207,423,1177,498,1384
241190,201906,1092,2892,903,2515,22,81,658,1751,680,1832
241200,201906,18810,50075,16313,46192,2690,7715,9347,26451,12037,34166
241210,201906,1367,3778,1004,3034,115,388,580,1697,695,2085
241220,201906,8670,26152,7610,24293,1888,5965,3422,11433,5310,17398
241230,201906,2893,7759,2571,7234,105,358,2137,5882,2242,6240
241240,201906,1180,3363,705,2263,50,176,334,1066,384,1242
241250,201906,5191,15538,4303,13816,185,850,3181,9795,3366,10645
241255,201906,2043,6631,1802,6102,131,558,1304,4276,1435,4834
241260,201906,4839,12825,3788,11012,98,417,2950,8351,3048,8768
241270,201906,1770,5161,1463,4552,131,454,1011,3087,1142,3541
241280,201906,2132,5434,1851,4919,71,202,1546,4049,1617,4251
241290,201906,3436,8459,2582,7039,85,323,2006,5272,2091,5595
241300,201906,1445,3925,1155,3401,41,147,771,2207,812,2354
241310,201906,2046,5235,1746,4821,20,94,1467,4047,1487,4141
241320,201906,987,3213,820,2869,92,380,510,1771,602,2151
241330,201906,1791,4616,1392,4107,26,112,1183,3490,1209,3602
241335,201906,3078,8741,2760,8149,96,345,2297,6700,2393,7045
241340,201906,1615,4666,1261,3910,265,845,527,1609,792,2454
241350,201906,1975,5792,1755,5388,110,376,1328,3996,1438,4372
241355,201906,1304,3550,1080,3123,20,75,834,2372,854,2447
241360,201906,2058,5366,1564,4337,54,162,1126,3001,1180,3163
241370,201906,1352,3754,1049,3140,60,202,705,2010,765,2212
241380,201906,631,1773,500,1506,76,218,266,819,342,1037
241390,201906,2707,8167,2432,7730,181,589,1877,5982,2058,6571
241400,201906,3488,9760,3146,9251,173,569,2554,7442,2727,8011
241410,201906,2349,7031,1907,6123,344,1134,979,3142,1323,4276
241415,201906,1626,4839,1336,4263,69,273,955,2967,1024,3240
241420,201906,2172,7176,1855,6590,464,1776,802,2839,1266,4615
241430,201906,571,1630,393,1200,29,101,244,719,273,820
241440,201906,7242,23071,6527,21762,397,1596,5125,16775,5522,18371
241445,201906,1076,2787,980,2668,25,66,880,2446,905,2512
241450,201906,2667,6764,2325,6208,279,667,1678,4517,1957,5184
241460,201906,3607,9917,3022,8675,167,525,2144,5972,2311,6497
241470,201906,1417,3734,1128,3302,26,97,924,2682,950,2779
241475,201906,1196,3416,939,2922,30,156,681,2015,711,2171
241480,201906,2795,8873,2355,7931,783,2605,696,2668,1479,5273
241490,201906,667,1617,533,1424,23,68,360,933,383,1001
241500,201906,820,2341,718,2207,9,36,638,1975,647,2011
250010,201906,2609,7807,2151,6835,57,233,1558,4809,1615,5042
250020,201906,1587,4320,1119,3390,42,113,814,2430,856,2543
250030,201906,6783,18805,6092,17721,497,1502,4612,13233,5109,14735
250040,201906,4043,12528,3502,11518,230,915,2483,7991,2713,8906
250050,201906,3466,9545,3173,9117,128,461,2568,7318,2696,7779
250053,201906,1158,3347,1048,3168,73,239,769,2333,842,2572
250057,201906,642,2300,606,2245,6,28,543,2045,549,2073
250060,201906,5338,14303,4878,13718,381,1028,3876,11015,4257,12043
250070,201906,3942,11241,3447,10344,56,258,2735,7993,2791,8251
250073,201906,743,2015,612,1808,6,27,502,1429,508,1456
250077,201906,2215,6029,1669,5110,72,244,1223,3720,1295,3964
250080,201906,4619,11898,4067,11161,86,343,3505,9461,3591,9804
250090,201906,3120,7814,2754,7318,59,194,2374,6176,2433,6370
250100,201906,3653,11323,3373,10790,170,672,2673,8301,2843,8973
250110,201906,4845,13637,4367,12939,323,1172,3368,9712,3691,10884
250115,201906,556,1608,472,1469,10,57,350,1061,360,1118
250120,201906,1868,5460,1557,4939,38,173,1221,3842,1259,4015
250130,201906,5471,15273,4648,14066,77,421,3840,11398,3917,11819
250135,201906,1177,3211,1053,3013,15,61,949,2702,964,2763
250140,201906,2162,6521,2040,6350,121,557,1726,5232,1847,5789
250150,201906,4798,15180,4332,14333,164,735,3458,11202,3622,11937
250153,201906,1441,3738,1201,3379,27,86,977,2707,1004,2793
250157,201906,1721,5189,1533,4810,81,310,1198,3683,1279,3993
250160,201906,3865,9797,3127,8787,34,146,2791,7790,2825,7936
250170,201906,1805,4659,1615,4383,33,123,1387,3704,1420,3827
250180,201906,18771,47191,16397,44061,861,2713,12627,33140,13488,35853
250190,201906,4021,11016,3416,10062,394,1127,2241,6526,2635,7653
250200,201906,1885,5140,1620,4729,50,172,1376,3990,1426,4162
250205,201906,821,2613,715,2435,24,123,589,1983,613,2106
250210,201906,1574,4788,1420,4533,52,260,1123,3502,1175,3762
250215,201906,1566,4444,1292,3979,74,255,788,2397,862,2652
250220,201906,660,1879,538,1687,44,174,340,1002,384,1176
250230,201906,1584,3654,1149,2993,25,87,910,2278,935,2365
250240,201906,2233,6783,1994,6360,40,167,1697,5347,1737,5514
250250,201906,4558,12712,3957,11824,94,303,3326,9927,3420,10230
250260,201906,1703,4738,1430,4275,42,131,1136,3364,1178,3495
250270,201906,1203,3640,1080,3485,71,232,803,2690,874,2922
250280,201906,3224,9186,2838,8575,107,338,2244,6759,2351,7097
250290,201906,1612,4261,1370,3928,26,75,1093,3159,1119,3234
250300,201906,5417,14694,4987,14184,200,888,4136,11320,4336,12208
250310,201906,1140,3181,966,2885,36,122,745,2179,781,2301
250320,201906,10649,25368,9372,23835,331,968,8129,20373,8460,21341
250330,201906,2307,6606,1949,6133,116,421,1549,4809,1665,5230
250340,201906,1099,2813,965,2629,7,22,859,2314,866,2336
250350,201906,4006,11224,3615,10616,146,376,2926,8826,3072,9202
250355,201906,1969,6026,1755,5730,27,153,1586,5146,1613,5299
250360,201906,1766,4982,1600,4732,32,115,1313,3855,1345,3970
250370,201906,12660,33530,10617,30430,342,1298,8678,24401,9020,25699
250375,201906,1161,3035,953,2775,6,18,888,2614,894,2632
250380,201906,1603,4213,1476,4044,36,155,1256,3310,1292,3465
250390,201906,1768,4594,1502,4161,112,294,1134,3136,1246,3430
250400,201906,69946,172910,50447,142616,13785,41024,15621,46009,29406,87033
250403,201906,1656,4736,1510,4541,73,365,1191,3420,1264,3785
250407,201906,1211,3086,990,2761,61,144,720,2035,781,2179
250410,201906,601,1650,527,1529,4,19,439,1248,443,1267
250415,201906,1814,5206,1612,4866,42,182,1362,4068,1404,4250
250420,201906,1222,3477,1106,3321,14,64,1032,3098,1046,3162
250430,201906,6167,15411,5315,14235,156,508,4396,11540,4552,12048
250435,201906,1534,4291,1253,3796,22,99,939,2793,961,2892
250440,201906,4484,12006,3866,11238,74,265,3362,9741,3436,10006
250450,201906,1800,4884,1512,4486,35,142,1253,3689,1288,3831
250460,201906,7241,19681,6493,18604,347,1049,5277,15052,5624,16101
250470,201906,1557,4010,1290,3613,54,178,990,2696,1044,2874
250480,201906,4078,11071,3540,10432,17,78,3202,9531,3219,9609
250485,201906,725,1656,534,1389,33,67,389,979,422,1046
250490,201906,4893,12107,4407,11526,194,620,3821,9799,4015,10419
250500,201906,1968,5423,1751,5061,74,238,1427,4116,1501,4354
250510,201906,5443,13689,4713,12734,91,273,4140,11207,4231,11480
250520,201906,1780,4917,1545,4580,138,448,1080,3168,1218,3616
250523,201906,2223,5457,1989,5159,76,326,1668,4178,1744,4504
250527,201906,1658,4334,1515,4162,32,92,1322,3654,1354,3746
250530,201906,613,1645,529,1531,9,26,462,1332,471,1358
250535,201906,1339,3961,1230,3751,29,125,993,2932,1022,3057
250540,201906,2959,6854,2442,6270,70,143,2132,5555,2202,5698
250550,201906,760,2465,670,2286,20,89,515,1714,535,1803
250560,201906,1648,4619,1478,4374,46,178,1226,3522,1272,3700
250570,201906,2627,7900,2258,7224,80,326,1785,5597,1865,5923
250580,201906,1039,2730,940,2586,52,173,772,2089,824,2262
250590,201906,822,2328,725,2182,15,78,603,1800,618,1878
250600,201906,8130,20969,6804,19224,313,958,5580,15664,5893,16622
250610,201906,3008,8421,2710,7986,116,438,2239,6494,2355,6932
250620,201906,729,1979,615,1774,14,61,467,1309,481,1370
250625,201906,2545,7386,2284,6960,42,227,1897,5600,1939,5827
250630,201906,9539,27135,7973,24225,875,2766,5213,15424,6088,18190
250640,201906,3293,9359,3028,8985,82,390,2568,7420,2650,7810
250650,201906,920,2281,768,2073,19,65,654,1710,673,1775
250660,201906,1578,3979,1349,3662,38,111,1130,2999,1168,3110
250670,201906,2307,7253,2131,6952,50,230,1831,5841,1881,6071
250680,201906,5933,13634,5264,12863,96,349,4769,11402,4865,11751
250690,201906,6691,15425,5836,14325,103,279,5196,12616,5299,12895
250700,201906,4307,12230,3780,11413,312,969,2810,8379,3122,9348
250710,201906,4423,12764,3824,11934,291,1021,2776,8628,3067,9649
250720,201906,2748,7291,2489,6917,41,194,2193,5994,2234,6188
250730,201906,4076,10921,3594,10267,117,423,2968,8220,3085,8643
250740,201906,1957,4976,1599,4488,108,313,1232,3421,1340,3734
250750,201906,98675,250945,85505,232234,7549,22192,61059,162389,68608,184581
250760,201906,2355,6113,2065,5640,106,318,1603,4243,1709,4561
250770,201906,3877,11948,3521,11461,343,1158,2546,8271,2889,9429
250780,201906,1715,4700,1441,4183,76,261,1065,3015,1141,3276
250790,201906,2441,7329,2127,6861,200,769,1398,4418,1598,5187
250800,201906,2457,6560,2121,6017,87,180,1738,4967,1825,5147
250810,201906,1272,3448,1036,3096,25,72,879,2641,904,2713
250820,201906,1900,5460,1783,5326,43,193,1613,4775,1656,4968
250830,201906,5700,17134,4803,15333,327,1229,3269,10128,3596,11357
250840,201906,791,2507,672,2259,18,73,484,1637,502,1710
250850,201906,1801,5465,1630,5171,41,210,1351,4174,1392,4384
250855,201906,955,2793,829,2578,65,224,617,1898,682,2122
250860,201906,3067,9351,2580,8468,484,1660,1385,4520,1869,6180
250870,201906,1042,2859,880,2585,33,116,709,2061,742,2177
250880,201906,1578,4118,1300,3707,136,386,917,2609,1053,2995
250890,201906,9725,26393,8863,25184,430,1844,7142,19302,7572,21146
250900,201906,2771,7952,2384,7222,75,274,1993,5920,2068,6194
250905,201906,2326,6689,2132,6400,50,204,1911,5717,1961,5921
250910,201906,5868,14721,4822,13489,105,379,4072,11450,4177,11829
250915,201906,1984,4777,1474,4227,12,28,1330,3872,1342,3900
250920,201906,3470,8941,3044,8275,329,845,2194,5883,2523,6728
250930,201906,2144,5860,1964,5614,57,229,1692,4726,1749,4955
250933,201906,1143,3416,1012,3168,19,105,765,2323,784,2428
250937,201906,709,1936,593,1741,23,83,434,1287,457,1370
250939,201906,1722,4692,1504,4376,57,196,1200,3437,1257,3633
250940,201906,3825,10443,3413,9875,53,219,2943,8449,2996,8668
250950,201906,1662,4282,1341,3871,23,98,1133,3230,1156,3328
250960,201906,1094,3244,963,3033,25,131,788,2388,813,2519
250970,201906,8257,21730,7221,20031,299,979,5795,15718,6094,16697
250980,201906,2472,6629,2224,6233,44,171,1873,5114,1917,5285
250990,201906,1977,6151,1693,5612,75,335,1254,4093,1329,4428
251000,201906,2084,5856,1706,5227,35,145,1412,4289,1447,4434
251010,201906,2606,7386,2370,7010,26,117,2144,6313,2170,6430
251020,201906,1665,4480,1509,4249,34,142,1325,3660,1359,3802
251030,201906,997,2693,836,2384,32,94,580,1613,612,1707
251040,201906,1845,5358,1563,4867,48,228,1224,3760,1272,3988
251050,201906,1097,2983,915,2634,46,153,660,1829,706,1982
251060,201906,1053,2266,783,1931,11,52,643,1534,654,1586
251065,201906,448,1237,360,1085,12,34,261,756,273,790
251070,201906,737,2001,637,1865,9,32,537,1558,546,1590
251080,201906,18612,48274,15337,43346,1855,5552,9977,28158,11832,33710
251090,201906,2614,7655,2228,6935,49,183,1831,5661,1880,5844
251100,201906,794,2500,712,2356,29,111,547,1749,576,1860
251110,201906,1679,4569,1451,4154,54,153,1113,3161,1167,3314
251120,201906,6995,20331,5978,19008,254,1056,4712,14812,4966,15868
251130,201906,3892,8926,3466,8441,155,396,3041,7361,3196,7757
251140,201906,4210,11874,3812,11299,89,357,3152,9222,3241,9579
251150,201906,2690,7838,2423,7411,116,503,1944,5753,2060,6256
251160,201906,2065,6154,1819,5797,95,361,1497,4705,1592,5066
251170,201906,1516,4211,1361,4024,38,159,1178,3450,1216,3609
251180,201906,2599,7120,2166,6517,182,538,1438,4296,1620,4834
251190,201906,4316,11389,4007,11029,52,253,3628,9787,3680,10040
251200,201906,4174,12463,3762,11930,92,383,3245,10325,3337,10708
251203,201906,929,3058,868,2927,33,137,651,2139,684,2276
251207,201906,1070,2997,842,2600,16,82,589,1761,605,1843
251210,201906,7379,19219,6019,17436,275,714,4598,13482,4873,14196
251220,201906,1172,2882,909,2519,50,121,706,1977,756,2098
251230,201906,4631,12828,4021,11808,135,533,3183,9074,3318,9607
251240,201906,3610,10026,3011,9043,151,488,2248,6586,2399,7074
251250,201906,9850,27020,8762,25193,825,2505,6366,17708,7191,20213
251260,201906,470,1397,431,1323,13,65,332,981,345,1046
251270,201906,4152,13014,3745,12474,106,436,3125,10573,3231,11009
251272,201906,1335,3650,1216,3481,37,166,1040,2876,1077,3042
251274,201906,893,2519,733,2242,49,176,497,1446,546,1622
251275,201906,1233,3445,1057,3172,46,217,789,2254,835,2471
251276,201906,1337,3586,1176,3378,35,181,955,2650,990,2831
251278,201906,560,1597,497,1494,37,106,371,1115,408,1221
251280,201906,2230,6195,1997,5818,52,207,1652,4715,1704,4922
251290,201906,5770,14001,5357,13471,182,654,4646,11210,4828,11864
251300,201906,811,2428,751,2340,9,31,635,1982,644,2013
251310,201906,2759,7957,2415,7398,60,307,1903,5654,1963,5961
251315,201906,1687,5349,1553,5108,66,238,1169,3785,1235,4023
251320,201906,1642,4346,1157,3506,30,109,839,2514,869,2623
251330,201906,2021,4757,1681,4354,24,86,1521,3958,1545,4044
251335,201906,1013,3115,922,2976,26,100,785,2485,811,2585
251340,201906,3640,9013,2914,8013,120,368,2171,5854,2291,6222
251350,201906,1071,3153,954,2960,30,136,794,2399,824,2535
251360,201906,1810,5117,1488,4672,23,102,1277,4010,1300,4112
251365,201906,701,1989,558,1687,10,34,423,1272,433,1306
251370,201906,22520,61565,19935,57919,2346,7091,13148,38351,15494,45442
251380,201906,1182,3435,1055,3215,19,111,882,2583,901,2694
251385,201906,724,1895,571,1620,17,54,427,1163,444,1217
251390,201906,6349,18975,5562,17664,594,2027,3473,10940,4067,12967
251392,201906,974,2684,807,2424,28,134,625,1825,653,1959
251394,201906,603,1800,494,1602,23,93,370,1178,393,1271
251396,201906,698,1883,595,1709,18,48,409,1154,427,1202
251398,201906,918,2387,661,1923,18,77,500,1410,518,1487
251400,201906,1177,2980,957,2669,28,101,740,1986,768,2087
251410,201906,1508,3587,1244,3202,22,98,1065,2641,1087,2739
251420,201906,1906,5142,1577,4762,47,188,1224,3646,1271,3834
251430,201906,1526,4720,1366,4455,31,151,1180,3815,1211,3966
251440,201906,1111,3138,909,2749,32,99,720,2182,752,2281
251445,201906,1500,4335,1396,4179,45,190,1159,3354,1204,3544
251450,201906,4375,13083,3946,12428,94,419,3301,10276,3395,10695
251455,201906,902,2730,815,2573,28,108,619,1929,647,2037
251460,201906,900,2594,799,2428,23,87,658,1993,681,2080
251465,201906,442,1311,378,1173,6,27,283,860,289,887
251470,201906,1163,3247,867,2622,73,237,530,1529,603,1766
251480,201906,981,2603,818,2317,20,88,623,1685,643,1773
251490,201906,1883,5076,1500,4541,60,196,1095,3308,1155,3504
251500,201906,1909,5482,1764,5263,48,197,1543,4545,1591,4742
251510,201906,2674,8134,2230,7222,127,474,1469,4640,1596,5114
251520,201906,946,2524,717,2088,70,192,467,1327,537,1519
251530,201906,14186,34555,11695,31416,123,697,10349,27246,10472,27943
251540,201906,2805,8339,2570,7894,108,421,2065,6184,2173,6605
251550,201906,3681,8898,2947,7955,81,219,2469,6647,2550,6866
251560,201906,574,1719,506,1607,73,242,333,1009,406,1251
251570,201906,892,2585,742,2270,20,92,571,1689,591,1781
251580,201906,1915,4598,1708,4296,64,219,1463,3550,1527,3769
251590,201906,1592,4076,1354,3797,60,193,1083,2933,1143,3126
251593,201906,885,2654,820,2547,86,289,530,1590,616,1879
251597,201906,2077,5838,1894,5593,26,108,1660,4830,1686,4938
251600,201906,6350,17338,5646,16252,174,566,4724,13391,4898,13957
251610,201906,3281,9342,2797,8439,298,868,1899,5776,2197,6644
251615,201906,1222,3088,992,2711,23,70,783,2095,806,2165
251620,201906,18164,42726,14325,38092,195,662,11976,32311,12171,32973
251630,201906,4645,11072,3764,9862,201,580,2900,7492,3101,8072
251640,201906,2067,5864,1871,5512,41,205,1595,4561,1636,4766
251650,201906,4048,10776,3542,10145,136,452,3025,8627,3161,9079
251660,201906,3440,10315,3032,9581,82,397,2515,7778,2597,8175
251670,201906,4057,11489,3577,10823,53,279,3162,9464,3215,9743
251675,201906,653,1901,590,1820,85,281,384,1184,469,1465
251680,201906,2538,6878,2124,6319,43,166,1702,5039,1745,5205
251690,201906,3168,9020,2684,8147,82,267,1999,5957,2081,6224
251700,201906,1934,5754,1721,5482,46,220,1456,4537,1502,4757
251710,201906,791,2078,543,1551,50,174,303,848,353,1022
251720,201906,1317,3770,1084,3349,26,116,825,2466,851,2582
251740,201906,621,1746,500,1518,36,138,353,1025,389,1163
260005,201906,29304,62370,24053,55626,1760,4173,18268,41302,20028,45475
260010,201906,9945,26396,8224,23630,490,1510,4932,14260,5422,15770
260020,201906,6737,16059,5797,14674,125,555,4815,11946,4940,12501
260030,201906,6461,16989,5495,15506,179,609,4405,12297,4584,12906
260040,201906,7759,20952,6418,18846,570,1635,4242,12721,4812,14356
260050,201906,13278,35355,11483,33340,239,879,10318,30131,10557,31010
260060,201906,3917,10040,3374,9152,185,501,2666,7179,2851,7680
260070,201906,10384,26652,8906,24463,454,1540,6958,18626,7412,20166
260080,201906,6474,14999,5679,13887,127,411,4711,11250,4838,11661
260090,201906,4803,12504,4292,11824,586,1586,2921,8130,3507,9716
260100,201906,3041,8292,2593,7612,80,329,2089,6023,2169,6352
260105,201906,5090,13803,4518,13001,137,504,3723,10547,3860,11051
260110,201906,22392,61357,20056,57994,1090,3625,16362,46560,17452,50185
260120,201906,14380,39156,12101,35632,1617,4729,7399,22210,9016,26939
260130,201906,2996,7941,2689,7463,208,624,1988,5410,2196,6034
260140,201906,13078,30090,11234,27800,634,1792,9270,22535,9904,24327
260150,201906,3533,8402,3037,7787,109,358,2596,6538,2705,6896
260160,201906,6604,17422,5587,16129,109,450,4905,14244,5014,14694
260170,201906,18674,46174,15946,42318,1298,3368,12169,32073,13467,35441
260180,201906,3322,9209,2920,8658,99,377,2453,7117,2552,7494
260190,201906,18369,37352,15455,33915,186,535,13546,29052,13732,29587
260200,201906,11013,26754,9529,24870,446,1099,8020,21038,8466,22137
260210,201906,11864,33884,10034,30891,355,1424,7963,24311,8318,25735
260220,201906,10307,25142,9538,24157,190,654,8348,20753,8538,21407
260230,201906,10583,26542,9241,24695,231,750,7676,20152,7907,20902
260240,201906,2712,8124,2370,7473,151,533,1805,5642,1956,6175
260250,201906,2191,5853,1920,5448,116,290,1453,4105,1569,4395
260260,201906,12837,33997,11362,31639,457,1573,8910,24234,9367,25807
260270,201906,4046,10172,3551,9538,144,574,2867,7479,3011,8053
260280,201906,12845,39032,11549,37218,541,2261,9694,30823,10235,33084
260290,201906,38840,101646,33730,93889,3882,11075,22287,61484,26169,72559
260300,201906,9765,26238,8467,24426,251,1054,6992,19997,7243,21051
260310,201906,4729,12546,4268,11939,309,823,3311,9366,3620,10189
260320,201906,7540,21938,6501,20149,277,839,5272,16391,5549,17230
260330,201906,2530,7809,2245,7215,71,270,1820,5711,1891,5981
260340,201906,2037,5507,1764,5085,35,165,1480,4149,1515,4314
260345,201906,24511,65759,20746,60105,3314,10301,10521,29748,13835,40049
260350,201906,5116,12517,4532,11804,103,321,3973,10271,4076,10592
260360,201906,2510,6608,2284,6186,43,190,1575,4181,1618,4371
260370,201906,5471,15883,4756,14646,244,870,3625,11058,3869,11928
260380,201906,4914,14758,4223,13603,181,649,3120,9901,3301,10550
260390,201906,4351,13223,3685,11857,208,699,2534,7984,2742,8683
260392,201906,3440,10971,3048,10470,135,792,2408,8227,2543,9019
260400,201906,16746,40100,14637,37291,591,1761,11411,27961,12002,29722
260410,201906,71387,175419,54882,152086,10087,29472,24701,69950,34788,99422
260415,201906,4477,12535,3857,11440,82,353,3072,8917,3154,9270
260420,201906,12807,26944,10843,24722,141,393,9857,22203,9998,22596
260430,201906,2808,8693,2399,7892,133,504,1660,5413,1793,5917
260440,201906,3661,9801,3206,9031,95,348,2601,7145,2696,7493
260450,201906,5650,14460,5094,13763,288,659,4181,11478,4469,12137
260460,201906,5145,15707,4415,14329,477,1778,2613,8247,3090,10025
260470,201906,4966,13016,4214,12144,110,276,3778,11081,3888,11357
260480,201906,4073,10815,3395,9832,242,862,2307,6697,2549,7559
260490,201906,5262,12304,4655,11369,52,190,4151,9921,4203,10111
260500,201906,6104,15614,5236,14348,454,1228,3640,10027,4094,11255
260510,201906,9500,23671,8016,21590,150,564,7009,18625,7159,19189
260515,201906,4233,11838,3296,10002,153,492,2163,6391,2316,6883
260520,201906,17258,40500,15162,37722,904,2281,12145,29823,13049,32104
260530,201906,9703,28045,8355,25915,188,874,7059,21576,7247,22450
260540,201906,7009,15444,6250,14458,327,737,5387,12404,5714,13141
260545,201906,43,142,17,80,4,15,4,18,8,33
260550,201906,3009,8534,2488,7614,141,582,1625,4845,1766,5427
260560,201906,5909,15287,5055,14041,149,602,4195,11369,4344,11971
260570,201906,7611,21113,6721,19867,445,1450,5198,15302,5643,16752
260580,201906,4431,10595,3954,9951,28,117,3611,9024,3639,9141
260590,201906,6676,15716,5626,14514,249,652,4620,12006,4869,12658
260600,201906,30163,79710,24708,71095,1291,4132,18350,51889,19641,56021
260610,201906,7056,18836,6411,17955,418,1289,4759,13163,5177,14452
260620,201906,15674,42124,13859,39422,1470,4643,9613,26743,11083,31386
260630,201906,2319,6367,1922,5716,37,162,1537,4464,1574,4626
260640,201906,20702,48217,17607,44572,930,2456,13943,34940,14873,37396
260650,201906,5777,15852,4793,14557,173,731,4028,12101,4201,12832
260660,201906,7190,19182,6186,17808,171,748,5196,14594,5367,15342
260670,201906,2182,5737,1805,5161,81,199,1351,3827,1432,4026
260680,201906,26490,64753,22311,58546,1825,5119,14999,38512,16824,43631
260690,201906,3623,9362,2956,8355,111,405,2318,6456,2429,6861
260700,201906,5944,17374,5630,17011,23,72,5457,16619,5480,16691
260710,201906,1329,3561,1182,3366,46,170,894,2542,940,2712
260720,201906,21981,57989,19354,54150,2397,6978,12825,35327,15222,42305
260730,201906,7334,21772,6515,20575,316,1193,5339,16585,5655,17778
260740,201906,1344,3767,1118,3394,11,62,886,2723,897,2785
260750,201906,6865,19361,5907,18088,132,439,5259,16313,5391,16752
260760,201906,5589,13414,4832,12479,215,629,3892,10055,4107,10684
260765,201906,7720,22924,6783,21585,504,2104,4682,14472,5186,16576
260770,201906,3840,9937,3270,8968,89,304,2599,7012,2688,7316
260775,201906,5216,14055,4628,13145,221,838,3530,9675,3751,10513
260780,201906,3645,10950,3255,10312,293,1127,2095,6430,2388,7557
260790,201906,115855,265190,96916,239794,15031,36435,59408,146542,74439,182977
260795,201906,3018,8009,2601,7422,117,402,1967,5596,2084,5998
260800,201906,5354,12610,4813,11841,169,534,4183,9934,4352,10468
260805,201906,3598,10405,3033,9380,182,671,2190,6623,2372,7294
260810,201906,6614,18033,5836,16531,546,1523,4142,11491,4688,13014
260820,201906,4414,10583,3897,9912,139,493,3187,7892,3326,8385
260825,201906,2925,8826,2531,8109,121,455,1871,5924,1992,6379
260830,201906,4291,12551,3577,11247,466,1326,2269,7318,2735,8644
260840,201906,4144,10954,3699,10298,204,554,3064,8516,3268,9070
260845,201906,4159,11244,3750,10502,254,702,2777,7694,3031,8396
260850,201906,4831,13730,4124,12347,372,1206,2647,7697,3019,8903
260860,201906,3481,9915,2954,8998,90,337,2372,7026,2462,7363
260870,201906,4435,10721,3835,9967,95,364,3379,8598,3474,8962
260875,201906,6761,17289,5583,15493,627,1778,3711,10250,4338,12028
260880,201906,9693,27334,8452,25125,474,1391,6627,19765,7101,21156
260890,201906,13184,34391,11564,31925,727,2234,8271,22236,8998,24470
260900,201906,5223,15114,4390,13818,305,1120,2951,9136,3256,10256
260910,201906,3153,8721,2734,8073,106,365,2137,6240,2243,6605
260915,201906,5175,15227,4567,14510,58,289,4127,13141,4185,13430
260920,201906,3313,8455,2846,7921,99,288,2416,6746,2515,7034
260930,201906,3542,11453,3102,10650,169,728,2325,7803,2494,8531
260940,201906,14518,35307,12655,32582,808,2257,9577,24109,10385,26366
260950,201906,6640,18290,5376,15969,445,1539,3268,9207,3713,10746
260960,201906,66328,153812,53692,136872,6585,17549,32906,82415,39491,99964
260970,201906,5277,14213,4713,13451,171,462,3631,10365,3802,10827
260980,201906,4473,13174,4022,12591,68,256,3617,11399,3685,11655
260990,201906,17811,50012,15141,46385,894,3138,11601,35167,12495,38305
261000,201906,16004,38652,13541,35340,458,1690,10614,27010,11072,28700
261010,201906,2421,6323,2118,5914,74,196,1838,5134,1912,5330
261020,201906,6119,16941,5244,15360,252,904,4155,11688,4407,12592
261030,201906,4087,11699,3538,10776,160,595,2777,8235,2937,8830
261040,201906,5184,15425,4216,13488,201,795,3066,9612,3267,10407
261050,201906,7658,20444,6953,19269,490,1119,5046,14025,5536,15144
261060,201906,13706,35022,12066,32941,382,1236,9910,26741,10292,27977
261070,201906,60469,134282,50304,120641,3063,7244,37615,88458,40678,95702
261080,201906,6269,15690,5769,15032,158,423,5262,13682,5420,14105
261090,201906,18289,44555,16326,42007,354,1235,14032,35469,14386,36704
261100,201906,8199,23153,7096,21489,581,1896,5080,15380,5661,17276
261110,201906,61322,174426,51646,157352,8782,27994,28078,85431,36860,113425
261120,201906,3797,9442,3261,8721,92,256,2801,7481,2893,7737
261130,201906,7392,18018,6508,16848,127,369,5731,14750,5858,15119
261140,201906,3549,8335,3177,7832,175,470,2545,6152,2720,6622
261150,201906,5280,14090,4667,13132,94,367,4011,11122,4105,11489
261153,201906,1870,5614,1632,5175,64,253,1120,3534,1184,3787
261160,201906,206333,490189,169275,438135,42107,112117,68770,180689,110877,292806
261170,201906,5938,15146,5310,14187,361,936,4183,11085,4544,12021
261180,201906,9789,24925,8612,23363,512,1465,6161,16638,6673,18103
261190,201906,4676,13984,4192,13137,238,1000,3148,9520,3386,10520
261200,201906,3366,7817,3005,7333,145,374,2493,5963,2638,6337
261210,201906,1932,4697,1635,4283,66,206,1365,3512,1431,3718
261220,201906,13678,39331,11364,34870,1436,4764,6404,19322,7840,24086
261230,201906,4154,11976,3460,11003,67,290,2843,9122,2910,9412
261240,201906,5127,13198,4522,12242,252,712,3708,9904,3960,10616
261245,201906,3547,10145,3010,9185,92,420,2361,6952,2453,7372
261247,201906,2911,8801,2440,7925,139,516,1687,5408,1826,5924
261250,201906,21355,49544,18414,46058,1730,3998,13850,35461,15580,39459
261255,201906,3965,11870,3338,10646,146,645,2448,7510,2594,8155
261260,201906,12949,34800,11152,32482,408,1671,9358,26848,9766,28519
261270,201906,4060,10589,3613,9973,168,596,3000,8082,3168,8678
261280,201906,2578,7302,2278,6773,86,340,1775,5137,1861,5477
261290,201906,2948,7752,2512,7236,85,337,2031,5863,2116,6200
261300,201906,11844,33877,10083,30812,564,2136,7247,21629,7811,23765
261310,201906,8566,22300,7310,20481,780,2414,5123,13968,5903,16382
261320,201906,5975,17023,5215,15710,94,421,4339,12823,4433,13244
261330,201906,5939,14779,5384,14026,144,504,4668,11936,4812,12440
261340,201906,4167,12128,3632,11392,179,723,2857,8820,3036,9543
261350,201906,8693,25606,7754,24011,134,658,6291,19074,6425,19732
261360,201906,8221,20216,6979,18450,260,819,5502,14055,5762,14874
261370,201906,21995,56498,18636,51800,2373,6634,11674,32592,14047,39226
261380,201906,3991,12283,3568,11515,473,1670,2332,7378,2805,9048
261390,201906,16121,46575,13661,42525,1241,4200,8854,27361,10095,31561
261400,201906,4648,14877,4035,13584,165,773,2994,9780,3159,10553
261410,201906,9361,23976,7812,21486,533,1493,6022,16280,6555,17773
261420,201906,7280,22433,6643,21619,801,3000,4582,14789,5383,17789
261430,201906,3444,9753,2897,8893,79,311,2374,7171,2453,7482
261440,201906,1455,4388,1230,3941,40,199,860,2634,900,2833
261450,201906,15051,40754,13428,38175,249,997,11131,31420,11380,32417
261460,201906,7445,20559,6618,19314,184,700,5531,15961,5715,16661
261470,201906,4203,10521,3711,9871,41,195,3140,8332,3181,8527
261480,201906,4913,15306,4263,14203,232,964,3228,10526,3460,11490
261485,201906,4988,14237,4279,13103,385,1296,2930,8808,3315,10104
261500,201906,5643,14827,4977,13911,438,1097,3426,9905,3864,11002
261510,201906,1856,5630,1601,5179,66,244,1177,3860,1243,4104
261520,201906,2401,7388,2194,6966,94,344,1517,4816,1611,5160
261530,201906,11349,34092,9308,30126,1106,4178,4540,14229,5646,18407
261540,201906,7972,23180,7175,21969,1112,3380,4051,12922,5163,16302
261550,201906,3611,9704,3159,8984,214,707,2255,6254,2469,6961
261560,201906,7698,23122,6697,21615,354,1382,4978,16030,5332,17412
261570,201906,3469,9418,2789,8311,209,761,1914,5540,2123,6301
261580,201906,6565,17491,5788,16438,122,560,5154,14429,5276,14989
261590,201906,2695,6984,2152,6185,73,240,1595,4548,1668,4788
261600,201906,5133,13266,4304,12005,412,1033,2863,8288,3275,9321
261610,201906,2340,6468,1938,5797,97,370,1391,4101,1488,4471
261618,201906,2567,6509,2241,6026,75,230,1783,4735,1858,4965
261620,201906,4037,11639,3749,11205,878,2365,2262,7132,3140,9497
261630,201906,6432,18147,5487,16351,396,1436,3615,10262,4011,11698
261640,201906,36627,83349,31573,76977,1716,3539,24220,60397,25936,63936
261650,201906,4172,10439,3630,9728,153,525,2713,7164,2866,7689
270010,201906,4251,14566,3717,13607,174,975,2909,10362,3083,11337
270020,201906,3885,9917,3440,9336,189,613,2857,7597,3046,8210
270030,201906,33160,91984,28411,84389,4034,11787,18443,55058,22477,66845
270040,201906,11129,30122,9598,28289,416,1713,7836,22755,8252,24468
270050,201906,5528,12782,4693,11852,185,465,4142,10486,4327,10951
270060,201906,2037,5322,1724,4954,124,331,1370,3985,1494,4316
270070,201906,4583,13061,4011,12247,148,569,3349,10034,3497,10603
270080,201906,1432,3975,1187,3551,43,147,901,2581,944,2728
270090,201906,1882,5748,1659,5320,72,320,1317,4088,1389,4408
270100,201906,5560,15018,4843,13941,202,786,3917,10991,4119,11777
270110,201906,3246,7887,2616,7132,145,358,2045,5801,2190,6159
270120,201906,2928,7976,2545,7482,79,325,2162,6276,2241,6601
270130,201906,5131,13499,4439,12675,159,521,3751,10744,3910,11265
270135,201906,2051,4936,1735,4577,55,181,1549,4054,1604,4235
270140,201906,9750,22826,7921,20297,353,1318,6287,15220,6640,16538
270150,201906,2725,8143,2537,7869,6,29,2428,7515,2434,7544
270160,201906,5835,16457,5135,15617,68,409,4729,14234,4797,14643
270170,201906,3445,10144,2932,9427,218,987,2163,6669,2381,7656
270180,201906,2244,6999,2047,6734,48,240,1802,5842,1850,6082
270190,201906,1664,4975,1493,4756,51,246,1285,4026,1336,4272
270200,201906,2420,7405,2102,6958,132,517,1519,4944,1651,5461
270210,201906,5711,13687,4946,12818,124,473,4488,11440,4612,11913
270220,201906,1438,3877,1163,3485,220,671,634,1901,854,2572
270230,201906,9225,26302,7679,23873,701,2502,5268,16072,5969,18574
270235,201906,5868,18180,5090,16900,160,706,4071,13335,4231,14041
270240,201906,10524,28804,8570,26274,929,3153,6129,18696,7058,21849
270250,201906,2841,7310,2502,6837,222,577,1914,5277,2136,5854
270255,201906,4571,13162,3526,11207,140,570,2582,8028,2722,8598
270260,201906,5630,16755,5132,15930,119,610,4410,13268,4529,13878
270270,201906,1046,2760,895,2564,118,337,627,1775,745,2112
270280,201906,3921,9470,3116,8447,491,829,2141,6275,2632,7104
270290,201906,7694,24532,6930,23252,236,1056,5881,19482,6117,20538
270300,201906,4128,11036,3254,10075,172,532,2461,7752,2633,8284
270310,201906,7083,19884,6121,18454,137,706,5165,15131,5302,15837
270320,201906,5586,16370,4889,15043,517,1652,3404,10215,3921,11867
270330,201906,3842,12754,3443,12133,262,1110,2636,9197,2898,10307
270340,201906,1637,4529,1406,4216,61,193,1151,3422,1212,3615
270350,201906,1837,4488,1527,4111,182,545,1038,2797,1220,3342
270360,201906,2478,6428,2217,6123,74,201,2011,5575,2085,5776
270370,201906,1407,4403,1274,4146,48,214,1023,3272,1071,3486
270375,201906,3075,7294,2602,6751,18,58,2434,6318,2452,6376
270380,201906,5621,16231,4741,15031,635,2016,3015,9903,3650,11919
270390,201906,1203,3070,986,2807,24,115,796,2238,820,2353
270400,201906,6222,16745,5270,15239,221,720,4105,11636,4326,12356
270410,201906,4574,13489,3992,12538,181,662,3233,10055,3414,10717
270420,201906,5505,16539,5028,15844,163,772,4257,13105,4420,13877
270430,201906,138516,339532,110302,302988,22620,64798,50724,141220,73344,206018
270440,201906,4796,13090,4126,12265,101,456,3519,10312,3620,10768
270450,201906,6791,18769,6077,17902,267,1004,5086,14872,5353,15876
270460,201906,3811,8432,3331,7875,106,255,3045,7124,3151,7379
270470,201906,11029,31384,9640,29341,842,2765,7118,21660,7960,24425
270480,201906,2858,7779,2460,7189,134,533,1957,5523,2091,6056
270490,201906,959,2725,837,2573,52,185,655,1980,707,2165
270500,201906,4941,15170,4405,14336,232,949,3490,11167,3722,12116
270510,201906,5536,15212,4751,14141,400,1574,3475,9853,3875,11427
270520,201906,3923,11403,3106,9943,673,2189,1230,4125,1903,6314
270530,201906,1185,3505,1032,3259,50,157,761,2411,811,2568
270540,201906,2159,6449,1900,6110,66,306,1631,5146,1697,5452
270550,201906,6713,17778,5504,16434,561,1426,4135,12798,4696,14224
270560,201906,3047,8133,2678,7626,171,542,2065,5775,2236,6317
270570,201906,4070,11587,3459,10639,106,436,2822,8538,2928,8974
270580,201906,2302,6539,2095,6231,100,304,1796,5313,1896,5617
270590,201906,1614,4808,1488,4639,16,84,1405,4364,1421,4448
270600,201906,2748,8555,2482,8131,60,316,2176,7009,2236,7325
270610,201906,3720,9778,3176,9051,94,359,2802,7879,2896,8238
270620,201906,1220,3808,1119,3623,47,193,937,2943,984,3136
270630,201906,16825,42293,14690,39295,702,2294,12144,31778,12846,34072
270640,201906,5428,15716,4739,14632,183,753,3825,11490,4008,12243
270642,201906,2468,8038,2200,7596,146,700,1686,5623,1832,6323
270644,201906,3563,8965,2907,8099,235,630,2189,6201,2424,6831
270650,201906,3142,9397,2780,8864,426,1513,1843,5697,2269,7210
270660,201906,2093,5267,1707,4723,84,301,1279,3465,1363,3766
270670,201906,15701,37360,13200,34304,517,1606,11003,28006,11520,29612
270680,201906,5326,13225,4771,12601,134,215,4445,11897,4579,12112
270690,201906,9023,22741,7512,20846,862,2280,5434,15153,6296,17433
270700,201906,534,1615,468,1498,26,108,347,1104,373,1212
270710,201906,5557,16866,5039,16089,252,1113,4117,12818,4369,13931
270720,201906,3447,10396,3057,9724,71,403,2672,8304,2743,8707
270730,201906,8045,18316,7177,17352,275,642,5670,14967,5945,15609
270740,201906,2350,6284,2088,5964,102,369,1718,4785,1820,5154
270750,201906,5568,15048,4912,14183,145,607,4224,12078,4369,12685
270760,201906,3321,9439,2890,8843,63,330,2433,7324,2496,7654
270770,201906,21248,52012,16749,46488,2934,7487,9844,28934,12778,36421
270780,201906,1756,5147,1635,4973,97,360,1350,4033,1447,4393
270790,201906,1540,4486,1305,4136,113,381,839,2621,952,3002
270800,201906,10700,29721,9592,28152,375,1478,8160,23377,8535,24855
270810,201906,3263,9442,2569,8242,195,777,1767,5530,1962,6307
270820,201906,1675,5051,1410,4608,62,272,1096,3486,1158,3758
270830,201906,5258,12855,4273,11633,198,675,3389,9101,3587,9776
270840,201906,8164,24389,7310,23178,198,1077,6365,19623,6563,20700
270850,201906,8919,21772,8012,20638,596,1805,6662,16763,7258,18568
270860,201906,12365,29660,10356,27256,415,1381,8587,22053,9002,23434
270870,201906,2086,6043,1784,5520,207,677,1226,3819,1433,4496
270880,201906,8121,24373,7278,23124,230,1038,6006,18714,6236,19752
270890,201906,2667,7378,2299,6871,183,618,1618,4749,1801,5367
270895,201906,2951,9491,2730,9189,76,426,2407,7916,2483,8342
270900,201906,1804,4697,1367,4003,47,146,1076,3114,1123,3260
270910,201906,3870,11418,3331,10513,117,463,2617,8136,2734,8599
270915,201906,9178,27101,7549,24303,730,2761,5039,15782,5769,18543
270920,201906,5271,16518,4796,15704,214,1022,3868,12196,4082,13218
270930,201906,17221,40908,13495,36499,1845,4504,9166,25692,11011,30196
270940,201906,6267,17273,5467,16276,242,1170,4335,12450,4577,13620
280010,201906,676,1863,548,1591,17,73,383,994,400,1067
280020,201906,4760,12359,4075,11272,520,1367,2695,7515,3215,8882
280030,201906,73475,175606,57571,152926,13321,35661,24181,66877,37502,102538
280040,201906,3018,8487,2633,7903,266,843,1752,5178,2018,6021
280050,201906,3921,11257,3371,10343,541,1742,1988,6100,2529,7842
280060,201906,5478,14809,4398,13136,792,2436,2169,6721,2961,9157
280067,201906,6930,17494,5888,15882,350,1006,4232,11120,4582,12126
280070,201906,1909,5802,1791,5588,91,335,1490,4559,1581,4894
280100,201906,3863,10570,3266,9590,336,1017,2261,6606,2597,7623
280110,201906,1360,3734,1185,3462,21,104,1020,2911,1041,3015
280120,201906,7489,22079,6728,20816,724,2055,4951,15592,5675,17647
280130,201906,9100,21671,7996,20084,497,1336,6340,15769,6837,17105
280140,201906,5487,13397,4838,12511,253,719,4019,10274,4272,10993
280150,201906,3997,10150,3484,9479,208,560,2834,7672,3042,8232
280160,201906,1257,3633,1039,3251,112,371,670,2041,782,2412
280170,201906,5165,13698,4599,12936,246,727,3667,10249,3913,10976
280190,201906,1211,2754,1036,2510,65,167,808,1909,873,2076
280200,201906,1319,3489,1068,3082,100,363,736,2050,836,2413
280210,201906,15960,41000,13918,38091,1718,4999,8647,23544,10365,28543
280220,201906,1755,4723,1492,4354,39,214,1204,3487,1243,3701
280230,201906,3989,10226,3477,9475,273,686,2516,6821,2789,7507
280240,201906,3392,9093,3045,8569,60,306,2573,7031,2633,7337
280250,201906,842,2131,681,1874,74,224,407,1071,481,1295
280260,201906,2125,5228,1901,4952,42,108,1742,4551,1784,4659
280270,201906,2300,6518,2043,6112,128,464,1688,4907,1816,5371
280280,201906,4096,12562,3662,11939,456,1388,2561,8621,3017,10009
280290,201906,17243,46875,14982,43598,1461,4599,10006,29276,11467,33875
280300,201906,11404,28457,9893,26809,261,876,7657,22062,7918,22938
280310,201906,1356,3524,1126,3136,36,130,832,2236,868,2366
280320,201906,8661,23796,7501,22012,858,2561,4940,14273,5798,16834
280330,201906,4723,11873,3971,10751,270,740,2907,7806,3177,8546
280340,201906,5518,11440,4671,10517,242,427,4025,9215,4267,9642
280350,201906,24844,59951,21720,55638,1320,3703,16707,41944,18027,45647
280360,201906,5913,16650,5175,15365,852,2559,2918,8736,3770,11295
280370,201906,2224,5486,1812,4763,65,179,1420,3646,1485,3825
280380,201906,983,2734,848,2547,91,288,541,1620,632,1908
280390,201906,3583,9095,2959,8062,134,372,2310,6211,2444,6583
280400,201906,3973,10316,3411,9484,469,1205,2122,6113,2591,7318
280410,201906,2203,6247,1763,5473,191,637,1046,3150,1237,3787
280420,201906,4332,11684,3940,11155,92,335,3553,9998,3645,10333
280430,201906,2055,5091,1796,4736,74,292,1434,3654,1508,3946
280440,201906,4366,11851,3824,11018,211,720,3111,8720,3322,9440
280445,201906,2310,5876,2038,5386,55,187,1521,3826,1576,4013
280450,201906,10348,23751,9045,22023,566,1091,7192,17790,7758,18881
280460,201906,6801,16453,6155,15523,452,1084,5040,12647,5492,13731
280470,201906,1739,4959,1492,4504,56,217,1093,3211,1149,3428
280480,201906,40395,99846,35100,92421,2896,8361,24990,64375,27886,72736
280490,201906,3785,10857,3267,9978,89,397,2491,7338,2580,7735
280500,201906,983,2389,834,2181,35,135,687,1761,722,1896
280510,201906,2558,6726,2202,6198,81,307,1677,4614,1758,4921
280520,201906,1621,4151,1425,3886,76,216,1134,3044,1210,3260
280530,201906,2634,6486,2256,6004,314,727,1568,4272,1882,4999
280540,201906,8980,24252,8173,23054,240,903,7082,19584,7322,20487
280550,201906,6754,15881,5452,13994,240,789,4315,10674,4555,11463
280560,201906,7111,20221,6657,19538,152,583,5790,16763,5942,17346
280570,201906,6419,15923,5202,14356,224,787,3799,10328,4023,11115
280580,201906,5572,15252,4793,14024,525,1449,3330,9831,3855,11280
280590,201906,2992,6881,2504,6292,125,480,1898,4500,2023,4980
280600,201906,3503,9555,3098,8956,173,562,2201,6322,2374,6884
280610,201906,2516,6277,2265,5917,153,396,1829,4728,1982,5124
280620,201906,5362,13443,4560,12352,422,980,3206,8995,3628,9975
280630,201906,3779,10889,3438,10381,169,621,2766,8267,2935,8888
280640,201906,2416,6535,2157,6244,68,205,1904,5520,1972,5725
280650,201906,1249,3272,979,2855,101,336,679,1892,780,2228
280660,201906,3238,7560,2849,7085,107,277,2491,6139,2598,6416
280670,201906,19491,44503,16901,41168,957,2538,13384,32275,14341,34813
280680,201906,2746,6741,2347,6142,196,396,1686,4423,1882,4819
280690,201906,950,2436,790,2210,28,86,592,1617,620,1703
280700,201906,1132,2888,967,2625,22,91,758,2011,780,2102
280710,201906,15082,34043,12785,31408,495,961,10987,27465,11482,28426
280720,201906,2708,6067,2196,5468,91,274,1481,3867,1572,4141
280730,201906,1061,2745,940,2543,52,162,703,1837,755,1999
280740,201906,14230,34982,12121,31753,930,2548,8431,21608,9361,24156
280750,201906,3560,10111,3115,9319,181,638,2231,6535,2412,7173
280760,201906,6209,17128,5472,15964,552,1559,3671,10936,4223,12495
290010,201906,3124,6657,2069,4996,9,32,1681,3859,1690,3891
290020,201906,5450,14501,4959,13848,372,739,4136,11911,4508,12650
290030,201906,4324,10374,3595,9549,176,429,3005,8044,3181,8473
290035,201906,5236,11565,4258,10285,372,614,3333,8415,3705,9029
290040,201906,4287,10502,3639,9707,122,328,2856,7896,2978,8224
290050,201906,2092,6689,1739,5926,126,522,1169,3876,1295,4398
290060,201906,1319,3246,976,2669,80,278,653,1720,733,1998
290070,201906,35637,80513,30696,74200,2005,5112,22967,54823,24972,59935
290080,201906,5399,16028,4598,14808,499,1726,3128,10153,3627,11879
290090,201906,2163,4204,1557,3552,29,80,1401,3162,1430,3242
290100,201906,9830,26228,8085,23566,1181,3240,4604,13846,5785,17086
290110,201906,5087,13787,4571,12881,397,1170,3226,8991,3623,10161
290115,201906,4122,11982,3507,10902,239,822,2600,8000,2839,8822
290120,201906,6561,16279,5491,14895,132,496,4735,12605,4867,13101
290130,201906,4605,11281,3650,10088,143,468,2873,7849,3016,8317
290135,201906,4295,10181,3468,8806,228,595,2586,6357,2814,6952
290140,201906,4593,12299,3628,10993,110,428,3065,9213,3175,9641
290150,201906,2464,6535,2144,6125,161,489,1608,4569,1769,5058
290160,201906,3154,7552,2839,7141,299,673,2165,5472,2464,6145
290170,201906,3295,8557,2930,8138,110,323,2595,7255,2705,7578
290180,201906,2984,8118,2449,7272,80,293,1964,5768,2044,6061
290190,201906,4124,11955,3643,11296,163,695,2965,9015,3128,9710
290195,201906,2346,5931,1869,5252,35,163,1532,4275,1567,4438
290200,201906,4063,11413,3344,10219,227,765,2540,7690,2767,8455
290205,201906,3400,8802,2990,8193,140,535,2352,6216,2492,6751
290210,201906,13300,37289,11744,34934,943,2559,8956,27198,9899,29757
290220,201906,2805,7138,2480,6724,155,453,1984,5317,2139,5770
290225,201906,3336,7162,2630,6406,200,410,2183,5388,2383,5798
290230,201906,2522,6692,2295,6425,38,140,2045,5685,2083,5825
290240,201906,3646,9265,2977,8403,99,341,2470,6909,2569,7250
290250,201906,4056,11810,3460,10941,136,471,2789,8971,2925,9442
290260,201906,5429,13583,4447,12166,201,694,3572,9520,3773,10214
290265,201906,3537,10437,2855,9084,149,565,2099,6579,2248,7144
290270,201906,11280,38530,10647,37419,567,2543,8519,29486,9086,32029
290280,201906,6023,18162,5217,16577,337,1233,3705,11599,4042,12832
290290,201906,10035,29529,8225,26129,847,2960,5420,16919,6267,19879
290300,201906,4224,11609,3159,9582,180,610,2219,6723,2399,7333
290310,201906,1545,3948,1278,3603,83,333,959,2599,1042,2932
290320,201906,24285,64807,19558,57421,4377,12773,9334,28667,13711,41440
290323,201906,3733,10218,3256,9495,99,320,2599,7522,2698,7842
290327,201906,4272,12333,3607,11040,280,816,2509,7640,2789,8456
290330,201906,2096,4506,1667,4034,45,84,1471,3577,1516,3661
290340,201906,5668,14769,4471,13254,495,1535,3200,9602,3695,11137
290350,201906,4751,13266,3940,11886,300,961,2801,8446,3101,9407
290360,201906,5039,13377,4416,12550,128,390,3793,10778,3921,11168
290370,201906,5312,12910,3932,11129,193,473,2900,8359,3093,8832
290380,201906,5579,14948,4746,13791,126,357,4118,12067,4244,12424
290390,201906,14390,40949,12151,37569,1239,3810,8226,25781,9465,29591
290395,201906,2769,8234,2304,7414,73,363,1776,5598,1849,5961
290400,201906,3668,9991,2966,8838,87,381,2263,6559,2350,6940
290405,201906,4591,13560,3900,12332,259,878,2750,8825,3009,9703
290410,201906,5728,15921,4448,13770,117,559,3369,10063,3486,10622
290420,201906,3004,8475,2464,7607,81,308,1894,5806,1975,6114
290430,201906,3115,8728,2556,7830,261,838,1681,5124,1942,5962
290440,201906,2770,7092,1994,5858,44,141,1434,4272,1478,4413
290450,201906,3322,8813,2693,7874,156,508,2018,5861,2174,6369
290460,201906,11721,33120,9997,29827,2091,6301,4626,13741,6717,20042
290470,201906,4462,11261,3321,9655,345,1102,1917,5621,2262,6723
290475,201906,6456,18870,5456,17052,104,538,4409,13450,4513,13988
290480,201906,1765,4535,1488,4129,108,341,1011,2674,1119,3015
290485,201906,4509,13374,3998,12599,125,639,3375,10404,3500,11043
290490,201906,9129,21714,8135,20351,512,1251,6390,16088,6902,17339
290500,201906,3929,11998,3066,10080,534,1847,1396,4458,1930,6305
290510,201906,3388,8638,2849,7934,81,284,2431,6676,2512,6960
290515,201906,3716,10132,3187,9440,62,186,2796,8453,2858,8639
290520,201906,11236,32595,8772,27780,514,1869,5555,17264,6069,19133
290530,201906,4986,14292,4260,13095,150,544,3538,10859,3688,11403
290540,201906,3472,9289,3116,8854,73,251,2824,7982,2897,8233
290550,201906,4308,11290,3755,10640,21,83,3459,9923,3480,10006
290560,201906,6598,17260,5073,14957,456,1637,3311,9399,3767,11036
290570,201906,42790,107496,38614,102112,2609,7136,30842,80924,33451,88060
290580,201906,7801,23288,6804,21803,645,2085,4915,16084,5560,18169
290590,201906,7049,21907,6009,20036,146,625,4870,16236,5016,16861
290600,201906,18552,52134,16586,49023,672,2188,13215,38909,13887,41097
290610,201906,2520,8015,1989,6923,103,427,1371,4704,1474,5131
290620,201906,6608,18523,5696,16992,207,632,4730,14037,4937,14669
290630,201906,9076,22339,7271,19969,608,1618,5570,15412,6178,17030
290640,201906,2747,7201,2092,6210,72,248,1544,4563,1616,4811
290650,201906,12499,32430,11280,30930,2811,7292,6430,18677,9241,25969
290660,201906,3698,9504,3095,8628,53,122,2302,6683,2355,6805
290670,201906,6657,18850,5723,17289,432,1263,4341,13257,4773,14520
290680,201906,10653,29952,9056,27580,219,1153,7392,21925,7611,23078
290682,201906,4640,12277,4085,11494,134,322,3442,9732,3576,10054
290685,201906,3403,7809,2417,6394,180,460,1534,4301,1714,4761
290687,201906,6679,18337,5416,16223,735,2108,3390,10432,4125,12540
290689,201906,2778,7926,2254,6988,124,388,1662,5170,1786,5558
290690,201906,5683,14786,4612,13278,374,1115,3273,9323,3647,10438
290700,201906,2611,7204,2320,6819,83,277,1892,5586,1975,5863
290710,201906,8528,24014,7252,22233,174,741,6121,18642,6295,19383
290720,201906,18962,51903,17247,49285,962,3179,13691,38560,14653,41739
290730,201906,7235,17468,6171,16204,300,660,4776,12633,5076,13293
290740,201906,1060,2898,807,2459,39,156,620,1885,659,2041
290750,201906,11007,28180,9536,25666,790,2295,6775,17623,7565,19918
290755,201906,2085,5901,1688,5161,103,346,1180,3589,1283,3935
290760,201906,3816,11229,3041,9726,246,733,1948,6417,2194,7150
290770,201906,2621,8498,2372,8192,57,299,1981,6886,2038,7185
290780,201906,8372,20811,7212,19249,313,705,5679,15378,5992,16083
290790,201906,4639,12797,4048,11989,144,452,3398,10150,3542,10602
290800,201906,7220,15025,5177,12634,353,817,3789,9363,4142,10180
290810,201906,5606,14951,4486,13258,113,401,3320,9892,3433,10293
290820,201906,4971,13482,4465,12707,216,667,3293,9452,3509,10119
290830,201906,4600,10486,4133,9880,53,147,3587,8443,3640,8590
290840,201906,16700,45386,14621,42089,1859,4536,9476,28665,11335,33201
290850,201906,6388,15939,5772,15252,307,747,4835,12969,5142,13716
290860,201906,5955,17604,5217,16715,222,759,4382,14250,4604,15009
290870,201906,4792,13316,3686,11275,119,420,2611,7881,2730,8301
290880,201906,1391,3524,1109,3146,71,184,774,2256,845,2440
290890,201906,8930,18479,8015,17421,154,380,7473,16104,7627,16484
290900,201906,2340,6223,1786,5284,100,287,1138,3296,1238,3583
290910,201906,5107,12519,3935,10731,46,175,3247,8737,3293,8912
290920,201906,5128,12790,4685,12264,60,135,4391,11547,4451,11682
290930,201906,7872,22125,6356,19470,195,898,4960,14697,5155,15595
290940,201906,3746,10534,3108,9615,171,645,2443,7548,2614,8193
290950,201906,1487,3799,1232,3420,63,170,876,2443,939,2613
290960,201906,5460,14581,4902,13885,151,444,4122,11653,4273,12097
290970,201906,3513,10239,2860,9089,133,465,2156,6822,2289,7287
290980,201906,11758,28860,9950,26024,870,2434,6075,15453,6945,17887
290990,201906,9372,25405,8210,23480,302,1200,6766,18678,7068,19878
291000,201906,3433,9087,2721,8189,168,466,2160,6601,2328,7067
291005,201906,15058,37167,13294,34870,916,2405,10696,27899,11612,30304
291010,201906,3006,9146,2439,7949,132,475,1612,5131,1744,5606
291020,201906,1292,3234,1025,2731,27,96,730,1835,757,1931
291030,201906,2418,6018,1684,4710,99,263,1089,2953,1188,3216
291040,201906,5303,14972,4526,13846,195,835,3548,10693,3743,11528
291050,201906,7465,20257,6450,18777,785,2467,4439,12726,5224,15193
291060,201906,5851,18667,5071,17529,400,1691,3723,12755,4123,14446
291070,201906,15747,42998,13254,39050,525,1826,10620,31014,11145,32840
291072,201906,24136,63449,17525,51481,3416,10391,7245,21456,10661,31847
291075,201906,5288,13556,4702,12601,126,369,3838,10062,3964,10431
291077,201906,1588,4182,1250,3574,48,130,887,2518,935,2648
291080,201906,89502,237158,72427,211855,24461,73326,16824,52418,41285,125744
291085,201906,5686,14443,4755,13050,198,633,3948,10727,4146,11360
291090,201906,1969,3725,1449,3150,30,72,1217,2607,1247,2679
291100,201906,3140,7007,2190,5846,116,355,1674,4381,1790,4736
291110,201906,5926,17857,5039,16312,321,1338,3766,11706,4087,13044
291120,201906,7712,19145,6571,17643,371,1061,4925,13188,5296,14249
291125,201906,2176,3859,1592,3207,133,195,1190,2503,1323,2698
291130,201906,3160,9195,2357,7595,89,410,1674,5200,1763,5610
291140,201906,4789,13152,3523,10769,417,1117,2240,6916,2657,8033
291150,201906,2286,5204,1902,4764,12,35,1780,4444,1792,4479
291160,201906,5102,14251,4257,12987,400,1318,2793,8431,3193,9749
291165,201906,2169,5989,1675,5046,43,188,1201,3469,1244,3657
291170,201906,20789,53128,17489,47552,1015,2984,11365,30498,12380,33482
291180,201906,5925,14196,4518,12198,372,945,3363,9127,3735,10072
291185,201906,3172,8660,2757,7954,82,257,2117,6061,2199,6318
291190,201906,7607,18945,6305,17203,337,1047,4914,13357,5251,14404
291200,201906,2833,7888,2103,6486,90,322,1289,3855,1379,4177
291210,201906,6916,15274,5301,13375,170,562,3943,9932,4113,10494
291220,201906,4038,11686,3653,11075,233,850,2811,8400,3044,9250
291230,201906,4410,9651,3422,8553,58,127,3044,7703,3102,7830
291240,201906,4236,11007,3663,10040,63,223,3139,8466,3202,8689
291250,201906,3438,10159,2690,8792,173,566,1734,5698,1907,6264
291260,201906,1418,3341,1211,3075,34,105,980,2510,1014,2615
291270,201906,5092,13769,4084,12203,621,1844,2619,7938,3240,9782
291280,201906,2538,6499,1934,5552,146,496,1187,3260,1333,3756
291290,201906,5843,15682,4623,13741,405,1310,3108,9151,3513,10461
291300,201906,3959,10673,2978,9034,130,448,2194,6541,2324,6989
291310,201906,5119,13798,4380,12413,124,420,3652,10145,3776,10565
291320,201906,6095,17379,4744,14793,1081,3117,2306,7613,3387,10730
291330,201906,1812,4632,1499,4100,76,206,1090,2913,1166,3119
291340,201906,4176,10892,3481,9728,82,271,2692,7381,2774,7652
291345,201906,2985,9100,2728,8702,126,437,2230,7122,2356,7559
291350,201906,6792,17177,5297,15263,79,255,4518,13216,4597,13471
291360,201906,35672,84675,28634,75884,3383,9166,17745,47934,21128,57100
291370,201906,7897,21847,7092,20645,531,1698,5282,15177,5813,16875
291380,201906,3364,9509,3007,8976,92,435,2478,7246,2570,7681
291390,201906,12967,28604,10216,25532,391,1019,8457,21051,8848,22070
291400,201906,13515,35642,11334,32320,1558,4000,6737,20536,8295,24536
291410,201906,2867,7618,2199,6489,51,229,1616,4632,1667,4861
291420,201906,1935,4830,1532,4326,39,153,1309,3671,1348,3824
291430,201906,2882,8176,2489,7531,101,453,1958,5739,2059,6192
291440,201906,6314,18377,5443,16905,327,1118,4270,13249,4597,14367
291450,201906,8824,22715,7387,21025,120,232,6449,18944,6569,19176
291460,201906,15258,41165,13464,38471,698,2235,10081,28550,10779,30785
291465,201906,8968,22935,7180,20844,196,880,6035,17348,6231,18228
291470,201906,15632,36616,13295,33975,642,1590,9903,25974,10545,27564
291480,201906,40798,92199,30019,77273,3908,10561,15481,39705,19389,50266
291490,201906,5528,14084,4859,13265,174,562,4327,11748,4501,12310
291500,201906,5006,12350,4176,11225,68,280,3753,10033,3821,10313
291510,201906,3960,10303,3057,9092,74,352,2472,7312,2546,7664
291520,201906,4510,10406,3464,9024,175,497,2635,6831,2810,7328
291530,201906,2232,5247,1609,4405,287,713,946,2802,1233,3515
291535,201906,3206,9696,2960,9271,170,508,2293,7284,2463,7792
291540,201906,2262,5161,1585,4335,55,215,1302,3455,1357,3670
291550,201906,5536,12922,4357,11367,403,925,2956,7837,3359,8762
291560,201906,19289,44591,13573,37436,1065,2847,8827,25285,9892,28132
291570,201906,2383,5711,1902,5108,67,165,1554,4294,1621,4459
291580,201906,6221,16500,4916,14711,248,882,3617,10626,3865,11508
291590,201906,1930,5100,1721,4818,114,388,1444,3947,1558,4335
291600,201906,5058,12601,3813,10625,463,1424,2376,6398,2839,7822
291610,201906,5669,15348,5261,14887,98,361,4841,13669,4939,14030
291620,201906,3158,7066,2312,6117,117,312,1784,4799,1901,5111
291630,201906,3230,7426,2404,6355,221,663,1775,4601,1996,5264
291640,201906,15432,39200,11797,33784,1908,5306,5042,15220,6950,20526
291650,201906,9238,23789,8162,22458,499,1061,6855,19238,7354,20299
291660,201906,2073,5128,1507,4216,137,468,980,2576,1117,3044
291670,201906,2078,5447,1766,5016,107,262,1357,3903,1464,4165
291680,201906,4097,10302,3332,9132,303,845,2366,6430,2669,7275
291685,201906,4662,11238,3721,10020,223,455,2822,7882,3045,8337
291690,201906,4221,9399,2862,7436,211,470,2183,5659,2394,6129
291700,201906,8566,25041,7616,23360,409,1428,6148,18564,6557,19992
291710,201906,5232,12803,3921,10922,265,862,2787,7582,3052,8444
291720,201906,4388,13606,3679,12154,413,1474,2413,7748,2826,9222
291730,201906,6320,16546,5471,15412,288,886,4440,12462,4728,13348
291733,201906,2934,7527,2473,6902,69,203,1814,5285,1883,5488
291735,201906,2919,7619,2345,6652,84,246,1819,5119,1903,5365
291740,201906,3855,10034,2923,8393,108,327,2128,5978,2236,6305
291750,201906,19666,47668,15953,42096,1550,4165,10637,28075,12187,32240
291760,201906,10337,30448,8164,26775,2533,9386,2131,6987,4664,16373
291770,201906,7059,19372,5889,17278,444,1362,4245,12146,4689,13508
291780,201906,5056,13647,4567,12919,102,390,3945,11012,4047,11402
291790,201906,2666,7588,2447,7296,266,680,1805,5524,2071,6204
291800,201906,29031,74720,22175,64244,3403,9547,11533,34502,14936,44049
291810,201906,10677,25754,8867,23514,242,726,7620,20064,7862,20790
291820,201906,3821,10195,3328,9517,109,361,2616,7513,2725,7874
291830,201906,4261,10451,3619,9551,211,550,2870,7588,3081,8138
291835,201906,6367,19149,4945,16327,687,2367,2913,9791,3600,12158
291840,201906,47134,130122,40794,120637,4673,14637,27989,82648,32662,97285
291845,201906,2391,6474,1950,5924,94,307,1590,4874,1684,5181
291850,201906,3937,11310,3281,10197,264,757,2346,7488,2610,8245
291855,201906,2197,4431,1735,3898,50,130,1551,3456,1601,3586
291860,201906,2242,5894,1553,4555,40,130,1043,2936,1083,3066
291870,201906,1318,3334,877,2557,60,182,572,1625,632,1807
291875,201906,2706,8206,2370,7524,78,295,1786,5507,1864,5802
291880,201906,5583,16120,4817,14781,261,809,3559,10901,3820,11710
291890,201906,1574,3354,1028,2702,136,329,682,1783,818,2112
291900,201906,1171,2972,909,2544,23,89,718,1951,741,2040
291905,201906,2644,6652,2064,5696,86,286,1538,4112,1624,4398
291910,201906,2912,7439,2454,6891,71,248,2105,5919,2176,6167
291915,201906,7344,21079,6040,18829,249,913,4507,14045,4756,14958
291920,201906,25438,68459,21992,63612,2456,7651,14798,42007,17254,49658
291930,201906,2473,6862,2112,6311,254,807,1369,4048,1623,4855
291940,201906,3845,10018,2565,7819,209,638,1491,4470,1700,5108
291950,201906,9151,27827,7852,25292,414,1529,5312,16938,5726,18467
291955,201906,14700,37553,13239,35650,1216,3394,10238,27707,11454,31101
291960,201906,3118,8361,2546,7546,134,452,1948,5840,2082,6292
291970,201906,4344,11342,3713,10501,168,575,2774,7842,2942,8417
291980,201906,10009,28421,7947,25046,775,2316,5138,16445,5913,18761
291990,201906,2175,5712,1882,5382,21,97,1785,5101,1806,5198
291992,201906,4030,9901,3114,8658,254,605,2436,6894,2690,7499
291995,201906,2140,5771,1724,5156,52,247,1338,3880,1390,4127
292000,201906,2654,6382,2158,5753,119,451,1659,4339,1778,4790
292010,201906,5949,13825,4851,12276,204,594,3980,9873,4184,10467
292020,201906,4545,13285,3794,11934,225,832,2751,8385,2976,9217
292030,201906,1765,5554,1668,5386,73,291,1062,3336,1135,3627
292040,201906,4299,11271,3433,9993,253,687,2629,7829,2882,8516
292045,201906,4026,10675,2985,9121,49,138,2616,8152,2665,8290
292050,201906,6502,18508,5222,16135,272,971,3278,9945,3550,10916
292060,201906,11802,27438,10948,26380,577,1310,9411,22438,9988,23748
292070,201906,5806,15186,5106,14322,287,848,4375,12187,4662,13035
292080,201906,3217,8060,2647,7340,82,267,2334,6451,2416,6718
292090,201906,4544,9873,3276,8368,257,685,2474,6385,2731,7070
292100,201906,10363,25930,8826,23941,1060,3045,5748,15450,6808,18495
292105,201906,3409,8777,2995,8177,90,243,2429,6622,2519,6865
292110,201906,6068,15183,4300,12256,989,2860,1944,5542,2933,8402
292120,201906,6907,17938,5635,15740,393,1176,4193,11478,4586,12654
292130,201906,3405,8250,2789,7490,112,342,2165,5732,2277,6074
292140,201906,5166,12173,4269,10866,295,736,3383,8565,3678,9301
292145,201906,2336,6842,1966,6178,66,213,1482,4681,1548,4894
292150,201906,13613,37875,12052,35378,297,1240,9955,28761,10252,30001
292160,201906,2932,7271,2252,6399,58,170,1841,5383,1899,5553
292170,201906,8273,22309,6903,19997,440,1415,4986,14200,5426,15615
292180,201906,2830,7759,2077,6411,221,656,1253,3807,1474,4463
292190,201906,2899,7736,2480,7107,140,436,1849,5278,1989,5714
292200,201906,7956,20638,6000,17767,1069,3274,3147,9505,4216,12779
292205,201906,3871,10708,3342,9919,64,307,2922,8572,2986,8879
292210,201906,6307,15037,5140,13524,97,431,4561,11796,4658,12227
292220,201906,2097,5146,1850,4774,64,191,1437,3587,1501,3778
292225,201906,3204,9447,2828,8875,77,355,2376,7328,2453,7683
292230,201906,8514,20430,7606,19241,196,708,6448,15942,6644,16650
292240,201906,4748,13892,4094,12670,335,1023,2784,8610,3119,9633
292250,201906,5248,14332,4733,13512,529,1467,3223,9281,3752,10748
292260,201906,3344,8893,3004,8462,128,347,2582,7302,2710,7649
292265,201906,3331,9252,2815,8453,74,360,2194,6421,2268,6781
292270,201906,4340,10006,3468,8962,171,445,2802,7254,2973,7699
292273,201906,2656,5781,2112,5119,63,115,1585,4046,1648,4161
292275,201906,1650,4345,1312,3864,56,137,995,2974,1051,3111
292280,201906,2609,6214,2109,5633,101,216,1749,4822,1850,5038
292285,201906,2578,6287,2022,5516,85,214,1607,4409,1692,4623
292290,201906,7172,19526,5845,17566,180,685,4751,14234,4931,14919
292300,201906,10108,26119,7969,23294,815,2564,5339,15558,6154,18122
292303,201906,2902,8355,2549,7797,75,192,2147,6614,2222,6806
292305,201906,2465,6603,2277,6337,51,234,2010,5477,2061,5711
292310,201906,6720,17253,5780,16088,170,570,4920,13550,5090,14120
292320,201906,6168,16844,4935,14549,250,806,3655,10487,3905,11293
292330,201906,2785,6145,2183,5469,107,249,1685,4333,1792,4582
292335,201906,4750,12347,4231,11604,258,655,3538,9774,3796,10429
292340,201906,5750,16089,4818,14284,213,688,3581,10462,3794,11150
292350,201906,2567,6873,2097,6232,84,319,1696,5011,1780,5330
292360,201906,4882,13162,4076,11761,292,968,2832,7908,3124,8876
292370,201906,10879,24992,9374,22978,132,485,8622,20721,8754,21206
292380,201906,6873,19347,6137,18034,430,1255,4586,13386,5016,14641
292390,201906,4449,8670,3247,7271,105,227,2833,6345,2938,6572
292400,201906,22027,63742,19210,59116,1840,5983,13246,40627,15086,46610
292405,201906,4189,10482,3541,9492,125,317,2883,7677,3008,7994
292410,201906,2168,5183,1860,4803,62,177,1630,4203,1692,4380
292420,201906,3649,11007,3310,10448,134,632,2772,8540,2906,9172
292430,201906,4821,14638,3701,12614,305,1125,2427,8257,2732,9382
292440,201906,8455,27001,7806,25996,121,633,6999,23243,7120,23876
292450,201906,3848,11248,3102,9770,103,394,2402,7540,2505,7934
292460,201906,4864,13532,3998,12041,380,1103,2808,8469,3188,9572
292465,201906,2603,6856,2173,6266,98,235,1494,4613,1592,4848
292467,201906,1831,5218,1640,4959,235,641,1123,3526,1358,4167
292470,201906,2987,7592,2327,6535,65,140,1802,5057,1867,5197
292480,201906,6460,15323,5144,13723,73,284,4602,12116,4675,12400
292490,201906,2103,5569,1753,5049,111,295,1313,3844,1424,4139
292500,201906,6411,17863,5258,15738,563,1730,3417,10111,3980,11841
292510,201906,12531,34134,9973,30249,510,1908,7248,21854,7758,23762
292520,201906,6902,17345,6111,16181,558,1538,4601,12096,5159,13634
292525,201906,5723,13776,4774,12683,113,310,4143,11075,4256,11385
292530,201906,26996,72810,21022,62684,5554,16818,7673,23594,13227,40412
292540,201906,4256,8107,3369,7144,120,211,2976,6323,3096,6534
292550,201906,7935,21502,6132,19245,440,1457,4495,14543,4935,16000
292560,201906,4274,10868,3691,10083,86,288,3034,8260,3120,8548
292570,201906,3776,9815,3194,8866,73,264,2738,7434,2811,7698
292575,201906,6962,20093,6425,19372,317,992,5215,15761,5532,16753
292580,201906,7477,19037,6295,17281,143,472,5280,14342,5423,14814
292590,201906,7399,19612,6383,17935,265,837,5350,14715,5615,15552
292593,201906,2842,7055,2354,6242,81,201,1943,5129,2024,5330
292595,201906,5456,14512,4700,13578,171,571,3907,11162,4078,11733
292600,201906,11091,30146,9531,27786,387,1068,7462,21820,7849,22888
292610,201906,4165,10982,3514,9820,198,480,2563,7264,2761,7744
292620,201906,6453,17761,5413,16534,108,264,5027,15579,5135,15843
292630,201906,8523,20960,6966,18468,596,1608,4677,12368,5273,13976
292640,201906,8160,24371,7124,22647,208,908,5079,16144,5287,17052
292650,201906,4617,11315,4127,10679,127,376,3713,9445,3840,9821
292660,201906,11286,30844,9669,28427,482,1562,7461,21829,7943,23391
292665,201906,2186,6511,1943,6206,78,244,1630,5296,1708,5540
292670,201906,3556,9654,2736,8107,122,400,1875,5462,1997,5862
292680,201906,3977,10727,3183,9250,191,545,2304,6538,2495,7083
292690,201906,2648,6952,1853,5630,188,542,1114,3551,1302,4093
292700,201906,9851,26986,8586,25006,790,2179,5836,17472,6626,19651
292710,201906,2463,7730,2277,7476,48,191,2036,6727,2084,6918
292720,201906,9049,21864,7685,20314,272,766,6099,16325,6371,17091
292730,201906,4427,10433,4160,10106,204,326,3634,8972,3838,9298
292740,201906,320880,796829,283316,741127,42979,113717,173089,449149,216068,562866
292750,201906,6270,16788,5461,15572,260,761,4125,11897,4385,12658
292760,201906,3869,11261,3385,10391,244,825,2447,7437,2691,8262
292770,201906,6069,16346,4885,14632,763,2399,2984,9216,3747,11615
292780,201906,2017,4194,1504,3534,45,153,1194,2662,1239,2815
292790,201906,4147,8803,3190,7768,162,433,2687,6532,2849,6965
292800,201906,11061,27970,9559,25661,349,979,7864,20844,8213,21823
292805,201906,3396,8323,2672,7344,124,363,2076,5665,2200,6028
292810,201906,10646,28470,8418,24987,246,1023,6224,17964,6470,18987
292820,201906,7535,20727,5417,17264,499,1677,3638,11421,4137,13098
292830,201906,2909,6837,2473,6291,88,288,2115,5344,2203,5632
292840,201906,8754,23083,7516,21390,173,673,6451,17918,6624,18591
292850,201906,2541,6835,2133,6213,144,467,1471,4199,1615,4666
292860,201906,16879,37969,15065,35713,654,1583,12548,29391,13202,30974
292870,201906,17267,44103,15014,40904,1036,3132,10000,26806,11036,29938
292880,201906,11179,30523,9635,28195,325,1367,7494,21169,7819,22536
292890,201906,6767,19138,5986,17936,244,953,5060,14966,5304,15919
292895,201906,2969,6491,2175,5283,95,236,1719,4106,1814,4342
292900,201906,2599,7169,2391,6833,53,224,1941,5371,1994,5595
292905,201906,4401,11665,3451,10234,176,616,2482,7249,2658,7865
292910,201906,4924,13560,4490,12901,250,799,3377,9600,3627,10399
292920,201906,9772,26972,9142,26067,268,1041,7922,22121,8190,23162
292925,201906,5409,15337,4618,13948,228,713,3377,10036,3605,10749
292930,201906,6563,19620,5617,17763,504,1826,3472,10625,3976,12451
292935,201906,2357,6033,1837,5446,34,154,1622,4814,1656,4968
292937,201906,3028,7401,2657,6946,71,226,2350,6131,2421,6357
292940,201906,2987,7624,2389,6715,200,472,1692,4920,1892,5392
292950,201906,9733,25011,8526,23149,493,1265,6406,17241,6899,18506
292960,201906,5255,12779,4446,11647,128,368,3536,9100,3664,9468
292970,201906,3848,11233,3376,10517,103,481,2806,8722,2909,9203
292975,201906,4463,9730,3954,9149,169,324,3536,8269,3705,8593
292980,201906,3328,8109,2684,7131,95,292,2145,5586,2240,5878
292990,201906,11432,31351,9617,28116,682,2188,7083,20395,7765,22583
293000,201906,2587,6250,2241,5745,41,159,1756,4498,1797,4657
293010,201906,18151,46966,14678,41358,1977,5746,8895,24926,10872,30672
293015,201906,8027,25029,6353,21714,434,1754,4298,14650,4732,16404
293020,201906,9903,28892,8931,27513,144,679,7911,24597,8055,25276
293030,201906,5380,14478,4099,12500,118,406,2790,8704,2908,9110
293040,201906,3965,10987,3416,10224,83,315,2945,8773,3028,9088
293050,201906,21766,54422,19391,50960,1149,3202,14429,37429,15578,40631
293060,201906,3482,9201,2847,8089,238,729,1976,5490,2214,6219
293070,201906,24987,61562,21311,56637,2476,6830,14294,38150,16770,44980
293075,201906,3379,10796,2986,10140,200,837,2337,7907,2537,8744
293076,201906,3609,8933,3231,8460,84,225,2785,7338,2869,7563
293077,201906,6078,17030,4891,15172,475,1527,3106,9935,3581,11462
293080,201906,4789,14144,4142,13057,114,505,3296,10168,3410,10673
293090,201906,3227,9449,2461,8178,232,821,1590,5269,1822,6090
293100,201906,5672,15404,4627,13501,242,762,3588,10331,3830,11093
293105,201906,3660,11631,3227,10746,209,755,2338,7677,2547,8432
293110,201906,2429,6069,2053,5537,70,268,1684,4405,1754,4673
293120,201906,4353,11962,3883,11206,125,348,3220,9285,3345,9633
293130,201906,3802,10459,3351,9859,86,343,2862,8340,2948,8683
293135,201906,29384,70679,21810,60132,3650,10969,9893,27430,13543,38399
293140,201906,2356,5357,2035,4953,75,190,1684,4066,1759,4256
293150,201906,5365,16199,4480,14534,383,1318,3048,9893,3431,11211
293160,201906,3878,9450,3302,8791,273,478,2688,7528,2961,8006
293170,201906,4600,10035,4011,9266,137,298,3433,7881,3570,8179
293180,201906,4476,12454,3676,11054,114,476,2912,8501,3026,8977
293190,201906,14175,38837,12362,36227,195,839,10789,31394,10984,32233
293200,201906,8130,20434,6575,17967,225,852,5219,13919,5444,14771
293210,201906,5287,13975,4458,12647,312,866,3389,9647,3701,10513
293220,201906,5039,13370,3764,11121,868,2584,1499,4558,2367,7142
293230,201906,3915,10162,2930,8721,243,795,1986,5963,2229,6758
293240,201906,4471,11823,3590,10371,84,239,2737,8126,2821,8365
293245,201906,3868,10435,3479,9880,158,478,2929,8230,3087,8708
293250,201906,5606,13536,4762,12409,207,544,3910,10143,4117,10687
293260,201906,4413,12217,3639,11006,126,404,2546,7653,2672,8057
293270,201906,7011,15898,5642,14414,444,738,4382,11948,4826,12686
293280,201906,4724,12513,4120,11659,257,628,3171,9048,3428,9676
293290,201906,13803,41644,12326,39279,2159,6924,7381,24027,9540,30951
293300,201906,5794,14175,5006,12992,286,708,3662,9558,3948,10266
293305,201906,3989,9904,3508,9274,40,125,3128,8216,3168,8341
293310,201906,2179,5555,1791,4900,57,167,1385,3728,1442,3895
293315,201906,4143,10009,3384,8835,164,393,2745,7136,2909,7529
293317,201906,2534,6246,2231,5807,152,330,1731,4545,1883,4875
293320,201906,11168,28231,10246,27156,329,897,9056,23915,9385,24812
293325,201906,1700,4353,1349,3852,189,548,861,2469,1050,3017
293330,201906,45991,139931,38770,126845,8535,28341,16949,56881,25484,85222
293340,201906,2300,6484,1911,5803,115,415,1301,3885,1416,4300
293345,201906,3350,9302,2690,8318,313,753,1850,6116,2163,6869
293350,201906,6702,19085,5883,18160,64,261,5396,16900,5460,17161
293360,201906,15367,38981,13095,36034,381,1491,11419,30849,11800,32340
310010,201906,844,2012,578,1633,57,189,267,703,324,892
310020,201906,2318,6583,1674,5390,359,1275,295,889,654,2164
310030,201906,1992,5806,1558,5019,241,866,936,2891,1177,3757
310040,201906,940,2481,762,2181,41,164,509,1373,550,1537
310050,201906,1550,4766,1349,4438,177,710,809,2565,986,3275
310060,201906,3193,9160,2784,8626,123,517,2267,6938,2390,7455
310070,201906,353,800,244,636,6,14,183,470,189,484
310080,201906,796,2167,532,1629,85,296,205,580,290,876
310090,201906,4540,12368,3704,10974,288,943,2665,7742,2953,8685
310100,201906,3316,9424,2809,8569,95,440,2242,6604,2337,7044
310110,201906,4693,12621,3687,10820,793,2534,1566,4392,2359,6926
310120,201906,649,1615,409,1208,55,194,228,603,283,797
310130,201906,372,1019,317,933,39,143,209,577,248,720
310140,201906,251,753,181,622,41,157,64,194,105,351
310150,201906,4998,13606,3764,11315,609,2064,1642,4664,2251,6728
310160,201906,7260,18984,5310,15734,1178,3806,1707,5029,2885,8835
310163,201906,1029,3062,820,2673,222,812,255,761,477,1573
310170,201906,8969,23394,7251,20690,686,2031,5083,14463,5769,16494
310180,201906,1713,4375,1289,3680,129,440,832,2273,961,2713
310190,201906,2852,8640,2266,7515,535,1981,305,925,840,2906
310200,201906,1785,5407,1305,4401,229,874,531,1746,760,2620
310205,201906,1087,3026,808,2576,159,564,321,1021,480,1585
310210,201906,2658,7073,2174,6260,110,326,1613,4545,1723,4871
310220,201906,1131,3111,880,2663,87,292,595,1744,682,2036
310230,201906,2259,6437,1838,5614,234,812,1094,3116,1328,3928
310240,201906,891,2849,760,2610,58,247,517,1736,575,1983
310250,201906,1023,2767,831,2462,27,116,589,1707,616,1823
310260,201906,2823,7587,1763,5690,528,1971,393,936,921,2907
310270,201906,2713,6835,2120,6013,103,391,1724,4818,1827,5209
310280,201906,2331,5571,1800,4787,303,879,968,2433,1271,3312
310285,201906,1866,6111,1601,5641,178,735,944,3284,1122,4019
310290,201906,1140,3046,948,2708,211,693,500,1279,711,1972
310300,201906,1463,4429,1268,4082,169,677,688,2036,857,2713
310310,201906,303,776,195,577,32,96,101,296,133,392
310320,201906,512,1334,333,1025,27,106,171,506,198,612
310330,201906,478,1132,282,776,37,123,119,291,156,414
310340,201906,7618,21139,6110,18539,954,2817,2994,9345,3948,12162
310350,201906,12418,30705,8428,24090,1826,5533,3196,8859,5022,14392
310360,201906,482,1144,365,991,12,39,269,710,281,749
310370,201906,1276,4055,1060,3629,222,827,325,1129,547,1956
310375,201906,839,2183,564,1759,101,326,240,745,341,1071
310380,201906,392,922,210,608,31,92,89,234,120,326
310390,201906,451,1391,358,1210,98,363,91,244,189,607
310400,201906,9512,23558,6661,19163,854,2838,3689,10279,4543,13117
310410,201906,849,2478,541,1902,101,385,170,550,271,935
310420,201906,4142,10791,2718,7960,407,1354,987,2592,1394,3946
310430,201906,1482,4112,959,3112,194,714,318,919,512,1633
310440,201906,577,1480,401,1168,28,116,236,661,264,777
310445,201906,1335,3904,997,3239,48,180,714,2263,762,2443
310450,201906,4719,12017,3538,10114,194,717,2620,7237,2814,7954
310460,201906,1601,4335,1109,3404,209,681,334,989,543,1670
310470,201906,3831,8395,3020,7326,301,788,2230,5375,2531,6163
310480,201906,968,2581,732,2151,106,341,456,1299,562,1640
310490,201906,2854,7972,2233,6876,292,1071,1155,3317,1447,4388
310500,201906,1391,3985,1016,3295,184,676,497,1561,681,2237
310510,201906,1970,5290,1238,3877,247,862,429,1352,676,2214
310520,201906,1266,3249,904,2618,130,353,502,1452,632,1805
310530,201906,762,1989,437,1341,63,229,124,301,187,530
310540,201906,3209,9313,2654,8306,614,2007,1124,3364,1738,5371
310550,201906,1251,3242,856,2557,70,260,503,1417,573,1677
310560,201906,14165,37936,10214,30997,1898,6511,3809,10387,5707,16898
310570,201906,1091,2934,862,2602,73,273,579,1699,652,1972
310590,201906,4109,11108,3295,9629,251,857,1884,5182,2135,6039
310600,201906,1390,4148,1122,3603,172,626,560,1662,732,2288
310610,201906,487,1307,303,988,54,199,156,470,210,669
310620,201906,166024,435139,121331,353315,21103,70314,53453,139250,74556,209564
310630,201906,4393,12275,3556,10652,281,970,2305,6668,2586,7638
310640,201906,1010,3089,849,2760,192,703,322,967,514,1670
310650,201906,2409,7052,1766,5814,198,708,980,3106,1178,3814
310660,201906,1245,3433,1045,3173,38,134,874,2613,912,2747
310665,201906,1361,3567,1073,3143,36,141,884,2559,920,2700
310670,201906,52161,138400,43933,123867,4823,15694,28784,76839,33607,92533
310680,201906,693,1699,579,1535,20,68,468,1198,488,1266
310690,201906,1745,4741,1268,3909,126,444,695,2044,821,2488
310700,201906,493,1123,382,992,36,124,274,671,310,795
310710,201906,5351,15642,3830,13399,912,3691,511,1647,1423,5338
310720,201906,932,2312,733,2050,44,144,538,1459,582,1603
310730,201906,9509,26374,8169,24133,451,1705,5884,16952,6335,18657
310740,201906,5616,15837,3767,11837,656,2240,1206,3503,1862,5743
310750,201906,1219,2998,869,2480,129,422,384,1000,513,1422
310760,201906,562,1502,406,1250,27,91,206,652,233,743
310770,201906,1082,3038,741,2493,99,394,359,1134,458,1528
310780,201906,4071,10217,3389,9159,101,315,2572,6874,2673,7189
310790,201906,1799,5730,1565,5229,421,1497,355,1120,776,2617
310800,201906,2234,6786,1621,5507,393,1550,102,310,495,1860
310810,201906,1143,2970,923,2563,46,153,639,1705,685,1858
310820,201906,1179,3097,708,2250,150,510,163,511,313,1021
310825,201906,2449,7788,1992,6986,87,488,1559,5240,1646,5728
310830,201906,1560,4581,1053,3498,214,792,432,1334,646,2126
310840,201906,1899,5252,1341,4269,370,1294,323,912,693,2206
310850,201906,1499,4145,1271,3830,61,300,969,2768,1030,3068
310855,201906,3178,8575,2457,7404,203,696,1673,4902,1876,5598
310860,201906,6915,20222,5502,17385,539,1847,3349,10595,3888,12442
310870,201906,1037,2496,789,2128,79,218,560,1523,639,1741
310880,201906,1009,3029,779,2563,97,324,459,1473,556,1797
310890,201906,2279,6487,1456,4895,295,1065,206,602,501,1667
310900,201906,4112,11641,2967,9285,454,1500,1278,3696,1732,5196
310910,201906,1870,4759,1253,3703,120,442,223,578,343,1020
310920,201906,1853,4958,1410,4251,244,780,741,2210,985,2990
310925,201906,950,2697,781,2399,89,305,510,1494,599,1799
310930,201906,5716,15418,4098,12758,800,2599,1948,6212,2748,8811
310940,201906,6331,15851,5086,13978,255,935,3700,9796,3955,10731
310945,201906,1258,3330,1015,2958,113,384,575,1599,688,1983
310950,201906,1851,5568,1232,4165,243,905,428,1305,671,2210
310960,201906,710,1866,426,1336,60,199,148,464,208,663
310970,201906,1172,3523,811,2744,202,737,152,466,354,1203
310980,201906,315,758,209,590,26,78,126,342,152,420
310990,201906,1251,3589,943,3014,191,625,426,1329,617,1954
311000,201906,4015,11513,2978,9718,779,2708,1142,3574,1921,6282
311010,201906,813,2502,648,2137,241,864,208,651,449,1515
311020,201906,979,2609,640,1978,64,213,308,922,372,1135
311030,201906,1558,4016,1047,3106,222,747,446,1209,668,1956
311040,201906,323,1038,252,863,70,250,69,219,139,469
311050,201906,2574,6640,1954,5694,394,1285,917,2532,1311,3817
311060,201906,2918,7794,2034,6013,319,1094,802,2153,1121,3247
311070,201906,2177,5675,1571,4679,190,697,775,2177,965,2874
311080,201906,1048,2506,865,2199,40,152,657,1563,697,1715
311090,201906,2039,6609,1600,5790,358,1457,493,1731,851,3188
311100,201906,2068,6016,1254,4359,269,1050,190,600,459,1650
311110,201906,3638,7645,2012,5316,397,1120,748,2010,1145,3130
311115,201906,1291,3100,1059,2769,63,168,835,2148,898,2316
311120,201906,6474,17329,4810,14197,777,2607,1697,4434,2474,7041
311130,201906,1876,5014,1425,4374,135,535,766,2244,901,2779
311140,201906,1387,3461,1033,2956,75,247,653,1847,728,2094
311150,201906,1539,4905,1214,4266,198,781,636,2146,834,2927
311160,201906,3690,10814,2565,8700,689,2610,712,2351,1401,4961
311170,201906,864,2286,687,2032,42,127,431,1327,473,1454
311180,201906,1316,3024,834,2309,168,495,369,1016,537,1511
311190,201906,989,2743,723,2211,109,377,284,772,393,1149
311200,201906,1849,5108,1279,3977,293,990,371,1032,664,2022
311205,201906,868,2679,716,2368,45,206,425,1343,470,1549
311210,201906,1004,2985,874,2816,116,350,639,2103,755,2453
311220,201906,733,2079,605,1853,66,230,344,978,410,1208
311230,201906,7659,23290,5695,19298,988,3537,2091,7216,3079,10753
311240,201906,976,2653,748,2336,174,586,338,1035,512,1621
311250,201906,872,2543,682,2202,160,526,297,931,457,1457
311260,201906,2481,6258,1565,4651,268,837,614,1717,882,2554
311265,201906,1262,3339,943,2797,45,165,663,1894,708,2059
311270,201906,2986,9028,2602,8385,175,789,1913,5853,2088,6642
311280,201906,1174,3117,526,1726,99,354,73,215,172,569
311290,201906,1877,5815,1725,5479,171,568,1160,3665,1331,4233
311300,201906,4637,13343,3824,11929,221,953,2953,8942,3174,9895
311310,201906,572,1626,483,1457,55,183,259,740,314,923
311320,201906,3080,9604,2607,8523,419,1564,1183,3549,1602,5113
311330,201906,4818,13103,3938,11642,443,1429,2167,6491,2610,7920
311340,201906,10035,29088,7915,25183,2305,7873,1962,6039,4267,13912
311350,201906,2253,5762,1560,4461,153,523,839,2146,992,2669
311360,201906,1107,2758,697,2105,212,726,195,547,407,1273
311370,201906,4461,11174,3306,9245,175,704,2075,5459,2250,6163
311380,201906,376,1159,292,987,73,250,101,353,174,603
311390,201906,1676,5272,1327,4790,560,2303,325,1013,885,3316
311400,201906,1394,3978,1013,3229,145,509,408,1163,553,1672
311410,201906,1594,4800,1312,4397,214,812,706,2398,920,3210
311420,201906,1527,4563,1035,3507,188,700,183,496,371,1196
311430,201906,3508,9603,2277,7096,460,1467,660,2078,1120,3545
311440,201906,2464,7191,1734,5881,365,1434,587,1930,952,3364
311450,201906,1708,5302,1256,4421,314,1242,305,918,619,2160
311455,201906,958,2236,648,1769,179,491,234,652,413,1143
311460,201906,485,1538,326,1211,68,324,91,299,159,623
311470,201906,435,1401,306,1092,76,321,52,167,128,488
311480,201906,1155,3219,992,2987,40,110,809,2476,849,2586
311490,201906,237,712,185,602,41,154,84,241,125,395
311500,201906,408,1046,305,884,28,96,188,526,216,622
311510,201906,2985,8043,1969,6165,322,1168,759,2170,1081,3338
311520,201906,560,1652,507,1542,96,337,277,803,373,1140
311530,201906,8652,20683,5425,15349,1329,4169,1365,3750,2694,7919
311535,201906,732,2026,489,1536,72,252,158,466,230,718
311540,201906,507,1615,444,1502,86,305,270,908,356,1213
311545,201906,2030,5830,1761,5448,100,395,1339,4056,1439,4451
311547,201906,1458,3813,1283,3539,45,145,895,2495,940,2640
311550,201906,2702,7731,2138,6643,324,1156,875,2595,1199,3751
311560,201906,284,634,191,508,28,85,105,250,133,335
311570,201906,1780,4181,1274,3478,53,156,985,2741,1038,2897
311580,201906,2189,4085,1410,3173,158,318,919,2121,1077,2439
311590,201906,482,1326,392,1194,63,217,208,612,271,829
311600,201906,1737,3939,1464,3606,63,165,1244,3008,1307,3173
311610,201906,2308,7745,1913,6836,279,1056,972,3426,1251,4482
311615,201906,2991,8895,2451,7974,154,580,1845,5895,1999,6475
311620,201906,421,1159,362,1083,21,81,289,849,310,930
311630,201906,1339,3728,1078,3220,91,297,703,2006,794,2303
311640,201906,539,1571,422,1351,73,282,200,598,273,880
311650,201906,1877,4952,1561,4448,127,436,1057,2888,1184,3324
311660,201906,2748,7973,1997,6557,370,1320,483,1363,853,2683
311670,201906,1521,4014,1114,3304,165,555,500,1490,665,2045
311680,201906,2157,6323,1610,5292,236,789,971,3178,1207,3967
311690,201906,572,1247,437,1076,45,102,311,811,356,913
311700,201906,2250,5450,1762,4756,33,146,1457,3807,1490,3953
311710,201906,1476,4346,1030,3479,248,916,376,1245,624,2161
311720,201906,410,1255,325,1091,31,132,180,585,211,717
311730,201906,4104,10542,2571,7678,778,2515,442,1334,1220,3849
311740,201906,845,2344,715,2174,37,101,617,1921,654,2022
311750,201906,3844,11859,3138,10609,461,1708,1689,5459,2150,7167
311760,201906,608,1787,508,1602,83,333,230,611,313,944
311770,201906,1982,5857,1523,4978,280,1010,636,1966,916,2976
311780,201906,1278,3790,856,2910,169,650,237,700,406,1350
311783,201906,2183,6153,1784,5436,57,256,1402,4117,1459,4373
311787,201906,700,2059,509,1626,76,280,192,526,268,806
311790,201906,1447,3865,951,2974,241,841,270,792,511,1633
311800,201906,4800,14695,3914,12743,767,2713,660,1921,1427,4634
311810,201906,964,2980,758,2595,52,206,473,1607,525,1813
311820,201906,770,1961,576,1645,82,262,325,866,407,1128
311830,201906,8327,24516,5701,18668,1590,5576,675,2114,2265,7690
311840,201906,3267,8688,2760,7954,286,880,1991,5681,2277,6561
311850,201906,322,884,263,776,17,49,169,486,186,535
311860,201906,55712,144273,42630,121850,6721,20556,23226,63752,29947,84308
311870,201906,1935,5199,1260,3951,204,712,457,1284,661,1996
311880,201906,6180,16322,5179,14891,296,800,3943,11462,4239,12262
311890,201906,1542,3892,1194,3389,104,351,803,2182,907,2533
311900,201906,719,1896,545,1648,65,227,350,1025,415,1252
311910,201906,4111,10684,3090,9332,575,1696,1587,4927,2162,6623
311920,201906,2012,5642,1616,5028,137,406,968,3056,1105,3462
311930,201906,3254,8105,2450,6936,865,2625,728,1926,1593,4551
311940,201906,14087,38154,10394,31030,1523,4983,4703,13146,6226,18129
311950,201906,2127,5996,1566,5015,88,406,1020,3173,1108,3579
311960,201906,531,1344,432,1190,28,123,273,649,301,772
311970,201906,429,1407,284,1038,57,231,56,171,113,402
311980,201906,431,1216,224,773,29,114,63,214,92,328
311990,201906,542,1328,355,1057,77,273,148,397,225,670
311995,201906,988,2777,511,1662,18,59,62,138,80,197
312000,201906,594,1594,497,1451,38,126,331,963,369,1089
312010,201906,887,2517,679,2150,63,224,400,1205,463,1429
312015,201906,1324,3996,1179,3744,63,286,908,2793,971,3079
312020,201906,1166,3650,926,3185,233,849,299,985,532,1834
312030,201906,2021,4999,1760,4698,23,99,1625,4304,1648,4403
312040,201906,784,2498,592,2059,57,205,256,866,313,1071
312050,201906,1224,3950,961,3406,222,910,267,830,489,1740
312060,201906,854,2146,558,1759,142,459,250,789,392,1248
312070,201906,882,2617,630,2104,70,270,307,972,377,1242
312080,201906,2729,6860,2040,5821,131,436,1294,3528,1425,3964
312083,201906,853,2303,643,1972,65,233,403,1186,468,1419
312087,201906,2348,6333,1951,5715,66,225,1509,4425,1575,4650
312090,201906,9453,25707,7238,22032,1220,4163,3382,10014,4602,14177
312100,201906,1556,4679,1149,3918,118,536,567,1838,685,2374
312110,201906,1014,3224,853,2893,217,849,272,824,489,1673
312120,201906,749,2085,517,1673,160,590,154,415,314,1005
312125,201906,1652,4395,1389,4000,123,395,998,2769,1121,3164
312130,201906,924,2320,680,1913,64,193,280,751,344,944
312140,201906,732,2178,606,1920,131,451,245,705,376,1156
312150,201906,454,1294,384,1137,13,63,270,732,283,795
312160,201906,7965,22831,6040,19324,842,3109,2758,8275,3600,11384
312170,201906,902,2456,675,2022,36,141,461,1329,497,1470
312180,201906,1352,3749,1064,3169,164,525,523,1486,687,2011
312190,201906,576,1706,408,1361,84,297,99,322,183,619
312200,201906,4716,12737,3716,11135,1073,3224,1418,4361,2491,7585
312210,201906,1335,3145,954,2581,46,155,672,1759,718,1914
312220,201906,1785,5567,1527,5077,121,437,942,3132,1063,3569
312230,201906,12090,32472,7947,24740,2107,7270,1409,3798,3516,11068
312235,201906,1841,4928,1482,4361,93,342,1038,2966,1131,3308
312240,201906,664,2218,507,1873,107,427,145,525,252,952
312245,201906,2523,6759,2087,6084,79,283,1669,4825,1748,5108
312247,201906,903,2284,639,1875,130,398,311,921,441,1319
312250,201906,972,2606,625,1914,88,279,258,777,346,1056
312260,201906,867,2491,697,2207,44,189,490,1482,534,1671
312270,201906,701,1962,533,1630,31,135,287,791,318,926
312280,201906,422,1240,326,1061,102,337,37,110,139,447
312290,201906,728,2211,585,1929,125,467,198,623,323,1090
312300,201906,901,2731,622,2075,160,576,119,331,279,907
312310,201906,793,2591,652,2298,99,392,290,983,389,1375
312320,201906,1782,4722,1298,3861,347,1083,262,741,609,1824
312330,201906,860,2590,686,2234,66,223,436,1389,502,1612
312340,201906,258,674,182,548,45,152,60,156,105,308
312350,201906,264,558,194,480,20,57,129,308,149,365
312352,201906,1610,4835,1419,4495,111,371,863,2888,974,3259
312360,201906,2524,7549,1844,6130,388,1388,482,1539,870,2927
312370,201906,1721,4762,1429,4247,225,757,743,2095,968,2852
312380,201906,2168,4973,1802,4509,12,39,1595,3959,1607,3998
312385,201906,1271,3575,975,3020,148,526,469,1371,617,1897
312390,201906,1876,5529,1397,4612,220,809,479,1423,699,2232
312400,201906,2783,8372,2249,7340,720,2453,672,2241,1392,4694
312410,201906,11449,32665,9383,29025,1757,5651,4832,14734,6589,20385
312420,201906,3600,10182,3030,9193,568,1848,1581,4699,2149,6547
312430,201906,7956,21235,6335,18340,508,1680,4245,12004,4753,13684
312440,201906,905,2941,695,2443,359,1329,70,209,429,1538
312450,201906,1166,3515,883,2983,261,937,283,981,544,1918
312460,201906,433,1146,293,922,35,125,162,520,197,645
312470,201906,476,1179,306,889,43,148,120,297,163,445
312480,201906,1117,2848,777,2357,108,347,378,1105,486,1452
312490,201906,2031,5039,1522,4255,227,645,782,2110,1009,2755
312500,201906,896,2260,711,1986,45,165,486,1335,531,1500
312510,201906,3586,9785,2648,7997,700,2018,759,2342,1459,4360
312520,201906,157,485,135,443,36,116,62,201,98,317
312530,201906,563,1439,489,1346,17,59,429,1177,446,1236
312540,201906,1507,4374,990,3249,165,590,500,1578,665,2168
312550,201906,759,2059,562,1644,38,127,364,977,402,1104
312560,201906,1971,5108,1600,4553,71,244,1233,3489,1304,3733
312570,201906,2099,5463,1626,4833,490,1521,611,1856,1101,3377
312580,201906,595,1724,441,1378,63,229,197,570,260,799
312590,201906,1628,4861,1322,4257,113,483,768,2292,881,2775
312595,201906,1699,5240,1487,4857,304,946,859,2940,1163,3886
312600,201906,1027,2544,527,1684,76,288,173,559,249,847
312610,201906,6242,16395,3991,12067,589,1941,1296,3683,1885,5624
312620,201906,2481,6477,1807,5531,52,230,1434,4448,1486,4678
312630,201906,263,825,198,701,36,155,74,251,110,406
312640,201906,555,1547,374,1233,48,160,129,444,177,604
312650,201906,2067,5439,1403,4139,79,253,950,2661,1029,2914
312660,201906,1345,3347,1014,2777,88,305,672,1733,760,2038
312670,201906,4917,13337,4054,11939,215,918,2844,7931,3059,8849
312675,201906,1211,3340,989,2982,59,237,776,2272,835,2509
312680,201906,1372,3927,1146,3580,63,283,906,2741,969,3024
312690,201906,2564,5807,2019,5119,85,240,1682,4188,1767,4428
312695,201906,938,2685,794,2433,46,114,596,1845,642,1959
312700,201906,2055,5494,1468,4395,156,538,824,2354,980,2892
312705,201906,1305,3351,1098,3020,25,90,941,2555,966,2645
312707,201906,1358,4097,1052,3521,70,363,643,2008,713,2371
312710,201906,6475,14986,3739,10642,1028,3163,979,2877,2007,6040
312720,201906,1023,2893,768,2464,98,353,437,1341,535,1694
312730,201906,1641,3965,1189,3338,90,280,695,1883,785,2163
312733,201906,1443,3834,1086,3170,37,142,720,1994,757,2136
312735,201906,635,1766,540,1581,74,259,343,889,417,1148
312737,201906,823,1931,556,1526,77,242,309,768,386,1010
312738,201906,595,1573,412,1241,51,177,207,584,258,761
312740,201906,430,1077,243,757,55,184,58,144,113,328
312750,201906,1380,4324,1099,3777,202,758,424,1376,626,2134
312760,201906,1824,5533,1311,4455,252,915,430,1394,682,2309
312770,201906,43500,106010,26863,77538,5987,18324,8434,23847,14421,42171
312780,201906,2424,7443,2041,6788,236,910,1295,4258,1531,5168
312790,201906,261,645,159,499,8,39,56,145,64,184
312800,201906,4871,14190,3769,12018,893,3060,1337,4123,2230,7183
312810,201906,1651,4482,1074,3497,264,982,346,973,610,1955
312820,201906,1770,4868,1442,4254,57,222,1039,2961,1096,3183
312825,201906,1323,3172,1132,2907,25,93,954,2398,979,2491
312830,201906,2747,7839,1574,5358,337,1281,367,1190,704,2471
312840,201906,1229,3520,943,3000,125,495,434,1273,559,1768
312850,201906,875,2208,611,1797,41,167,335,902,376,1069
312860,201906,1295,3321,851,2615,222,725,195,569,417,1294
312870,201906,6303,17458,3767,12279,632,2258,851,2631,1483,4889
312880,201906,1381,3541,1077,3039,46,174,594,1682,640,1856
312890,201906,2101,5532,1461,4389,141,445,683,2059,824,2504
312900,201906,1184,3140,949,2827,90,294,545,1717,635,2011
312910,201906,1613,3016,830,1983,148,309,309,706,457,1015
312920,201906,1009,2810,681,2220,149,554,254,757,403,1311
312930,201906,2127,5534,1689,4862,360,1072,742,2110,1102,3182
312940,201906,915,2608,717,2295,87,337,348,1060,435,1397
312950,201906,3110,7875,2020,6056,523,1708,669,1907,1192,3615
312960,201906,1880,4999,1555,4507,111,299,1158,3463,1269,3762
312965,201906,1664,4837,1389,4357,141,477,896,2762,1037,3239
312970,201906,1181,3429,918,2977,172,668,450,1336,622,2004
312980,201906,22225,63192,18040,55491,3126,10602,9194,26675,12320,37277
312990,201906,445,1165,269,859,58,218,117,360,175,578
313000,201906,444,1318,336,1119,37,158,179,559,216,717
313005,201906,2532,7380,2141,6727,134,461,1559,4779,1693,5240
313010,201906,4658,13366,3784,11866,705,2481,2172,6551,2877,9032
313020,201906,925,2848,609,2105,102,382,113,334,215,716
313030,201906,1167,2836,786,2234,84,309,486,1294,570,1603
313040,201906,774,2468,620,2118,50,213,350,1123,400,1336
313050,201906,1761,5062,1237,4264,212,885,361,1093,573,1978
313055,201906,1852,5124,1665,4836,53,169,1398,4039,1451,4208
313060,201906,958,2418,640,1895,205,679,132,327,337,1006
313065,201906,1629,5043,1437,4709,71,307,1064,3360,1135,3667
313070,201906,965,2557,722,2121,76,241,414,1186,490,1427
313080,201906,367,1015,264,815,61,214,85,212,146,426
313090,201906,4709,13119,4045,11960,511,1691,2477,7183,2988,8874
313100,201906,1362,3583,1038,3103,45,180,757,2223,802,2403
313110,201906,1462,3953,1039,3163,93,354,577,1602,670,1956
313115,201906,2446,7391,2026,6556,296,1066,1006,3043,1302,4109
313120,201906,3629,8742,2690,7486,296,907,1640,4538,1936,5445
313130,201906,28472,76651,21979,64229,2738,9078,11878,32656,14616,41734
313140,201906,563,1286,347,959,27,89,225,610,252,699
313150,201906,1352,3903,992,3186,272,929,276,828,548,1757
313160,201906,1000,2621,771,2225,39,144,562,1570,601,1714
313170,201906,11303,33385,7939,26738,1430,5184,2912,9241,4342,14425
313180,201906,2204,5982,1541,4643,201,656,808,2360,1009,3016
313190,201906,4288,12561,3092,10056,571,1981,1029,3108,1600,5089
313200,201906,1066,3055,921,2797,22,102,769,2242,791,2344
313210,201906,3708,11073,3059,9872,388,1423,1784,5541,2172,6964
313220,201906,1745,4702,1150,3536,185,648,411,1096,596,1744
313230,201906,2948,8316,2448,7716,71,252,2009,6419,2080,6671
313240,201906,9074,22873,5586,17157,1034,3607,2274,6412,3308,10019
313250,201906,5958,17849,4669,15259,698,2395,2289,7321,2987,9716
313260,201906,602,1604,419,1260,50,180,196,553,246,733
313270,201906,5521,14848,4429,13128,659,2013,2722,8130,3381,10143
313280,201906,434,1243,288,936,43,146,110,344,153,490
313290,201906,905,2901,695,2554,235,936,222,786,457,1722
313300,201906,1600,4490,1161,3672,313,1050,222,609,535,1659
313310,201906,1048,3198,826,2702,135,513,215,595,350,1108
313320,201906,2125,5691,1478,4633,287,1019,627,1948,914,2967
313330,201906,3951,10819,3023,9380,182,771,1946,5910,2128,6681
313340,201906,1312,3010,929,2454,101,274,649,1701,750,1975
313350,201906,2184,6269,1462,4678,211,767,552,1593,763,2360
313360,201906,1309,3338,881,2631,153,545,447,1236,600,1781
313370,201906,1300,3827,1134,3506,149,541,647,1852,796,2393
313375,201906,1680,4442,1033,3243,196,694,241,706,437,1400
313380,201906,5792,15039,4075,11788,805,2553,1757,4581,2562,7134
313390,201906,855,2797,748,2618,54,250,477,1589,531,1839
313400,201906,3672,9284,2847,8155,183,590,2170,6058,2353,6648
313410,201906,1271,3400,968,2858,63,207,704,2049,767,2256
313420,201906,15157,34434,7526,21350,1695,5298,973,2749,2668,8047
313430,201906,849,2520,646,2115,113,438,259,769,372,1207
313440,201906,5976,13125,3910,10396,290,813,2533,6700,2823,7513
313450,201906,614,1760,445,1413,94,328,142,388,236,716
313460,201906,2093,6224,1675,5555,346,1330,769,2413,1115,3743
313470,201906,2935,7535,2315,6644,251,701,1476,4315,1727,5016
313480,201906,905,2638,510,1740,81,298,135,408,216,706
313490,201906,1798,4321,856,2735,300,1081,90,296,390,1377
313500,201906,422,1268,327,1045,37,121,125,376,162,497
313505,201906,9575,25784,8176,23907,320,1155,6659,19359,6979,20514
313507,201906,1463,3888,1209,3496,30,127,958,2716,988,2843
313510,201906,12576,35285,10240,30926,1288,4165,5122,15007,6410,19172
313520,201906,13486,39170,10944,34691,712,2658,7882,24463,8594,27121
313530,201906,528,1541,403,1287,29,100,184,548,213,648
313535,201906,2338,6454,2011,5846,141,359,1419,4067,1560,4426
313540,201906,782,2426,602,1965,114,376,232,708,346,1084
313545,201906,1181,3987,1002,3622,164,620,537,1867,701,2487
313550,201906,1716,5308,1426,4623,349,1261,659,2026,1008,3287
313560,201906,2588,5223,1906,4395,76,142,1603,3702,1679,3844
313570,201906,940,2876,764,2537,192,683,295,925,487,1608
313580,201906,5444,14650,4141,12441,526,1694,2311,7032,2837,8726
313590,201906,949,2780,749,2479,225,798,308,1055,533,1853
313600,201906,3761,10398,3142,9403,107,451,2589,7588,2696,8039
313610,201906,996,2570,800,2221,105,303,483,1277,588,1580
313620,201906,5350,14584,4264,12611,643,2095,2302,6547,2945,8642
313630,201906,8320,20785,5757,16843,668,2267,3191,9120,3859,11387
313640,201906,1020,2450,630,1922,202,632,179,568,381,1200
313650,201906,1743,5314,1424,4780,97,384,936,3151,1033,3535
313652,201906,776,2543,704,2381,123,470,419,1369,542,1839
313655,201906,1094,2893,882,2603,45,146,690,2023,735,2169
313657,201906,1241,3341,966,2890,48,202,701,1985,749,2187
313660,201906,864,2468,701,2159,94,355,403,1149,497,1504
313665,201906,4540,12497,3518,10685,506,1725,1989,5778,2495,7503
313670,201906,45720,115656,29129,86795,4871,15919,11995,33771,16866,49690
313680,201906,1002,2738,840,2481,67,227,541,1542,608,1769
313690,201906,833,2691,642,2303,154,595,187,631,341,1226
313695,201906,1692,4749,1309,4111,86,308,899,2807,985,3115
313700,201906,3000,9814,2624,9332,258,972,1974,7001,2232,7973
313710,201906,1363,3266,963,2689,82,238,649,1815,731,2053
313720,201906,5287,14937,3825,11935,576,2038,1637,4720,2213,6758
313730,201906,1272,2980,965,2565,86,198,629,1664,715,1862
313740,201906,1650,5915,1330,5077,332,1425,214,705,546,2130
313750,201906,1905,5292,1470,4434,304,1017,615,1728,919,2745
313753,201906,2116,5138,1411,4003,148,447,799,2180,947,2627
313760,201906,4998,14074,3674,11447,852,2822,1416,4171,2268,6993
313770,201906,3792,10873,3026,9631,211,735,2161,6911,2372,7646
313780,201906,4010,10961,2925,9071,277,1015,771,2416,1048,3431
313790,201906,473,1503,419,1396,53,200,227,721,280,921
313800,201906,1314,3148,981,2646,131,406,524,1331,655,1737
313810,201906,1587,4149,1250,3657,69,268,916,2615,985,2883
313820,201906,14545,35367,9534,26297,1576,4712,3338,8900,4914,13612
313830,201906,354,1020,262,818,53,172,105,302,158,474
313835,201906,910,2747,737,2411,71,273,381,1181,452,1454
313840,201906,6536,17542,4714,14353,1234,3960,981,3058,2215,7018
313850,201906,922,2316,739,2051,118,400,390,969,508,1369
313860,201906,2576,7155,1904,5802,307,1049,729,2051,1036,3100
313862,201906,1477,3268,717,2085,55,177,348,962,403,1139
313865,201906,2271,6273,1945,5746,113,350,1484,4300,1597,4650
313867,201906,1118,3519,946,3182,182,634,558,1881,740,2515
313868,201906,1710,5343,1414,4740,54,262,1066,3454,1120,3716
313870,201906,787,2192,579,1806,112,365,201,571,313,936
313880,201906,1461,3952,1067,3278,184,622,469,1309,653,1931
313890,201906,1977,4492,1456,3814,74,232,1007,2578,1081,2810
313900,201906,3836,11538,2819,9461,742,2765,677,2100,1419,4865
313910,201906,593,1806,436,1501,100,371,89,294,189,665
313920,201906,2906,9247,2436,8266,512,1717,1192,4066,1704,5783
313925,201906,1569,4114,1259,3542,205,560,770,2154,975,2714
313930,201906,4776,14548,3865,12907,306,1182,2521,8264,2827,9446
313940,201906,8263,24610,5913,20394,1048,4292,1405,5254,2453,9546
313950,201906,4937,11340,3527,9528,464,1598,2071,5448,2535,7046
313960,201906,5328,13535,3616,10557,817,2638,1139,3072,1956,5710
313970,201906,1381,3898,1197,3575,28,100,760,2253,788,2353
313980,201906,1335,3553,868,2786,129,467,317,974,446,1441
313990,201906,1802,5963,1306,4767,349,1408,378,1219,727,2627
314000,201906,9409,25176,7889,22544,533,1945,5323,14902,5856,16847
314010,201906,1352,3392,1078,3010,46,161,803,2173,849,2334
314015,201906,1991,5609,1527,4862,220,852,794,2421,1014,3273
314020,201906,487,1360,293,976,59,245,51,178,110,423
314030,201906,752,2224,599,1922,69,234,304,958,373,1192
314040,201906,643,1757,517,1511,89,294,263,737,352,1031
314050,201906,1706,4647,1224,3749,167,601,624,1769,791,2370
314053,201906,1801,5437,1443,4710,265,844,718,2454,983,3298
314055,201906,2282,6258,1947,5751,55,218,1577,4660,1632,4878
314060,201906,1210,3279,912,2803,42,164,622,1876,664,2040
314070,201906,4477,12631,3508,10849,748,2335,1454,4393,2202,6728
314080,201906,2140,5766,1377,4340,206,783,508,1402,714,2185
314085,201906,2057,6113,1692,5529,300,1029,867,2857,1167,3886
314090,201906,4095,11756,3486,10777,247,1001,2281,6959,2528,7960
314100,201906,3124,7440,2428,6470,69,187,1862,4964,1931,5151
314110,201906,4214,12374,3476,10910,436,1589,1907,5584,2343,7173
314120,201906,844,1973,319,975,76,271,55,164,131,435
314130,201906,671,1789,389,1228,33,125,204,625,237,750
314140,201906,4563,13285,3513,11162,531,1786,1638,5062,2169,6848
314150,201906,1489,3781,1098,3091,95,282,719,1955,814,2237
314160,201906,2202,5973,1580,4841,240,788,638,1969,878,2757
314170,201906,971,2768,773,2367,63,216,464,1321,527,1537
314180,201906,5367,15283,4386,13658,398,1389,2544,7883,2942,9272
314190,201906,596,1546,420,1282,83,289,183,507,266,796
314200,201906,2850,8160,2323,7235,131,510,1656,4988,1787,5498
314210,201906,1955,5223,1541,4466,159,485,819,2313,978,2798
314220,201906,1301,3667,920,2986,218,827,319,944,537,1771
314225,201906,1097,3186,924,2916,76,230,658,2106,734,2336
314230,201906,758,2014,624,1844,80,259,386,1168,466,1427
314240,201906,1022,2793,786,2444,184,597,313,991,497,1588
314250,201906,519,1461,320,1037,46,170,121,353,167,523
314260,201906,927,2694,744,2405,172,616,375,1153,547,1769
314270,201906,3230,9226,2607,8239,96,383,1909,5952,2005,6335
314280,201906,3301,7727,2109,5847,278,853,1024,2646,1302,3499
314290,201906,4455,11748,3688,10397,347,996,2493,6915,2840,7911
314300,201906,1731,5132,1186,3901,260,941,364,1145,624,2086
314310,201906,4380,11841,3031,9470,948,3171,525,1516,1473,4687
314315,201906,908,3208,775,2917,61,298,523,1891,584,2189
314320,201906,2754,7577,1784,5758,343,1203,648,2022,991,3225
314330,201906,47240,133824,35550,113231,10134,33647,7755,25721,17889,59368
314340,201906,2261,5725,1248,3839,274,997,298,733,572,1730
314345,201906,1379,4195,1135,3752,160,547,662,2143,822,2690
314350,201906,891,2502,592,1949,131,471,137,409,268,880
314360,201906,575,1665,352,1179,61,220,99,304,160,524
314370,201906,690,1910,541,1673,30,125,389,1152,419,1277
314380,201906,1089,3097,744,2430,178,670,157,490,335,1160
314390,201906,12066,31921,7720,23649,1648,5391,2209,6035,3857,11426
314400,201906,3920,11777,3051,10166,838,2927,1080,3678,1918,6605
314410,201906,2732,7689,1850,5976,280,1009,640,2160,920,3169
314420,201906,802,1971,606,1706,23,109,431,1144,454,1253
314430,201906,6973,17968,4932,14370,824,2529,2102,5868,2926,8397
314435,201906,1586,4361,1275,3828,46,185,942,2784,988,2969
314437,201906,934,2434,653,1956,60,215,312,917,372,1132
314440,201906,585,1699,422,1379,112,394,88,246,200,640
314450,201906,1327,3645,1102,3279,106,358,671,1933,777,2291
314460,201906,3269,10207,2352,8149,590,2164,452,1520,1042,3684
314465,201906,2175,6421,1876,5823,52,219,1421,4237,1473,4456
314467,201906,841,2328,727,2132,30,95,575,1647,605,1742
314470,201906,2167,6376,1731,5432,325,1128,747,2176,1072,3304
314480,201906,6122,18098,4382,14317,761,2739,1382,4046,2143,6785
314490,201906,962,2698,712,2159,76,259,418,1226,494,1485
314500,201906,1642,4180,1190,3468,234,700,489,1412,723,2112
314505,201906,1931,4843,1592,4363,104,293,1143,3074,1247,3367
314510,201906,1826,4850,1250,3947,265,929,546,1676,811,2605
314520,201906,4486,14096,3179,11145,627,2392,392,1207,1019,3599
314530,201906,5456,17921,4884,16797,406,1677,3438,11564,3844,13241
314535,201906,2557,6759,2066,6020,115,429,1539,4413,1654,4842
314537,201906,1106,3203,849,2757,58,233,586,1851,644,2084
314540,201906,417,1090,284,839,22,80,135,378,157,458
314545,201906,1750,4427,1546,4172,42,110,1290,3612,1332,3722
314550,201906,646,1618,485,1379,40,154,255,646,295,800
314560,201906,3982,12350,2969,10032,498,1804,962,3012,1460,4816
314570,201906,290,807,221,681,29,107,100,308,129,415
314580,201906,436,1329,327,1104,97,338,83,287,180,625
314585,201906,649,2070,487,1697,59,264,239,780,298,1044
314587,201906,2002,5554,1522,4792,202,571,838,2706,1040,3277
314590,201906,3605,10136,2492,7936,378,1347,973,2891,1351,4238
314600,201906,1796,5096,1055,3605,219,819,117,353,336,1172
314610,201906,8619,22575,5975,18616,1144,4112,2417,7359,3561,11471
314620,201906,2138,5133,1667,4515,53,205,1365,3605,1418,3810
314625,201906,1495,4276,1270,3949,49,278,1033,3116,1082,3394
314630,201906,5134,13504,4231,12249,124,503,3485,10082,3609,10585
314640,201906,636,1578,450,1271,70,231,228,582,298,813
314650,201906,878,2115,539,1573,51,173,261,668,312,841
314655,201906,1567,4363,1111,3527,183,565,524,1648,707,2213
314660,201906,333,798,216,572,10,17,128,324,138,341
314670,201906,1675,3877,1165,3154,32,108,731,1954,763,2062
314675,201906,1710,4645,1479,4252,101,363,1126,3121,1227,3484
314690,201906,2050,5928,1568,5155,469,1666,447,1475,916,3141
314700,201906,9891,28542,6321,21268,1298,4758,1640,5335,2938,10093
314710,201906,7592,21711,5404,17063,1133,3862,1389,3900,2522,7762
314720,201906,2091,6325,1416,4873,309,1188,352,1164,661,2352
314730,201906,2039,5752,1456,4589,344,1124,398,1207,742,2331
314740,201906,2775,7968,2189,6925,298,1037,1113,3442,1411,4479
314750,201906,312,881,245,747,21,77,133,367,154,444
314760,201906,1822,5602,1174,4070,181,709,287,821,468,1530
314770,201906,1067,3180,534,1747,54,186,141,406,195,592
314780,201906,343,838,225,660,46,160,115,302,161,462
314790,201906,9581,26522,6477,20633,1608,5790,1796,5290,3404,11080
314795,201906,1421,3861,1212,3504,39,173,946,2610,985,2783
314800,201906,10718,27692,6238,19195,1211,4056,1285,3538,2496,7594
314810,201906,8266,22805,6022,18800,1645,5426,1806,5614,3451,11040
314820,201906,1033,2630,805,2273,51,202,517,1390,568,1592
314830,201906,1427,4446,1205,3994,258,915,547,1808,805,2723
314840,201906,884,2878,688,2549,63,327,469,1652,532,1979
314850,201906,1942,4792,1569,4282,46,157,1350,3686,1396,3843
314860,201906,3115,9559,2582,8498,319,1244,1614,5121,1933,6365
314870,201906,6161,16197,4698,14144,341,1128,3372,10165,3713,11293
314875,201906,1714,5221,1524,4970,113,313,1221,4045,1334,4358
314880,201906,871,2131,679,1856,31,92,449,1264,480,1356
314890,201906,413,1230,298,965,54,197,109,322,163,519
314900,201906,635,1733,491,1484,103,338,186,542,289,880
314910,201906,1607,4703,1197,4029,259,1012,553,1729,812,2741
314915,201906,2227,6663,1865,6024,133,465,1235,3894,1368,4359
314920,201906,475,1237,304,969,11,41,204,643,215,684
314930,201906,5163,15189,3892,12752,761,2721,1418,4359,2179,7080
314940,201906,402,1050,336,932,36,94,204,532,240,626
314950,201906,456,1195,291,917,27,115,131,355,158,470
314960,201906,783,1991,609,1672,36,113,435,1130,471,1243
314970,201906,827,2405,656,2084,113,393,320,952,433,1345
314980,201906,1327,3566,953,2974,231,821,347,1053,578,1874
314990,201906,2329,6831,1565,5047,344,1233,324,885,668,2118
314995,201906,1627,4650,1296,4047,67,287,836,2482,903,2769
315000,201906,1087,2887,783,2399,65,218,502,1485,567,1703
315010,201906,380,1085,278,892,49,190,128,383,177,573
315015,201906,2188,6345,1920,5892,189,644,1234,3732,1423,4376
315020,201906,775,2346,554,1842,65,267,230,680,295,947
315030,201906,567,1580,371,1195,95,320,75,221,170,541
315040,201906,803,2378,685,2095,93,317,428,1292,521,1609
315050,201906,1113,2949,847,2557,67,266,465,1368,532,1634
315053,201906,1142,3028,866,2532,59,189,495,1389,554,1578
315057,201906,1607,5136,1382,4692,159,549,885,3033,1044,3582
315060,201906,555,1719,397,1387,77,281,100,333,177,614
315070,201906,551,1476,384,1172,97,331,97,264,194,595
315080,201906,2667,8029,2065,6762,358,1207,1048,3336,1406,4543
315090,201906,781,2447,565,1999,89,344,204,686,293,1030
315100,201906,1170,3611,727,2555,138,536,286,905,424,1441
315110,201906,1612,4177,1212,3509,139,405,584,1706,723,2111
315120,201906,11476,27575,8246,22567,1143,3006,4203,11956,5346,14962
315130,201906,1319,3833,1060,3339,144,535,430,1266,574,1801
315140,201906,2831,8026,2151,6768,398,1394,1057,3086,1455,4480
315150,201906,4221,10545,2919,8364,451,1460,1297,3592,1748,5052
315160,201906,1606,4090,1040,3146,219,680,447,1331,666,2011
315170,201906,1390,4499,941,3384,228,854,184,656,412,1510
315180,201906,16489,41267,8474,25814,1257,4331,2391,6350,3648,10681
315190,201906,2055,4693,1618,4103,226,563,1163,2941,1389,3504
315200,201906,3646,10789,2645,8926,807,2951,611,1976,1418,4927
315210,201906,7890,21110,5504,15929,692,2181,2568,6722,3260,8903
315213,201906,1116,2991,959,2765,22,69,771,2203,793,2272
315217,201906,2572,7867,2007,6878,100,493,1335,4407,1435,4900
315220,201906,7896,21973,6342,19217,1432,4616,2518,7593,3950,12209
315230,201906,3068,7274,2558,6642,151,277,2016,5493,2167,5770
315240,201906,2317,7093,1985,6482,483,1693,1025,3263,1508,4956
315250,201906,10951,30733,7895,24947,1364,4674,3288,9921,4652,14595
315260,201906,975,2795,512,1721,84,273,37,116,121,389
315270,201906,803,2386,536,1853,74,288,160,463,234,751
315280,201906,2870,7308,1648,4998,395,1296,245,734,640,2030
315290,201906,1172,2975,700,2215,201,695,182,583,383,1278
315300,201906,675,1625,433,1286,120,400,160,481,280,881
315310,201906,1286,3676,940,3005,83,284,515,1562,598,1846
315320,201906,693,2056,482,1637,61,262,208,643,269,905
315330,201906,746,2600,408,1650,73,325,115,413,188,738
315340,201906,3033,7562,2214,6364,157,518,1376,3907,1533,4425
315350,201906,1506,4205,1155,3614,173,618,618,1898,791,2516
315360,201906,1665,5096,1210,4063,181,641,477,1503,658,2144
315370,201906,438,1278,342,1076,67,203,139,430,206,633
315380,201906,176,540,131,426,32,105,23,53,55,158
315390,201906,1131,3349,867,2820,169,624,337,999,506,1623
315400,201906,3937,11183,3095,9610,432,1392,1589,4763,2021,6155
315410,201906,2258,5299,1739,4533,452,1264,328,882,780,2146
315415,201906,1219,3416,966,3016,222,818,397,1228,619,2046
315420,201906,1183,3459,758,2608,148,545,123,394,271,939
315430,201906,3518,8759,2449,7096,454,1561,1000,2680,1454,4241
315440,201906,980,2674,793,2352,82,295,447,1228,529,1523
315445,201906,1998,4914,1437,4089,116,364,996,2798,1112,3162
315450,201906,2159,6240,1786,5643,236,729,1108,3522,1344,4251
315460,201906,33486,97105,27772,86564,5540,19017,13092,38376,18632,57393
315470,201906,458,1307,367,1139,30,111,219,650,249,761
315480,201906,1235,3657,858,2820,169,577,270,866,439,1443
315490,201906,2954,7440,1997,5951,284,872,707,2074,991,2946
315500,201906,498,1367,302,934,34,131,130,341,164,472
315510,201906,1226,3357,1057,3100,27,121,901,2579,928,2700
315520,201906,1050,2935,827,2552,58,217,596,1785,654,2002
315530,201906,586,1750,450,1475,149,528,179,552,328,1080
315540,201906,1329,3676,899,2846,110,412,367,1120,477,1532
315550,201906,1820,4843,1173,3676,260,905,290,889,550,1794
315560,201906,6232,19441,5341,17782,329,1113,3502,11751,3831,12864
315570,201906,1865,5299,1547,4743,97,411,919,2688,1016,3099
315580,201906,2365,5917,1798,4993,309,1005,658,1744,967,2749
315590,201906,884,2373,699,2071,89,318,343,949,432,1267
315600,201906,2389,7739,1735,6433,260,943,915,3516,1175,4459
315610,201906,880,2289,659,1865,122,417,291,705,413,1122
315620,201906,364,1107,306,1000,43,157,192,629,235,786
315630,201906,876,2439,686,2109,148,492,255,708,403,1200
315640,201906,337,894,280,822,30,111,172,476,202,587
315645,201906,948,2522,635,1985,162,550,154,455,316,1005
315650,201906,1723,4341,1372,3828,34,146,1115,2985,1149,3131
315660,201906,2423,5965,1807,4901,107,317,1273,3326,1380,3643
315670,201906,13175,37492,10134,31851,2136,7011,4316,13110,6452,20121
315680,201906,3010,9097,2192,7464,366,1381,988,3208,1354,4589
315690,201906,2796,7313,1727,5288,380,1174,517,1726,897,2900
315700,201906,7563,21553,5710,17813,961,3191,2553,7620,3514,10811
315710,201906,1851,4730,1331,3931,52,228,925,2610,977,2838
315720,201906,4195,12026,3543,10840,186,808,2464,7215,2650,8023
315725,201906,1891,5324,1452,4482,154,471,956,3009,1110,3480
315727,201906,544,1445,403,1207,58,192,159,449,217,641
315730,201906,610,1882,535,1732,75,273,231,711,306,984
315733,201906,1351,3513,926,2737,145,510,337,931,482,1441
315737,201906,1114,3269,877,2802,45,183,601,1865,646,2048
315740,201906,895,2574,701,2164,96,359,401,1141,497,1500
315750,201906,1230,3371,987,2954,80,256,631,1903,711,2159
315760,201906,1148,2773,1038,2634,43,124,889,2221,932,2345
315765,201906,1847,4993,1513,4559,38,135,1310,3918,1348,4053
315770,201906,945,2823,773,2578,301,1104,185,527,486,1631
315780,201906,27355,77544,23059,69749,1801,6671,14906,42861,16707,49532
315790,201906,3541,11119,3012,10101,268,960,1861,6345,2129,7305
315800,201906,1198,4413,838,3384,147,649,206,765,353,1414
315810,201906,1293,3262,1081,2914,47,172,849,2172,896,2344
315820,201906,2524,7150,2057,6412,203,731,1391,4259,1594,4990
315830,201906,1055,3096,774,2564,66,247,337,1070,403,1317
315840,201906,809,2005,512,1448,49,168,244,625,293,793
315850,201906,1110,3379,888,2975,177,644,442,1395,619,2039
315860,201906,495,1487,339,1189,79,302,85,280,164,582
315870,201906,461,1211,358,1057,29,98,237,650,266,748
315880,201906,1088,2835,717,2187,89,336,177,477,266,813
315890,201906,1584,4717,1265,4246,337,1224,593,1918,930,3142
315895,201906,5894,16327,4445,13417,479,1637,2248,6329,2727,7966
315900,201906,808,2123,697,1969,55,175,519,1421,574,1596
315910,201906,510,1494,426,1353,68,256,276,826,344,1082
315920,201906,1550,4100,828,2589,138,478,239,682,377,1160
315930,201906,1073,2508,712,1957,132,360,305,844,437,1204
315935,201906,780,2392,632,2106,121,421,212,707,333,1128
315940,201906,584,1691,467,1486,53,183,243,746,296,929
315950,201906,1164,3266,984,2975,100,284,748,2287,848,2571
315960,201906,4024,11482,2350,8087,780,3104,164,347,944,3451
315970,201906,629,1688,486,1496,64,221,320,976,384,1197
315980,201906,4189,9347,2246,6105,389,1102,754,1886,1143,2988
315990,201906,3518,9078,2733,7751,290,886,1593,4396,1883,5282
316000,201906,525,1411,399,1230,65,245,175,503,240,748
316010,201906,804,2178,605,1844,41,160,369,1034,410,1194
316020,201906,954,2934,772,2568,79,336,464,1415,543,1751
316030,201906,2823,7886,2073,6564,232,773,1290,4142,1522,4915
316040,201906,2480,7449,1805,6113,310,1141,423,1299,733,2440
316045,201906,2038,5393,1838,5128,81,177,1540,4413,1621,4590
316050,201906,369,1084,275,912,43,164,146,458,189,622
316060,201906,668,1810,499,1539,26,114,335,957,361,1071
316070,201906,5357,15364,4385,13453,799,2582,1977,5855,2776,8437
316080,201906,707,2234,543,1882,131,489,74,244,205,733
316090,201906,412,1268,293,1001,36,153,134,399,170,552
316095,201906,1245,3942,1016,3391,240,847,377,1225,617,2072
316100,201906,2483,7541,1755,5894,331,1198,561,1702,892,2900
316105,201906,848,2282,652,1982,50,170,444,1370,494,1540
316110,201906,12789,38169,10712,34586,935,3413,7167,22896,8102,26309
316120,201906,1085,3223,672,2181,121,422,176,449,297,871
316130,201906,1203,2711,734,1952,58,184,415,1069,473,1253
316140,201906,1113,3030,734,2330,117,407,364,1128,481,1535
316150,201906,1764,4020,1447,3609,197,610,596,1372,793,1982
316160,201906,1020,2852,825,2510,58,204,530,1551,588,1755
316165,201906,894,2245,668,1879,105,354,344,907,449,1261
316170,201906,1068,2767,795,2348,65,236,514,1451,579,1687
316180,201906,1240,3610,828,2732,168,639,155,441,323,1080
316190,201906,2584,7512,1507,4908,230,768,527,1507,757,2275
316200,201906,3234,9581,2332,7817,536,1968,469,1497,1005,3465
316210,201906,4324,12937,3101,10114,1054,3704,284,798,1338,4502
316220,201906,606,1861,395,1365,92,353,45,177,137,530
316225,201906,1477,3429,1123,2826,41,163,842,1972,883,2135
316230,201906,408,1124,312,965,31,94,176,564,207,658
316240,201906,5619,16538,4952,15393,417,1417,3715,11352,4132,12769
316245,201906,2889,9779,2594,9271,148,880,1941,6572,2089,7452
316250,201906,9671,24175,6750,19400,1585,4912,2148,6013,3733,10925
316255,201906,2881,8161,2506,7557,167,567,1812,5482,1979,6049
316257,201906,1242,3061,875,2469,132,385,453,1258,585,1643
316260,201906,1851,4939,1394,4187,125,405,730,2286,855,2691
316265,201906,1138,3127,892,2700,38,139,620,1831,658,1970
316270,201906,3540,11262,3005,10039,546,1925,1381,4397,1927,6322
316280,201906,2897,8673,2482,7872,351,1225,1332,4076,1683,5301
316290,201906,3375,9514,2661,8130,331,1186,1106,3291,1437,4477
316292,201906,4808,13083,3934,11645,498,1655,2636,7549,3134,9204
316294,201906,797,2399,585,2030,106,423,128,429,234,852
316295,201906,2784,7984,2294,7105,131,530,1604,4705,1735,5235
316300,201906,943,2889,800,2640,53,212,544,1776,597,1988
316310,201906,863,2268,522,1668,93,353,89,244,182,597
316320,201906,576,1658,444,1427,51,196,209,644,260,840
316330,201906,1049,2897,774,2373,54,207,539,1578,593,1785
316340,201906,1013,2883,746,2365,77,322,395,1168,472,1490
316350,201906,1196,3544,1027,3259,102,337,694,2188,796,2525
316360,201906,643,1695,510,1479,52,172,361,1018,413,1190
316370,201906,4770,13305,3573,11008,723,2545,1166,3179,1889,5724
316380,201906,1620,3970,1276,3490,46,105,928,2560,974,2665
316390,201906,837,2290,602,1855,211,734,131,381,342,1115
316400,201906,1178,3418,767,2581,129,476,255,769,384,1245
316410,201906,1081,3219,908,2940,63,221,698,2226,761,2447
316420,201906,1838,5253,1612,4969,58,238,1331,4002,1389,4240
316430,201906,862,2362,534,1734,107,381,145,446,252,827
316440,201906,712,2260,558,1993,129,510,96,326,225,836
316443,201906,531,1532,405,1289,108,374,84,260,192,634
316447,201906,1829,5071,1593,4685,48,187,1299,3750,1347,3937
316450,201906,2197,6784,1655,5643,215,791,989,3318,1204,4109
316460,201906,970,2555,776,2234,165,518,426,1148,591,1666
316470,201906,6305,18516,4549,14812,810,3015,1632,4901,2442,7916
316480,201906,211,591,176,532,38,116,86,249,124,365
316490,201906,288,783,213,653,24,83,90,239,114,322
316500,201906,1179,3848,778,2826,161,631,152,514,313,1145
316510,201906,698,2357,557,2079,119,462,240,909,359,1371
316520,201906,1074,2830,845,2441,126,435,403,1063,529,1498
316530,201906,1041,2819,761,2300,95,403,370,966,465,1369
316540,201906,780,2134,628,1894,117,414,288,796,405,1210
316550,201906,1335,4041,1153,3676,75,293,854,2668,929,2961
316553,201906,3484,10645,2417,8051,485,1763,702,2092,1187,3855
316555,201906,2524,8302,2306,7986,147,582,1766,6175,1913,6757
316556,201906,565,1380,398,1102,23,64,224,563,247,627
316557,201906,943,3073,805,2813,293,1077,239,832,532,1909
316560,201906,282,848,206,739,59,246,54,171,113,417
316570,201906,1142,3458,981,3148,253,824,349,1111,602,1935
316580,201906,397,895,249,639,43,123,115,272,158,395
316590,201906,1292,3434,929,2717,146,413,503,1406,649,1819
316600,201906,956,3011,815,2706,138,484,418,1360,556,1844
316610,201906,579,1869,489,1725,56,259,298,999,354,1258
316620,201906,1985,5565,1710,5186,84,281,1265,3873,1349,4154
316630,201906,1541,4645,1233,4062,332,1094,477,1715,809,2809
316640,201906,139,377,108,330,19,61,51,135,70,196
316650,201906,1009,3300,810,2987,71,287,503,1889,574,2176
316660,201906,200,512,89,276,7,21,13,44,20,65
316670,201906,1828,4732,1352,3949,345,1096,454,1275,799,2371
316680,201906,2130,5556,1632,4686,126,395,1196,3363,1322,3758
316690,201906,1195,3572,948,3081,182,648,418,1325,600,1973
316695,201906,992,2933,817,2619,32,139,559,1762,591,1901
316700,201906,376,910,315,839,15,57,237,586,252,643
316710,201906,2876,9679,2186,8193,497,1975,819,3068,1316,5043
316720,201906,20032,56658,14638,45957,2860,9613,5716,17065,8576,26678
316730,201906,398,1138,315,968,50,176,144,390,194,566
316740,201906,695,2094,607,1946,62,262,385,1209,447,1471
316750,201906,398,1213,301,1018,62,245,126,377,188,622
316760,201906,3608,11591,2933,10164,1196,4459,730,2425,1926,6884
316770,201906,1531,3678,1209,3236,29,99,1020,2758,1049,2857
316780,201906,547,1667,426,1434,146,554,66,192,212,746
316790,201906,696,1905,475,1465,114,362,130,372,244,734
316800,201906,5953,17199,4781,15047,438,1596,2612,7937,3050,9533
316805,201906,997,2222,812,2017,51,128,660,1663,711,1791
316810,201906,672,1899,449,1412,91,341,211,615,302,956
316820,201906,312,790,155,494,16,57,53,173,69,230
316830,201906,675,1955,552,1750,84,317,330,1001,414,1318
316840,201906,2694,7342,2208,6487,267,940,1388,3877,1655,4817
316850,201906,1982,5285,1418,4258,211,688,617,1813,828,2501
316860,201906,17588,47384,13261,40732,2336,8246,6103,18224,8439,26470
316870,201906,7106,20102,5303,16555,887,3102,2240,6428,3127,9530
316880,201906,782,2149,634,1941,133,470,283,829,416,1299
316890,201906,1101,2507,647,1884,114,403,348,890,462,1293
316900,201906,2217,6194,1722,5201,354,1193,559,1533,913,2726
316905,201906,510,1541,397,1313,91,330,157,525,248,855
316910,201906,873,2379,566,1839,142,527,54,162,196,689
316920,201906,1566,4068,1032,3196,199,652,396,1223,595,1875
316930,201906,7896,23851,5716,19613,1153,4178,1238,4099,2391,8277
316935,201906,3871,10754,2771,8683,531,1757,1037,3125,1568,4882
316940,201906,6498,19615,4929,16216,852,3078,1752,5345,2604,8423
316950,201906,1805,4321,1388,3743,59,186,1094,2901,1153,3087
316960,201906,4956,11620,3626,9683,419,1226,2334,6074,2753,7300
316970,201906,3414,10061,2969,9176,637,2033,1059,3148,1696,5181
316980,201906,709,2161,512,1758,157,604,71,261,228,865
316990,201906,10413,29340,7321,22725,1993,6581,916,2540,2909,9121
317000,201906,2512,7707,2235,7285,166,520,1635,5337,1801,5857
317005,201906,2575,7554,2040,6418,363,1172,1011,3097,1374,4269
317010,201906,22854,54818,13948,41155,3266,10490,4528,13842,7794,24332
317020,201906,61678,149484,34864,101935,6559,20802,9954,26858,16513,47660
317030,201906,642,1800,520,1629,24,104,395,1216,419,1320
317040,201906,10457,27340,7412,22006,1774,5565,2660,8080,4434,13645
317043,201906,813,1916,600,1620,71,196,403,1104,474,1300
317047,201906,1162,2820,775,2181,105,295,456,1264,561,1559
317050,201906,1190,3744,823,2870,116,423,322,993,438,1416
317052,201906,2344,6799,1894,6040,268,905,1156,3648,1424,4553
317057,201906,1653,4196,1166,3340,52,199,692,1941,744,2140
317060,201906,441,1198,266,822,43,148,105,296,148,444
317065,201906,1220,3600,993,3167,50,197,633,1871,683,2068
317070,201906,7475,21003,5093,16287,1076,3901,1194,3575,2270,7476
317075,201906,885,2447,610,1925,111,384,185,530,296,914
317080,201906,5902,14268,4316,11654,1285,3706,1260,3184,2545,6890
317090,201906,4318,13423,3905,12721,347,1109,2805,9107,3152,10216
317100,201906,2378,5761,1584,4521,400,1238,581,1589,981,2827
317103,201906,1858,5657,1606,5195,137,685,1111,3328,1248,4013
317107,201906,1329,3682,1037,3102,55,237,638,1672,693,1909
317110,201906,686,1553,342,1038,53,198,108,331,161,529
317115,201906,1088,3150,918,2830,54,155,642,1986,696,2141
317120,201906,11975,34364,9409,29966,1300,4733,5017,15384,6317,20117
317130,201906,10113,24247,6221,17831,1137,3561,2007,5672,3144,9233
317140,201906,685,1895,538,1662,46,147,333,1057,379,1204
317150,201906,1007,2478,772,2178,34,120,600,1650,634,1770
317160,201906,3532,8676,2353,6859,191,593,1339,3896,1530,4489
317170,201906,1898,4867,1319,3827,217,742,485,1193,702,1935
317180,201906,1772,5752,1319,4605,278,1037,345,1142,623,2179
317190,201906,1221,3362,908,2856,112,355,518,1617,630,1972
317200,201906,4854,13064,3627,10879,999,3258,698,1908,1697,5166
317210,201906,1149,2886,888,2519,43,162,629,1804,672,1966
317220,201906,274,885,236,805,62,216,80,280,142,496
320010,201906,4428,13183,3606,11541,386,1373,2295,7195,2681,8568
320013,201906,1578,4703,1128,3704,187,586,528,1781,715,2367
320016,201906,2993,7793,2355,6846,112,305,1862,5384,1974,5689
320020,201906,3867,10487,2862,8732,723,2364,954,2998,1677,5362
320030,201906,1519,4495,1048,3499,217,799,346,1074,563,1873
320035,201906,1742,4935,1442,4415,379,1264,618,1848,997,3112
320040,201906,3661,10840,2997,9560,455,1575,1600,4989,2055,6564
320050,201906,1766,4061,1516,3688,233,660,875,2056,1108,2716
320060,201906,11176,31979,8263,26033,1386,4789,3621,10769,5007,15558
320070,201906,1418,4124,985,3211,190,682,332,1040,522,1722
320080,201906,5412,14238,3849,11147,839,2555,1358,3763,2197,6318
320090,201906,7453,20405,5108,15560,1115,3686,2051,5849,3166,9535
320100,201906,2654,7714,2106,6697,420,1441,1021,3171,1441,4612
320110,201906,1439,3722,1072,3097,199,601,485,1371,684,1972
320115,201906,1741,5774,1504,5360,656,2430,454,1679,1110,4109
320120,201906,18451,48750,12677,38205,2074,6788,5296,15252,7370,22040
320130,201906,39470,114664,32985,102660,5010,17031,18442,55777,23452,72808
320140,201906,2943,8624,2190,7047,389,1422,883,2783,1272,4205
320150,201906,13067,34910,9087,26930,2477,7856,1598,4407,4075,12263
320160,201906,5376,15713,4017,13031,681,2347,1860,5944,2541,8291
320170,201906,1436,4292,1060,3524,291,976,406,1376,697,2352
320180,201906,698,2284,566,2007,189,716,142,469,331,1185
320190,201906,2754,9003,2096,7463,509,1907,504,1740,1013,3647
320200,201906,1091,3082,797,2525,208,748,255,800,463,1548
320210,201906,4338,11315,3359,9597,559,1736,1777,4855,2336,6591
320220,201906,2563,7157,1946,6049,368,1236,920,2786,1288,4022
320225,201906,1322,4222,906,3184,342,1274,141,494,483,1768
320230,201906,4578,13106,3463,11217,826,2914,1362,4317,2188,7231
320240,201906,13756,36743,10431,31218,2371,7545,4086,12078,6457,19623
320245,201906,2918,9001,2365,7847,949,3261,515,1665,1464,4926
320250,201906,1987,5724,1308,4079,308,1074,330,923,638,1997
320255,201906,1692,5501,1485,5126,510,1791,651,2350,1161,4141
320260,201906,1031,3094,726,2339,180,657,200,547,380,1204
320265,201906,2306,7324,1936,6575,920,3285,385,1274,1305,4559
320270,201906,2200,6459,1655,5328,363,1264,710,2279,1073,3543
320280,201906,6095,17028,4922,14920,1175,3751,1893,5696,3068,9447
320290,201906,1321,4027,862,2884,237,859,209,649,446,1508
320300,201906,3459,10938,2812,9518,877,3204,555,1740,1432,4944
320305,201906,4867,14234,3846,12154,808,2736,1801,5494,2609,8230
320310,201906,1865,5354,1287,4077,246,815,546,1682,792,2497
320313,201906,2308,6025,1434,4261,320,1048,304,840,624,1888
320316,201906,1434,4226,1205,3783,195,636,695,2171,890,2807
320320,201906,20719,55777,14640,45158,3557,11499,5431,16707,8988,28206
320330,201906,2890,8070,2270,6933,501,1504,1090,3431,1591,4935
320332,201906,5552,16142,4514,14274,1136,3863,2093,6563,3229,10426
320334,201906,1852,5501,1295,4278,294,1148,288,764,582,1912
320335,201906,1515,4521,976,3272,248,891,202,629,450,1520
320340,201906,4730,12321,3948,11097,546,1633,2219,6299,2765,7932
320350,201906,5056,12879,3499,9997,460,1400,1776,4845,2236,6245
320360,201906,1452,3746,1064,2990,137,365,512,1384,649,1749
320370,201906,2359,7589,1865,6474,550,1956,639,2179,1189,4135
320380,201906,2303,6432,1929,5792,257,836,1168,3426,1425,4262
320390,201906,7320,20390,5408,16433,1164,3716,2076,6020,3240,9736
320400,201906,3205,9331,2527,7892,688,2278,968,2895,1656,5173
320405,201906,4382,11850,3294,9957,538,1729,1544,4591,2082,6320
320410,201906,4744,12675,3601,10799,631,1886,1793,5617,2424,7503
320420,201906,2814,7710,2196,6672,664,2207,547,1626,1211,3833
320425,201906,1991,4838,1539,4096,101,303,1038,2668,1139,2971
320430,201906,2812,7240,2181,6021,304,916,1360,3594,1664,4510
320435,201906,2275,7291,1773,6247,643,2363,510,1834,1153,4197
320440,201906,1322,3769,962,3057,148,522,420,1276,568,1798
320450,201906,1579,4718,1250,4084,290,1054,544,1679,834,2733
320455,201906,3852,11904,2574,8864,707,2547,743,2447,1450,4994
320460,201906,2090,6417,1465,5005,365,1312,360,1136,725,2448
320465,201906,1198,3507,900,2909,126,444,493,1575,619,2019
320470,201906,3734,10448,2544,7923,612,2083,593,1694,1205,3777
320480,201906,1623,4690,1353,4184,220,777,720,2143,940,2920
320490,201906,19694,52974,14353,43308,2640,8852,5681,16796,8321,25648
320495,201906,1389,3855,939,2979,198,704,329,979,527,1683
320500,201906,48601,133728,39510,117537,6258,20103,22007,62852,28265,82955
320501,201906,4333,12794,3109,10520,863,3227,970,3217,1833,6444
320503,201906,2035,6314,1456,5046,450,1682,464,1465,914,3147
320506,201906,2692,8172,1859,6278,529,1928,182,594,711,2522
320510,201906,9604,26890,7773,23540,1033,3508,4532,13225,5565,16733
320515,201906,1712,4737,1322,3940,391,1247,418,1201,809,2448
320517,201906,2074,6429,1635,5484,545,1972,416,1371,961,3343
320520,201906,33711,90872,25148,76093,4689,15488,10459,30647,15148,46135
320530,201906,29647,81427,23292,69862,2622,9296,13890,39052,16512,48348
330010,201906,20331,56200,16648,49831,2715,8567,9892,29012,12607,37579
330015,201906,1460,3715,1130,3173,192,619,606,1600,798,2219
330020,201906,19751,50469,17160,46757,2236,7006,12361,32710,14597,39716
330022,201906,1908,5204,1442,4387,230,724,844,2522,1074,3246
330023,201906,4596,11231,3166,9125,614,1894,1521,4257,2135,6151
330025,201906,4860,12129,3264,9447,988,3052,1004,2837,1992,5889
330030,201906,10197,28147,7659,23717,919,3354,4504,13187,5423,16541
330040,201906,14126,37943,11215,32813,1233,4074,7196,20139,8429,24213
330045,201906,81321,197683,67617,179663,6075,16081,52099,137138,58174,153219
330050,201906,2384,6470,1767,5407,388,1259,795,2311,1183,3570
330060,201906,4842,13214,4029,11801,862,2773,1736,4725,2598,7498
330070,201906,21800,57869,17923,51878,3264,10067,9829,28135,13093,38202
330080,201906,8524,22336,7409,20677,978,2830,4956,13621,5934,16451
330090,201906,3442,7308,2225,5657,163,447,1466,3688,1629,4135
330093,201906,2467,6255,1821,5252,147,451,1312,3769,1459,4220
330095,201906,1193,3511,920,2984,88,350,528,1571,616,1921
330100,201906,67033,182974,56986,167615,3846,13591,42304,122086,46150,135677
330110,201906,1974,5834,1719,5405,298,1023,870,2639,1168,3662
330115,201906,2079,5342,1576,4578,244,782,914,2564,1158,3346
330120,201906,3451,7947,2530,6691,227,669,1758,4497,1985,5166
330130,201906,3731,10578,3115,9624,466,1535,1908,5832,2374,7367
330140,201906,3469,9298,2776,8264,418,1413,1691,4848,2109,6261
330150,201906,2110,5810,1631,4997,338,1101,710,2108,1048,3209
330160,201906,1314,3669,1033,3192,189,647,539,1583,728,2230
330170,201906,96202,253220,80155,230700,11610,33326,52225,151715,63835,185041
330180,201906,2068,5206,1600,4476,111,365,1068,2885,1179,3250
330185,201906,9245,24451,7716,22066,703,2389,5738,15852,6441,18241
330187,201906,3844,10113,3069,8916,443,1430,1840,5318,2283,6748
330190,201906,30547,77025,26512,71325,2190,6352,20645,54657,22835,61009
330200,201906,14662,39186,12246,36089,2521,7066,7567,22947,10088,30013
330205,201906,2050,5220,1569,4395,104,357,1075,2903,1179,3260
330210,201906,3324,8576,2393,6864,373,1181,1046,2771,1419,3952
330220,201906,10946,28305,7801,22793,1782,5695,2513,6752,4295,12447
330225,201906,3530,9439,2766,8271,245,884,1894,5495,2139,6379
330227,201906,16563,41741,14268,38797,750,2372,11999,32058,12749,34430
330230,201906,1662,3886,1188,3275,79,229,816,2227,895,2456
330240,201906,22205,59340,18005,52448,2813,8923,10856,30707,13669,39630
330245,201906,1655,4195,949,2951,209,675,296,930,505,1605
330250,201906,34848,93221,29451,84943,6135,17930,16121,46884,22256,64814
330260,201906,4031,10698,3125,9369,439,1457,1871,5353,2310,6810
330270,201906,25009,52972,15301,38880,2788,7657,6474,16133,9262,23790
330280,201906,2353,6319,1753,5259,206,682,998,2864,1204,3546
330285,201906,21132,52729,16920,46573,1703,5320,11865,31573,13568,36893
330290,201906,3551,9137,2867,8138,392,1228,1799,4927,2191,6155
330300,201906,5497,13444,3903,11020,384,1228,2502,6892,2886,8120
330310,201906,2267,5857,1722,4934,103,269,1155,3315,1258,3584
330320,201906,15127,37759,12074,33764,1615,4562,8446,23681,10061,28243
330330,201906,32571,75805,25814,66299,2822,7982,18014,45098,20836,53080
330340,201906,13985,35838,10213,29650,1845,5914,4949,13665,6794,19579
330350,201906,111081,274001,93248,251409,7315,20725,73419,196958,80734,217683
330360,201906,7461,18451,6430,17208,296,838,5399,14342,5695,15180
330370,201906,4656,13639,3435,11450,808,2785,1360,4693,2168,7478
330380,201906,5124,14363,3904,12159,800,2783,1771,5286,2571,8069
330385,201906,3891,11632,3209,10594,802,2891,1445,4757,2247,7648
330390,201906,24544,70138,19149,60055,3109,10921,10029,29837,13138,40758
330395,201906,3107,7998,2569,7265,201,634,1762,4861,1963,5495
330400,201906,3025,8338,2638,7682,179,665,1942,5318,2121,5983
330410,201906,2879,8041,2147,6706,437,1511,946,2767,1383,4278
330411,201906,2765,7602,2185,6477,162,571,1509,4265,1671,4836
330412,201906,1473,4381,1206,3905,157,580,691,2084,848,2664
330414,201906,22748,59234,18555,53331,1999,5855,12937,36852,14936,42707
330415,201906,3676,10315,2870,8921,356,1114,1653,5166,2009,6280
330420,201906,10055,25347,6732,19824,931,3039,3039,8392,3970,11431
330430,201906,8964,22498,7716,20652,496,1617,5813,14974,6309,16591
330440,201906,2216,6181,1659,5247,350,1274,828,2476,1178,3750
330450,201906,1317,3906,1063,3430,151,528,528,1666,679,2194
330452,201906,15240,39887,12070,34895,1808,5819,7215,20160,9023,25979
330455,201906,538930,1318193,410892,1126650,64980,189219,247037,664705,312017,853924
330460,201906,1169,3314,883,2862,170,599,439,1384,609,1983
330470,201906,4684,12124,3458,10188,1048,3172,1183,3524,2231,6696
330475,201906,8826,23616,7122,21311,1269,4257,4346,12711,5615,16968
330480,201906,5831,15592,4965,14256,471,1502,3296,9194,3767,10696
330490,201906,112182,266771,93054,240006,10608,28906,65573,166511,76181,195417
330500,201906,6421,16727,5414,15311,653,2067,3827,10629,4480,12696
330510,201906,37940,99208,29460,86913,6416,19769,16022,46797,22438,66566
330513,201906,1257,3317,987,2919,210,667,496,1460,706,2127
330515,201906,2460,6809,2028,6114,515,1647,942,2737,1457,4384
330520,201906,10547,29167,8696,26103,1280,4267,4986,14473,6266,18740
330530,201906,1658,4179,1198,3422,273,840,503,1384,776,2224
330540,201906,2861,7785,2212,6617,603,1833,853,2511,1456,4344
330550,201906,8133,23178,6580,20824,2153,7292,2200,6827,4353,14119
330555,201906,14779,33836,12358,30805,1106,3123,9346,23234,10452,26357
330560,201906,4258,11605,3444,10196,533,1616,2003,5764,2536,7380
330570,201906,2836,7926,2319,7040,382,1261,1413,4224,1795,5485
330575,201906,5346,14211,4636,12961,339,1090,3571,9617,3910,10707
330580,201906,14812,41103,11269,34436,2388,7883,4998,14591,7386,22474
330590,201906,1458,4065,1265,3820,188,573,851,2604,1039,3177
330600,201906,11413,31093,8996,26985,1244,4038,5132,15153,6376,19191
330610,201906,9101,24992,7457,22343,717,2504,4968,14436,5685,16940
330615,201906,2041,5696,1555,5003,309,1069,939,3041,1248,4110
330620,201906,3850,11511,3104,10141,810,2890,1194,3623,2004,6513
330630,201906,24213,62844,18969,54237,1757,5947,12849,35171,14606,41118
350010,201906,2085,5524,1012,3142,229,732,123,279,352,1011
350020,201906,688,1822,360,1138,48,149,132,378,180,527
350030,201906,3757,10886,2758,8940,692,2388,978,3040,1670,5428
350040,201906,675,1990,399,1379,63,245,125,347,188,592
350050,201906,1024,2709,714,2138,167,564,235,570,402,1134
350055,201906,916,2402,682,2028,77,253,383,1059,460,1312
350060,201906,107,289,74,233,13,43,37,113,50,156
350070,201906,3692,9853,2225,7042,436,1494,642,1825,1078,3319
350075,201906,589,1790,431,1464,185,656,44,139,229,795
350080,201906,650,1732,396,1237,52,179,163,465,215,644
350090,201906,633,1544,361,1046,78,241,123,322,201,563
350100,201906,2088,5736,1393,4428,151,581,749,2244,900,2825
350110,201906,465,1223,321,962,20,76,178,522,198,598
350115,201906,1308,3875,1049,3288,189,679,538,1525,727,2204
350120,201906,678,1663,358,1035,44,135,175,487,219,622
350130,201906,3081,8447,2445,7241,431,1342,1193,3357,1624,4699
350140,201906,741,2184,480,1635,50,218,224,701,274,919
350150,201906,505,1569,417,1399,96,322,98,304,194,626
350160,201906,10718,26969,7038,20374,874,2964,4197,11381,5071,14345
350170,201906,1875,5613,1453,4626,285,939,566,1715,851,2654
350180,201906,1081,2719,526,1596,118,356,126,360,244,716
350190,201906,2868,8298,2008,6504,405,1502,783,2104,1188,3606
350200,201906,419,1182,331,1018,21,73,221,643,242,716
350210,201906,5286,12537,3552,9891,590,1741,2014,5404,2604,7145
350220,201906,2773,7613,1826,5740,430,1423,610,1727,1040,3150
350230,201906,965,2624,800,2359,163,520,410,1161,573,1681
350240,201906,710,2092,451,1480,85,267,138,430,223,697
350250,201906,2376,7227,1773,6130,622,2349,313,1122,935,3471
350260,201906,778,1947,503,1438,54,159,304,843,358,1002
350270,201906,4587,12726,3619,10813,606,1937,1790,4972,2396,6909
350275,201906,2330,6502,1854,5651,320,1076,998,2865,1318,3941
350280,201906,18829,42792,10881,29725,2029,5860,3855,10199,5884,16059
350290,201906,3087,8612,2058,6489,402,1407,803,2346,1205,3753
350300,201906,663,1848,470,1438,83,280,211,600,294,880
350310,201906,812,2421,594,1935,101,399,228,638,329,1037
350315,201906,556,1488,371,1143,36,133,163,448,199,581
350320,201906,12990,34670,9854,29072,2379,7669,3211,8927,5590,16596
350330,201906,13737,34652,9757,26756,1249,3700,5752,14843,7001,18543
350335,201906,350,997,255,807,19,74,150,454,169,528
350340,201906,1084,2862,628,2014,112,386,218,686,330,1072
350350,201906,746,1971,585,1789,87,310,304,893,391,1203
350360,201906,1098,3323,846,2778,221,713,233,778,454,1491
350370,201906,620,1609,423,1235,137,382,106,309,243,691
350380,201906,4454,12173,2931,9138,811,2553,709,2276,1520,4829
350390,201906,9445,26081,7466,22579,1872,5852,2996,8892,4868,14744
350395,201906,423,1095,203,661,22,66,64,193,86,259
350400,201906,7903,20213,5426,15951,1367,4349,1542,4311,2909,8660
350410,201906,9168,26414,6611,21289,1535,5492,2172,6435,3707,11927
350420,201906,675,1867,486,1512,93,321,111,314,204,635
350430,201906,655,1823,533,1617,62,228,335,921,397,1149
350440,201906,1789,4697,1427,4123,116,417,931,2589,1047,3006
350450,201906,6634,18776,5166,16137,1156,3903,2059,6074,3215,9977
350460,201906,1678,4369,818,2569,131,439,165,447,296,886
350470,201906,271,695,201,567,9,36,130,335,139,371
350480,201906,874,2351,551,1723,119,422,73,193,192,615
350490,201906,1859,4998,1305,4037,305,969,398,1143,703,2112
350500,201906,663,1799,506,1501,81,260,239,659,320,919
350510,201906,1084,2891,776,2312,115,385,396,1112,511,1497
350520,201906,2015,6373,1551,5391,259,1030,680,2155,939,3185
350530,201906,2648,6775,1929,5369,237,741,1126,2948,1363,3689
350535,201906,1422,4007,1227,3713,185,630,755,2205,940,2835
350540,201906,1742,4505,1266,3744,203,632,691,1997,894,2629
350550,201906,8420,21252,5793,16771,654,2239,3235,8727,3889,10966
350560,201906,3820,10995,3037,9515,293,958,1850,5608,2143,6566
350570,201906,22906,65910,18322,56674,3835,12934,8640,25395,12475,38329
350580,201906,1896,5337,1015,3317,246,855,142,388,388,1243
350590,201906,4578,12880,3330,10003,503,1744,1870,5106,2373,6850
350600,201906,37185,88582,22813,62513,3313,10008,10649,26678,13962,36686
350610,201906,6468,18240,4677,14589,932,3101,2018,6054,2950,9155
350620,201906,408,1030,240,761,27,100,132,393,159,493
350630,201906,1450,3857,1048,3121,72,285,648,1796,720,2081
350635,201906,7734,20034,5858,16996,1049,3403,3228,8861,4277,12264
350640,201906,929,2555,502,1573,57,183,167,443,224,626
350650,201906,7772,21423,5134,15927,1043,3499,1690,4854,2733,8353
350660,201906,4474,12025,3444,10264,631,1892,1717,5130,2348,7022
350670,201906,1868,5113,1544,4636,163,532,1014,3019,1177,3551
350680,201906,1123,3069,725,2300,145,484,288,869,433,1353
350690,201906,1230,3353,890,2741,153,518,463,1348,616,1866
350700,201906,4965,12653,3214,9901,532,1886,1393,3986,1925,5872
350710,201906,2695,7596,2247,6798,321,1120,1239,3543,1560,4663
350715,201906,854,2475,688,2151,72,282,326,913,398,1195
350720,201906,165,411,119,334,21,63,50,130,71,193
350730,201906,548,1574,434,1352,36,149,293,851,329,1000
350740,201906,1595,4466,1047,3282,192,617,292,838,484,1455
350745,201906,570,1553,329,1036,32,118,149,424,181,542
350750,201906,9673,26085,7278,21743,1351,4562,3019,7978,4370,12540
350760,201906,13371,34570,9396,27575,2321,7417,2964,7760,5285,15177
350770,201906,923,2324,570,1696,50,156,331,958,381,1114
350775,201906,672,1668,462,1329,43,130,206,575,249,705
350780,201906,1963,5077,1385,4169,260,874,461,1555,721,2429
350790,201906,1680,4607,1027,3348,198,704,234,634,432,1338
350800,201906,3213,9622,2743,8750,373,1310,1625,5019,1998,6329
350810,201906,2462,6291,1947,5535,289,842,1052,3039,1341,3881
350820,201906,920,2188,498,1412,51,155,223,576,274,731
350830,201906,853,2419,462,1527,84,281,128,361,212,642
350840,201906,2893,8800,2107,7214,537,1994,789,2469,1326,4463
350850,201906,6586,19114,5003,16051,1195,4091,1848,5725,3043,9816
350860,201906,3352,9364,2953,8778,138,538,2212,6438,2350,6976
350870,201906,2660,7663,1940,6464,309,1161,987,3167,1296,4328
350880,201906,1208,3608,949,3042,223,723,300,935,523,1658
350890,201906,562,1489,346,1040,49,163,120,313,169,476
350900,201906,6585,18579,4145,13132,1109,3809,946,2716,2055,6525
350910,201906,884,2303,747,2065,106,327,498,1331,604,1658
350920,201906,11628,29879,9874,26887,512,1713,7755,20205,8267,21918
350925,201906,4372,12302,3115,9881,603,2039,1383,4019,1986,6058
350930,201906,1436,3748,954,2817,111,355,522,1482,633,1837
350940,201906,2099,5875,1659,5089,210,693,1016,3035,1226,3728
350945,201906,843,2407,631,1986,109,409,294,832,403,1241
350950,201906,81674,218196,62832,180802,8919,28224,36744,100429,45663,128653
350960,201906,5882,16523,4548,13960,628,2183,2626,7612,3254,9795
350970,201906,3572,10691,2644,8705,839,3038,410,1165,1249,4203
350980,201906,611,1708,482,1458,147,468,185,552,332,1020
350990,201906,1726,5081,1291,4331,310,1156,450,1426,760,2582
350995,201906,760,2441,683,2279,49,199,467,1492,516,1691
351000,201906,2764,7332,1939,5821,388,1249,637,1814,1025,3063
351010,201906,314,790,202,586,19,62,103,287,122,349
351015,201906,753,2297,611,2015,91,353,292,857,383,1210
351020,201906,8972,25001,6722,21096,1389,4535,3267,9974,4656,14509
351030,201906,2545,7780,2057,6754,312,1158,1083,3435,1395,4593
351040,201906,4687,11973,3928,10772,220,771,3139,8284,3359,9055
351050,201906,17190,42663,11582,33632,2448,7559,4628,13159,7076,20718
351060,201906,46030,118834,35144,99690,4245,13143,22413,61409,26658,74552
351070,201906,1347,3517,782,2493,229,779,110,342,339,1121
351080,201906,2644,6768,1918,5854,300,1065,1125,3235,1425,4300
351090,201906,332,1001,230,799,47,164,55,192,102,356
351100,201906,2267,6246,1456,4595,354,1152,384,1271,738,2423
351110,201906,5812,15103,3724,11185,695,2257,1488,4161,2183,6418
351120,201906,751,1990,506,1545,70,222,212,615,282,837
351130,201906,1069,2807,460,1497,94,312,81,241,175,553
351140,201906,1873,5456,1323,4359,311,1135,454,1334,765,2469
351150,201906,2060,6097,1311,4387,276,1000,435,1276,711,2276
351160,201906,1124,3640,882,3074,197,728,266,827,463,1555
351170,201906,1373,3924,1183,3543,118,388,776,2228,894,2616
351190,201906,1031,2905,632,2039,111,354,198,572,309,926
351200,201906,1620,3990,1223,3376,100,318,814,2124,914,2442
351210,201906,1536,3855,894,2543,83,270,508,1340,591,1610
351220,201906,3119,9103,2672,8335,339,1101,1693,5218,2032,6319
351230,201906,1789,5044,1313,4174,263,971,553,1550,816,2521
351240,201906,2117,5571,1362,3966,259,791,596,1593,855,2384
351250,201906,1089,2925,608,1918,80,264,221,702,301,966
351260,201906,919,2407,668,1936,147,410,233,686,380,1096
351270,201906,392,1130,324,1017,45,170,178,484,223,654
351280,201906,3902,10673,2964,8850,528,1714,1340,3805,1868,5519
351290,201906,1087,2828,737,2193,133,401,366,1056,499,1457
351300,201906,15405,43423,10514,33721,2089,7227,4147,12923,6236,20150
351310,201906,3151,8194,2392,6926,228,796,1575,4264,1803,5060
351320,201906,896,2695,651,2125,126,457,241,712,367,1169
351330,201906,590,1792,505,1633,42,128,383,1253,425,1381
351340,201906,6293,18578,5021,16287,1255,4209,2049,6639,3304,10848
351350,201906,11413,29898,9572,26763,1069,3215,6931,18731,8000,21946
351360,201906,3795,10411,3137,9339,794,2542,1101,3021,1895,5563
351370,201906,2142,6151,1418,4591,377,1275,444,1273,821,2548
351380,201906,45795,115082,32598,90983,4880,14467,17470,46625,22350,61092
351385,201906,283,724,151,453,29,81,41,113,70,194
351390,201906,1384,3499,845,2663,138,506,466,1363,604,1869
351400,201906,928,2657,739,2254,152,467,403,1201,555,1668
351410,201906,2530,7167,1789,5703,331,1067,693,2162,1024,3229
351420,201906,365,894,192,575,36,94,91,272,127,366
351430,201906,900,2553,724,2260,73,239,479,1463,552,1702
351440,201906,3349,9012,2153,6455,397,1291,568,1426,965,2717
351450,201906,1736,4652,1130,3504,237,800,206,546,443,1346
351460,201906,787,2138,609,1821,158,468,312,924,470,1392
351470,201906,1192,3125,903,2607,94,322,552,1495,646,1817
351480,201906,2552,7698,2036,6783,353,1296,885,2781,1238,4077
351490,201906,1907,5614,1644,5102,83,332,1250,3699,1333,4031
351492,201906,342,956,277,810,13,48,181,505,194,553
351495,201906,199,552,142,430,18,54,71,201,89,255
351500,201906,35356,90573,26199,74149,4586,13911,14232,38254,18818,52165
351510,201906,12327,31654,8922,25449,1212,3903,5346,14520,6558,18423
351512,201906,490,1359,322,971,52,153,102,277,154,430
351515,201906,3198,7326,1875,5154,357,1100,532,1480,889,2580
351518,201906,2363,6129,1497,4553,219,772,793,2170,1012,2942
351519,201906,742,2071,415,1354,75,248,63,191,138,439
351520,201906,1163,2957,447,1414,57,196,173,486,230,682
351530,201906,355,993,199,628,35,115,69,168,104,283
351535,201906,2024,4941,1422,3921,191,583,759,1955,950,2538
351540,201906,2233,5751,1431,4319,370,1267,369,953,739,2220
351550,201906,6268,16117,4199,12086,445,1516,2374,6286,2819,7802
351560,201906,435,1279,350,1104,87,311,95,267,182,578
351565,201906,192,582,152,505,37,141,40,125,77,266
351570,201906,19097,52879,14165,42284,1735,5672,8511,24218,10246,29890
351580,201906,268,698,155,476,15,47,61,189,76,236
351590,201906,501,1148,256,703,30,104,131,310,161,414
351600,201906,1448,3830,1096,3170,112,367,655,1748,767,2115
351610,201906,763,1814,485,1332,27,86,255,632,282,718
351620,201906,21201,58994,15643,48538,2758,9702,6589,18293,9347,27995
351630,201906,25844,71118,20772,61942,3570,11132,12275,35510,15845,46642
351640,201906,15896,43476,12189,36300,1397,4715,7877,22434,9274,27149
351650,201906,405,1094,179,589,22,74,40,110,62,184
351660,201906,759,2200,460,1468,86,291,73,200,159,491
351670,201906,5315,14760,3728,11220,744,2280,1705,4768,2449,7048
351680,201906,413,1235,258,837,52,147,62,186,114,333
351685,201906,444,1314,355,1157,98,318,114,340,212,658
351690,201906,1063,2753,619,1818,104,331,245,643,349,974
351700,201906,1262,3248,912,2606,126,361,513,1395,639,1756
351710,201906,761,2080,513,1609,47,174,247,683,294,857
351720,201906,1467,3927,932,2921,167,571,333,969,500,1540
351730,201906,922,2520,756,2221,81,290,471,1299,552,1589
351740,201906,3593,9248,2768,7614,500,1456,1308,3310,1808,4766
351750,201906,1306,3586,797,2630,159,560,268,865,427,1425
351760,201906,3275,9383,2297,7306,478,1707,801,2332,1279,4039
351770,201906,1805,5462,1469,4771,341,1142,683,2167,1024,3309
351780,201906,1404,3647,732,2237,127,453,214,606,341,1059
351790,201906,1270,3111,1004,2746,163,423,606,1688,769,2111
351800,201906,518,1202,251,703,29,84,87,205,116,289
351810,201906,995,2697,811,2386,49,146,580,1631,629,1777
351820,201906,2476,7142,1703,5575,449,1598,339,1056,788,2654
351830,201906,4245,11737,3246,9940,339,1227,1930,5605,2269,6832
351840,201906,7964,23043,6026,19336,985,3512,2861,8637,3846,12149
351850,201906,1758,4725,1080,3403,211,753,319,877,530,1630
351860,201906,2790,8292,2179,7090,390,1331,1162,3795,1552,5126
351870,201906,22670,60011,17333,50964,5249,15825,6299,19110,11548,34935
351880,201906,114123,311219,85210,258043,23011,75273,30531,87582,53542,162855
351885,201906,873,2460,683,2094,96,321,387,1122,483,1443
351890,201906,677,1900,488,1568,110,353,66,182,176,535
351900,201906,1058,2931,820,2545,145,457,403,1244,548,1701
351905,201906,391,1116,260,837,22,75,94,266,116,341
351907,201906,21647,57795,16588,48508,1888,6053,10635,29950,12523,36003
351910,201906,1250,3329,862,2505,85,273,465,1221,550,1494
351920,201906,848,2283,616,1819,76,276,296,795,372,1071
351925,201906,892,2503,683,2090,105,353,317,901,422,1254
351930,201906,3151,9049,2861,8496,450,1413,2044,5949,2494,7362
351940,201906,1086,2875,781,2332,116,386,392,1128,508,1514
351950,201906,1559,3709,1116,3036,72,215,717,1889,789,2104
351960,201906,5108,13350,3773,10973,833,2615,1614,4387,2447,7002
351970,201906,6284,19649,5196,17684,869,3325,2821,9244,3690,12569
351980,201906,1054,2528,666,1877,83,281,379,987,462,1268
351990,201906,1411,3439,977,2748,81,282,431,1098,512,1380
352000,201906,2506,7349,2130,6551,260,925,1346,3840,1606,4765
352010,201906,2136,5993,1732,5264,440,1448,323,1042,763,2490
352020,201906,1449,4066,1138,3525,197,644,536,1585,733,2229
352030,201906,5408,14712,4290,12873,885,2893,2171,6309,3056,9202
352040,201906,2605,7208,1650,5203,284,941,488,1332,772,2273
352042,201906,3160,7946,1906,5744,398,1295,752,2240,1150,3535
352044,201906,2094,5745,1156,3893,201,733,230,713,431,1446
352050,201906,12218,33471,7700,24201,1892,6658,1229,3334,3121,9992
352060,201906,736,2032,522,1604,70,232,231,649,301,881
352070,201906,745,1536,520,1238,66,178,294,654,360,832
352080,201906,470,1231,284,844,32,105,106,276,138,381
352090,201906,1451,4386,1166,3769,157,573,473,1367,630,1940
352100,201906,3027,8702,2505,7715,592,1953,1129,3293,1721,5246
352110,201906,579,1790,443,1493,103,371,165,510,268,881
352115,201906,517,1486,427,1341,59,204,244,763,303,967
352120,201906,857,2637,677,2250,77,302,392,1197,469,1499
352130,201906,1873,5355,1207,3685,220,685,463,1312,683,1997
352140,201906,1251,3404,824,2540,130,440,388,1151,518,1591
352150,201906,821,2274,611,1884,119,388,340,1022,459,1410
352160,201906,984,2477,712,2051,85,291,379,1036,464,1327
352170,201906,2969,8191,2318,6845,404,1335,1227,3295,1631,4630
352180,201906,2619,7236,2057,6156,517,1722,626,1631,1143,3353
352190,201906,1167,3173,876,2709,144,443,404,1275,548,1718
352200,201906,373,1148,258,900,36,138,89,298,125,436
352210,201906,18281,44765,14281,39215,1274,3823,10515,28429,11789,32252
352215,201906,533,1433,460,1335,53,177,317,888,370,1065
352220,201906,17140,44670,11404,33955,2874,8943,3810,10868,6684,19811
352230,201906,12745,38522,9679,32449,2373,8768,3314,10312,5687,19080
352240,201906,10813,28647,8143,24022,1851,6180,3283,8764,5134,14944
352250,201906,22796,65612,18324,57417,3642,12099,9999,30678,13641,42777
352260,201906,4825,12606,3331,9577,487,1660,1880,4876,2367,6536
352265,201906,910,2621,801,2443,55,213,583,1708,638,1921
352270,201906,1481,4592,1106,3761,234,875,364,1149,598,2024
352280,201906,2352,6149,1789,5293,184,683,1017,2771,1201,3454
352290,201906,1094,3315,894,2886,153,552,434,1247,587,1799
352300,201906,936,2561,644,1950,97,345,316,852,413,1197
352310,201906,44999,121793,32940,99953,8341,25744,13874,42238,22215,67982
352320,201906,6230,17045,4743,13985,759,2486,2372,6298,3131,8784
352330,201906,2147,5906,1633,5158,329,1193,779,2309,1108,3502
352340,201906,5177,14138,3737,11520,680,2371,1696,4806,2376,7177
352350,201906,2099,6215,1634,5129,208,803,849,2364,1057,3167
352360,201906,1225,3326,1041,3000,101,352,776,2141,877,2493
352370,201906,1048,3067,897,2783,31,131,693,2092,724,2223
352380,201906,809,2304,624,1945,135,456,213,627,348,1083
352390,201906,15672,39274,10548,30332,1695,5342,5671,15318,7366,20660
352400,201906,3429,9692,2917,8725,485,1758,1757,4883,2242,6641
352410,201906,3057,8183,2304,6861,236,832,1390,3946,1626,4778
352420,201906,864,2153,594,1717,111,338,201,549,312,887
352430,201906,7212,18756,5123,15028,1342,4366,2080,5671,3422,10037
352440,201906,17280,48300,13044,39941,3063,9740,5119,15150,8182,24890
352450,201906,810,2106,400,1319,55,190,120,365,175,555
352460,201906,2914,8256,1952,6402,415,1498,666,2064,1081,3562
352470,201906,3404,8614,2440,7015,295,972,1336,3567,1631,4539
352480,201906,3414,8423,2259,6306,376,1195,1067,2730,1443,3925
352490,201906,713,2178,560,1860,110,406,245,760,355,1166
352500,201906,10243,27078,6966,20833,3187,10324,792,1461,3979,11785
352510,201906,3440,9579,2563,8021,583,1999,1037,3035,1620,5034
352520,201906,2503,6997,1936,5968,429,1474,950,2639,1379,4113
352530,201906,9378,25587,5920,18434,1251,4364,1128,2765,2379,7129
352540,201906,534,1610,385,1260,71,243,106,321,177,564
352550,201906,967,2837,668,2218,125,462,199,592,324,1054
352560,201906,584,1665,431,1340,69,226,171,482,240,708
352570,201906,2013,5961,1298,4460,328,1183,171,521,499,1704
352580,201906,725,1962,587,1708,91,315,314,848,405,1163
352585,201906,245,717,183,584,19,73,100,292,119,365
352590,201906,13198,35419,9133,27464,2642,8556,3644,10098,6286,18654
352600,201906,1949,5431,1481,4506,222,733,803,2279,1025,3012
352610,201906,3016,8600,2246,7204,488,1747,863,2589,1351,4336
352620,201906,5675,15061,4381,13053,1387,4168,1543,4663,2930,8831
352630,201906,833,2112,627,1796,105,350,281,730,386,1080
352640,201906,2948,7818,2117,6356,227,742,1225,3513,1452,4255
352650,201906,565,1641,400,1250,61,219,144,424,205,643
352660,201906,1016,3102,816,2669,173,594,355,1117,528,1711
352670,201906,8677,24317,5518,17781,1511,5178,842,2634,2353,7812
352680,201906,3241,9872,2275,7541,364,1415,1083,3298,1447,4713
352690,201906,27267,70367,20357,57791,1786,5885,13212,35599,14998,41484
352700,201906,560,1441,414,1232,158,526,92,235,250,761
352710,201906,4942,13130,3502,10433,886,2913,1421,3910,2307,6823
352720,201906,7815,22297,6030,18726,2833,8959,814,2209,3647,11168
352725,201906,535,1371,277,834,19,57,124,356,143,413
352730,201906,2751,7939,2311,6922,349,1188,1335,3647,1684,4835
352740,201906,2222,5352,1636,4462,201,630,927,2388,1128,3018
352750,201906,415,1048,222,682,40,132,83,216,123,348
352760,201906,1557,4438,1169,3637,154,508,574,1733,728,2241
352770,201906,911,2493,601,1867,121,384,220,643,341,1027
352780,201906,650,1923,450,1515,91,326,139,460,230,786
352790,201906,482,1311,324,985,33,101,120,315,153,416
352800,201906,1271,4023,903,3129,235,854,142,442,377,1296
352810,201906,1097,2644,677,1866,90,272,389,1005,479,1277
352820,201906,517,1368,333,1050,76,248,73,243,149,491
352830,201906,592,1527,256,797,33,105,47,125,80,230
352840,201906,3846,11402,3173,10135,1118,3853,973,2964,2091,6817
352850,201906,10260,26044,6795,20279,1947,6236,1990,5518,3937,11754
352860,201906,1014,2812,711,2227,146,489,225,670,371,1159
352870,201906,892,2284,610,1674,44,148,393,1022,437,1170
352880,201906,1841,4515,1275,3467,177,513,744,1873,921,2386
352885,201906,289,831,213,690,32,115,115,347,147,462
352890,201906,716,1724,442,1156,52,148,238,546,290,694
352900,201906,17817,47485,11822,35485,2015,6502,5183,14470,7198,20972
352910,201906,460,1224,216,679,25,76,52,151,77,227
352920,201906,2619,6949,1900,5631,173,579,1222,3463,1395,4042
352930,201906,5650,15731,4139,12688,760,2484,1824,5206,2584,7690
352940,201906,22303,63887,16395,50846,3964,13480,5540,16101,9504,29581
352950,201906,468,1243,254,819,62,201,29,88,91,289
352960,201906,724,2004,370,1217,64,222,71,218,135,440
352965,201906,268,719,149,487,42,141,30,84,72,225
352970,201906,3046,7381,2290,6135,264,743,1462,3874,1726,4617
352980,201906,1384,3822,1075,3320,262,857,506,1513,768,2370
352990,201906,4024,11455,3243,10167,651,2263,1633,4921,2284,7184
353000,201906,464,1289,222,710,35,119,50,135,85,254
353010,201906,2506,6406,1619,4776,405,1308,557,1493,962,2801
353020,201906,3689,9646,2064,6193,294,994,711,1952,1005,2946
353030,201906,4196,11099,2833,8553,705,2290,666,1959,1371,4249
353040,201906,607,1486,440,1224,62,190,249,650,311,840
353050,201906,5048,14993,3660,12067,786,2807,1564,4898,2350,7705
353060,201906,46935,122855,38384,108811,2994,10273,27967,75988,30961,86261
353070,201906,9209,26821,6480,20994,1416,4910,2280,6896,3696,11806
353080,201906,4153,11926,2859,9300,579,2088,1004,2881,1583,4969
353090,201906,577,1785,430,1457,44,169,236,766,280,935
353100,201906,311,855,129,420,28,95,32,84,60,179
353110,201906,7448,20871,6047,18750,1106,3512,3432,10872,4538,14384
353120,201906,467,1183,300,869,42,132,120,315,162,447
353130,201906,2324,5787,1544,4513,437,1394,491,1327,928,2721
353140,201906,2571,6511,1842,5155,155,498,1170,3054,1325,3552
353150,201906,1477,3772,1041,3044,211,645,427,1166,638,1811
353160,201906,579,1538,410,1249,85,292,164,444,249,736
353170,201906,509,1450,398,1280,77,285,179,534,256,819
353180,201906,9667,24436,7514,20805,839,2597,5290,14230,6129,16827
353190,201906,3274,8998,2573,7597,277,918,1577,4316,1854,5234
353200,201906,2037,5530,932,3098,140,504,215,651,355,1155
353205,201906,335,1048,282,915,58,203,130,415,188,618
353210,201906,980,2360,616,1740,33,109,388,1071,421,1180
353215,201906,396,1137,307,950,48,153,135,367,183,520
353220,201906,775,2140,453,1433,101,309,56,166,157,475
353230,201906,773,2222,628,1989,170,598,256,725,426,1323
353240,201906,2233,6252,1797,5453,260,901,1044,3030,1304,3931
353250,201906,1282,2920,747,2008,101,275,383,985,484,1260
353260,201906,1076,2579,605,1775,110,364,243,672,353,1036
353270,201906,685,1843,560,1609,46,148,375,1022,421,1170
353280,201906,727,2009,503,1569,100,316,153,443,253,759
353282,201906,1780,5160,1505,4613,173,610,883,2531,1056,3141
353284,201906,356,862,176,501,25,91,69,164,94,255
353286,201906,163,431,99,317,22,72,39,123,61,195
353290,201906,1566,4153,941,2862,110,378,416,1159,526,1537
353300,201906,1761,4823,1292,3865,214,751,577,1509,791,2260
353310,201906,395,1001,274,776,25,93,166,443,191,536
353320,201906,644,1662,550,1499,12,35,465,1262,477,1297
353325,201906,638,1911,429,1446,97,328,147,478,244,806
353330,201906,561,1480,348,1028,47,145,173,483,220,628
353340,201906,2807,7783,1937,6066,485,1644,764,2260,1249,3904
353350,201906,3274,8916,2206,6620,488,1623,512,1303,1000,2926
353360,201906,583,1679,458,1445,50,165,237,737,287,902
353370,201906,550,1663,452,1489,36,125,302,956,338,1081
353380,201906,269,829,213,711,37,139,94,286,131,425
353390,201906,5618,14366,4104,11668,576,1809,2133,5690,2709,7499
353400,201906,404,1167,302,957,51,192,82,206,133,398
353410,201906,531,1458,407,1229,76,253,222,666,298,919
353420,201906,463,1261,273,832,54,152,21,44,75,196
353430,201906,2214,6324,1597,5149,376,1334,619,1830,995,3164
353440,201906,62712,175499,44254,138078,8045,26842,21879,64629,29924,91471
353450,201906,386,1024,263,808,44,160,110,300,154,460
353460,201906,3281,9017,2340,7098,171,620,1092,3197,1263,3817
353470,201906,7618,20538,5314,16135,978,3355,2060,5684,3038,9039
353475,201906,1410,3767,965,2804,140,443,451,1202,591,1645
353480,201906,1665,4512,1293,3816,81,281,844,2394,925,2675
353490,201906,959,2626,629,1925,117,392,273,785,390,1177
353500,201906,976,2358,756,2023,183,494,408,1102,591,1596
353510,201906,832,2517,603,1945,138,472,139,388,277,860
353520,201906,1112,2966,697,2176,90,315,306,897,396,1212
353530,201906,2455,6627,1875,5530,241,797,944,2582,1185,3379
353540,201906,1999,5616,1631,4990,304,960,880,2616,1184,3576
353550,201906,5777,15389,4571,13321,856,2602,2342,6561,3198,9163
353560,201906,2012,5769,1482,4872,483,1725,346,1057,829,2782
353570,201906,564,1499,413,1232,59,176,242,685,301,861
353580,201906,2021,5416,1586,4607,372,1060,702,1990,1074,3050
353590,201906,710,1976,449,1413,112,403,136,411,248,814
353600,201906,1779,4512,1353,3742,172,469,699,1882,871,2351
353610,201906,558,1723,400,1386,89,348,103,330,192,678
353620,201906,2611,7169,1814,5700,373,1315,548,1523,921,2838
353625,201906,504,1258,319,927,23,77,204,586,227,663
353630,201906,1207,3895,972,3330,230,871,293,902,523,1773
353640,201906,1378,3657,1081,3181,135,421,624,1813,759,2234
353650,201906,8776,24244,6280,19070,763,2577,3443,9711,4206,12288
353657,201906,384,1026,259,797,29,92,103,291,132,383
353660,201906,1179,2571,798,2037,320,813,233,567,553,1380
353670,201906,3958,11312,3062,9511,634,2196,1485,4207,2119,6403
353680,201906,703,1957,524,1684,93,317,280,867,373,1184
353690,201906,452,1172,167,539,9,25,17,44,26,69
353700,201906,1938,5335,1621,4750,148,495,1129,3170,1277,3665
353710,201906,4311,9689,2375,6258,245,674,1411,3385,1656,4059
353715,201906,472,1246,269,844,18,70,70,191,88,261
353720,201906,1865,5157,1456,4541,182,653,912,2761,1094,3414
353730,201906,4281,11791,3162,9613,518,1743,1455,4089,1973,5832
353740,201906,1954,5281,1337,4138,325,1116,414,1174,739,2290
353750,201906,820,2553,574,2056,145,541,94,374,239,915
353760,201906,12017,29222,9339,25416,1621,4623,5487,14548,7108,19171
353770,201906,723,2193,355,1220,66,230,43,117,109,347
353780,201906,5023,14704,3839,12201,837,2932,1561,4536,2398,7468
353790,201906,2489,7773,1828,6354,507,1981,395,1211,902,3192
353800,201906,16991,46396,13013,39595,2109,6872,6740,20350,8849,27222
353810,201906,1111,3072,735,2296,105,361,291,853,396,1214
353820,201906,1723,4893,1186,3750,266,892,385,1191,651,2083
353830,201906,632,1589,442,1264,71,202,188,520,259,722
353850,201906,1628,4667,1236,3875,307,975,406,1287,713,2262
353860,201906,2571,7438,2007,6336,506,1783,848,2437,1354,4220
353870,201906,28498,76608,19558,58881,2804,9461,9497,26057,12301,35518
353880,201906,2915,8396,2296,7135,212,775,1357,4022,1569,4797
353890,201906,2365,5320,1527,4109,161,455,985,2529,1146,2984
353900,201906,719,2017,512,1594,102,345,203,593,305,938
353910,201906,1873,5516,1560,4990,203,769,1034,3233,1237,4002
353920,201906,2043,5689,1358,4312,297,1083,320,850,617,1933
353930,201906,4171,11354,2759,8759,566,2003,904,2547,1470,4550
353940,201906,1100,3266,733,2478,150,517,224,704,374,1221
353950,201906,2998,8450,2351,7248,451,1530,1255,3544,1706,5074
353960,201906,748,2028,485,1506,99,320,170,507,269,827
353970,201906,709,1737,514,1446,45,136,314,846,359,982
353980,201906,14569,38200,11159,31860,1071,3412,7468,20511,8539,23923
353990,201906,886,2203,520,1511,71,233,251,684,322,917
354000,201906,2518,6246,1349,3955,292,886,208,599,500,1485
354010,201906,352,941,258,786,34,112,153,456,187,568
354020,201906,3434,9965,2684,8293,691,2300,978,2720,1669,5020
354025,201906,744,2072,466,1513,84,310,84,239,168,549
354030,201906,486,1068,233,629,43,116,93,234,136,350
354040,201906,795,1898,501,1386,24,80,346,916,370,996
354050,201906,942,2783,656,2228,164,578,172,595,336,1173
354060,201906,3560,10450,2404,7911,569,1968,729,2212,1298,4180
354070,201906,3381,9460,2321,7324,481,1683,769,2074,1250,3757
354075,201906,2423,7307,1830,6154,255,1013,985,3216,1240,4229
354080,201906,1418,3978,911,2942,174,601,222,662,396,1263
354085,201906,411,887,323,775,2,5,230,518,232,523
354090,201906,1468,4218,1292,3853,97,320,968,2827,1065,3147
354100,201906,17693,50625,12329,40737,2829,9966,4717,15463,7546,25429
354105,201906,1525,3871,988,2864,121,342,445,1236,566,1578
354110,201906,491,1360,331,1060,60,209,102,318,162,527
354120,201906,1525,4176,997,3030,186,593,340,913,526,1506
354130,201906,5689,15282,3669,11313,1016,3371,212,396,1228,3767
354140,201906,19140,47566,12378,35171,2377,7298,4830,12660,7207,19958
354150,201906,3125,7659,2285,6253,533,1497,878,2373,1411,3870
354160,201906,3065,9088,2233,7337,666,2333,638,1951,1304,4284
354165,201906,597,1802,445,1491,79,305,219,680,298,985
354170,201906,1555,4467,1268,3872,89,310,771,2239,860,2549
354180,201906,439,1242,305,947,58,185,117,324,175,509
354190,201906,1469,4240,1030,3329,91,327,393,1249,484,1576
354200,201906,878,2249,682,1937,89,269,391,1032,480,1301
354210,201906,696,1927,558,1681,46,161,378,1055,424,1216
354220,201906,3072,8499,2210,6717,429,1407,994,2853,1423,4260
354230,201906,707,1826,551,1625,43,167,377,1046,420,1213
354240,201906,1563,4439,1014,3254,189,662,299,847,488,1509
354250,201906,519,1336,332,1039,93,304,94,300,187,604
354260,201906,8159,22217,6161,18678,1413,4437,2309,6837,3722,11274
354270,201906,1033,3197,813,2748,192,637,275,908,467,1545
354280,201906,752,1950,628,1770,67,249,386,989,453,1238
354290,201906,879,2841,729,2505,119,408,361,1267,480,1675
354300,201906,3533,10670,2989,9617,960,3144,952,3007,1912,6151
354310,201906,610,1902,492,1631,117,427,149,433,266,860
354320,201906,898,2279,563,1669,73,262,225,585,298,847
354323,201906,479,1205,311,887,36,90,124,340,160,430
354325,201906,1219,3720,854,2900,144,496,334,1097,478,1593
354330,201906,8450,22074,5500,15853,764,2612,3106,8250,3870,10862
354340,201906,28301,74393,19239,57930,3792,12556,8714,24924,12506,37480
354350,201906,1171,3091,929,2642,106,312,603,1630,709,1942
354360,201906,602,1573,329,1085,58,199,54,175,112,374
354370,201906,972,2957,797,2647,136,471,427,1397,563,1868
354380,201906,754,2017,520,1620,92,340,123,311,215,651
354390,201906,13366,33439,8297,24284,1606,4930,2839,7906,4445,12836
354400,201906,1571,5151,1205,4267,209,783,436,1540,645,2323
354410,201906,5369,15142,3984,12268,950,3119,1636,4821,2586,7940
354420,201906,1431,3871,1041,3105,141,451,614,1753,755,2204
354425,201906,2580,6489,1809,5083,436,1256,698,1994,1134,3250
354430,201906,1542,4235,1190,3621,155,549,653,1824,808,2373
354440,201906,579,1587,360,1116,43,150,166,473,209,623
354450,201906,415,1107,223,739,34,115,58,168,92,283
354460,201906,916,2386,588,1790,88,290,295,855,383,1145
354470,201906,503,1291,308,885,20,65,142,359,162,424
354480,201906,1075,2479,722,1918,60,174,490,1237,550,1411
354490,201906,795,2400,578,1914,120,400,223,684,343,1084
354500,201906,1993,5751,1655,5227,525,1807,380,1203,905,3010
354510,201906,753,2114,598,1771,65,199,323,879,388,1078
354515,201906,303,921,221,744,38,152,85,261,123,413
354520,201906,6520,18547,4291,13455,667,2356,2231,6480,2898,8836
354530,201906,4089,12125,3121,10130,739,2518,1180,3738,1919,6256
354540,201906,1288,3518,929,2858,233,760,307,941,540,1701
354550,201906,523,1411,400,1172,58,172,233,655,291,827
354560,201906,2026,5083,1084,3162,143,428,547,1521,690,1949
354570,201906,1162,3020,476,1424,90,288,64,187,154,475
354580,201906,9133,24341,5870,18064,951,3217,2732,7966,3683,11183
354600,201906,1719,4881,1318,4079,155,559,819,2412,974,2971
354610,201906,410,1095,214,669,32,108,78,236,110,344
354620,201906,438,1287,280,966,47,178,99,299,146,477
354625,201906,328,924,177,596,28,108,41,109,69,217
354630,201906,1855,5663,1490,4910,555,1909,219,701,774,2610
354640,201906,3128,9209,2255,7335,388,1434,714,2120,1102,3554
354650,201906,901,2402,716,2076,64,187,440,1255,504,1442
354660,201906,3596,8600,1877,5630,177,631,930,2617,1107,3248
354670,201906,1046,2984,720,2291,158,555,261,767,419,1322
354680,201906,4676,12920,3712,11268,911,2849,1833,5670,2744,8519
354690,201906,569,1810,381,1364,90,347,105,360,195,707
354700,201906,879,2367,615,1826,98,326,280,751,378,1077
354710,201906,502,1377,350,1063,50,174,150,394,200,568
354720,201906,328,803,139,413,46,137,24,73,70,210
354730,201906,9642,27737,7130,22763,1037,3644,3877,11895,4914,15539
354740,201906,323,889,123,432,16,65,17,53,33,118
354750,201906,2439,6603,1536,4809,299,1011,583,1604,882,2615
354760,201906,1926,5407,1320,4198,344,1170,369,1094,713,2264
354765,201906,348,933,136,447,18,64,26,71,44,135
354770,201906,2303,5820,1646,4692,329,997,723,1922,1052,2919
354780,201906,53202,138826,39968,111748,5134,16012,23289,60766,28423,76778
354790,201906,974,2790,772,2431,99,342,449,1358,548,1700
354800,201906,2584,6970,1988,5933,518,1583,784,2215,1302,3798
354805,201906,1331,3187,880,2454,110,316,448,1121,558,1437
354810,201906,661,1924,356,1254,50,194,76,235,126,429
354820,201906,932,2767,658,2197,134,507,153,430,287,937
354830,201906,479,1196,303,868,67,186,96,259,163,445
354840,201906,923,2350,493,1464,47,143,255,721,302,864
354850,201906,20749,55735,14299,43561,1943,6843,8058,22929,10001,29772
354860,201906,1607,4608,1023,3366,196,709,320,921,516,1630
354870,201906,53746,138657,41609,115778,5136,15633,24629,64754,29765,80387
354880,201906,5712,14562,2606,7650,326,1090,870,2045,1196,3135
354890,201906,16580,42510,12743,35812,1806,5702,7383,19909,9189,25611
354900,201906,410,1095,265,824,41,135,69,192,110,327
354910,201906,5148,14021,2969,9815,679,2389,360,1117,1039,3506
354920,201906,442,1184,182,622,23,89,32,98,55,187
354925,201906,290,850,159,545,26,90,31,98,57,188
354930,201906,405,981,216,649,19,69,88,228,107,297
354940,201906,2050,6390,1434,4969,469,1757,220,700,689,2457
354950,201906,1467,4020,1161,3540,73,322,787,2235,860,2557
354960,201906,875,2357,671,2055,75,272,371,1061,446,1333
354970,201906,4067,11775,3156,10086,429,1483,1855,5747,2284,7230
354980,201906,30547,74376,19704,55137,2394,7886,10977,28444,13371,36330
354990,201906,60051,156669,44084,126881,4453,14495,26844,73012,31297,87507
354995,201906,2576,6185,1929,5291,233,726,1290,3348,1523,4074
355000,201906,1496,3967,1173,3463,186,629,494,1326,680,1955
355010,201906,3655,10208,2131,6916,696,2315,188,647,884,2962
355020,201906,3412,9905,2435,8064,722,2622,667,2044,1389,4666
355030,201906,1324072,3328357,938582,2549351,156674,464265,449153,1122343,605827,1586608
355040,201906,2786,7433,2231,6642,367,1122,1423,4245,1790,5367
355050,201906,970,2366,687,1910,189,537,228,590,417,1127
355060,201906,5724,16181,4175,13098,732,2617,1991,5652,2723,8269
355070,201906,8122,21880,6426,19026,793,2754,3903,10783,4696,13537
355080,201906,882,2583,539,1886,111,420,61,158,172,578
355090,201906,1131,3338,846,2814,223,730,241,828,464,1558
355100,201906,21501,57812,16683,50525,2982,9551,9797,29283,12779,38834
355110,201906,938,2702,698,2293,217,767,123,406,340,1173
355120,201906,682,1840,464,1481,47,166,158,468,205,634
355130,201906,865,1930,374,1002,19,55,212,526,231,581
355140,201906,1661,4025,1434,3696,112,363,1151,2845,1263,3208
355150,201906,4203,11480,3320,9858,395,1277,1985,5645,2380,6922
355160,201906,1838,5238,1327,4312,332,1215,297,918,629,2133
355170,201906,9479,24967,7267,21162,1660,5133,3479,9824,5139,14957
355180,201906,2724,7520,1907,6079,430,1550,643,1825,1073,3375
355190,201906,1862,4992,1464,4359,325,1007,767,2377,1092,3384
355200,201906,835,2632,701,2406,203,795,254,784,457,1579
355210,201906,2837,8098,2278,6875,346,1184,1227,3472,1573,4656
355220,201906,43522,119260,34025,100327,8730,27108,13007,35258,21737,62366
355230,201906,1163,2953,612,1832,116,346,183,509,299,855
355240,201906,22365,59953,15318,45812,2293,7464,7717,21978,10010,29442
355250,201906,35927,98606,25994,78957,6655,21437,9271,26678,15926,48115
355255,201906,807,2104,422,1320,80,256,136,409,216,665
355260,201906,1384,3602,992,2909,123,441,588,1604,711,2045
355270,201906,1216,3631,908,2953,231,774,274,832,505,1606
355280,201906,27905,74237,19383,57257,3173,10018,8806,24585,11979,34603
355290,201906,870,2473,638,2018,135,392,259,787,394,1179
355300,201906,1243,3688,973,3141,168,565,311,962,479,1527
355310,201906,1028,2853,761,2391,95,295,418,1328,513,1623
355320,201906,535,1450,392,1171,71,246,153,383,224,629
355330,201906,2327,6318,1784,5325,142,527,1247,3525,1389,4052
355340,201906,3685,8251,2897,7167,378,851,1849,4647,2227,5498
355350,201906,1343,3999,989,3266,215,742,334,1086,549,1828
355360,201906,1247,3326,961,2871,127,395,573,1698,700,2093
355365,201906,370,1016,184,648,38,117,30,106,68,223
355370,201906,5671,14589,4289,12467,1021,2847,1886,5956,2907,8803
355380,201906,2924,8017,2152,6474,382,1228,719,1871,1101,3099
355385,201906,1420,3886,1159,3488,123,465,700,1921,823,2386
355390,201906,802,2259,567,1731,125,394,224,635,349,1029
355395,201906,2011,5700,1355,4303,207,683,464,1326,671,2009
355400,201906,8996,27131,7162,23287,1922,6938,2315,6758,4237,13696
355410,201906,21595,60119,13922,45132,3276,11656,3270,10487,6546,22143
355420,201906,663,2200,542,1942,144,588,132,438,276,1026
355430,201906,3722,9570,2781,7897,714,1973,1188,3388,1902,5361
355440,201906,831,2306,479,1518,89,299,142,420,231,719
355450,201906,3432,9138,2121,6498,383,1245,802,2237,1185,3482
355460,201906,530,1325,322,966,41,141,152,413,193,554
355465,201906,391,1112,292,916,47,154,124,381,171,535
355470,201906,1150,3040,623,1929,173,583,183,506,356,1089
355475,201906,344,843,271,728,14,33,190,499,204,532
355480,201906,3593,10332,2943,9294,464,1659,1821,5566,2285,7225
355490,201906,967,2657,519,1644,42,135,246,732,288,867
355495,201906,785,2292,567,1883,80,296,198,622,278,918
355500,201906,6689,17804,3835,11887,586,1964,1178,3331,1764,5295
355510,201906,1328,3415,817,2455,116,397,303,803,419,1200
355520,201906,386,868,176,504,29,77,46,115,75,192
355530,201906,426,986,141,420,24,85,52,136,76,221
355535,201906,509,1434,382,1225,83,320,151,431,234,751
355540,201906,9801,26050,8012,23316,1452,4565,4706,13277,6158,17842
355550,201906,651,1990,536,1770,77,279,255,798,332,1077
355560,201906,1132,3001,607,1955,128,457,42,127,170,584
355570,201906,236,695,126,431,25,86,25,77,50,163
355580,201906,1198,2981,780,2280,119,403,377,1023,496,1426
355590,201906,179,448,135,379,16,47,81,215,97,262
355600,201906,1482,3729,975,2837,214,656,398,1122,612,1778
355610,201906,1735,4447,1149,3364,147,445,541,1513,688,1958
355620,201906,4461,12492,3263,10007,439,1625,1685,4675,2124,6300
355630,201906,2274,6403,1548,4956,272,908,739,2311,1011,3219
355635,201906,904,2716,673,2251,125,473,222,690,347,1163
355640,201906,2700,7921,1835,6130,400,1408,434,1414,834,2822
355645,201906,4223,12218,3155,10264,391,1389,1813,5803,2204,7192
355650,201906,6556,18293,5267,15872,1498,4682,2116,5857,3614,10539
355660,201906,1294,3506,880,2688,123,456,299,906,422,1362
355670,201906,3391,9639,2217,6847,307,1145,1075,2889,1382,4034
355680,201906,3094,8795,1223,4110,334,1152,134,475,468,1627
355690,201906,776,2396,501,1822,128,477,11,21,139,498
355695,201906,235,693,136,455,12,52,21,43,33,95
355700,201906,6919,20451,5573,17362,1052,3378,2748,8078,3800,11456
355710,201906,8249,19800,5058,13857,852,2505,2133,5275,2985,7780
355715,201906,467,1229,240,751,50,174,42,103,92,277
355720,201906,1471,4312,1140,3667,198,689,572,1687,770,2376
355730,201906,953,2765,749,2337,181,603,277,785,458,1388
410010,201906,1256,3502,939,2829,215,720,195,556,410,1276
410020,201906,985,3088,768,2568,272,854,194,665,466,1519
410030,201906,1459,4189,1244,3830,181,641,659,2013,840,2654
410040,201906,11361,32763,8432,26949,1855,6365,2709,8095,4564,14460
410045,201906,923,2443,610,1860,91,309,202,580,293,889
410050,201906,2473,6283,1557,4608,327,1072,409,1089,736,2161
410060,201906,2067,6140,1568,5047,386,1267,428,1346,814,2613
410070,201906,1792,4705,1270,3692,224,716,459,1256,683,1972
410080,201906,1364,3689,961,2920,149,462,396,1221,545,1683
410090,201906,1022,2792,902,2589,87,244,538,1617,625,1861
410100,201906,1922,5706,1318,4216,177,667,222,677,399,1344
410105,201906,477,1268,253,784,41,149,61,174,102,323
410110,201906,3085,8126,2117,6142,302,946,855,2329,1157,3275
410115,201906,551,1417,385,1125,62,199,131,367,193,566
410120,201906,2330,7082,2025,6551,581,2038,772,2410,1353,4448
410130,201906,1123,3105,972,2807,235,757,429,1131,664,1888
410140,201906,14333,35578,8558,24905,1686,5265,1920,5098,3606,10363
410150,201906,16265,39339,7607,21750,1355,4181,1600,4257,2955,8438
410160,201906,2904,8232,2347,7227,489,1654,840,2577,1329,4231
410165,201906,724,2028,595,1737,55,190,353,962,408,1152
410170,201906,2557,6844,1645,4816,383,1218,144,431,527,1649
410180,201906,14328,41168,11067,34101,1652,5559,5753,16555,7405,22114
410185,201906,439,1223,309,945,49,165,104,291,153,456
410190,201906,2208,5680,1601,4555,342,985,440,1224,782,2209
410200,201906,4870,11735,2606,7619,444,1505,525,1526,969,3031
410210,201906,2872,7463,1787,5408,314,1086,594,1542,908,2628
410220,201906,524,1394,327,993,47,160,47,138,94,298
410230,201906,1606,4497,1250,3730,172,616,678,1881,850,2497
410240,201906,4541,12474,3188,9807,852,2897,224,644,1076,3541
410250,201906,2547,6257,1822,5001,165,571,836,2213,1001,2784
410260,201906,1820,4663,1141,3376,229,712,446,1283,675,1995
410270,201906,460,1210,322,952,57,201,113,300,170,501
410275,201906,664,1932,420,1365,59,206,194,573,253,779
410280,201906,2262,6172,1456,4494,234,789,554,1582,788,2371
410290,201906,3003,8691,2075,6629,477,1539,632,2020,1109,3559
410300,201906,633,1617,499,1381,52,159,228,588,280,747
410302,201906,362,956,187,589,30,93,89,267,119,360
410304,201906,1170,3197,994,2839,146,408,545,1524,691,1932
410305,201906,1683,4163,1147,3358,171,543,636,1793,807,2336
410310,201906,2532,7455,1973,6260,398,1363,778,2451,1176,3814
410315,201906,728,1792,368,1173,125,407,76,236,201,643
410320,201906,1100,3102,714,2250,110,396,103,316,213,712
410322,201906,556,1530,283,882,27,99,124,356,151,455
410330,201906,1481,3741,1019,2823,161,497,299,815,460,1312
410335,201906,828,2354,659,2015,89,294,295,842,384,1136
410337,201906,808,1996,553,1484,50,141,245,611,295,752
410340,201906,486,1345,319,938,30,100,158,393,188,493
410345,201906,2327,6167,1190,3638,253,786,306,838,559,1624
410347,201906,694,1794,493,1410,53,197,136,376,189,573
410350,201906,1296,3415,909,2718,94,313,394,1107,488,1420
410360,201906,4095,10150,3186,8582,239,761,2038,5234,2277,5995
410370,201906,11984,32803,7851,23216,1025,3395,3066,8010,4091,11405
410380,201906,1413,3770,1035,3005,117,381,431,1147,548,1528
410390,201906,2571,6844,1628,4997,407,1368,402,1131,809,2499
410395,201906,857,2526,700,2184,140,461,304,933,444,1394
410400,201906,5317,14652,3954,11964,682,2184,1697,4890,2379,7074
410405,201906,800,1982,612,1697,133,416,257,661,390,1077
410410,201906,1169,3247,1110,3162,170,597,687,2008,857,2605
410420,201906,8125,23700,6238,19766,1175,4137,2037,5771,3212,9908
410425,201906,2914,8506,2071,6750,378,1342,710,2085,1088,3427
410430,201906,12727,32735,8559,24767,1456,4557,2878,7893,4334,12450
410440,201906,2385,7294,2014,6561,335,1229,1022,3256,1357,4485
410442,201906,2185,6860,1817,6003,533,1754,534,1765,1067,3519
410445,201906,2264,6761,1747,5736,354,1302,460,1588,814,2890
410450,201906,1461,3873,1052,3105,206,687,319,865,525,1552
410460,201906,1852,4754,1449,4137,176,527,692,1919,868,2446
410465,201906,2605,7868,2008,6571,398,1332,630,1958,1028,3290
410470,201906,1895,5490,1346,4360,345,1247,257,866,602,2113
410480,201906,35635,86371,18956,56206,3100,10290,3998,10142,7098,20432
410490,201906,10749,30611,7499,23515,1478,4986,2654,7811,4132,12797
410500,201906,1709,4737,1178,3628,249,898,321,844,570,1742
410510,201906,1979,5007,1283,3627,244,666,378,1098,622,1764
410520,201906,3029,9753,2720,9122,863,2932,1042,3563,1905,6495
410530,201906,1619,4135,741,2187,110,333,150,338,260,671
410540,201906,2547,7063,1814,5593,304,1021,872,2637,1176,3658
410550,201906,6905,18854,4381,13116,769,2497,1151,3025,1920,5522
410560,201906,1439,3850,1083,3126,221,683,407,1033,628,1716
410570,201906,2489,7086,1852,5905,544,2027,142,490,686,2517
410580,201906,23769,63723,17483,51739,3698,11642,7213,19914,10911,31556
410590,201906,1460,4293,947,2971,158,512,251,679,409,1191
410600,201906,1788,4896,1343,4003,291,821,479,1485,770,2306
410610,201906,736,1978,520,1551,57,202,220,628,277,830
410620,201906,2103,6336,1321,4411,305,1122,216,648,521,1770
410630,201906,2356,6446,1504,4613,298,1004,264,667,562,1671
410640,201906,4596,11125,2909,8166,686,2192,393,1111,1079,3303
410645,201906,1000,2984,822,2726,272,927,330,1103,602,2030
410650,201906,2018,5755,1342,4274,300,1037,419,1198,719,2235
410655,201906,903,2249,628,1745,33,113,310,811,343,924
410657,201906,626,1701,398,1224,62,226,158,419,220,645
410660,201906,3192,8442,1734,5147,314,971,375,1066,689,2037
410670,201906,1061,2683,599,1732,124,364,255,689,379,1053
410680,201906,2660,8186,1878,6211,470,1535,421,1425,891,2960
410685,201906,564,1466,432,1228,97,309,186,481,283,790
410690,201906,120183,306302,78269,225684,13484,43936,26850,67633,40334,111569
410700,201906,2368,6115,2000,5543,291,840,1054,2818,1345,3658
410710,201906,781,2017,509,1525,56,192,265,756,321,948
410712,201906,648,1970,543,1727,136,473,194,578,330,1051
410715,201906,865,2609,517,1770,96,330,157,520,253,850
410720,201906,3165,8348,2345,6660,340,1134,471,1190,811,2324
410725,201906,1114,2841,638,1918,127,414,104,252,231,666
410730,201906,607,1632,447,1334,88,303,97,280,185,583
410740,201906,919,2608,660,2116,101,345,260,824,361,1169
410750,201906,1725,4492,1377,3865,221,693,562,1498,783,2191
410752,201906,350,899,156,481,18,66,66,191,84,257
410753,201906,231,718,161,561,20,87,35,114,55,201
410754,201906,1124,2966,918,2644,62,170,603,1837,665,2007
410755,201906,588,1539,416,1188,57,189,190,476,247,665
410760,201906,3234,8574,2313,6902,658,2186,496,1398,1154,3584
410765,201906,12553,36530,9700,30708,1639,5677,1701,4920,3340,10597
410770,201906,993,2433,672,1872,72,221,337,923,409,1144
410773,201906,1266,3399,1091,3112,126,406,682,1871,808,2277
410775,201906,1425,3725,1241,3446,80,253,732,1989,812,2242
410780,201906,604,1525,375,1051,54,150,93,262,147,412
410785,201906,738,2101,580,1794,98,333,216,644,314,977
410790,201906,664,1935,530,1654,139,483,66,150,205,633
410800,201906,3232,7385,2576,6361,71,239,1601,3831,1672,4070
410810,201906,371,1027,285,855,37,124,128,353,165,477
410820,201906,789,2309,416,1309,91,291,76,211,167,502
410830,201906,30739,77601,20673,60133,4702,15473,6747,18431,11449,33904
410832,201906,976,2617,793,2286,112,378,434,1156,546,1534
410840,201906,7366,19497,4364,13507,901,3091,947,2607,1848,5698
410845,201906,1120,2991,881,2591,179,558,340,969,519,1527
410850,201906,2246,6649,1938,6062,335,1144,904,2745,1239,3889
410855,201906,743,1899,482,1398,40,125,219,584,259,709
410860,201906,3995,10327,3137,8767,472,1476,1452,3824,1924,5300
410865,201906,1358,4180,1191,3824,170,611,680,2219,850,2830
410870,201906,1281,3505,1080,3164,54,169,759,2198,813,2367
410880,201906,4161,11741,2957,9370,535,1918,436,1496,971,3414
410890,201906,957,2736,680,2162,155,537,186,576,341,1113
410895,201906,973,3223,801,2814,292,1117,126,416,418,1533
410900,201906,909,2465,593,1829,99,310,121,306,220,616
410910,201906,370,902,210,582,8,29,131,332,139,361
410920,201906,849,2072,572,1615,87,286,253,704,340,990
410930,201906,1492,4071,1086,3305,276,974,237,711,513,1685
410940,201906,21599,61220,15472,49572,3345,11731,4312,13706,7657,25437
410950,201906,1918,5692,1707,5349,67,254,1386,4260,1453,4514
410960,201906,7020,18370,4490,13794,1039,3503,1584,4785,2623,8288
410965,201906,961,2599,711,2116,107,336,377,1092,484,1428
410970,201906,3813,10528,2658,8250,626,2338,361,948,987,3286
410975,201906,1283,3327,966,2776,137,444,371,1040,508,1484
410980,201906,6691,17350,4199,12671,548,1833,1703,4795,2251,6628
410990,201906,1280,3278,825,2501,251,887,200,527,451,1414
411000,201906,532,1472,360,1122,51,184,102,263,153,447
411005,201906,414,1121,258,778,54,170,51,136,105,306
411007,201906,2165,6278,1772,5536,393,1289,583,1843,976,3132
411010,201906,4207,12847,3274,10817,864,3063,336,982,1200,4045
411020,201906,2298,6716,1879,5960,547,1833,516,1577,1063,3410
411030,201906,722,1800,482,1295,41,142,251,603,292,745
411040,201906,920,2372,413,1223,53,172,129,322,182,494
411050,201906,1825,5888,1494,5088,405,1452,219,639,624,2091
411060,201906,1719,4606,1094,3349,249,900,180,504,429,1404
411065,201906,346,951,248,760,39,123,107,322,146,445
411070,201906,6464,17161,5102,14725,815,2627,2320,6426,3135,9053
411080,201906,2136,5829,1688,4987,470,1528,358,996,828,2524
411090,201906,841,2244,518,1595,45,164,125,365,170,529
411095,201906,1549,3709,1040,2873,117,367,364,946,481,1313
411100,201906,1093,2877,732,2222,83,292,219,676,302,968
411110,201906,629,1658,262,821,39,107,22,48,61,155
411120,201906,1219,3548,974,3026,332,1148,206,530,538,1678
411125,201906,5026,15079,4437,13871,967,3079,2069,6672,3036,9751
411130,201906,676,1870,476,1457,83,246,180,576,263,822
411140,201906,2234,6984,1845,6072,515,1815,534,1736,1049,3551
411150,201906,3705,9835,2536,7361,526,1758,228,489,754,2247
411155,201906,973,2538,557,1712,56,175,240,680,296,855
411160,201906,342,801,216,603,32,101,38,107,70,208
411170,201906,699,2142,512,1688,113,351,170,557,283,908
411180,201906,5238,14381,3991,12041,678,2245,1727,4890,2405,7135
411190,201906,1526,4063,1127,3331,183,565,402,1127,585,1692
411200,201906,4982,13745,3321,10456,896,3031,617,1755,1513,4786
411210,201906,2734,6236,1808,4773,341,1047,528,1275,869,2322
411220,201906,852,2314,622,1829,135,423,180,518,315,941
411230,201906,831,2284,563,1744,114,367,207,635,321,1002
411240,201906,1579,3852,924,2565,103,330,448,1147,551,1477
411250,201906,2070,5644,1532,4647,326,1152,465,1378,791,2530
411260,201906,329,888,209,637,29,86,82,221,111,307
411270,201906,1918,5347,1464,4408,226,702,676,1925,902,2627
411275,201906,1341,3233,918,2499,151,485,399,995,550,1480
411280,201906,1329,3695,861,2759,219,719,112,342,331,1061
411290,201906,745,2040,496,1537,51,147,248,781,299,928
411295,201906,1175,2971,864,2356,91,253,413,1087,504,1340
411300,201906,1030,2614,628,1804,67,207,246,617,313,824
411310,201906,856,2040,641,1720,43,115,275,723,318,838
411320,201906,5257,14129,3773,11330,768,2422,1434,3948,2202,6370
411325,201906,1475,4233,1230,3794,213,636,673,2137,886,2773
411330,201906,3243,9017,2358,7350,572,1940,671,2117,1243,4057
411340,201906,864,2409,510,1593,70,248,173,513,243,761
411342,201906,965,2385,574,1588,96,270,248,681,344,951
411345,201906,1078,2863,793,2378,80,258,533,1601,613,1859
411350,201906,2498,7050,1633,5209,434,1488,182,557,616,2045
411360,201906,655,1618,465,1321,54,155,166,468,220,623
411370,201906,49731,125521,35435,100521,2930,10064,20424,54111,23354,64175
411373,201906,1355,3524,1098,3114,101,337,582,1659,683,1996
411375,201906,1073,2759,765,2160,121,353,297,773,418,1126
411380,201906,1061,2512,733,1860,38,106,469,1111,507,1217
411390,201906,1600,4482,1221,3620,191,626,474,1215,665,1841
411400,201906,2197,5637,1681,4652,225,751,808,2090,1033,2841
411410,201906,2174,6232,1602,4903,360,1215,339,990,699,2205
411420,201906,3983,10106,2163,6497,339,1183,375,880,714,2063
411430,201906,3315,9208,2542,7694,549,1830,936,2595,1485,4425
411435,201906,424,1216,273,889,47,145,98,276,145,421
411440,201906,2531,7380,2040,6366,426,1475,690,2122,1116,3597
411450,201906,2544,6863,1937,5833,273,800,1008,3064,1281,3864
411460,201906,3777,10125,2158,6784,393,1401,363,1059,756,2460
411470,201906,726,1975,528,1567,88,286,179,481,267,767
411480,201906,4386,12241,3099,9724,669,2414,903,2571,1572,4985
411490,201906,1590,4211,1214,3544,165,569,458,1175,623,1744
411500,201906,1354,3694,885,2678,137,468,197,528,334,996
411510,201906,2220,5910,1761,5071,392,1302,372,1082,764,2384
411520,201906,29298,72468,16194,46627,2142,6922,5728,14756,7870,21678
411530,201906,912,2439,551,1725,115,403,96,271,211,674
411535,201906,470,1402,235,807,23,88,45,121,68,209
411540,201906,2774,7078,1851,5224,247,788,791,2151,1038,2939
411545,201906,935,2759,775,2470,74,241,500,1601,574,1842
411550,201906,696,1836,492,1421,83,263,87,253,170,516
411560,201906,1924,5225,1091,3414,160,576,80,200,240,776
411570,201906,6839,16563,4448,12661,951,2958,947,2664,1898,5622
411573,201906,764,2113,641,1898,87,276,343,984,430,1260
411575,201906,1810,5082,1346,4098,281,922,308,890,589,1812
411580,201906,4332,10228,2421,7175,333,1171,368,957,701,2128
411585,201906,669,1999,278,949,71,250,41,121,112,371
411590,201906,391,1125,269,834,20,73,150,414,170,487
411600,201906,287,760,172,558,40,133,56,175,96,308
411605,201906,1564,3711,929,2590,126,440,479,1299,605,1739
411610,201906,2366,5981,1637,4516,100,340,1004,2591,1104,2931
411620,201906,2817,7707,2386,7015,408,1313,1316,3783,1724,5096
411630,201906,746,1964,498,1473,81,291,158,398,239,689
411640,201906,536,1488,359,1066,47,151,127,334,174,485
411650,201906,218,638,140,465,32,111,28,85,60,196
411660,201906,906,2299,639,1807,48,141,307,835,355,976
411670,201906,1251,3206,856,2373,101,296,366,940,467,1236
411680,201906,1512,4120,1147,3398,143,489,554,1612,697,2101
411690,201906,3540,9366,2650,7797,539,1642,800,2434,1339,4076
411695,201906,678,2115,428,1426,49,177,166,545,215,722
411700,201906,1561,4159,1015,3088,243,819,126,342,369,1161
411705,201906,1856,5874,1558,5346,325,1116,827,3025,1152,4141
411710,201906,1827,4794,1258,3702,328,1010,172,502,500,1512
411720,201906,1071,2577,742,1969,125,350,308,760,433,1110
411721,201906,897,2348,662,1897,129,377,152,441,281,818
411722,201906,750,2063,400,1193,60,206,145,357,205,563
411725,201906,1168,3447,790,2638,182,631,164,563,346,1194
411727,201906,1490,4218,953,3054,239,803,141,411,380,1214
411729,201906,702,1730,441,1224,58,208,156,377,214,585
411730,201906,5211,14281,3860,11503,936,2886,1432,4197,2368,7083
411740,201906,534,1398,265,807,51,161,60,153,111,314
411745,201906,762,2234,483,1561,56,185,88,218,144,403
411750,201906,4914,13235,3474,10316,453,1459,1657,4584,2110,6043
411760,201906,6960,18944,5330,16009,1789,5541,1040,3446,2829,8987
411770,201906,3012,8950,2152,6984,545,1906,290,857,835,2763
411780,201906,2864,8323,2411,7371,661,2150,805,2447,1466,4597
411790,201906,2890,7174,1523,4584,347,1160,192,473,539,1633
411800,201906,994,2839,674,2082,109,351,141,405,250,756
411810,201906,1591,4237,1166,3385,181,554,550,1514,731,2068
411820,201906,10619,31968,8717,28258,2452,8436,3287,10333,5739,18769
411830,201906,593,1480,396,1127,73,215,88,272,161,487
411840,201906,11564,31334,7508,22614,1316,4303,1976,5452,3292,9755
411845,201906,480,1387,251,810,38,143,42,125,80,268
411850,201906,7366,19541,5077,15268,1368,4533,760,2040,2128,6573
411860,201906,711,2087,510,1642,92,322,130,371,222,693
411870,201906,644,1969,434,1451,93,338,87,254,180,592
411880,201906,2062,5414,1494,4429,251,812,404,1167,655,1979
411885,201906,1041,2723,733,2149,102,339,247,691,349,1030
411890,201906,1155,3171,778,2412,136,465,62,160,198,625
411900,201906,804,2320,481,1575,109,381,58,185,167,566
411910,201906,961,2957,685,2324,181,655,190,589,371,1244
411915,201906,15551,38933,9766,28191,1615,5151,3302,8479,4917,13630
411920,201906,1033,3163,861,2787,201,730,277,837,478,1567
411925,201906,482,1284,321,972,73,245,113,324,186,569
411930,201906,5048,16052,4249,14429,1856,6838,224,899,2080,7737
411940,201906,3231,9913,2463,8092,618,2145,704,2081,1322,4226
411950,201906,13217,36743,10756,32504,1846,6124,5659,16445,7505,22569
411960,201906,5604,15603,4532,13327,941,3047,1579,4349,2520,7396
411965,201906,425,1183,296,919,39,129,114,318,153,447
411970,201906,1028,2489,793,2153,170,430,329,1025,499,1455
411980,201906,1462,3809,1056,3082,270,819,363,1006,633,1825
411990,201906,36743,99643,23445,74022,4745,16441,7772,23287,12517,39728
411995,201906,2868,7477,2138,6294,625,2024,600,1642,1225,3666
412000,201906,1988,4627,1407,3630,46,146,973,2348,1019,2494
412010,201906,622,1958,433,1512,58,221,104,299,162,520
412015,201906,551,1585,453,1405,56,192,258,796,314,988
412020,201906,447,1275,269,873,35,135,110,335,145,470
412030,201906,630,1807,429,1407,82,269,114,377,196,646
412033,201906,849,2303,580,1715,73,211,208,563,281,774
412035,201906,784,2134,498,1614,65,243,254,775,319,1018
412040,201906,586,1625,364,1143,67,215,65,192,132,407
412050,201906,1707,4377,1162,3357,217,713,275,791,492,1504
412060,201906,7049,21620,5890,19261,1752,6384,1450,4457,3202,10841
412065,201906,623,1764,430,1324,88,285,123,389,211,674
412070,201906,1131,2948,857,2369,122,354,353,925,475,1279
412080,201906,1978,5746,1212,4003,192,662,155,427,347,1089
412085,201906,291,755,95,316,13,37,13,33,26,70
412090,201906,5681,15100,4360,12598,1222,3609,1588,4715,2810,8324
412100,201906,1679,4725,1244,3892,357,1210,241,812,598,2022
412110,201906,846,2303,600,1772,90,269,201,574,291,843
412120,201906,1878,5675,1456,4783,301,1122,408,1161,709,2283
412125,201906,663,1932,475,1515,102,320,141,435,243,755
412130,201906,699,1836,487,1413,69,218,120,358,189,576
412135,201906,603,1626,264,801,41,121,90,251,131,372
412140,201906,1595,4049,1033,3003,212,726,190,499,402,1225
412150,201906,2822,7627,2338,6734,343,1106,1377,3784,1720,4890
412160,201906,996,3117,596,2060,123,462,92,280,215,742
412170,201906,4206,12050,3525,10853,744,2440,1441,4133,2185,6573
412175,201906,1264,3871,1049,3461,244,809,426,1438,670,2247
412180,201906,1674,4729,1217,3839,178,674,515,1447,693,2121
412190,201906,3354,8546,2469,6932,320,988,1091,3058,1411,4046
412200,201906,1763,5385,1256,4137,347,1217,205,627,552,1844
412210,201906,615,1548,339,1005,63,211,86,231,149,442
412215,201906,3491,9559,2784,8193,759,2175,1117,3728,1876,5903
412217,201906,953,2551,793,2278,66,203,524,1460,590,1663
412220,201906,5775,16398,4655,14239,1173,3558,1481,4782,2654,8340
412230,201906,2623,8017,2100,6933,391,1456,566,1586,957,3042
412240,201906,6709,17514,4232,12586,741,2402,1244,3429,1985,5831
412250,201906,1985,5164,1498,4262,355,1019,353,958,708,1977
412260,201906,1233,3355,859,2540,145,423,244,671,389,1094
412265,201906,810,2350,684,2100,140,471,292,853,432,1324
412270,201906,863,2448,556,1742,69,232,219,599,288,831
412280,201906,453,1315,353,1137,75,247,97,286,172,533
412290,201906,983,2545,659,1922,103,319,211,599,314,918
412300,201906,1430,3991,1119,3364,253,781,261,805,514,1586
412310,201906,754,2075,621,1830,46,191,337,940,383,1131
412320,201906,840,2196,556,1617,74,284,196,562,270,846
412330,201906,1448,4019,979,3060,189,628,340,1092,529,1720
412340,201906,1107,3195,673,2165,116,414,122,367,238,781
412350,201906,2787,7460,1763,5386,371,1148,358,1091,729,2239
412360,201906,252,716,157,494,8,30,81,248,89,278
412370,201906,806,2345,530,1749,109,408,30,99,139,507
412380,201906,1559,4322,1053,3235,300,971,149,498,449,1469
412382,201906,524,1325,340,989,52,178,117,284,169,462
412385,201906,2142,6004,1755,5243,574,1643,511,1673,1085,3316
412390,201906,2373,5996,1912,5262,335,940,782,2147,1117,3087
412395,201906,717,2079,488,1547,63,191,197,613,260,804
412400,201906,893,2415,634,1894,138,432,160,493,298,925
412402,201906,1845,4671,1264,3674,291,889,146,437,437,1326
412405,201906,3116,8485,2005,6211,502,1826,54,143,556,1969
412410,201906,5487,14860,3930,12080,788,2791,1129,3207,1917,5998
412420,201906,510,1336,314,921,29,93,130,337,159,430
412430,201906,538,1416,352,1048,30,97,157,440,187,537
412440,201906,2697,7599,1784,5750,490,1697,272,874,762,2571
412450,201906,382,1157,248,802,49,151,22,48,71,199
412460,201906,997,2717,796,2366,146,488,340,990,486,1478
412470,201906,1553,5106,1243,4360,326,1194,295,1067,621,2261
412480,201906,936,2617,588,1802,108,353,154,424,262,777
412490,201906,1186,3057,937,2578,101,270,537,1421,638,1691
412500,201906,1884,4886,1402,3927,317,879,382,1009,699,1888
412510,201906,1972,6104,1348,4449,307,1088,113,316,420,1404
412520,201906,1299,3443,679,2034,160,475,38,103,198,578
412530,201906,652,1776,471,1389,70,229,110,314,180,543
412535,201906,815,2188,551,1661,111,348,115,310,226,658
412540,201906,1212,3222,825,2424,93,344,265,798,358,1142
412545,201906,698,1833,475,1358,81,249,130,330,211,579
412550,201906,29979,82952,20484,62965,3715,12286,7261,20586,10976,32872
412555,201906,257,697,162,477,17,52,48,111,65,163
412560,201906,4746,14162,3457,11053,594,2035,1044,3339,1638,5374
412570,201906,4139,10822,2313,7147,534,1791,303,1033,837,2824
412575,201906,959,2516,759,2132,85,261,437,1158,522,1419
412580,201906,1373,3719,945,2859,119,415,459,1330,578,1745
412590,201906,413,1102,212,677,28,104,18,45,46,149
412600,201906,1392,3936,1031,3183,184,643,396,1166,580,1809
412610,201906,803,2195,534,1575,52,166,263,687,315,853
412620,201906,1247,3435,925,2850,194,689,277,779,471,1468
412625,201906,8549,23302,5289,16585,785,2772,316,909,1101,3681
412627,201906,1063,3051,688,2251,147,528,184,593,331,1121
412630,201906,2842,8384,1997,6466,401,1315,620,1801,1021,3116
412635,201906,351,936,233,676,33,109,74,181,107,290
412640,201906,1048,2877,571,1772,84,281,145,389,229,670
412650,201906,1564,4422,1234,3702,221,728,439,1148,660,1876
412660,201906,2498,6701,1729,5137,293,942,500,1336,793,2278
412665,201906,413,1118,303,883,60,180,112,304,172,484
412667,201906,1702,4555,1244,3622,169,547,508,1391,677,1938
412670,201906,781,1947,520,1474,100,334,154,398,254,732
412680,201906,1632,4547,1085,3426,141,507,425,1204,566,1711
412690,201906,904,2492,673,2007,103,332,252,709,355,1041
412700,201906,2061,5555,1650,4872,230,824,827,2318,1057,3142
412710,201906,5850,17609,4471,14579,951,3419,1255,3744,2206,7163
412720,201906,1220,3675,910,2938,144,499,178,484,322,983
412730,201906,2126,5896,1261,3994,248,850,313,938,561,1788
412740,201906,1766,4992,1161,3678,219,775,165,530,384,1305
412750,201906,3811,10365,3194,9422,365,1274,2054,5729,2419,7003
412760,201906,2887,8036,2387,7139,415,1376,1231,3456,1646,4832
412770,201906,10170,26296,5306,16399,780,2550,1089,2925,1869,5475
412780,201906,1193,3268,897,2715,192,619,335,974,527,1593
412785,201906,1958,4988,1345,3856,180,545,765,2135,945,2680
412788,201906,1317,3828,1063,3326,281,868,445,1381,726,2249
412790,201906,1263,3371,672,2102,112,409,202,539,314,948
412795,201906,1333,3548,689,2136,115,393,130,373,245,766
412796,201906,2323,6955,1907,6047,393,1328,609,1799,1002,3127
412800,201906,3386,8502,2273,6347,286,894,962,2379,1248,3273
412810,201906,10787,27839,6490,18864,887,2955,2260,5753,3147,8708
412820,201906,6334,17761,4487,13970,1049,3428,1316,4061,2365,7489
412830,201906,345,1003,226,724,30,91,49,148,79,239
412840,201906,1822,4693,1292,3643,174,533,460,1228,634,1761
412850,201906,2863,7727,2069,6282,345,1111,784,2292,1129,3403
412853,201906,1639,4317,1357,3734,180,543,685,1718,865,2261
412855,201906,1202,3281,757,2280,162,541,201,569,363,1110
412860,201906,814,2121,558,1685,74,249,274,786,348,1035
412862,201906,710,1706,458,1269,72,214,200,527,272,741
412863,201906,1188,3702,1098,3551,135,449,769,2480,904,2929
412865,201906,727,2040,526,1641,102,334,176,545,278,879
412870,201906,878,2340,642,1938,186,621,128,404,314,1025
412880,201906,836,2345,534,1692,98,332,74,197,172,529
420005,201906,451,1360,241,857,36,134,105,379,141,513
420010,201906,3370,8393,2188,6298,169,529,1548,4476,1717,5005
420020,201906,489,1541,303,1069,54,221,54,160,108,381
420030,201906,91,315,67,264,21,90,17,63,38,153
420040,201906,568,1770,336,1237,52,211,25,78,77,289
420050,201906,670,1626,413,1152,43,147,259,664,302,811
420055,201906,168,507,87,307,19,82,30,90,49,172
420060,201906,108,305,64,192,11,42,16,28,27,70
420070,201906,747,2393,552,1932,118,431,190,653,308,1084
420075,201906,78,211,36,117,8,26,7,11,15,37
420080,201906,336,1021,262,854,84,299,81,251,165,550
420090,201906,423,1364,253,928,62,246,56,199,118,445
420100,201906,1132,3121,960,2857,48,162,762,2238,810,2400
420110,201906,250,827,226,778,47,184,93,295,140,479
420120,201906,456,1311,295,949,58,209,117,332,175,541
420125,201906,315,1022,238,848,63,240,103,342,166,582
420127,201906,283,804,96,332,20,71,22,77,42,148
420130,201906,2477,7146,1865,6030,284,1150,963,2916,1247,4066
420140,201906,3404,9415,2447,7722,654,2342,324,1010,978,3352
420150,201906,571,1522,369,1164,57,191,185,567,242,758
420160,201906,229,594,102,335,11,43,33,104,44,147
420165,201906,158,463,91,304,23,80,25,75,48,155
420170,201906,261,795,165,565,24,77,32,93,56,170
420180,201906,181,566,102,372,16,61,31,105,47,166
420190,201906,171,554,104,379,35,139,22,69,57,208
420195,201906,1343,3632,979,3013,292,1014,126,323,418,1337
420200,201906,3501,9079,2010,6163,317,1215,724,1871,1041,3086
420205,201906,1482,4066,1043,3235,161,509,578,1811,739,2320
420207,201906,1657,4515,1035,3281,205,748,399,1191,604,1939
420208,201906,347,992,201,721,36,143,82,288,118,431
420209,201906,139,464,86,300,22,88,28,89,50,177
420210,201906,2502,6639,1621,5184,355,1244,716,2231,1071,3475
420213,201906,752,2394,617,2100,133,486,300,1004,433,1490
420215,201906,212,643,143,492,38,146,18,51,56,197
420220,201906,239,727,147,508,30,122,64,199,94,321
420230,201906,4336,12212,3268,10170,477,1635,1737,5209,2214,6844
420240,201906,11819,32817,7254,22605,976,3549,3598,9882,4574,13431
420243,201906,377,1096,303,946,48,162,171,508,219,670
420245,201906,1238,3319,856,2630,79,315,479,1383,558,1698
420250,201906,424,1251,367,1145,71,263,186,529,257,792
420253,201906,514,1320,372,1104,32,101,202,592,234,693
420257,201906,184,471,106,323,21,71,54,157,75,228
420260,201906,1080,2980,776,2514,133,481,443,1422,576,1903
420270,201906,468,1253,211,640,31,108,73,204,104,312
420280,201906,1205,3498,833,2761,169,621,245,788,414,1409
420285,201906,84,223,47,146,7,33,11,28,18,61
420287,201906,460,1126,318,905,92,268,101,291,193,559
420290,201906,3993,11550,3013,9325,448,1657,1613,4501,2061,6158
420300,201906,6641,19069,3785,12365,754,2708,969,2837,1723,5545
420310,201906,831,1993,397,1130,61,178,194,500,255,678
420315,201906,817,2415,555,1889,121,451,219,744,340,1195
420320,201906,4169,12136,3207,10395,985,3508,718,2170,1703,5678
420325,201906,242,731,182,625,39,131,64,217,103,348
420330,201906,861,2644,558,1957,115,451,171,532,286,983
420340,201906,956,2799,682,2241,178,602,64,197,242,799
420350,201906,1300,3485,894,2704,95,314,573,1696,668,2010
420360,201906,2542,7285,1344,4550,268,978,135,443,403,1421
420370,201906,1037,2908,829,2539,95,349,551,1606,646,1955
420380,201906,4583,12450,2979,9378,641,2177,998,2980,1639,5157
420390,201906,1065,2673,704,1894,113,386,319,616,432,1002
420395,201906,976,2874,625,2115,100,363,68,188,168,551
420400,201906,897,2653,592,1968,111,410,188,582,299,992
420410,201906,505,1420,376,1149,38,140,233,667,271,807
420415,201906,296,905,224,746,61,221,78,266,139,487
420417,201906,620,1890,497,1623,127,423,178,597,305,1020
420419,201906,148,520,112,424,42,171,10,30,52,201
420420,201906,10332,27820,6854,21310,2129,7338,1679,4749,3808,12087
420425,201906,671,1814,454,1387,44,164,201,588,245,752
420430,201906,2919,8248,1793,5674,462,1575,519,1445,981,3020
420435,201906,265,688,113,384,17,64,52,172,69,236
420440,201906,681,1987,404,1329,117,424,127,359,244,783
420445,201906,302,781,174,518,35,114,61,167,96,281
420450,201906,659,1975,466,1535,87,357,162,469,249,826
420455,201906,1957,5018,1425,4158,190,673,722,1982,912,2655
420460,201906,8425,23216,6292,19214,1035,3603,3031,8811,4066,12414
420470,201906,609,1609,325,1048,68,255,76,210,144,465
420475,201906,53,153,27,93,10,33,3,13,13,46
420480,201906,5309,13536,3233,9900,666,2200,985,2980,1651,5180
420490,201906,359,1080,245,830,55,219,83,275,138,494
420500,201906,1326,3882,896,3020,173,632,351,1175,524,1807
420510,201906,165,475,87,291,13,47,28,89,41,136
420515,201906,43,123,28,90,1,1,12,42,13,43
420517,201906,751,2097,646,1915,41,122,494,1464,535,1586
420519,201906,310,745,204,584,24,74,107,314,131,388
420520,201906,363,980,164,570,21,72,14,46,35,118
420530,201906,801,2381,549,1832,111,413,168,494,279,907
420535,201906,219,645,84,289,19,76,21,67,40,143
420540,201906,29326,71604,18224,51988,3019,9636,6378,15501,9397,25137
420543,201906,226,689,171,550,27,83,87,276,114,359
420545,201906,1080,3253,824,2676,167,576,315,950,482,1526
420550,201906,3390,9571,2162,7299,409,1535,875,2989,1284,4524
420555,201906,304,894,203,672,31,119,106,327,137,446
420560,201906,413,1053,280,844,65,200,142,417,207,617
420570,201906,2056,5965,1551,4957,318,1115,569,1715,887,2830
420580,201906,1721,4518,1196,3681,276,900,462,1430,738,2330
420590,201906,2851,7768,1649,5125,319,1160,388,881,707,2041
420600,201906,954,2847,727,2383,127,462,344,1083,471,1545
420610,201906,362,1069,194,678,45,153,58,212,103,365
420620,201906,601,1527,383,1152,90,276,152,452,242,728
420630,201906,892,2685,638,2032,118,426,317,909,435,1335
420640,201906,511,1458,241,857,61,212,23,71,84,283
420650,201906,3060,8425,1804,5634,293,1022,679,1822,972,2844
420660,201906,344,940,229,700,48,156,66,194,114,350
420665,201906,528,1410,320,1032,61,214,130,372,191,586
420670,201906,1382,3812,892,2859,144,569,340,951,484,1520
420675,201906,135,393,79,283,24,103,22,69,46,172
420680,201906,329,783,168,555,29,114,74,237,103,351
420690,201906,829,2569,497,1713,72,295,118,323,190,618
420700,201906,2711,7360,2039,6184,275,945,1066,3090,1341,4035
420710,201906,741,2244,558,1827,75,312,314,934,389,1246
420720,201906,1272,3572,905,2945,210,678,396,1273,606,1951
420730,201906,2665,7245,2037,6225,333,1065,1130,3349,1463,4414
420740,201906,568,1753,352,1261,98,366,36,147,134,513
420750,201906,1839,5520,1197,3983,204,774,453,1376,657,2150
420757,201906,63,171,30,110,2,9,12,38,14,47
420760,201906,358,1077,150,484,37,135,29,76,66,211
420765,201906,390,1211,211,737,27,101,89,308,116,409
420768,201906,1209,3621,1034,3301,146,467,725,2291,871,2758
420770,201906,423,1161,194,687,30,117,85,282,115,399
420775,201906,360,1060,228,774,45,175,48,134,93,309
420780,201906,915,2594,535,1773,116,408,91,263,207,671
420785,201906,192,519,134,399,14,41,60,155,74,196
420790,201906,1011,3204,742,2615,154,619,367,1213,521,1832
420800,201906,705,1810,328,1032,87,288,72,230,159,518
420810,201906,1449,4746,1181,4163,351,1392,343,1032,694,2424
420820,201906,10334,26666,7242,21487,1476,4979,3220,8611,4696,13590
420830,201906,3088,8540,2306,7094,506,1684,912,2720,1418,4404
420840,201906,535,1648,249,920,69,261,41,143,110,404
420845,201906,2040,5398,1213,3892,239,893,455,1400,694,2293
420850,201906,1055,3485,639,2363,134,536,92,311,226,847
420860,201906,288,743,157,504,38,135,37,112,75,247
420870,201906,809,2230,615,1883,169,612,266,751,435,1363
420880,201906,933,2921,730,2508,157,617,258,801,415,1418
420890,201906,7538,20561,4302,13774,699,2464,1362,3749,2061,6213
420895,201906,160,484,97,316,26,85,28,94,54,179
420900,201906,1345,3463,795,2465,109,408,335,907,444,1315
420910,201906,26016,70235,16071,50613,2616,9284,5868,16579,8484,25863
420915,201906,541,1987,384,1527,59,239,181,725,240,964
420917,201906,340,903,174,512,25,83,79,221,104,304
420920,201906,77,210,24,89,0,0,4,10,4,10
420930,201906,16817,44690,11768,35692,2124,7115,5214,15014,7338,22129
420940,201906,2379,6010,1422,4327,343,1179,217,517,560,1696
420945,201906,129,387,101,319,24,88,38,105,62,193
420950,201906,312,923,170,580,28,113,34,95,62,208
420960,201906,967,2457,666,1924,117,404,277,699,394,1103
420970,201906,2382,6929,1580,5260,459,1583,246,844,705,2427
420980,201906,280,891,238,825,110,381,73,282,183,663
420985,201906,317,928,155,553,30,116,49,151,79,267
420990,201906,381,1163,196,711,36,132,34,92,70,224
421000,201906,502,1647,326,1210,79,324,74,236,153,560
421003,201906,477,1122,147,438,14,45,24,63,38,108
421005,201906,58,181,51,171,14,46,22,71,36,117
421010,201906,3246,9132,2329,7431,492,1751,573,1597,1065,3348
421020,201906,376,1160,293,1013,40,162,154,507,194,669
421030,201906,747,2360,585,2019,171,651,164,522,335,1173
421040,201906,688,1637,411,1209,36,113,246,716,282,829
421050,201906,1057,2982,650,2043,119,399,219,622,338,1021
421055,201906,171,473,81,256,13,45,31,81,44,126
421060,201906,553,1671,347,1141,65,238,128,372,193,610
421070,201906,533,1654,300,1072,69,258,54,197,123,455
421080,201906,458,1349,392,1222,50,172,250,783,300,955
421085,201906,382,1135,134,500,23,91,20,60,43,151
421090,201906,290,777,169,518,17,53,58,173,75,226
421100,201906,927,2115,379,1125,93,309,63,166,156,475
421105,201906,1466,4105,1044,3272,172,531,487,1517,659,2048
421110,201906,1028,2946,863,2692,41,117,615,1999,656,2116
421120,201906,884,2838,626,2208,90,353,201,648,291,1001
421125,201906,255,700,204,619,72,245,68,164,140,409
421130,201906,4147,12565,3449,11176,744,2692,1908,5927,2652,8619
421140,201906,289,808,189,601,35,115,67,194,102,309
421145,201906,440,1249,274,872,57,203,124,360,181,563
421150,201906,546,1520,296,983,62,226,91,286,153,512
421160,201906,522,1403,357,1110,39,137,225,682,264,819
421165,201906,191,585,120,407,27,91,49,167,76,258
421170,201906,1045,2812,807,2432,129,369,507,1556,636,1925
421175,201906,1055,2768,664,2131,134,494,269,800,403,1294
421180,201906,368,961,197,608,36,133,66,188,102,321
421185,201906,297,799,193,580,33,109,104,302,137,411
421187,201906,298,904,180,598,33,108,59,181,92,289
421189,201906,351,1032,264,847,42,133,100,309,142,442
421190,201906,9386,25972,6106,19767,1283,4547,1653,5013,2936,9560
421200,201906,648,1981,521,1715,89,323,270,850,359,1173
421205,201906,192,521,142,439,29,98,71,210,100,308
421210,201906,1032,2738,614,1991,154,506,191,621,345,1127
421220,201906,1312,4179,1035,3524,247,920,262,797,509,1717
421223,201906,350,1021,224,765,56,179,94,329,150,508
421225,201906,883,2717,761,2488,146,529,426,1392,572,1921
421227,201906,943,2512,543,1699,95,320,236,745,331,1065
421230,201906,589,1581,366,1163,94,311,110,355,204,666
421240,201906,287,885,117,445,12,58,16,62,28,120
421250,201906,1586,4172,1062,3288,179,594,475,1440,654,2034
421260,201906,169,497,43,163,9,37,10,36,19,73
421265,201906,598,1708,557,1649,13,44,520,1541,533,1585
421270,201906,396,1042,174,614,31,108,60,202,91,310
421280,201906,1547,4576,1156,3826,222,871,554,1693,776,2564
421290,201906,794,2222,418,1327,83,282,82,247,165,529
421300,201906,249,689,138,454,21,73,29,100,50,173
421310,201906,161,484,121,396,25,87,54,183,79,270
421315,201906,208,608,128,410,34,104,30,96,64,200
421320,201906,623,1869,302,1029,43,150,41,101,84,251
421330,201906,613,1846,432,1470,91,339,115,372,206,711
421335,201906,362,1122,293,998,58,219,110,372,168,591
421340,201906,1298,3799,938,3083,198,739,368,1142,566,1881
421350,201906,1183,3260,811,2582,164,628,343,1012,507,1640
421360,201906,2209,6171,1315,4321,275,1092,460,1298,735,2390
421370,201906,484,1592,285,1058,61,242,75,246,136,488
421380,201906,809,2228,690,2010,88,294,418,1177,506,1471
421390,201906,173,475,64,220,14,40,18,55,32,95
421400,201906,264,856,182,654,35,147,85,274,120,421
421410,201906,242,657,98,337,16,56,27,95,43,151
421415,201906,219,676,118,394,33,111,24,67,57,178
421420,201906,491,1405,408,1247,52,180,252,731,304,911
421430,201906,119,387,94,329,10,36,32,98,42,134
421440,201906,590,1571,370,1191,73,230,170,543,243,773
421450,201906,377,1165,237,819,34,132,36,142,70,274
421460,201906,311,912,192,667,29,95,42,122,71,217
421470,201906,252,761,143,505,24,100,57,201,81,301
421480,201906,2665,7320,1732,5515,385,1420,610,1726,995,3146
421490,201906,100,326,61,221,7,31,17,48,24,79
421500,201906,2087,6343,1457,5007,413,1637,311,957,724,2594
421505,201906,288,864,254,805,32,110,159,488,191,598
421507,201906,396,1176,225,773,63,231,64,206,127,437
421510,201906,264,768,151,489,31,103,65,194,96,297
421520,201906,506,1369,313,934,38,132,176,486,214,618
421530,201906,322,1027,188,687,41,183,44,126,85,309
421535,201906,395,1087,244,795,41,157,131,397,172,554
421540,201906,254,628,128,410,18,66,42,120,60,186
421545,201906,680,2034,500,1684,102,400,244,767,346,1167
421550,201906,1889,5411,1535,4846,308,1066,787,2423,1095,3489
421555,201906,197,618,71,268,13,57,9,23,22,80
421560,201906,78,260,49,187,12,43,13,47,25,90
421565,201906,881,2357,608,1908,155,536,180,572,335,1108
421567,201906,445,1544,283,1055,112,430,62,211,174,641
421568,201906,325,999,233,777,33,128,109,345,142,473
421569,201906,188,544,75,256,20,72,31,101,51,173
421570,201906,924,2616,661,2110,184,640,144,450,328,1090
421575,201906,273,838,213,677,43,151,81,214,124,365
421580,201906,3043,8762,2025,6626,397,1536,715,1974,1112,3510
421590,201906,138,448,107,367,36,131,29,85,65,216
421600,201906,513,1433,349,1082,83,272,92,238,175,510
421605,201906,727,1956,500,1562,102,297,194,632,296,929
421610,201906,1062,2967,655,2143,125,424,174,569,299,993
421620,201906,3823,10477,2195,7368,531,1924,536,1738,1067,3662
421625,201906,185,520,76,248,12,38,16,49,28,87
421630,201906,2354,6433,1386,4420,245,915,399,1090,644,2005
421635,201906,229,650,153,476,20,71,82,232,102,303
421640,201906,671,1877,478,1552,105,357,152,504,257,861
421650,201906,2159,6124,1369,4591,348,1348,329,919,677,2267
421660,201906,7905,22835,5799,18776,965,3563,2328,6856,3293,10419
421670,201906,746,2201,520,1672,93,338,255,793,348,1131
421680,201906,957,2786,734,2348,196,668,305,892,501,1560
421690,201906,1190,3532,829,2724,161,601,279,922,440,1523
421700,201906,461,1431,250,894,45,183,72,230,117,413
421710,201906,217,689,92,308,24,85,20,62,44,147
421715,201906,99,284,73,224,20,56,42,126,62,182
421720,201906,1881,5262,1065,3489,292,1059,276,769,568,1828
421725,201906,209,511,104,328,20,68,40,100,60,168
421730,201906,371,1111,190,583,18,59,96,274,114,333
421740,201906,615,1799,425,1376,120,393,100,305,220,698
421750,201906,855,2074,399,1199,85,283,151,406,236,689
421755,201906,176,488,97,296,14,54,48,133,62,187
421760,201906,852,2370,526,1733,101,370,161,456,262,826
421770,201906,2203,6017,1614,4957,406,1271,567,1889,973,3160
421775,201906,217,574,135,403,19,64,64,171,83,235
421780,201906,776,2399,516,1822,108,420,196,648,304,1068
421790,201906,701,1848,400,1309,88,300,187,597,275,897
421795,201906,215,630,133,417,27,99,45,127,72,226
421800,201906,2401,6871,1774,5665,287,1027,901,2732,1188,3759
421810,201906,619,1745,424,1360,55,214,231,710,286,924
421820,201906,880,2629,483,1640,93,361,129,364,222,725
421825,201906,1289,3693,1145,3465,137,454,793,2342,930,2796
421830,201906,1909,6009,1612,5438,331,1205,689,2241,1020,3446
421835,201906,213,561,117,377,20,80,38,101,58,181
421840,201906,213,690,139,512,27,107,34,117,61,224
421850,201906,383,1134,212,755,43,171,65,175,108,346
421860,201906,291,855,178,614,21,86,61,180,82,266
421870,201906,3537,9216,2461,7112,476,1560,1140,2999,1616,4559
421875,201906,221,672,107,387,19,75,25,72,44,147
421880,201906,494,1402,343,1110,97,365,68,228,165,593
421885,201906,205,548,125,391,32,102,31,79,63,181
421890,201906,731,2347,575,2013,113,453,256,823,369,1276
421895,201906,383,1013,314,921,36,125,207,620,243,745
421900,201906,940,2464,625,1829,105,363,273,708,378,1071
421910,201906,315,947,215,727,45,179,48,129,93,308
421915,201906,372,1059,201,651,44,141,25,71,69,212
421917,201906,538,1336,309,1012,110,392,70,227,180,619
421920,201906,414,1281,293,1037,129,482,86,302,215,784
421930,201906,2350,6225,1102,3689,295,1088,196,598,491,1686
421935,201906,407,1327,317,1114,61,228,171,571,232,799
421940,201906,311,947,119,403,16,65,33,102,49,167
421950,201906,2958,7526,1463,4627,303,1075,336,927,639,2002
421960,201906,161,420,89,292,21,80,17,51,38,131
421970,201906,1872,4981,1063,3306,233,797,328,891,561,1688
421985,201906,248,647,146,445,17,58,44,131,61,189
422000,201906,1673,4568,1360,4019,153,518,870,2554,1023,3072
430003,201906,528,1511,345,1149,66,241,137,451,203,692
430005,201906,262,711,161,518,38,124,72,225,110,349
430010,201906,1646,4265,1325,3699,154,477,910,2443,1064,2920
430020,201906,574,1339,435,1152,61,190,269,668,330,858
430030,201906,1000,2430,560,1640,159,496,154,418,313,914
430040,201906,9495,23685,5578,16485,1478,4735,489,1579,1967,6314
430045,201906,546,1405,369,1063,29,93,216,602,245,695
430047,201906,254,556,96,276,21,67,24,71,45,138
430050,201906,921,2427,520,1589,117,385,118,349,235,734
430055,201906,257,653,111,335,14,53,59,159,73,212
430057,201906,95,216,32,90,8,28,6,14,14,42
430060,201906,15880,44422,12386,38715,2820,9409,5459,17021,8279,26430
430063,201906,868,2442,678,2034,130,391,364,1076,494,1467
430064,201906,969,2770,729,2241,197,639,269,781,466,1420
430066,201906,100,231,71,183,4,11,51,117,55,128
430070,201906,708,1807,93,307,5,20,12,30,17,50
430080,201906,745,1895,446,1289,71,235,206,520,277,755
430085,201906,859,2002,514,1429,87,249,217,589,304,838
430087,201906,502,1387,405,1245,73,222,227,719,300,941
430090,201906,563,1475,181,587,16,70,55,168,71,238
430100,201906,636,1596,344,1021,72,232,117,302,189,534
430105,201906,1046,2835,655,2149,121,435,315,1039,436,1474
430107,201906,179,527,112,361,21,73,30,79,51,152
430110,201906,2071,5208,1507,4355,231,707,847,2406,1078,3113
430120,201906,1317,4008,804,2662,152,530,353,1178,505,1708
430130,201906,3356,8147,2529,6960,986,2714,489,1588,1475,4302
430140,201906,891,2556,603,1966,149,486,255,819,404,1305
430150,201906,566,1477,302,936,68,225,95,286,163,511
430155,201906,246,648,114,357,16,50,20,53,36,103
430160,201906,17592,44048,13929,38549,2352,6955,6985,19410,9337,26365
430163,201906,2512,6305,1723,5003,119,358,1156,3373,1275,3731
430165,201906,334,810,78,253,12,26,14,38,26,64
430170,201906,902,2431,325,1118,59,214,60,191,119,405
430175,201906,656,2028,538,1763,143,459,252,813,395,1272
430180,201906,631,1642,500,1405,65,192,340,929,405,1121
430185,201906,442,1068,266,755,53,151,90,221,143,372
430187,201906,648,1609,455,1335,77,246,214,647,291,893
430190,201906,1399,3851,1123,3388,254,825,491,1389,745,2214
430192,201906,125,364,53,159,8,27,14,39,22,66
430195,201906,400,1203,53,187,9,29,5,20,14,49
430200,201906,1081,3296,877,2917,282,985,257,869,539,1854
430205,201906,486,1305,405,1137,16,53,338,919,354,972
430210,201906,4703,12249,3178,9085,651,1979,1019,2379,1670,4358
430215,201906,306,806,185,554,38,122,73,218,111,340
430220,201906,641,1590,166,559,30,133,41,106,71,239
430222,201906,181,534,137,441,18,69,55,167,73,236
430223,201906,241,667,196,582,24,73,116,334,140,407
430225,201906,15,37,12,32,1,2,9,17,10,19
430230,201906,1713,4886,1495,4562,137,421,1138,3484,1275,3905
430235,201906,274,825,185,620,45,169,55,162,100,331
430237,201906,531,1310,365,1015,22,79,241,630,263,709
430240,201906,1102,2490,628,1701,77,244,353,899,430,1143
430245,201906,655,1999,506,1689,155,514,229,778,384,1292
430250,201906,946,2515,731,2167,235,757,35,86,270,843
430258,201906,102,281,77,231,5,10,40,129,45,139
430260,201906,618,1688,442,1330,77,237,230,686,307,923
430265,201906,198,568,139,449,28,98,44,126,72,224
430270,201906,2656,6841,2133,5991,379,1160,1274,3460,1653,4620
430280,201906,4845,11884,3414,9304,744,2076,1427,3843,2171,5919
430290,201906,2066,4972,1768,4598,52,166,1503,3829,1555,3995
430300,201906,8767,23537,6817,19927,1193,3804,3439,9847,4632,13651
430310,201906,10121,26188,6693,19405,949,3158,3124,8394,4073,11552
430320,201906,944,2547,507,1613,70,199,274,896,344,1095
430330,201906,611,1562,392,1106,75,218,174,445,249,663
430340,201906,695,1570,363,1044,56,177,203,559,259,736
430350,201906,6564,17692,4845,14361,992,3074,2258,6488,3250,9562
430355,201906,330,860,108,362,24,73,16,52,40,125
430360,201906,818,2045,541,1550,125,400,200,522,325,922
430367,201906,329,806,174,504,42,129,64,186,106,315
430370,201906,477,1333,208,679,36,129,52,148,88,277
430380,201906,664,1702,331,1063,81,305,71,218,152,523
430390,201906,2974,7417,1602,4784,296,962,128,281,424,1243
430400,201906,1078,2334,828,1970,69,173,602,1380,671,1553
430410,201906,549,1345,365,1038,56,181,205,556,261,737
430420,201906,2690,7528,2028,6026,572,1780,745,2092,1317,3872
430430,201906,660,1728,312,968,71,211,67,211,138,422
430435,201906,1500,3883,1115,3231,237,722,496,1435,733,2157
430440,201906,3558,10209,2655,8398,404,1456,1446,4479,1850,5935
430450,201906,6640,17295,5267,14787,685,2169,2967,8072,3652,10241
430460,201906,28530,75327,20172,61128,4078,13617,8877,25603,12955,39220
430461,201906,387,979,103,322,12,39,30,80,42,119
430462,201906,243,664,140,464,18,60,46,161,64,221
430463,201906,4735,13364,3626,11350,713,2467,1741,5297,2454,7764
430465,201906,455,1221,375,1065,57,174,225,615,282,789
430466,201906,3778,9789,2969,8379,757,2232,1368,3654,2125,5886
430467,201906,494,1241,342,993,51,175,170,460,221,635
430468,201906,1306,3282,1024,2855,115,340,615,1679,730,2019
430469,201906,651,1833,77,267,12,41,11,15,23,56
430470,201906,5366,14279,3620,11083,1150,3776,878,2528,2028,6304
430471,201906,515,1554,435,1395,73,240,210,647,283,887
430480,201906,815,2173,421,1319,63,205,82,217,145,422
430485,201906,169,464,65,217,16,54,7,21,23,75
430490,201906,408,1065,217,640,25,76,103,280,128,356
430495,201906,360,1009,204,681,30,105,73,229,103,334
430500,201906,1008,2656,704,2125,210,682,221,600,431,1282
430510,201906,23130,61873,16286,48006,3203,10639,6601,17703,9804,28342
430511,201906,322,951,123,429,14,52,15,44,29,96
430512,201906,912,2140,713,1834,178,454,250,662,428,1116
430513,201906,780,1990,366,1059,52,154,177,498,229,652
430515,201906,384,1104,269,857,39,116,130,414,169,530
430517,201906,1022,3198,774,2601,141,477,386,1333,527,1810
430520,201906,1301,3446,666,2050,116,356,135,384,251,740
430530,201906,1060,2755,396,1239,83,269,92,274,175,543
430535,201906,2996,7998,2137,6385,330,1041,1041,3020,1371,4061
430537,201906,312,1117,281,1014,27,83,216,785,243,868
430540,201906,565,1397,342,1028,49,139,164,488,213,627
430543,201906,654,1265,392,955,63,127,198,519,261,646
430544,201906,634,1886,443,1435,103,357,196,619,299,976
430545,201906,1980,5317,1472,4531,301,942,710,2250,1011,3192
430550,201906,405,1160,255,823,44,141,80,246,124,387
430558,201906,115,270,51,145,8,21,14,39,22,60
430560,201906,329,736,139,419,14,49,41,120,55,169
430570,201906,746,1784,540,1457,86,255,318,808,404,1063
430580,201906,898,2261,617,1821,147,479,262,733,409,1212
430583,201906,197,488,35,113,4,12,6,18,10,30
430585,201906,224,550,115,314,19,55,52,122,71,177
430587,201906,197,570,140,439,23,73,58,185,81,258
430590,201906,1367,3325,1157,2998,52,147,975,2487,1027,2634
430593,201906,19,69,13,47,2,8,6,20,8,28
430595,201906,427,1044,91,303,6,24,19,46,25,70
430597,201906,353,963,208,634,23,76,77,180,100,256
430600,201906,1797,4713,799,2399,155,482,223,634,378,1116
430605,201906,1101,3122,804,2512,114,425,339,1006,453,1431
430607,201906,554,1303,417,1078,25,71,298,772,323,843
430610,201906,5513,13673,3683,10755,1062,3338,666,2013,1728,5351
430613,201906,257,611,71,207,8,27,18,45,26,72
430620,201906,540,1414,408,1148,65,204,215,572,280,776
430630,201906,423,1189,123,398,19,65,24,64,43,129
430632,201906,520,1407,236,730,29,92,103,308,132,400
430635,201906,522,1343,377,1066,49,143,263,739,312,882
430637,201906,451,1152,357,1007,43,136,209,561,252,697
430640,201906,1058,2758,596,1806,93,294,198,570,291,864
430642,201906,346,956,254,744,46,132,129,362,175,494
430645,201906,218,493,76,212,17,49,13,39,30,88
430650,201906,1533,4649,1269,4185,336,1122,591,2017,927,3139
430655,201906,257,635,146,410,23,68,63,158,86,226
430660,201906,4766,12738,3602,10652,842,2653,1574,4588,2416,7241
430670,201906,622,1546,477,1290,28,80,320,864,348,944
430673,201906,558,1292,214,643,41,126,78,223,119,349
430675,201906,202,583,55,194,17,67,18,59,35,126
430676,201906,4411,11378,3453,9832,455,1417,2107,5847,2562,7264
430680,201906,954,2592,573,1795,162,527,136,412,298,939
430690,201906,2955,8213,2350,7072,780,2456,611,1785,1391,4241
430692,201906,211,655,158,563,12,50,111,397,123,447
430693,201906,995,2666,567,1763,114,412,127,357,241,769
430695,201906,484,1273,272,819,34,99,146,418,180,517
430697,201906,386,983,290,831,68,186,138,421,206,607
430700,201906,6593,16704,3567,10936,842,2750,473,1414,1315,4164
430705,201906,399,997,189,575,27,90,74,212,101,302
430710,201906,1634,3656,1139,2931,167,472,628,1582,795,2054
430720,201906,734,1774,385,1156,57,156,178,530,235,686
430730,201906,1051,2909,719,2251,116,341,348,1098,464,1439
430740,201906,591,1671,300,1019,47,169,85,302,132,471
430745,201906,437,1220,238,752,41,147,68,183,109,330
430750,201906,1300,3446,919,2756,200,618,465,1334,665,1952
430755,201906,452,1099,284,753,14,49,162,396,176,445
430760,201906,1859,4862,1481,4250,370,1114,629,1745,999,2859
430770,201906,5825,14980,4478,12915,651,2109,2736,7640,3387,9749
430780,201906,2002,5055,1139,3532,238,764,357,1100,595,1864
430781,201906,417,1177,221,705,36,112,58,154,94,266
430783,201906,411,954,234,670,27,93,134,356,161,449
430786,201906,35,121,19,76,3,10,2,9,5,19
430790,201906,4346,11071,2916,8427,408,1367,1611,4308,2019,5675
430800,201906,746,1818,549,1488,45,140,354,943,399,1083
430805,201906,414,1135,247,744,23,85,147,400,170,485
430807,201906,331,740,191,512,11,37,109,265,120,302
430810,201906,805,1969,262,844,35,129,76,228,111,357
430820,201906,1338,3581,715,2337,152,527,160,539,312,1066
430825,201906,265,686,90,252,16,44,23,53,39,97
430830,201906,1644,4851,1343,4260,65,250,940,2952,1005,3202
430840,201906,915,2429,703,2047,100,315,462,1319,562,1634
430843,201906,118,293,38,116,4,12,18,47,22,59
430845,201906,387,945,249,706,73,217,75,199,148,416
430850,201906,2242,6000,1604,4749,274,875,713,2093,987,2968
430860,201906,817,1883,429,1214,61,207,202,489,263,696
430865,201906,500,1290,385,1086,62,189,201,544,263,733
430870,201906,635,1690,262,839,44,162,84,237,128,399
430880,201906,1257,3007,848,2355,156,462,421,1117,577,1579
430885,201906,197,489,88,287,6,24,53,168,59,192
430890,201906,1000,2663,673,2056,57,261,110,302,167,563
430900,201906,2882,6557,1965,5181,171,536,1251,3098,1422,3634
430905,201906,761,1993,475,1438,85,288,177,510,262,798
430910,201906,1430,3893,988,2972,163,572,449,1205,612,1777
430912,201906,482,1333,322,1020,32,94,207,670,239,764
430915,201906,496,1534,356,1256,104,370,112,401,216,771
430920,201906,22400,58021,17117,49135,2470,7876,9995,27752,12465,35628
430925,201906,133,301,48,142,11,32,15,49,26,81
430930,201906,9513,22854,5830,17072,1260,3863,2193,6680,3453,10543
430940,201906,1087,3024,615,1919,189,626,99,229,288,855
430950,201906,708,1743,441,1246,45,157,263,670,308,827
430955,201906,226,612,71,232,14,43,20,58,34,101
430957,201906,175,606,164,578,30,111,92,317,122,428
430960,201906,1331,3185,769,2176,165,512,330,898,495,1410
430965,201906,1648,4061,1248,3421,70,216,941,2566,1011,2782
430970,201906,377,964,187,568,28,97,86,235,114,332
430975,201906,478,1495,360,1201,87,305,156,504,243,809
430980,201906,394,933,209,607,38,119,84,215,122,334
430990,201906,561,1649,334,1074,42,146,172,545,214,691
430995,201906,565,1492,410,1230,61,194,193,565,254,759
431000,201906,1318,3162,516,1538,89,290,36,91,125,381
431010,201906,2067,5471,1222,3947,228,792,159,446,387,1238
431020,201906,8162,18239,4783,12923,1133,3375,1522,3664,2655,7039
431030,201906,319,869,140,479,28,99,20,66,48,165
431033,201906,3252,7922,2012,5915,506,1535,657,1964,1163,3499
431036,201906,349,762,72,207,8,19,20,47,28,66
431040,201906,908,2389,586,1774,95,324,249,692,344,1016
431041,201906,457,1074,333,892,31,79,195,516,226,595
431043,201906,390,962,201,640,48,166,77,243,125,409
431046,201906,108,285,45,137,3,8,11,32,14,40
431050,201906,1373,3453,978,2819,162,480,522,1512,684,1992
431053,201906,575,1608,310,1024,63,219,96,297,159,516
431055,201906,579,1447,486,1307,40,106,364,963,404,1069
431057,201906,265,770,122,415,19,66,35,107,54,173
431060,201906,4994,13565,3445,10773,932,3149,753,2393,1685,5542
431065,201906,459,1204,308,932,66,204,105,309,171,513
431070,201906,436,1278,242,814,62,233,39,115,101,348
431075,201906,220,665,140,473,27,91,38,132,65,223
431080,201906,605,1696,412,1290,91,312,125,368,216,680
431085,201906,694,1890,467,1354,71,204,233,653,304,857
431087,201906,452,1291,356,1078,26,73,238,739,264,812
431090,201906,422,989,151,479,28,100,40,115,68,215
431100,201906,3138,7193,2226,5937,350,995,1097,2927,1447,3922
431110,201906,1366,3249,935,2489,255,672,397,1029,652,1701
431112,201906,509,1528,419,1341,78,269,216,664,294,933
431113,201906,340,979,296,891,58,184,170,508,228,692
431115,201906,1036,2983,812,2560,123,436,455,1353,578,1789
431120,201906,2269,6523,1578,5069,526,1861,354,1027,880,2888
431123,201906,372,1073,236,774,47,133,121,418,168,551
431125,201906,1032,3103,778,2546,295,953,232,811,527,1764
431127,201906,249,658,56,183,8,24,6,15,14,39
431130,201906,2957,7955,2132,6435,395,1320,1002,2933,1397,4253
431140,201906,4898,11820,2718,7629,354,1056,1128,2836,1482,3892
431142,201906,485,1331,352,1080,50,160,203,623,253,783
431150,201906,995,2737,687,2129,149,488,269,825,418,1313
431160,201906,679,1939,469,1494,89,313,149,459,238,772
431162,201906,516,1276,250,761,23,89,124,347,147,436
431164,201906,196,457,41,128,9,28,4,12,13,40
431170,201906,523,1454,353,1106,100,293,90,272,190,565
431171,201906,623,1542,512,1396,83,209,316,864,399,1073
431173,201906,401,1069,288,885,89,306,104,302,193,608
431175,201906,1034,2570,630,1853,124,370,194,560,318,930
431177,201906,693,2023,526,1738,148,540,255,817,403,1357
431179,201906,335,731,73,219,14,47,15,33,29,80
431180,201906,2252,5866,1367,4111,365,1085,313,946,678,2031
431190,201906,452,1241,236,748,30,89,60,166,90,255
431198,201906,313,963,268,880,102,347,70,254,172,601
431200,201906,370,951,68,210,12,32,4,12,16,44
431205,201906,182,527,88,309,23,86,31,109,54,195
431210,201906,604,1574,485,1397,122,335,235,714,357,1049
431213,201906,245,690,182,570,12,44,90,285,102,329
431215,201906,535,1308,234,716,27,90,98,273,125,363
431217,201906,155,426,101,317,6,23,60,169,66,192
431220,201906,592,1572,334,1046,30,120,178,512,208,632
431225,201906,1504,3681,1144,3068,129,383,736,1947,865,2330
431230,201906,667,1970,485,1514,65,224,277,823,342,1047
431235,201906,153,397,22,72,3,12,4,12,7,24
431237,201906,309,998,260,878,44,163,142,459,186,622
431238,201906,26,67,20,53,6,14,6,15,12,29
431240,201906,3851,9993,2996,8602,569,1787,1470,4094,2039,5881
431242,201906,286,795,234,693,61,190,109,320,170,510
431244,201906,331,801,155,433,22,81,55,119,77,200
431245,201906,1306,3119,801,2207,101,292,387,1020,488,1312
431247,201906,227,631,116,377,28,103,28,68,56,171
431250,201906,1578,4227,1177,3629,263,814,564,1809,827,2623
431260,201906,219,626,127,436,21,88,42,131,63,219
431261,201906,235,755,189,670,20,82,98,329,118,411
431262,201906,383,1084,170,565,12,39,104,348,116,387
431265,201906,1452,3467,565,1671,72,254,193,486,265,740
431267,201906,263,728,145,442,5,21,98,271,103,292
431270,201906,2607,6109,1385,3971,347,1069,391,1136,738,2205
431275,201906,146,420,77,250,18,58,10,24,28,82
431280,201906,235,647,62,211,8,29,6,14,14,43
431290,201906,305,891,207,664,32,111,53,134,85,245
431295,201906,72,195,25,78,2,5,6,17,8,22
431300,201906,369,937,60,200,5,17,12,38,17,55
431301,201906,293,851,67,233,9,22,5,12,14,34
431303,201906,577,1556,328,1002,30,113,131,365,161,478
431306,201906,2127,5137,1220,3566,201,638,456,1192,657,1830
431308,201906,25,81,22,71,13,44,6,17,19,61
431310,201906,547,1577,363,1141,43,151,167,493,210,644
431320,201906,576,1602,271,913,43,146,47,138,90,284
431330,201906,1659,4001,762,2314,196,648,214,584,410,1232
431333,201906,225,630,110,326,21,58,37,105,58,163
431335,201906,40,112,23,76,7,17,3,4,10,21
431337,201906,2524,6928,1801,5652,423,1509,737,2189,1160,3698
431339,201906,405,1071,297,868,72,210,131,378,203,588
431340,201906,19332,48220,13190,37561,2595,8025,5113,13668,7708,21693
431342,201906,445,1001,324,820,17,48,283,709,300,757
431344,201906,389,1007,223,663,10,33,139,400,149,433
431346,201906,254,634,94,303,14,50,30,97,44,147
431349,201906,658,1743,357,1059,81,249,132,368,213,617
431350,201906,3907,10527,2850,8629,432,1452,1399,4151,1831,5603
431360,201906,563,1365,308,877,77,232,99,277,176,509
431365,201906,1693,4272,1399,3850,138,440,1017,2775,1155,3215
431370,201906,4040,10425,2941,8502,767,2350,1232,3645,1999,5995
431380,201906,753,2132,635,1925,40,144,421,1265,461,1409
431390,201906,2459,6161,1431,4239,203,696,587,1516,790,2212
431395,201906,1200,3175,851,2616,205,654,359,1115,564,1769
431400,201906,340,975,171,553,31,99,37,110,68,209
431402,201906,829,1934,588,1531,74,207,377,939,451,1146
431403,201906,177,503,141,436,22,77,75,193,97,270
431405,201906,4318,11683,3364,10138,611,2087,1643,4656,2254,6743
431406,201906,464,1399,360,1168,91,280,164,543,255,823
431407,201906,461,1281,298,924,60,204,135,411,195,615
431410,201906,15743,41136,10025,30381,1738,6014,4371,12248,6109,18262
431413,201906,220,579,57,182,5,15,6,17,11,32
431415,201906,674,1708,414,1265,70,247,172,472,242,719
431417,201906,552,1262,376,995,55,155,205,533,260,688
431420,201906,1427,3416,1097,2937,180,507,551,1480,731,1987
431430,201906,530,1383,244,798,37,139,69,195,106,334
431440,201906,26415,64584,18866,52214,3735,11134,6842,18111,10577,29245
431442,201906,111,322,54,188,6,20,9,23,15,43
431445,201906,421,1194,136,469,14,39,14,49,28,88
431446,201906,301,843,207,649,48,167,86,255,134,422
431447,201906,616,1688,402,1234,86,284,144,444,230,728
431449,201906,719,1912,426,1265,74,215,178,511,252,726
431450,201906,2060,4463,1666,3895,100,258,1271,2861,1371,3119
431454,201906,40,119,36,110,6,19,13,41,19,60
431455,201906,585,1433,283,780,36,112,142,349,178,461
431460,201906,2834,7236,2050,5780,548,1612,607,1739,1155,3351
431470,201906,1419,4036,1003,3130,180,582,441,1371,621,1953
431475,201906,249,720,32,128,3,14,3,13,6,27
431477,201906,420,1096,257,761,38,112,116,312,154,424
431478,201906,279,730,60,190,16,45,5,15,21,60
431480,201906,2992,7694,2315,6613,494,1459,1201,3414,1695,4873
431490,201906,101021,247895,80248,215358,6792,21316,58272,150756,65064,172072
431500,201906,486,1277,356,1016,65,179,185,513,250,692
431505,201906,321,790,209,610,18,52,133,390,151,442
431507,201906,341,810,138,400,38,123,44,111,82,234
431510,201906,1502,4016,1038,3069,240,778,387,1130,627,1908
431513,201906,228,538,119,340,11,30,78,225,89,255
431514,201906,91,237,52,160,5,13,31,92,36,105
431515,201906,483,1260,335,980,71,216,164,457,235,673
431517,201906,73,207,57,168,10,28,23,69,33,97
431520,201906,430,1067,162,526,32,119,55,151,87,270
431530,201906,3854,8329,2289,6116,608,1655,442,1171,1050,2826
431531,201906,195,517,121,362,13,39,52,151,65,190
431532,201906,547,1301,332,914,76,226,130,347,206,573
431535,201906,248,663,98,313,22,74,15,40,37,114
431540,201906,1761,5692,1635,5499,60,240,1319,4435,1379,4675
431545,201906,354,933,63,197,9,25,15,44,24,69
431550,201906,1910,5085,1522,4328,270,829,761,2066,1031,2895
431555,201906,671,1564,413,1116,28,90,249,658,277,748
431560,201906,20637,52491,13606,40951,2851,9163,4123,13059,6974,22222
431570,201906,4663,11483,3629,10008,499,1564,2318,6124,2817,7688
431575,201906,230,634,170,516,30,81,41,110,71,191
431580,201906,556,1503,327,1013,45,164,162,469,207,633
431590,201906,653,1801,461,1399,98,299,183,566,281,865
431595,201906,335,940,214,672,43,141,87,252,130,393
431600,201906,1308,3180,951,2660,260,780,341,979,601,1759
431610,201906,1318,3483,888,2646,145,416,452,1374,597,1790
431620,201906,540,1447,225,689,36,118,95,267,131,385
431630,201906,1279,3256,561,1733,111,380,190,521,301,901
431640,201906,5807,14937,5106,13956,605,1724,3619,9942,4224,11666
431642,201906,494,1198,323,871,28,66,182,468,210,534
431643,201906,346,872,148,443,14,37,50,146,64,183
431645,201906,1733,4155,1369,3609,94,302,1035,2676,1129,2978
431647,201906,231,602,102,307,11,37,22,57,33,94
431650,201906,158,444,106,343,16,59,41,115,57,174
431660,201906,877,2412,461,1530,77,295,123,376,200,671
431670,201906,1123,2765,724,2034,104,307,383,1031,487,1338
431673,201906,237,618,86,296,15,45,14,47,29,92
431675,201906,572,1425,118,376,8,31,28,69,36,100
431680,201906,7108,18860,5171,15079,1305,3959,2064,5930,3369,9889
431690,201906,20760,52812,14014,40579,3203,9837,5044,14709,8247,24546
431695,201906,146,380,88,272,14,56,39,94,53,150
431697,201906,461,1113,340,912,56,140,182,507,238,647
431700,201906,1387,3672,1155,3232,160,445,668,1845,828,2290
431710,201906,11186,28786,8260,24419,1781,5538,3654,11186,5435,16724
431720,201906,5614,14709,3449,10289,912,2874,513,1377,1425,4251
431725,201906,24,67,17,51,5,14,4,11,9,25
431730,201906,3631,9144,2304,6892,562,1793,684,2150,1246,3943
431740,201906,4931,12212,3226,9181,934,3002,675,1624,1609,4626
431750,201906,6901,18448,5672,16476,1166,3669,2735,7920,3901,11589
431755,201906,315,865,68,246,9,35,12,46,21,81
431760,201906,5417,12515,3488,9395,350,1148,2082,5197,2432,6345
431770,201906,1762,4332,1406,3851,100,319,1027,2740,1127,3059
431775,201906,204,535,94,290,24,67,15,41,39,108
431780,201906,1888,4834,1215,3557,222,706,463,1323,685,2029
431790,201906,843,2308,602,1820,113,334,256,739,369,1073
431795,201906,226,586,103,314,24,77,28,78,52,155
431800,201906,7226,18706,4875,14700,1422,4780,602,1888,2024,6668
431805,201906,297,695,80,263,5,17,31,96,36,113
431810,201906,3233,7883,2032,5615,367,1092,854,2231,1221,3323
431820,201906,2109,5963,1693,5256,476,1555,593,1889,1069,3444
431830,201906,8591,19459,6334,16219,1597,4640,2129,5457,3726,10097
431840,201906,2401,6622,1980,5890,354,1069,1158,3462,1512,4531
431842,201906,667,1646,220,678,30,105,69,191,99,296
431843,201906,308,843,235,692,30,96,117,320,147,416
431844,201906,192,525,65,215,18,67,20,63,38,130
431845,201906,511,1345,353,1022,29,88,209,594,238,682
431846,201906,271,730,234,677,17,50,194,562,211,612
431848,201906,152,386,80,248,8,29,10,21,18,50
431849,201906,400,967,58,167,5,11,4,11,9,22
431850,201906,3911,10898,3046,9128,729,2348,952,2813,1681,5161
431860,201906,672,1712,389,1132,69,209,199,548,268,757
431861,201906,105,275,45,134,10,31,14,33,24,64
431862,201906,430,1364,348,1220,74,287,176,598,250,885
431870,201906,16713,44999,13613,39722,2029,6606,7630,21415,9659,28021
431880,201906,3935,10360,2779,8253,499,1684,1181,3335,1680,5019
431890,201906,4002,10516,2474,7407,762,2463,374,1203,1136,3666
431900,201906,997,2605,618,1853,101,349,306,851,407,1200
431910,201906,776,1903,268,778,53,156,72,166,125,322
431912,201906,448,1300,356,1122,66,224,210,655,276,879
431915,201906,974,2552,785,2222,37,120,573,1581,610,1701
431920,201906,1099,2786,929,2530,40,126,779,2088,819,2214
431930,201906,662,1840,461,1466,120,349,221,730,341,1079
431935,201906,84,245,49,168,15,49,7,26,22,75
431936,201906,290,871,160,535,35,121,54,174,89,295
431937,201906,183,464,113,309,23,77,45,97,68,174
431940,201906,2791,6782,1594,4542,207,675,768,2073,975,2748
431950,201906,1738,4782,1441,4295,444,1344,577,1722,1021,3066
431960,201906,2739,6948,2002,5568,581,1668,530,1477,1111,3145
431970,201906,435,1129,155,483,35,105,36,99,71,204
431971,201906,58,149,32,102,4,16,5,10,9,26
431973,201906,455,1486,369,1314,41,147,263,943,304,1090
431975,201906,101,211,18,60,3,10,5,14,8,24
431980,201906,1056,2832,798,2382,177,573,356,1011,533,1584
431990,201906,5672,14118,3716,11101,597,2009,1586,4529,2183,6538
432000,201906,10220,25597,7462,21145,1876,5455,3151,8996,5027,14451
432010,201906,1900,5008,1422,4087,210,662,801,2194,1011,2856
432020,201906,1737,4326,1171,3320,249,747,535,1417,784,2164
432023,201906,509,1248,260,747,48,153,121,315,169,468
432026,201906,1029,2917,733,2329,181,561,273,863,454,1424
432030,201906,334,875,187,571,28,86,96,292,124,378
432032,201906,387,1019,259,770,30,101,133,359,163,460
432035,201906,663,1902,585,1766,206,636,202,632,408,1268
432040,201906,1119,2592,379,1192,67,246,116,320,183,566
432045,201906,182,502,107,346,25,82,39,128,64,210
432050,201906,475,1263,357,1046,89,255,137,410,226,665
432055,201906,663,1778,410,1272,136,450,98,280,234,730
432057,201906,239,625,170,462,30,72,76,187,106,259
432060,201906,463,1110,138,439,27,100,45,119,72,219
432065,201906,219,622,150,467,30,85,53,159,83,244
432067,201906,726,2151,613,1883,65,214,406,1203,471,1417
432070,201906,1739,4664,1090,3356,238,826,304,831,542,1657
432080,201906,4006,10166,3085,8581,613,1964,1365,3612,1978,5576
432085,201906,376,980,253,785,83,252,88,291,171,543
432090,201906,1287,3411,915,2704,184,586,425,1192,609,1778
432100,201906,979,2623,430,1409,83,290,56,136,139,426
432110,201906,2078,5726,1385,4420,346,1263,100,308,446,1571
432120,201906,2631,7504,2127,6579,538,1819,654,1955,1192,3774
432130,201906,2400,6426,2039,5902,673,2008,810,2396,1483,4404
432132,201906,181,521,107,359,20,69,43,121,63,190
432135,201906,975,2409,626,1764,49,179,436,1190,485,1369
432140,201906,1529,4714,1139,3912,183,671,644,2212,827,2883
432143,201906,1318,3573,1042,3129,82,271,680,2021,762,2292
432145,201906,1335,3639,758,2363,125,419,211,558,336,977
432146,201906,110,319,69,239,20,77,17,50,37,127
432147,201906,482,1444,292,1004,90,331,60,179,150,510
432149,201906,425,1087,212,641,16,43,101,295,117,338
432150,201906,2816,7562,2076,6168,489,1649,674,1913,1163,3562
432160,201906,4800,13326,3619,11322,992,3352,1191,3626,2183,6978
432162,201906,276,621,38,114,6,18,5,14,11,32
432163,201906,135,348,26,74,0,0,3,6,3,6
432166,201906,549,1590,416,1300,70,231,160,457,230,688
432170,201906,1287,3598,812,2668,167,595,251,782,418,1377
432180,201906,2574,6484,1356,4053,260,828,431,1143,691,1971
432183,201906,347,1000,218,694,55,203,66,194,121,397
432185,201906,786,2079,457,1412,31,103,250,740,281,843
432190,201906,1881,4700,1151,3406,254,840,469,1292,723,2132
432195,201906,945,2372,590,1730,161,448,219,664,380,1112
432200,201906,3040,8199,2145,6636,419,1306,1032,3265,1451,4571
432210,201906,343,933,214,682,39,147,98,277,137,424
432215,201906,633,1868,566,1763,47,138,408,1278,455,1416
432218,201906,252,636,113,319,19,58,51,131,70,189
432220,201906,3609,8773,2664,7237,431,1272,1497,3944,1928,5216
432225,201906,93,277,70,225,16,54,32,102,48,156
432230,201906,719,1779,393,1148,56,158,161,442,217,600
432232,201906,486,1224,302,894,69,227,113,318,182,545
432234,201906,287,757,123,373,26,66,15,42,41,108
432235,201906,82,232,28,90,7,21,7,26,14,47
432237,201906,356,913,305,823,17,45,229,593,246,638
432240,201906,13678,36740,10399,31948,843,2976,6520,20751,7363,23727
432250,201906,4265,13281,3562,11899,1074,3642,1301,4426,2375,8068
432252,201906,442,1114,265,766,39,122,123,337,162,459
432253,201906,1005,3132,580,2021,156,591,30,93,186,684
432254,201906,832,2065,163,539,34,114,14,36,48,150
432255,201906,122,307,60,184,6,21,26,66,32,87
432260,201906,4673,12271,3405,9840,937,2815,987,2821,1924,5636
432270,201906,1877,5429,1500,4650,461,1512,264,791,725,2303
432280,201906,1093,2855,607,1861,104,350,233,620,337,970
432285,201906,190,583,24,84,0,0,3,6,3,6
432290,201906,346,1010,179,601,59,199,32,78,91,277
432300,201906,24931,65907,18982,55911,2851,9346,10982,31248,13833,40594
432310,201906,739,2067,530,1674,64,209,336,1069,400,1278
432320,201906,202,479,63,186,9,35,24,59,33,94
432330,201906,216,553,76,247,9,23,18,57,27,80
432335,201906,187,529,57,206,6,23,13,49,19,72
432340,201906,318,770,129,411,19,67,36,101,55,168
432345,201906,591,1417,524,1333,19,50,413,1043,432,1093
432350,201906,332,892,166,549,28,94,57,188,85,282
432360,201906,219,638,39,126,4,15,13,36,17,51
432370,201906,309,786,200,592,15,42,130,376,145,418
432375,201906,494,1263,370,1020,68,164,189,528,257,692
432377,201906,201,642,36,134,5,20,4,7,9,27
432380,201906,1500,4192,955,3113,193,714,432,1347,625,2061
500020,201906,2315,6198,1616,4966,244,842,862,2565,1106,3407
500025,201906,1209,2873,739,2043,72,215,412,1088,484,1303
500060,201906,6452,18384,4725,15350,665,2220,2762,9358,3427,11578
500070,201906,3950,10501,2777,8481,541,1704,1223,3825,1764,5529
500080,201906,1331,3470,887,2669,168,575,381,1040,549,1615
500085,201906,2001,5009,1325,3900,317,999,632,1772,949,2771
500090,201906,1883,5138,1274,4047,243,811,494,1621,737,2432
500100,201906,3421,8902,2580,7492,461,1469,1189,3273,1650,4742
500110,201906,7366,19767,4666,15218,1069,3833,1322,4977,2391,8810
500124,201906,1950,5945,1581,5275,277,874,859,3017,1136,3891
500150,201906,1233,2880,750,2126,182,539,235,627,417,1166
500190,201906,4130,10226,2836,8211,711,2112,885,2563,1596,4675
500200,201906,2141,5189,1549,4179,205,574,887,2287,1092,2861
500210,201906,4400,11539,3272,9934,863,2686,1403,4329,2266,7015
500215,201906,1327,3819,937,3066,89,327,481,1577,570,1904
500220,201906,2534,7226,1719,5746,298,1078,555,1829,853,2907
500230,201906,2112,5110,1582,4314,199,529,1020,2737,1219,3266
500240,201906,3446,10564,2390,8289,383,1458,874,3118,1257,4576
500260,201906,3033,6622,1844,4946,247,664,940,2425,1187,3089
500270,201906,131973,317559,76170,218946,14135,44211,25927,70161,40062,114372
500280,201906,1218,3136,831,2511,104,339,492,1449,596,1788
500290,201906,3553,8334,1950,5760,355,1177,662,1802,1017,2979
500295,201906,3059,7649,1787,5247,307,1004,678,1735,985,2739
500310,201906,884,1935,607,1576,104,225,315,848,419,1073
500315,201906,3295,9704,2665,8688,281,931,1815,6091,2096,7022
500320,201906,17341,49557,12228,40726,3260,11438,4023,14221,7283,25659
500325,201906,4134,9546,2803,7643,270,789,1736,4742,2006,5531
500330,201906,6625,15429,4225,11736,336,1061,2356,6646,2692,7707
500345,201906,1983,4920,1266,3769,326,1003,417,1199,743,2202
500348,201906,2472,6385,1871,5370,252,734,1069,3151,1321,3885
500350,201906,1260,3465,666,2145,79,268,263,829,342,1097
500370,201906,23170,61680,15783,49099,2415,8504,7627,23623,10042,32127
500375,201906,2370,6447,1612,4845,333,1093,539,1541,872,2634
500380,201906,3434,8763,2339,6876,661,2051,703,2090,1364,4141
500390,201906,492,1066,297,809,51,151,159,428,210,579
500400,201906,1218,3253,797,2414,152,515,274,756,426,1271
500410,201906,2302,5920,1652,4911,205,597,937,2862,1142,3459
500430,201906,2497,6437,1706,5218,256,897,675,2165,931,3062
500440,201906,1111,2740,678,2033,104,323,249,797,353,1120
500450,201906,1348,3461,733,2272,152,497,139,412,291,909
500460,201906,3510,9695,2138,6971,410,1506,651,2151,1061,3657
500470,201906,2361,6512,1456,4622,454,1560,274,744,728,2304
500480,201906,2122,6336,1814,5862,173,595,1226,4137,1399,4732
500490,201906,975,2327,552,1677,140,508,150,441,290,949
500500,201906,4157,11438,2680,8981,954,3698,511,1728,1465,5426
500510,201906,700,1790,441,1285,29,98,259,726,288,824
500515,201906,1824,4615,1409,3969,148,424,905,2505,1053,2929
500520,201906,2948,9814,2365,8622,669,2514,950,3578,1619,6092
500525,201906,853,2570,695,2320,69,254,425,1441,494,1695
500540,201906,4234,11261,2551,8246,736,2877,230,638,966,3515
500560,201906,5080,14773,4188,13532,324,1166,3172,10344,3496,11510
500568,201906,4271,9498,2539,6929,618,1840,809,2189,1427,4029
500570,201906,7297,17483,4168,11961,864,2727,1184,3154,2048,5881
500580,201906,3013,8181,2249,6855,478,1554,1082,3255,1560,4809
500600,201906,3032,7719,2121,6330,428,1298,918,2824,1346,4122
500620,201906,7237,19773,4842,15053,1096,3545,1672,5100,2768,8645
500625,201906,477,1314,261,828,48,168,96,272,144,440
500627,201906,716,1862,425,1307,60,186,141,433,201,619
500630,201906,6110,14715,3513,10246,756,2372,1048,3089,1804,5461
500635,201906,2780,9044,2162,8190,164,690,1536,6224,1700,6914
500640,201906,1631,3710,1089,2946,38,131,741,1924,779,2055
500660,201906,15977,44468,11204,36848,3884,14117,2613,8712,6497,22829
500690,201906,2102,5904,1452,4872,588,2244,91,213,679,2457
500710,201906,2846,7990,2170,6732,643,2098,643,1878,1286,3976
500720,201906,4893,12673,3065,9571,725,2443,807,2556,1532,4999
500730,201906,900,2360,556,1726,76,213,208,661,284,874
500740,201906,4524,10952,3118,8627,361,1053,1736,4821,2097,5874
500750,201906,952,2492,637,1921,99,313,232,621,331,934
500755,201906,869,2386,486,1632,98,346,72,211,170,557
500769,201906,4835,12224,2487,7553,480,1630,362,841,842,2471
500770,201906,1454,4028,913,3011,173,641,279,916,452,1557
500780,201906,1242,3103,792,2321,176,556,209,576,385,1132
500790,201906,7394,19685,5813,17089,1105,3523,3076,9060,4181,12583
500793,201906,1822,4740,1233,3712,403,1273,268,709,671,1982
500795,201906,2430,6420,2009,5863,99,284,1700,5086,1799,5370
500797,201906,694,1834,460,1389,118,365,161,472,279,837
500800,201906,2769,6637,1774,5151,598,1989,249,792,847,2781
500830,201906,17387,44555,11765,34111,2218,6944,4786,13104,7004,20048
500840,201906,1377,3466,783,2292,98,303,316,876,414,1179
510010,201906,1843,4312,1207,3434,134,391,788,2244,922,2635
510020,201906,3569,9275,1835,5663,425,1372,356,971,781,2343
510025,201906,6706,17199,4091,12585,682,2333,1488,4374,2170,6707
510030,201906,2208,5060,1442,3952,338,919,521,1457,859,2376
510035,201906,1184,3093,717,2333,91,325,417,1422,508,1747
510040,201906,2143,4976,1552,4169,157,411,968,2650,1125,3061
510050,201906,1956,4476,1289,3523,187,585,806,2098,993,2683
510060,201906,1349,3472,989,2898,183,589,328,914,511,1503
510080,201906,1186,3213,778,2486,236,795,229,644,465,1439
510100,201906,658,1593,436,1217,51,147,226,600,277,747
510120,201906,256,485,142,347,5,16,107,268,112,284
510125,201906,2101,5313,1635,4606,201,752,787,2039,988,2791
510130,201906,1429,3654,997,2949,217,720,303,900,520,1620
510140,201906,2860,7738,1988,6598,760,2930,639,1923,1399,4853
510160,201906,1683,4424,1217,3802,199,611,828,2612,1027,3223
510170,201906,4492,12243,3294,10261,797,2539,1308,4184,2105,6723
510180,201906,13275,31569,8001,23192,1910,6014,2300,7529,4210,13543
510185,201906,1643,4436,1076,3611,430,1436,304,1263,734,2699
510190,201906,1978,5734,1307,4528,387,1478,255,923,642,2401
510250,201906,14081,37693,11392,33886,2238,6894,6284,19355,8522,26249
510260,201906,2028,8375,1640,7655,271,1353,961,4924,1232,6277
510263,201906,2876,8272,1743,5881,315,1153,204,607,519,1760
510267,201906,4644,13543,2760,9310,609,2159,325,1046,934,3205
510268,201906,1277,3245,909,2621,109,312,541,1523,650,1835
510269,201906,1032,2870,637,2104,173,613,194,598,367,1211
510270,201906,2838,8406,1987,6837,376,1403,764,2591,1140,3994
510279,201906,1754,4711,1147,3629,222,778,493,1485,715,2263
510285,201906,1079,2967,750,2395,222,786,171,506,393,1292
510300,201906,3567,9213,2636,7922,415,1215,1513,4816,1928,6031
510305,201906,1468,4137,884,2970,188,659,227,831,415,1490
510310,201906,924,2366,642,1886,190,586,176,532,366,1118
510320,201906,3619,9428,2547,7536,570,1801,668,2021,1238,3822
510325,201906,4349,13139,3368,11423,953,3350,1236,4330,2189,7680
510330,201906,2799,8625,1891,6965,383,1439,680,2840,1063,4279
510335,201906,4499,13118,3358,11386,490,1772,1862,6547,2352,8319
510336,201906,466,1383,340,1175,67,215,154,581,221,796
510337,201906,1610,4869,1072,3859,428,1660,183,677,611,2337
510340,201906,86315,196774,51676,144359,13727,44842,13551,34916,27278,79758
510343,201906,1023,2852,699,2207,131,472,275,818,406,1290
510345,201906,1230,3595,904,2947,173,582,378,1189,551,1771
510350,201906,2752,7390,1770,5695,410,1377,674,2125,1084,3502
510360,201906,1840,3946,1165,3129,68,175,831,2341,899,2516
510370,201906,1673,5022,1194,4118,183,683,662,2317,845,3000
510380,201906,538,1378,285,902,67,250,87,256,154,506
510385,201906,1103,3839,806,3245,90,392,501,2103,591,2495
510390,201906,1101,3202,784,2749,204,706,350,1345,554,2051
510395,201906,717,1634,471,1265,31,95,269,774,300,869
510410,201906,4451,12877,3294,10704,665,2238,1750,5853,2415,8091
510420,201906,2160,4784,1477,3837,123,371,926,2373,1049,2744
510450,201906,498,1238,285,827,69,197,45,155,114,352
510452,201906,677,1925,450,1487,78,261,212,697,290,958
510454,201906,884,2510,663,2111,71,199,406,1383,477,1582
510455,201906,896,2580,631,2000,102,388,235,682,337,1070
510460,201906,1800,4554,1270,3749,111,394,798,2246,909,2640
510480,201906,4596,11528,2988,8370,611,1874,1107,2954,1718,4828
510490,201906,1635,4471,1213,3893,214,712,689,2231,903,2943
510500,201906,1558,4012,930,2926,182,612,316,989,498,1601
510510,201906,3236,9826,2429,8272,693,2600,675,2437,1368,5037
510515,201906,5242,14031,3364,10436,788,2708,853,2366,1641,5074
510517,201906,1068,3149,807,2679,245,915,138,381,383,1296
510520,201906,2035,4195,1178,3142,73,206,645,1841,718,2047
510523,201906,1001,2651,729,2175,144,418,397,1197,541,1615
510525,201906,6014,17077,4443,13898,741,2606,1960,5724,2701,8330
510530,201906,542,1402,396,1191,33,110,247,714,280,824
510550,201906,2504,7523,1810,6270,450,1606,723,2558,1173,4164
510558,201906,2058,5617,1484,4692,161,509,744,2506,905,3015
510560,201906,1589,4651,917,3292,212,832,229,861,441,1693
510562,201906,5100,13869,3620,11050,953,3147,1109,3430,2062,6577
510590,201906,3053,7774,2201,6671,219,698,1504,4606,1723,5304
510600,201906,1488,3477,936,2601,185,515,372,1029,557,1544
510610,201906,2746,6737,1847,5472,182,614,1114,3294,1296,3908
510615,201906,2178,5955,1543,4804,280,882,851,2706,1131,3588
510617,201906,946,2788,686,2347,116,446,386,1376,502,1822
510618,201906,1220,3336,833,2632,167,578,408,1255,575,1833
510619,201906,721,1866,428,1325,75,246,88,262,163,508
510620,201906,1400,3221,636,2010,161,589,39,90,200,679
510621,201906,1445,3970,875,2867,206,741,250,771,456,1512
510622,201906,4161,12028,2860,9093,1034,3515,414,1187,1448,4702
510623,201906,2621,6752,1803,5412,425,1520,464,1320,889,2840
510624,201906,1612,4220,693,2383,83,301,148,446,231,747
510625,201906,2651,6553,1428,4340,288,1004,303,898,591,1902
510626,201906,1480,3608,895,2678,262,906,206,610,468,1516
510627,201906,589,1556,339,1053,89,289,74,245,163,534
510628,201906,1526,3554,990,2822,189,562,441,1267,630,1829
510629,201906,1559,4610,1158,3828,270,963,391,1284,661,2247
510630,201906,3199,9174,1845,6478,426,1611,310,1168,736,2779
510631,201906,553,1351,397,1123,15,42,305,872,320,914
510637,201906,3286,8194,2351,6738,649,2053,622,1747,1271,3800
510642,201906,5108,15308,4032,13639,1088,3884,1592,5613,2680,9497
510645,201906,835,1813,489,1341,112,317,203,518,315,835
510650,201906,6811,18184,5475,16714,659,1871,3852,12677,4511,14548
510665,201906,1779,4077,1032,2854,152,446,430,1237,582,1683
510670,201906,412,877,231,604,26,77,128,335,154,412
510675,201906,5673,16215,3960,12923,1197,4212,678,2216,1875,6428
510677,201906,2089,5470,1431,4468,204,680,722,2236,926,2916
510680,201906,667,1802,388,1255,90,313,63,195,153,508
510682,201906,1585,4841,1161,4082,383,1478,241,834,624,2312
510685,201906,610,1805,446,1468,68,236,202,648,270,884
510700,201906,3734,9484,2640,7845,346,1146,1751,5170,2097,6316
510704,201906,9972,24255,6470,18082,1295,3923,1838,4914,3133,8837
510706,201906,1845,5628,1301,4744,233,885,692,2725,925,3610
510710,201906,2510,6617,1678,4992,364,1129,589,1672,953,2801
510715,201906,605,1396,451,1181,46,130,210,563,256,693
510718,201906,2405,5346,1342,4012,518,1565,312,1191,830,2756
510719,201906,413,886,247,668,31,87,141,361,172,448
510720,201906,936,2303,612,1794,125,397,239,661,364,1058
510724,201906,727,2009,484,1558,80,286,223,688,303,974
510726,201906,1152,2101,577,1374,68,171,287,676,355,847
510729,201906,610,1464,271,829,37,127,67,213,104,340
510730,201906,2902,7207,1940,5662,337,1089,829,2372,1166,3461
510735,201906,1012,2999,756,2618,81,329,537,1848,618,2177
510740,201906,913,2318,573,1664,84,243,290,851,374,1094
510757,201906,549,1789,445,1615,158,625,147,503,305,1128
510760,201906,40812,91075,23411,64137,5253,16533,6976,17405,12229,33938
510770,201906,4060,9492,2890,8034,284,740,1919,5585,2203,6325
510774,201906,345,946,232,727,36,115,115,370,151,485
510775,201906,597,1645,413,1345,96,356,89,267,185,623
510776,201906,453,1174,314,888,88,261,94,282,182,543
510777,201906,1567,4257,1122,3648,148,589,712,2261,860,2850
510779,201906,583,1622,448,1400,50,150,265,870,315,1020
510780,201906,3608,9663,2649,8220,636,1991,1115,3850,1751,5841
510785,201906,2057,5518,1150,3792,297,1045,175,652,472,1697
510787,201906,2517,7325,1640,5422,632,2222,114,348,746,2570
510788,201906,658,1579,448,1252,70,187,179,583,249,770
510790,201906,16131,42901,9518,29998,2104,7420,1420,3845,3524,11265
510792,201906,8411,22951,5233,16858,1100,3956,1047,3139,2147,7095
510794,201906,1204,3305,778,2547,248,898,162,455,410,1353
510795,201906,7651,20886,5082,16180,1232,4258,1290,4163,2522,8421
510800,201906,1753,4609,1109,3447,376,1179,153,422,529,1601
510805,201906,1564,4353,1025,3311,228,810,308,877,536,1687
510810,201906,634,1355,409,1036,117,320,175,442,292,762
510820,201906,774,1508,419,1055,35,109,199,507,234,616
510830,201906,830,2075,584,1733,66,193,388,1200,454,1393
510835,201906,558,1399,368,1118,50,171,196,579,246,750
510840,201906,47810,106825,33620,88942,6233,15755,17565,50386,23798,66141
510850,201906,1864,4548,1027,3177,321,1113,114,281,435,1394
510860,201906,2441,6629,1548,5099,484,1861,152,497,636,2358
510880,201906,648,1912,490,1601,123,417,196,654,319,1071
510885,201906,562,1419,384,1145,65,225,130,372,195,597
510890,201906,635,1898,481,1633,112,401,212,725,324,1126
510895,201906,1210,3176,803,2485,196,705,315,878,511,1583
520005,201906,2211,5924,1749,5353,478,1426,782,2701,1260,4127
520010,201906,2155,6403,1551,5154,406,1476,400,1157,806,2633
520013,201906,2639,7035,1822,5478,426,1317,485,1579,911,2896
520015,201906,533,1355,396,1164,94,300,134,414,228,714
520017,201906,1084,2889,820,2478,111,355,506,1497,617,1852
520020,201906,375,878,287,758,35,122,191,469,226,591
520025,201906,32203,91524,27974,85548,2834,9333,20107,61244,22941,70577
520030,201906,5205,13919,4204,12464,407,1327,2789,8222,3196,9549
520050,201906,401,948,257,692,16,38,152,428,168,466
520055,201906,1400,3636,973,2793,59,174,551,1529,610,1703
520060,201906,1400,4036,1044,3359,281,972,255,827,536,1799
520080,201906,1840,4790,1374,4144,244,750,633,2092,877,2842
520082,201906,895,2311,720,2008,78,201,409,1184,487,1385
520085,201906,777,2176,600,1873,114,373,256,759,370,1132
520090,201906,851,1695,579,1392,72,134,428,1087,500,1221
520110,201906,37727,104436,26494,85659,8728,31668,1970,5815,10698,37483
520120,201906,201,496,114,348,14,50,38,116,52,166
520130,201906,3632,9194,2879,7967,562,1613,1255,3494,1817,5107
520140,201906,38560,107367,27683,88377,10295,35383,3311,11025,13606,46408
520145,201906,536,1278,360,1012,73,226,174,444,247,670
520150,201906,564,1326,409,1118,65,173,219,620,284,793
520160,201906,809,1880,573,1512,101,252,276,751,377,1003
520170,201906,4983,10292,3418,8470,202,565,2625,6369,2827,6934
520180,201906,2016,5676,1658,5114,363,1222,801,2436,1164,3658
520215,201906,1879,4522,1337,3669,312,923,513,1363,825,2286
520235,201906,591,1414,360,1055,38,123,143,404,181,527
520250,201906,1504,3953,1091,3277,350,1173,197,594,547,1767
520260,201906,819,1928,493,1368,99,283,196,540,295,823
520280,201906,674,1750,517,1483,123,362,224,683,347,1045
520310,201906,1161,2617,745,1990,174,500,281,793,455,1293
520320,201906,1679,4640,1291,3987,147,505,677,2054,824,2559
520330,201906,3632,10217,2659,8552,452,1733,1271,3949,1723,5682
520340,201906,2273,5169,1445,3999,178,463,851,2445,1029,2908
520350,201906,2869,7074,2070,5797,623,1855,750,2067,1373,3922
520355,201906,1767,4955,1295,4019,347,1152,406,1183,753,2335
520357,201906,750,1910,580,1636,42,119,414,1187,456,1306
520360,201906,693,1842,518,1539,160,499,141,457,301,956
520380,201906,1274,3258,760,2288,76,259,381,1065,457,1324
520390,201906,984,2194,569,1668,174,553,161,502,335,1055
520393,201906,535,1293,358,1012,49,164,170,431,219,595
520396,201906,780,2131,656,1912,63,213,429,1204,492,1417
520400,201906,1593,4056,1242,3570,202,625,786,2261,988,2886
520410,201906,1833,4081,1074,2941,167,477,487,1292,654,1769
520420,201906,383,908,290,737,30,86,204,483,234,569
520425,201906,1441,3544,906,2607,233,687,280,792,513,1479
520430,201906,2206,5140,1204,3581,232,805,44,116,276,921
520440,201906,2972,7257,1836,5261,451,1388,480,1327,931,2715
520450,201906,11610,28603,7652,22300,2458,7757,1034,3115,3492,10872
520455,201906,648,1820,471,1541,126,433,136,452,262,885
520460,201906,896,2259,760,2074,100,232,571,1606,671,1838
520465,201906,791,2068,628,1825,100,316,406,1137,506,1453
520470,201906,1923,5349,1579,4900,389,1193,777,2587,1166,3780
520480,201906,887,2524,599,2019,192,662,121,439,313,1101
520485,201906,1527,4332,1286,3989,198,617,838,2587,1036,3204
520490,201906,3912,11010,2946,9486,870,2813,1226,4110,2096,6923
520495,201906,1504,3381,1147,2898,62,178,899,2256,961,2434
520500,201906,1347,3586,924,2780,209,686,339,1016,548,1702
520505,201906,713,1696,504,1415,74,210,286,790,360,1000
520510,201906,7390,19059,4916,15137,1164,4008,1311,4314,2475,8322
520520,201906,1126,2933,840,2470,196,602,271,815,467,1417
520530,201906,1992,5969,1481,5061,492,1737,421,1611,913,3348
520540,201906,2833,7685,1734,5400,347,1137,383,1132,730,2269
520545,201906,899,2447,692,2108,143,423,260,803,403,1226
520547,201906,760,2123,602,1833,160,506,262,789,422,1295
520549,201906,12148,33986,10033,30627,1632,5283,6247,18926,7879,24209
520551,201906,4330,12089,3658,11096,414,1526,2534,7444,2948,8970
520552,201906,822,2158,682,1982,129,368,419,1289,548,1657
520570,201906,559,1311,374,1044,100,262,131,393,231,655
520580,201906,2243,5258,1704,4609,133,414,1194,3192,1327,3606
520590,201906,1197,3206,838,2561,233,720,160,498,393,1218
520620,201906,8044,22220,6376,19740,1661,5252,2806,8940,4467,14192
520630,201906,754,1970,471,1461,83,268,110,345,193,613
520640,201906,2427,6052,1856,5063,476,1283,733,2090,1209,3373
520650,201906,878,2128,620,1730,109,306,293,862,402,1168
520660,201906,521,1261,248,762,48,167,58,179,106,346
520670,201906,923,2596,782,2394,69,228,522,1539,591,1767
520680,201906,706,1768,515,1467,97,268,250,724,347,992
520690,201906,351,824,241,671,79,217,73,221,152,438
520710,201906,470,1119,301,830,8,21,200,534,208,555
520725,201906,1556,3759,1089,2989,128,381,679,1798,807,2179
520735,201906,705,1788,483,1416,107,292,179,567,286,859
520740,201906,1977,4634,1515,4045,263,669,850,2377,1113,3046
520750,201906,652,1630,462,1322,84,238,214,626,298,864
520753,201906,1343,3594,1039,3013,193,588,439,1211,632,1799
520760,201906,1116,2480,1004,2334,60,115,856,2054,916,2169
520780,201906,1494,3610,1090,3033,119,347,545,1469,664,1816
520790,201906,3347,7974,2319,6366,256,728,1333,3870,1589,4598
520800,201906,14935,39663,11859,35198,2147,6537,6803,20813,8950,27350
520810,201906,1299,2756,925,2326,168,456,539,1408,707,1864
520815,201906,597,1794,432,1457,87,301,107,380,194,681
520830,201906,1848,4031,1290,3385,53,141,1019,2621,1072,2762
520840,201906,2338,6446,1901,5879,812,2648,527,1757,1339,4405
520850,201906,672,1807,475,1498,170,611,102,323,272,934
520860,201906,6001,16679,4548,14302,1128,3827,1719,5377,2847,9204
520870,201906,93445,223513,63726,179025,16130,49139,20607,56360,36737,105499
520880,201906,6248,18146,4879,15741,1275,4287,1640,5319,2915,9606
520890,201906,3742,9364,2562,7498,541,1702,1084,3169,1625,4871
520910,201906,4452,11447,2824,8543,715,2345,555,1693,1270,4038
520915,201906,619,1717,388,1221,64,221,117,352,181,573
520920,201906,4481,10411,3035,8433,399,1175,1616,4550,2015,5725
520929,201906,718,1736,501,1371,80,198,241,704,321,902
520940,201906,985,2665,775,2361,46,169,573,1691,619,1860
520945,201906,482,1103,388,958,30,73,270,647,300,720
520960,201906,1025,2654,800,2267,115,336,500,1370,615,1706
520970,201906,2426,6927,1959,6146,532,1827,480,1593,1012,3420
520980,201906,786,1967,580,1667,122,377,224,605,346,982
520990,201906,2969,8251,2405,7477,314,1002,1555,4875,1869,5877
520993,201906,1061,2541,706,1959,74,242,429,1136,503,1378
520995,201906,2232,5767,1688,5022,286,861,678,2057,964,2918
521000,201906,8221,21999,5631,17383,1281,4117,1605,4927,2886,9044
521010,201906,3713,9719,2779,8099,304,890,1583,4567,1887,5457
521015,201906,709,1800,523,1480,55,173,326,879,381,1052
521020,201906,2930,7681,1759,5392,529,1702,160,520,689,2222
521030,201906,470,1032,323,828,43,89,152,431,195,520
521040,201906,7546,18501,5583,15417,1186,3415,2366,6659,3552,10074
521056,201906,886,2404,690,2111,214,660,202,675,416,1335
521060,201906,975,2577,727,2149,59,180,367,1087,426,1267
521080,201906,1101,2466,566,1593,68,204,227,558,295,762
521090,201906,3335,8906,2261,6878,633,2023,294,950,927,2973
521100,201906,1740,4129,1247,3425,209,567,705,1964,914,2531
521120,201906,4709,11088,3294,9301,259,673,1625,5247,1884,5920
521130,201906,910,2120,564,1536,27,96,305,858,332,954
521140,201906,1234,3246,891,2642,151,474,392,1146,543,1620
521150,201906,12087,27112,7624,20791,1442,4493,3417,9422,4859,13915
521160,201906,631,1382,443,1088,52,129,268,629,320,758
521170,201906,1051,2510,752,2035,72,200,501,1325,573,1525
521180,201906,6725,19418,5589,17370,1048,3527,2628,7888,3676,11415
521190,201906,10343,26708,5915,18828,1481,4982,1158,3886,2639,8868
521200,201906,722,1808,489,1406,47,138,272,772,319,910
521205,201906,607,1541,457,1295,16,40,330,904,346,944
521210,201906,704,1806,405,1210,101,327,64,146,165,473
521220,201906,3830,9591,2477,7346,546,1790,658,1815,1204,3605
521225,201906,330,737,252,648,34,88,162,408,196,496
521230,201906,1269,3506,1162,3361,416,1191,564,1748,980,2939
521250,201906,29950,82926,23647,73723,8975,29196,7075,23500,16050,52696
521260,201906,576,1351,416,1090,63,166,232,598,295,764
521270,201906,1816,4636,1565,4327,92,224,1193,3325,1285,3549
521280,201906,1862,5083,1391,4266,360,1188,521,1609,881,2797
521290,201906,466,1148,323,954,50,168,179,516,229,684
521295,201906,1070,2356,832,2093,79,185,628,1662,707,1847
521300,201906,1889,4755,1496,4218,300,799,893,2584,1193,3383
521305,201906,708,1762,480,1396,64,173,270,788,334,961
521308,201906,4683,12786,3350,10192,396,1212,1835,5482,2231,6694
521310,201906,8157,21267,5483,16614,1285,4176,1951,5688,3236,9864
521340,201906,416,966,292,781,20,58,211,551,231,609
521350,201906,2036,5255,1549,4505,161,542,1036,2898,1197,3440
521370,201906,1190,3126,727,2313,198,720,102,338,300,1058
521375,201906,1351,3424,944,2832,221,657,308,986,529,1643
521377,201906,1459,3159,1066,2667,80,154,864,2247,944,2401
521380,201906,5946,16143,3919,12276,431,1521,955,3158,1386,4679
521385,201906,635,1551,491,1369,73,197,273,820,346,1017
521390,201906,686,1724,486,1414,152,473,170,518,322,991
521400,201906,2521,5834,1952,5140,214,552,1387,3784,1601,4336
521405,201906,1272,3306,944,2757,195,568,418,1223,613,1791
521410,201906,759,2070,603,1811,117,340,300,967,417,1307
521440,201906,1294,3377,940,2812,286,923,255,754,541,1677
521450,201906,3860,11728,2854,9678,715,2442,770,2764,1485,5206
521460,201906,5690,15423,4129,12605,1488,4728,846,2604,2334,7332
521470,201906,654,1808,396,1252,60,188,118,355,178,543
521480,201906,344,874,198,585,36,111,50,128,86,239
521483,201906,2447,5976,1687,4761,411,1233,587,1599,998,2832
521486,201906,1683,4023,1271,3447,80,230,947,2536,1027,2766
521487,201906,437,1088,310,898,61,177,137,411,198,588
521490,201906,855,2343,629,1965,39,155,454,1372,493,1527
521500,201906,2048,5227,1496,4297,87,314,1055,2948,1142,3262
521520,201906,747,1729,512,1379,89,249,211,574,300,823
521523,201906,11274,36211,9570,33340,3080,11457,2637,9414,5717,20871
521525,201906,1054,2460,775,2059,76,211,546,1439,622,1650
521530,201906,2293,5994,1314,3954,290,938,316,981,606,1919
521540,201906,851,2178,548,1651,80,286,238,742,318,1028
521550,201906,1259,3256,752,2241,145,480,218,685,363,1165
521560,201906,4253,11601,2956,9826,536,2097,1463,5037,1999,7134
521565,201906,620,1548,489,1357,81,210,298,819,379,1029
521570,201906,3648,9826,2417,7475,484,1699,286,946,770,2645
521580,201906,520,1291,294,879,38,127,77,191,115,318
521590,201906,618,1523,465,1290,102,305,237,634,339,939
521600,201906,388,1074,237,749,41,107,73,234,114,341
521630,201906,1635,3688,983,2666,207,589,320,842,527,1431
521640,201906,1848,4411,1300,3614,283,860,440,1168,723,2028
521645,201906,551,1456,355,1097,83,242,111,345,194,587
521680,201906,1134,3502,882,2986,251,919,112,410,363,1329
521690,201906,507,1342,442,1232,63,189,264,713,327,902
521710,201906,2959,7698,1949,5954,369,1277,435,1264,804,2541
521720,201906,2161,5185,1453,4091,176,551,811,2226,987,2777
521730,201906,3592,10492,2783,9023,849,3092,584,1605,1433,4697
521740,201906,3885,10364,2942,8954,843,2747,999,3170,1842,5917
521760,201906,14247,40723,11284,36034,3303,11579,3799,12536,7102,24115
521770,201906,2887,7174,1987,5688,618,1906,460,1317,1078,3223
521800,201906,5989,16707,4568,14311,1190,3843,1571,5376,2761,9219
521805,201906,521,1257,381,1050,129,332,151,434,280,766
521810,201906,693,1641,471,1319,74,207,240,684,314,891
521830,201906,5210,14742,4228,13260,369,1360,2919,8994,3288,10354
521839,201906,675,1722,484,1382,93,284,225,580,318,864
521850,201906,5095,12794,3275,9754,501,1639,272,730,773,2369
521860,201906,1691,4511,1159,3556,200,649,364,1102,564,1751
521870,201906,682,1926,469,1510,108,360,122,359,230,719
521878,201906,644,1699,468,1379,68,222,223,594,291,816
521880,201906,18091,44340,12139,35267,3141,9613,3936,11748,7077,21361
521890,201906,3080,8287,2038,6318,548,1802,314,902,862,2704
521900,201906,1590,3814,956,2859,286,820,172,548,458,1368
521910,201906,1163,2615,782,2147,80,212,448,1288,528,1500
521920,201906,449,1269,324,1027,63,214,127,405,190,619
521925,201906,755,2061,559,1738,101,316,255,768,356,1084
521930,201906,4806,12184,3346,9965,919,2611,1202,3966,2121,6577
521935,201906,886,2187,623,1722,64,187,367,954,431,1141
521940,201906,1285,2950,836,2328,187,566,330,896,517,1462
521945,201906,527,1493,419,1294,89,279,205,651,294,930
521950,201906,720,1757,514,1447,127,385,239,623,366,1008
521960,201906,731,1990,482,1480,70,237,227,643,297,880
521970,201906,2495,6348,2072,5835,152,424,1615,4606,1767,5030
521971,201906,749,1806,527,1479,147,412,127,349,274,761
521973,201906,1174,3166,918,2751,52,199,636,1855,688,2054
521975,201906,11718,31644,9818,28991,1568,4830,6131,18074,7699,22904
521980,201906,2526,6045,1932,5249,171,422,1412,3892,1583,4314
521990,201906,1127,3132,896,2740,152,471,406,1259,558,1730
522000,201906,2786,7597,2160,6814,252,779,1417,4652,1669,5431
522005,201906,328,804,245,688,50,130,119,341,169,471
522010,201906,3855,9636,2724,7806,716,2181,796,2234,1512,4415
522015,201906,941,2535,673,2095,154,492,261,831,415,1323
522020,201906,5191,12545,3415,9720,717,2154,1380,4035,2097,6189
522026,201906,648,1847,478,1523,84,284,166,514,250,798
522028,201906,470,1258,340,1002,59,173,138,382,197,555
522040,201906,2962,6797,2091,5632,258,763,1375,3620,1633,4383
522045,201906,16787,48117,12459,40060,3025,10405,3110,9644,6135,20049
522050,201906,995,2628,680,2104,155,511,266,795,421,1306
522060,201906,2504,6941,1960,6075,217,678,1132,3631,1349,4309
522068,201906,1767,4705,1389,4230,157,428,998,3126,1155,3554
522070,201906,617,1577,505,1405,28,92,397,1065,425,1157
522100,201906,633,1698,446,1383,53,169,240,742,293,911
522108,201906,911,2456,712,2145,50,220,562,1620,612,1840
522119,201906,1520,3939,1166,3455,187,585,601,1830,788,2415
522130,201906,359,904,254,764,51,162,138,438,189,600
522140,201906,16260,44279,11767,36263,3264,10744,2729,8079,5993,18823
522145,201906,821,2028,574,1659,148,410,239,723,387,1133
522150,201906,1035,2580,734,2079,200,564,212,625,412,1189
522155,201906,924,2403,718,2067,122,337,403,1166,525,1503
522157,201906,531,1357,453,1250,29,102,350,958,379,1060
522160,201906,5798,15395,3821,11710,1061,3521,281,922,1342,4443
522170,201906,2630,6851,1932,5785,365,1132,974,2940,1339,4072
522180,201906,452,1115,285,826,64,186,25,92,89,278
522185,201906,16248,41475,12029,35805,5160,16466,2712,8781,7872,25247
522190,201906,753,1823,521,1423,104,290,195,533,299,823
522200,201906,1606,4756,1017,3464,192,697,70,214,262,911
522205,201906,1588,3761,1209,3238,115,337,846,2240,961,2577
522220,201906,1289,3356,968,2857,145,423,496,1484,641,1907
522230,201906,1123,2974,922,2678,228,787,466,1264,694,2051
530010,201906,158280,446491,131172,403601,23571,79627,71091,214613,94662,294240
110001,201907,3720,10760,2556,8539,660,2335,970,3257,1630,5592
110002,201907,11502,30786,8061,24810,2338,7645,2341,7260,4679,14905
110003,201907,641,1919,454,1518,120,432,97,307,217,739
110004,201907,9957,27289,6706,21191,1623,5514,1785,5824,3408,11338
110005,201907,2500,6612,1564,4896,360,1224,440,1473,800,2697
110006,201907,1792,5080,1085,3571,231,853,180,527,411,1380
110007,201907,1125,3096,801,2548,289,950,204,763,493,1713
110008,201907,3183,9140,2340,7819,273,893,1568,5511,1841,6404
110009,201907,4142,11946,2674,9177,686,2437,957,3366,1643,5803
110010,201907,6496,22144,5005,19250,1153,4365,2328,9910,3481,14275
110011,201907,6463,17785,4559,14277,1649,5332,711,2358,2360,7690
110012,201907,14194,36708,8636,26694,2219,7209,953,3150,3172,10359
110013,201907,5236,15603,3929,12939,1682,5718,557,2045,2239,7763
110014,201907,3693,10087,2512,7815,684,2188,929,2851,1613,5039
110015,201907,5026,13537,2851,9117,748,2574,455,1354,1203,3928
110018,201907,3506,9120,2071,6551,424,1518,579,1774,1003,3292
110020,201907,74342,183528,51416,150941,11416,34562,20806,65794,32222,100356
110025,201907,4908,12211,3179,9163,683,2097,1397,3989,2080,6086
110026,201907,489,1333,360,1136,102,339,144,468,246,807
110028,201907,6263,16604,3945,12322,1074,3578,593,1826,1667,5404
110029,201907,1396,3451,799,2421,192,586,311,981,503,1567
110030,201907,12729,30083,8050,23265,1716,5735,2030,6177,3746,11912
110032,201907,2929,8650,1936,6505,626,2111,445,1545,1071,3656
110033,201907,3680,11924,2920,10457,1077,3935,692,2762,1769,6697
110034,201907,3351,8142,2213,6541,685,2173,849,2633,1534,4806
110037,201907,1614,5029,1265,4362,318,1100,555,1958,873,3058
110040,201907,2985,8569,2143,6978,648,2249,579,1832,1227,4081
110045,201907,4963,14636,3820,12556,1043,3708,1421,4696,2464,8404
110050,201907,1752,4991,1251,4046,517,1770,226,753,743,2523
110060,201907,780,2368,537,1825,215,764,69,237,284,1001
110070,201907,1685,5415,1287,4507,431,1612,261,844,692,2456
110080,201907,6061,14453,4388,12459,544,1440,2998,9027,3542,10467
110090,201907,589,1604,412,1285,102,347,171,521,273,868
110092,201907,1181,3560,866,2946,156,548,441,1582,597,2130
110094,201907,2772,8364,2112,7157,873,3084,439,1563,1312,4647
110100,201907,1700,5171,1382,4506,358,1223,634,2054,992,3277
110110,201907,1725,4938,1199,3981,407,1402,263,938,670,2340
110120,201907,1271,3847,953,3207,253,881,290,968,543,1849
110130,201907,2572,6709,1633,4984,360,1206,561,1706,921,2912
110140,201907,2041,6267,1431,4987,386,1372,361,1302,747,2674
110143,201907,1326,3648,899,2792,301,923,183,586,484,1509
110145,201907,854,2327,552,1758,140,459,183,608,323,1067
110146,201907,432,1175,303,971,58,181,146,498,204,679
110147,201907,774,2051,480,1436,71,224,189,489,260,713
110148,201907,815,2382,491,1694,126,479,55,189,181,668
110149,201907,2995,8468,2102,7022,797,2725,440,1610,1237,4335
110150,201907,2592,6594,1732,5372,570,1902,452,1583,1022,3485
110155,201907,660,2013,499,1639,122,417,165,519,287,936
110160,201907,1478,4677,1085,3789,351,1217,257,947,608,2164
110170,201907,2190,5772,1340,4084,271,864,660,1943,931,2807
110175,201907,1581,4581,1126,3780,201,707,498,1757,699,2464
110180,201907,1327,3756,895,2862,164,537,429,1356,593,1893
120001,201907,3095,9424,2599,8709,439,1474,1676,5777,2115,7251
120005,201907,1954,7493,1758,7188,163,750,1371,5691,1534,6441
120010,201907,5209,16082,4439,14845,509,1672,3137,10772,3646,12444
120013,201907,2180,8019,2011,7781,499,1853,1199,4939,1698,6792
120017,201907,2311,7567,2063,7187,338,1221,1317,4730,1655,5951
120020,201907,14656,59226,13632,57147,1217,5752,10496,44397,11713,50149
120025,201907,2987,8878,2456,8205,429,1460,1633,5592,2062,7052
120030,201907,6564,25856,6189,25158,411,2214,4882,19890,5293,22104
120032,201907,1652,7575,1583,7414,97,624,1308,6048,1405,6672
120033,201907,4091,15178,3824,14698,131,716,3290,12560,3421,13276
120034,201907,2607,9587,2225,8880,117,712,1807,7046,1924,7758
120035,201907,3512,14571,3328,14217,289,1390,2683,11570,2972,12960
120038,201907,2715,8907,2346,8291,554,2064,1232,4409,1786,6473
120039,201907,1977,8692,1843,8401,151,923,1443,6503,1594,7426
120040,201907,42594,138580,37313,129686,5939,21805,22981,80801,28920,102606
120042,201907,3386,12756,3078,12131,146,798,2496,9783,2642,10581
120043,201907,1409,5643,1274,5412,40,229,1142,4866,1182,5095
120045,201907,6030,16127,5289,15289,133,534,4831,13813,4964,14347
120050,201907,9257,33601,8463,32358,462,2343,6915,26507,7377,28850
120060,201907,9492,37046,8787,35939,406,2348,7575,30878,7981,33226
120070,201907,3112,10204,2717,9653,289,1054,1897,7011,2186,8065
120080,201907,4328,14394,3871,13659,578,2193,2648,9478,3226,11671
130002,201907,3088,12308,2759,11818,198,916,2336,10093,2534,11009
130006,201907,2364,9001,1945,8249,175,819,1447,6138,1622,6957
130008,201907,2552,9099,2288,8691,76,402,1940,7355,2016,7757
130010,201907,3930,11444,3305,10722,63,205,3073,10089,3136,10294
130014,201907,3033,9224,2376,8102,451,1557,1434,4999,1885,6556
130020,201907,2701,10718,2449,10315,151,894,1929,8090,2080,8984
130030,201907,9789,32296,8937,31297,251,933,8013,28462,8264,29395
130040,201907,3817,11607,3191,10741,179,633,2563,8665,2742,9298
130050,201907,7588,27890,6345,26268,185,959,5713,23849,5898,24808
130060,201907,7549,30232,6506,28837,531,2969,5199,22938,5730,25907
130063,201907,6227,20573,5558,19827,186,818,5061,18156,5247,18974
130068,201907,3598,13273,3093,12426,249,1388,2269,8931,2518,10319
130070,201907,7628,21740,6332,20292,306,988,5327,17415,5633,18403
130080,201907,6878,25911,6079,24937,297,1705,5049,20958,5346,22663
130083,201907,2677,9013,2420,8693,188,799,2036,7282,2224,8081
130090,201907,3443,10814,3065,10319,66,296,2652,9096,2718,9392
130100,201907,7753,23582,6634,22397,71,181,6191,21492,6262,21673
130110,201907,8409,24345,6973,22553,928,2486,5197,17916,6125,20402
130115,201907,5453,17203,4752,16372,110,429,4178,14580,4288,15009
130120,201907,14561,52175,13104,50244,1219,5160,10594,40966,11813,46126
130130,201907,5178,16962,4081,15528,448,1862,3056,11671,3504,13533
130140,201907,6990,25116,6383,24424,219,1165,5625,21616,5844,22781
130150,201907,3672,13777,3442,13499,93,585,3122,12257,3215,12842
130160,201907,5151,18488,4449,17578,316,1417,3693,14820,4009,16237
130165,201907,3256,12451,3086,12216,124,585,2754,10954,2878,11539
130170,201907,11836,35452,9539,32702,787,3107,7571,26070,8358,29177
130180,201907,4491,14214,4242,13935,40,221,4085,13386,4125,13607
130185,201907,18529,45750,15094,42062,916,1657,12870,37675,13786,39332
130190,201907,19129,63622,15595,58329,1929,7423,10841,41801,12770,49224
130195,201907,2427,8930,1973,8343,75,404,1751,7408,1826,7812
130200,201907,2548,7351,2127,6780,121,490,1730,5458,1851,5948
130210,201907,1311,4985,1177,4825,96,571,945,3781,1041,4352
130220,201907,2287,8139,2028,7770,69,347,1757,6765,1826,7112
130230,201907,4429,18731,3873,17920,281,1698,3249,15016,3530,16714
130240,201907,11776,35833,9597,32872,199,1150,8520,29099,8719,30249
130250,201907,26017,78901,22532,74950,1801,5602,18098,62535,19899,68137
130255,201907,4308,14772,3802,13864,180,834,3052,11122,3232,11956
130260,201907,258315,743719,213598,676698,59052,199626,97035,312413,156087,512039
130270,201907,8830,32673,7539,30628,1154,4737,5076,21393,6230,26130
130280,201907,3518,14196,3234,13879,104,509,2985,12995,3089,13504
130290,201907,13106,44408,11514,42438,632,2525,9897,37103,10529,39628
130300,201907,4717,16754,4299,16151,172,959,3671,13703,3843,14662
130310,201907,6017,20941,5313,19968,338,1494,4378,16561,4716,18055
130320,201907,3482,11335,2967,10696,346,1203,2237,8326,2583,9529
130330,201907,4613,14825,3759,13763,208,939,3199,11694,3407,12633
130340,201907,22830,73984,19859,70516,1561,5183,16414,60144,17975,65327
130350,201907,3927,14465,3552,13970,154,882,3078,11997,3232,12879
130353,201907,6948,19622,5712,18023,930,2839,3865,12647,4795,15486
130356,201907,5031,16627,4284,15415,701,2509,2704,10152,3405,12661
130360,201907,3152,9638,2690,9105,73,244,2481,8469,2554,8713
130370,201907,5710,22435,5033,21497,313,1632,4157,17679,4470,19311
130380,201907,7310,30561,6827,29851,413,2355,5723,24785,6136,27140
130390,201907,6020,25305,5305,24048,582,3149,3818,17255,4400,20404
130395,201907,2344,7571,2020,7027,208,770,1497,5182,1705,5952
130400,201907,2713,8722,2351,8242,104,366,2084,7417,2188,7783
130406,201907,11068,39651,9501,37637,1780,7100,6368,26089,8148,33189
130410,201907,4120,14850,3549,13868,1097,4448,1602,6507,2699,10955
130420,201907,13592,48447,11512,45882,1017,5190,9010,35891,10027,41081
130423,201907,4232,13566,3727,12979,185,902,3265,11201,3450,12103
130426,201907,2850,11185,2689,10960,83,442,2469,10096,2552,10538
130430,201907,4219,12214,3688,11490,329,1186,2953,9034,3282,10220
130440,201907,4817,15228,4195,14489,145,592,3814,13247,3959,13839
140002,201907,2249,6721,1961,6342,103,389,1636,5275,1739,5664
140005,201907,3228,9068,2914,8711,147,408,2530,7676,2677,8084
140010,201907,56058,149737,44115,131686,11378,35630,17522,53706,28900,89336
140015,201907,3539,10986,3059,10393,213,728,2643,9112,2856,9840
140017,201907,4060,11886,3567,11245,310,973,2777,9004,3087,9977
140020,201907,5227,15570,4472,14538,278,1174,3533,11413,3811,12587
140023,201907,2390,7255,1949,6627,219,785,1405,4846,1624,5631
140028,201907,2105,5446,1776,5013,114,365,1385,3868,1499,4233
140030,201907,5145,13491,4570,12808,373,806,3861,11180,4234,11986
140040,201907,2346,9618,2156,9332,108,672,1904,8096,2012,8768
140045,201907,2667,9776,2267,9208,403,1524,1510,6523,1913,8047
140047,201907,5857,17112,4973,15780,741,2478,3352,10727,4093,13205
140050,201907,1399,4176,1192,3867,143,485,848,2791,991,3276
140060,201907,1653,4440,1395,4054,128,341,1081,3212,1209,3553
140070,201907,1845,9705,1787,9557,145,979,1427,7523,1572,8502
150010,201907,45657,114329,41437,108853,993,2612,36825,96298,37818,98910
150013,201907,1959,5124,1613,4741,155,344,1230,3832,1385,4176
150020,201907,14240,43301,13297,42064,1161,2931,11211,36489,12372,39420
150030,201907,8655,32840,7931,31937,420,1980,6895,27854,7315,29834
150034,201907,4372,11059,3631,10100,274,730,2968,8407,3242,9137
150040,201907,16351,42303,14302,40004,1374,2291,11638,35583,13012,37874
150050,201907,6907,24412,6351,23630,147,676,5795,21736,5942,22412
150060,201907,21470,59682,17597,53819,2928,9098,10959,34300,13887,43398
150070,201907,6635,25307,5880,24391,206,1085,5275,22106,5481,23191
150080,201907,95316,216417,80948,196926,18979,50030,26160,77384,45139,127414
150085,201907,7258,21724,6651,20974,164,538,6185,19609,6349,20147
150090,201907,9983,37360,9385,36203,648,2773,7581,29351,8229,32124
150095,201907,5549,16670,4906,15839,286,701,4067,13667,4353,14368
150100,201907,3013,10673,2663,10059,211,793,2050,7827,2261,8620
150110,201907,4284,18167,4056,17887,221,1041,3669,16290,3890,17331
150120,201907,7809,25109,7522,24741,320,838,6656,22637,6976,23475
150125,201907,742,2047,560,1796,112,413,317,997,429,1410
150130,201907,22950,67013,20060,62671,2831,7859,14105,45914,16936,53773
150140,201907,239263,565807,205974,519584,32762,80822,120298,317083,153060,397905
150145,201907,4483,13603,3814,12634,875,2639,2305,8260,3180,10899
150150,201907,15732,41254,13941,38954,707,2134,11525,32188,12232,34322
150157,201907,3392,9483,2799,8712,296,958,1982,6390,2278,7348
150160,201907,3004,9142,2808,8835,614,1878,1651,5376,2265,7254
150170,201907,24538,81283,21445,76016,4024,13494,13001,49022,17025,62516
150172,201907,4644,13014,3763,11763,264,759,2836,9126,3100,9885
150175,201907,1634,5153,1375,4657,243,879,813,2758,1056,3637
150178,201907,10543,29208,8795,27148,286,835,7662,24013,7948,24848
150180,201907,21583,78747,19982,76787,1027,3859,17478,68421,18505,72280
150190,201907,6822,23150,6394,22573,276,1219,5568,19569,5844,20788
150195,201907,5264,17144,5034,16800,87,477,4660,15375,4747,15852
150200,201907,5782,17055,5305,16529,63,167,4990,15689,5053,15856
150210,201907,25777,91450,24170,89177,1972,7222,19697,74470,21669,81692
150215,201907,7516,21817,6430,20213,1344,4165,3564,11724,4908,15889
150220,201907,11863,34596,10509,32618,1233,3773,7033,22235,8266,26008
150230,201907,12495,35916,10896,33793,1233,3549,7523,24298,8756,27847
150240,201907,32620,91980,26985,82124,8078,25052,8544,26551,16622,51603
150250,201907,4185,16555,3984,16284,595,2415,3022,12608,3617,15023
150260,201907,2648,8905,2431,8554,185,642,1872,6676,2057,7318
150270,201907,8801,25575,6229,21183,2054,7310,1885,6811,3939,14121
150275,201907,6775,21977,6256,21215,238,941,5394,18181,5632,19122
150276,201907,2293,6211,1958,5809,237,646,1357,4393,1594,5039
150277,201907,5282,13949,4295,12806,355,952,3300,10479,3655,11431
150280,201907,6599,27139,6397,26768,532,2218,5323,22513,5855,24731
150285,201907,3269,11584,2882,10971,279,1115,2049,7946,2328,9061
150290,201907,10709,29213,9776,28195,351,789,8780,25920,9131,26709
150293,201907,9618,24136,7154,20838,1218,3497,4045,12521,5263,16018
150295,201907,7958,21593,5758,18622,2016,7127,1869,6668,3885,13795
150300,201907,2323,7089,2080,6760,56,226,1857,6033,1913,6259
150304,201907,4075,12361,3367,11192,638,2019,2027,7020,2665,9039
150307,201907,6251,20237,5824,19559,398,1280,4739,16141,5137,17421
150309,201907,6259,19224,5034,17042,963,3197,2727,9652,3690,12849
150310,201907,7286,28748,6930,28312,246,1376,6085,25079,6331,26455
150320,201907,9558,25995,8702,24807,464,1420,6744,19182,7208,20602
150330,201907,13947,45649,12909,43903,1460,4713,9604,33584,11064,38297
150340,201907,2587,7538,2319,7143,341,956,1629,5178,1970,6134
150345,201907,7876,23536,7157,22582,400,1350,6112,19375,6512,20725
150350,201907,8947,23350,8239,22424,817,1577,6686,18899,7503,20476
150360,201907,24233,68464,19587,62441,2211,6216,13444,45276,15655,51492
150370,201907,10387,32822,8713,30490,988,3136,6351,23585,7339,26721
150375,201907,3390,14000,3067,13510,271,1306,2516,11179,2787,12485
150380,201907,10975,28672,9123,26190,188,684,7956,22845,8144,23529
150390,201907,7935,32339,7189,31099,1130,4415,4975,22752,6105,27167
150400,201907,6376,23254,6119,22756,288,1143,5290,19725,5578,20868
150405,201907,9203,24695,8173,23423,507,1172,6597,19568,7104,20740
150410,201907,1911,6173,1624,5668,202,663,1063,3796,1265,4459
150420,201907,41401,118385,31968,103867,9507,32398,10134,38081,19641,70479
150430,201907,8454,25031,7761,24105,853,2091,6050,19607,6903,21698
150440,201907,5569,18335,5189,17746,679,2110,3785,13357,4464,15467
150442,201907,25583,63350,21259,57640,2351,6249,14500,40173,16851,46422
150445,201907,6261,19542,5559,18454,234,815,4715,15692,4949,16507
150450,201907,5031,21904,4725,21481,371,1857,4005,18236,4376,20093
150460,201907,8436,27817,7778,26965,250,1002,6691,24006,6941,25008
150470,201907,21341,55632,19010,52968,512,1306,17614,49280,18126,50586
150475,201907,4708,15266,4149,14389,189,707,3421,12003,3610,12710
150480,201907,13796,45423,12397,43272,2208,7178,8253,30499,10461,37677
150490,201907,8131,28774,7609,28096,257,1153,6755,25060,7012,26213
150495,201907,5259,18374,5077,18100,122,611,4629,16411,4751,17022
150497,201907,2850,9274,2301,8287,553,2064,1160,4408,1713,6472
150500,201907,3331,8686,2964,8152,264,665,2295,6329,2559,6994
150503,201907,4641,12481,3284,10635,1016,3505,1028,3762,2044,7267
150506,201907,10273,31787,8808,29715,1877,5602,5535,20472,7412,26074
150510,201907,9908,36461,8630,33989,1185,4485,5772,23779,6957,28264
150520,201907,7251,27751,6930,27343,221,1280,6278,24677,6499,25957
150530,201907,12372,42394,10833,40158,1589,4755,7742,30562,9331,35317
150540,201907,4961,13769,4239,12677,170,494,3615,10790,3785,11284
150543,201907,7207,19596,5913,17932,609,1901,4334,13701,4943,15602
150548,201907,10000,31467,9039,30159,296,1067,7942,26615,8238,27682
150549,201907,2042,6159,1755,5765,47,205,1524,4992,1571,5197
150550,201907,19888,59532,16852,54461,4019,13260,7492,25792,11511,39052
150553,201907,24828,75819,19602,66283,6203,21483,6281,23085,12484,44568
150555,201907,1884,5114,1482,4478,134,328,1030,3210,1164,3538
150560,201907,1833,5649,1630,5249,285,877,932,3127,1217,4004
150563,201907,2484,7761,2119,7110,465,1651,1151,3849,1616,5500
150565,201907,4258,13884,3771,13081,111,524,3065,10697,3176,11221
150570,201907,6216,20445,5918,19995,269,1057,5122,17207,5391,18264
150580,201907,10293,41562,9223,40350,657,3294,7541,33885,8198,37179
150590,201907,7614,27292,6838,26310,211,1208,6152,23536,6363,24744
150600,201907,9437,31865,8800,31050,235,948,8078,28641,8313,29589
150610,201907,2834,8474,2550,7990,114,427,2110,6549,2224,6976
150611,201907,3128,9059,2812,8590,90,367,2468,7449,2558,7816
150613,201907,13410,37442,10124,31787,1875,6291,4958,15605,6833,21896
150616,201907,3347,9330,2451,7833,604,1997,949,2995,1553,4992
150618,201907,6970,20501,5641,18399,611,1910,3533,12119,4144,14029
150619,201907,6222,17954,5177,16399,190,752,4245,13440,4435,14192
150620,201907,6623,22101,5766,20686,771,2697,3989,14720,4760,17417
150630,201907,6151,16997,5648,16362,457,1238,4640,13678,5097,14916
150635,201907,4688,13210,3985,12039,570,1691,2538,7827,3108,9518
150640,201907,2216,6484,2030,6261,36,118,1889,5904,1925,6022
150650,201907,11525,32640,10179,30366,3112,8761,4448,14363,7560,23124
150655,201907,5845,16783,5291,15947,231,705,4525,13621,4756,14326
150658,201907,4481,12793,3543,11365,578,1945,2135,7170,2713,9115
150660,201907,5774,16721,5179,15862,516,1513,3574,11148,4090,12661
150670,201907,8359,19685,6563,17626,666,1519,5119,14398,5785,15917
150680,201907,67636,202100,51679,176581,12916,43646,22839,87234,35755,130880
150690,201907,2822,7758,2530,7387,120,292,2222,6614,2342,6906
150700,201907,6228,18686,5595,17866,387,1144,4440,14482,4827,15626
150710,201907,3776,12661,3456,12134,256,935,2657,9440,2913,10375
150715,201907,5129,15070,4273,13721,353,1081,3322,10848,3675,11929
150720,201907,6820,24812,6371,24047,438,1847,5245,19882,5683,21729
150730,201907,11608,36359,10187,34215,1136,3979,7690,26321,8826,30300
150740,201907,3952,11237,3499,10490,345,891,2593,7930,2938,8821
150745,201907,5176,14919,4180,13427,847,2886,2646,8530,3493,11416
150746,201907,1635,5074,1500,4863,86,272,1224,3974,1310,4246
150747,201907,4843,15718,4309,14824,758,2322,2822,10229,3580,12551
150750,201907,3689,11669,3109,10744,236,867,2358,8347,2594,9214
150760,201907,12037,35440,10966,34023,1433,4111,7891,25136,9324,29247
150770,201907,6306,23000,6027,22652,214,702,5502,21253,5716,21955
150775,201907,917,2688,728,2408,139,507,392,1306,531,1813
150780,201907,4604,13846,4153,13300,132,376,3777,12316,3909,12692
150790,201907,5617,16319,4907,15553,218,534,4057,14001,4275,14535
150795,201907,13501,43289,12201,41129,3197,10222,6768,24351,9965,34573
150796,201907,3720,9421,3236,8839,185,468,2736,7561,2921,8029
150797,201907,3956,12436,3416,11623,150,439,2854,9863,3004,10302
150800,201907,13388,42476,12328,41129,1557,4755,9375,32381,10932,37136
150803,201907,6982,23016,6581,22393,367,1275,5627,19250,5994,20525
150805,201907,3471,10900,2954,10099,260,919,2248,7784,2508,8703
150808,201907,6192,17822,4511,14993,1709,6183,610,2268,2319,8451
150810,201907,20914,56521,15969,50438,3333,10697,8224,28196,11557,38893
150812,201907,5484,15683,4849,14569,460,1447,3545,10447,4005,11894
150815,201907,9255,28184,7897,26465,699,2337,6303,21468,7002,23805
150820,201907,11957,32929,10086,30622,1019,2712,7734,24349,8753,27061
150830,201907,11474,43243,10886,42496,404,2002,9479,37643,9883,39645
150835,201907,2248,7664,1962,7124,377,1348,1010,3701,1387,5049
150840,201907,7419,21672,5890,18997,1082,3727,3031,9678,4113,13405
160005,201907,1179,3251,1061,3084,49,172,916,2655,965,2827
160010,201907,2455,6323,2317,6176,20,100,2250,5925,2270,6025
160015,201907,2555,7784,2308,7456,77,264,2106,6816,2183,7080
160020,201907,2031,6765,1801,6455,210,773,1377,5003,1587,5776
160021,201907,1105,4348,1025,4236,72,419,826,3328,898,3747
160023,201907,1263,4483,1110,4225,116,399,785,3145,901,3544
160025,201907,1943,5603,1877,5527,14,41,1841,5432,1855,5473
160027,201907,8799,24666,7934,23576,587,1665,6456,19513,7043,21178
160030,201907,67203,194906,54652,177999,12025,37191,29245,104604,41270,141795
160040,201907,5447,19084,4961,18437,98,475,4580,17084,4678,17559
160050,201907,4644,14681,3708,13336,1485,5100,1278,5636,2763,10736
160053,201907,3708,11830,3424,11466,269,845,2815,9666,3084,10511
160055,201907,859,2625,835,2597,28,98,782,2423,810,2521
160060,201907,23690,65216,19579,60457,1078,3454,15549,50087,16627,53541
160070,201907,2873,10883,2585,10404,197,784,2034,8438,2231,9222
160080,201907,3231,10524,2955,10199,53,265,2696,9365,2749,9630
170025,201907,618,1677,455,1435,89,271,238,764,327,1035
170030,201907,1185,3623,894,3065,156,523,427,1492,583,2015
170035,201907,1490,3886,1073,3194,103,337,631,1882,734,2219
170040,201907,1829,5350,1454,4829,108,410,855,2970,963,3380
170070,201907,1789,4255,1250,3566,86,292,739,2145,825,2437
170100,201907,2448,7097,2013,6356,184,552,1300,4174,1484,4726
170105,201907,738,2151,502,1633,125,376,178,586,303,962
170110,201907,924,2897,705,2471,121,459,297,1035,418,1494
170130,201907,1337,4068,952,3308,184,648,447,1609,631,2257
170190,201907,1399,4034,950,3273,328,1140,176,795,504,1935
170200,201907,1845,4594,1131,3379,236,752,350,1045,586,1797
170210,201907,24920,68976,18885,58591,6689,22419,2014,7355,8703,29774
170215,201907,1332,3642,1104,3332,55,235,846,2534,901,2769
170220,201907,5895,18477,4959,16718,1276,4098,2200,8018,3476,12116
170230,201907,1273,3826,952,3169,269,904,185,662,454,1566
170240,201907,2693,7621,2057,6589,169,669,1383,4297,1552,4966
170255,201907,4041,11878,2828,9540,524,1834,1241,4300,1765,6134
170270,201907,1005,2467,650,1961,26,82,399,1185,425,1267
170290,201907,2964,8709,2524,8170,122,387,2008,6741,2130,7128
170300,201907,1941,5409,1576,4848,190,613,1046,3257,1236,3870
170305,201907,710,2003,559,1730,66,236,265,795,331,1031
170307,201907,952,3286,766,2907,114,460,416,1595,530,2055
170310,201907,1631,4164,1121,3308,188,612,500,1478,688,2090
170320,201907,1051,2752,777,2317,70,228,486,1457,556,1685
170330,201907,921,2855,821,2694,46,214,667,2132,713,2346
170360,201907,475,1317,334,1066,31,113,209,626,240,739
170370,201907,1301,3526,929,2894,296,891,228,830,524,1721
170380,201907,1774,5218,1313,4485,118,444,716,2527,834,2971
170382,201907,554,1697,448,1501,43,188,312,998,355,1186
170384,201907,1576,5760,1281,5169,286,1201,600,2450,886,3651
170386,201907,866,2411,533,1746,77,308,179,531,256,839
170388,201907,631,1816,447,1486,64,249,200,661,264,910
170389,201907,1044,3380,888,3108,48,205,678,2404,726,2609
170390,201907,1654,3885,1221,3345,75,193,958,2694,1033,2887
170410,201907,556,1657,398,1349,20,90,256,858,276,948
170460,201907,382,1024,300,884,42,122,182,548,224,670
170510,201907,901,2698,647,2204,49,207,398,1312,447,1519
170550,201907,6574,17880,4722,14748,1257,4222,1064,3543,2321,7765
170555,201907,1334,3752,1042,3286,62,206,546,1782,608,1988
170560,201907,1050,3005,776,2603,78,305,462,1666,540,1971
170600,201907,1335,3654,1074,3265,223,537,616,2043,839,2580
170610,201907,1760,4785,1267,3996,77,277,776,2418,853,2695
170625,201907,432,1200,258,823,34,94,87,277,121,371
170650,201907,1295,3912,1003,3405,162,555,515,1828,677,2383
170700,201907,3442,10169,2565,8499,519,1767,1106,3745,1625,5512
170710,201907,1546,4135,1166,3482,175,576,681,2008,856,2584
170720,201907,1833,4652,1454,4092,84,180,1090,3202,1174,3382
170730,201907,1026,2866,758,2422,153,458,342,1165,495,1623
170740,201907,2067,6960,1754,6354,212,813,1184,4287,1396,5100
170755,201907,870,2485,598,1967,59,217,287,915,346,1132
170765,201907,1239,3235,848,2606,180,556,348,1116,528,1672
170770,201907,1798,5356,1489,4851,193,588,949,3189,1142,3777
170820,201907,3419,10549,2799,9387,486,1739,1386,4708,1872,6447
170825,201907,966,2315,776,2044,84,223,537,1424,621,1647
170830,201907,1394,3806,1147,3411,26,96,915,2714,941,2810
170900,201907,2668,8723,2272,8107,192,757,1754,6340,1946,7097
170930,201907,3722,10412,2868,8843,663,2154,1051,3207,1714,5361
170950,201907,11284,31663,7739,25215,2279,8371,965,3370,3244,11741
170980,201907,438,1217,350,1073,17,79,251,722,268,801
171050,201907,1587,5127,1374,4721,56,269,1113,3792,1169,4061
171070,201907,1345,3954,1142,3649,288,915,540,1938,828,2853
171090,201907,1045,2602,838,2296,76,210,573,1573,649,1783
171110,201907,571,1580,407,1270,59,207,190,524,249,731
171150,201907,1104,2778,644,1971,80,270,380,1149,460,1419
171180,201907,761,2134,496,1615,86,261,199,669,285,930
171190,201907,1677,5847,1471,5470,243,957,874,3317,1117,4274
171195,201907,831,2722,682,2433,102,420,405,1417,507,1837
171200,201907,538,1567,404,1321,77,263,179,586,256,849
171215,201907,381,1086,297,936,49,171,174,530,223,701
171240,201907,761,2584,623,2304,43,217,401,1468,444,1685
171245,201907,647,1970,495,1639,47,175,294,938,341,1113
171250,201907,1075,2836,770,2357,137,438,380,1166,517,1604
171270,201907,385,1515,329,1377,72,326,127,571,199,897
171280,201907,857,2612,667,2269,85,269,371,1330,456,1599
171320,201907,4044,11504,3134,9907,622,1960,1252,4135,1874,6095
171330,201907,2715,7488,2081,6408,421,1250,989,3145,1410,4395
171360,201907,1435,4243,1159,3839,88,337,823,2767,911,3104
171370,201907,668,1751,523,1544,57,178,347,1040,404,1218
171380,201907,1499,4369,1239,3974,112,339,850,2825,962,3164
171395,201907,964,2788,645,2149,68,249,362,1178,430,1427
171420,201907,1927,5826,1393,4750,243,920,613,2085,856,3005
171430,201907,1045,3140,864,2776,72,273,574,1781,646,2054
171488,201907,2350,7027,1810,6105,314,1099,862,2999,1176,4098
171500,201907,979,2467,743,2094,39,114,555,1566,594,1680
171510,201907,776,2626,679,2431,45,201,465,1652,510,1853
171515,201907,468,1269,337,1048,38,155,198,576,236,731
171525,201907,669,1964,518,1688,36,152,314,953,350,1105
171550,201907,344,1015,246,842,31,132,138,450,169,582
171570,201907,1124,3421,930,3064,152,499,533,1802,685,2301
171575,201907,1815,4864,1134,3605,148,485,489,1540,637,2025
171610,201907,5794,16497,4322,13974,967,3437,1201,4118,2168,7555
171620,201907,2683,7646,2255,7013,131,513,1766,5485,1897,5998
171630,201907,980,2686,786,2413,121,377,510,1611,631,1988
171650,201907,2113,6140,1590,5181,410,1426,470,1628,880,3054
171660,201907,2355,6111,1615,4825,252,727,814,2465,1066,3192
171665,201907,1332,3778,998,3221,170,636,466,1516,636,2152
171670,201907,1871,5067,1425,4323,215,728,798,2377,1013,3105
171700,201907,1205,3484,878,2900,110,354,492,1632,602,1986
171720,201907,818,2144,629,1834,58,197,442,1264,500,1461
171750,201907,1268,3622,881,2900,212,716,128,515,340,1231
171780,201907,1223,3161,884,2662,69,245,615,1811,684,2056
171790,201907,1431,4822,1147,4208,240,897,507,1932,747,2829
171800,201907,748,2092,555,1789,69,270,307,980,376,1250
171820,201907,11145,31736,8264,26605,1995,6667,2681,9181,4676,15848
171830,201907,1500,5006,1260,4554,125,567,802,2853,927,3420
171840,201907,749,2019,590,1770,28,84,402,1203,430,1287
171845,201907,629,1618,457,1364,59,217,257,764,316,981
171850,201907,863,2972,733,2677,75,344,510,1794,585,2138
171855,201907,1064,3261,899,2955,80,258,550,1780,630,2038
171865,201907,393,1259,321,1130,51,191,153,510,204,701
171870,201907,786,2240,547,1784,61,204,290,972,351,1176
171875,201907,1268,3815,1018,3403,54,239,755,2488,809,2727
171880,201907,1136,3567,1003,3381,32,130,810,2759,842,2889
171884,201907,834,2317,604,1942,113,421,218,756,331,1177
171886,201907,1447,4097,1012,3333,291,1038,197,667,488,1705
171888,201907,736,2085,499,1633,34,121,314,1012,348,1133
171889,201907,420,1304,353,1182,81,290,142,474,223,764
171890,201907,1144,3199,846,2716,183,551,458,1530,641,2081
171900,201907,516,1806,359,1397,78,306,136,541,214,847
172000,201907,578,1788,483,1596,49,181,279,886,328,1067
172010,201907,1057,3696,892,3338,81,364,546,1977,627,2341
172015,201907,361,1289,266,1086,64,256,108,470,172,726
172020,201907,2491,7389,2220,7026,166,629,1658,5338,1824,5967
172025,201907,757,2094,549,1751,40,150,367,1166,407,1316
172030,201907,1231,3672,1053,3395,38,165,837,2681,875,2846
172049,201907,1286,3155,855,2524,199,572,454,1420,653,1992
172065,201907,1498,3722,1170,3321,108,223,946,2852,1054,3075
172080,201907,2327,7000,1878,6166,116,450,1242,4049,1358,4499
172085,201907,473,1319,299,936,54,161,104,309,158,470
172090,201907,4009,10294,3065,9023,138,472,2306,6806,2444,7278
172093,201907,487,1449,351,1199,33,137,189,621,222,758
172097,201907,608,1647,436,1353,59,185,213,677,272,862
172100,201907,49862,125314,33624,98612,6518,21046,11030,33113,17548,54159
172110,201907,1626,6033,1404,5675,161,659,1013,4309,1174,4968
172120,201907,4928,14849,3886,13119,559,1931,2118,7405,2677,9336
172125,201907,301,839,218,697,23,74,122,385,145,459
172130,201907,692,1754,566,1553,27,97,402,1026,429,1123
172208,201907,2497,6291,2001,5628,195,490,1395,4017,1590,4507
172210,201907,2758,7278,2090,6406,424,1343,1089,3451,1513,4794
210005,201907,19648,57626,15310,50409,4511,15419,5766,19811,10277,35230
210010,201907,1934,5996,1751,5741,68,306,1496,4929,1564,5235
210015,201907,3361,10111,2985,9594,124,337,2566,8388,2690,8725
210020,201907,7502,17260,6515,16114,85,234,6037,14932,6122,15166
210030,201907,4809,16057,4513,15619,199,953,3909,13436,4108,14389
210040,201907,1853,4500,1672,4281,28,48,1554,4029,1582,4077
210043,201907,6408,18081,5341,16668,553,1676,3957,12717,4510,14393
210047,201907,6661,21332,5571,19783,176,872,4800,16973,4976,17845
210050,201907,2288,7806,1788,6875,191,851,1199,4580,1390,5431
210055,201907,1860,6063,1699,5794,67,282,1429,4841,1496,5123
210060,201907,7118,26606,6329,25124,798,3271,4337,17761,5135,21032
210070,201907,7276,20602,6853,20084,45,176,6532,19209,6577,19385
210080,201907,4094,14086,3915,13875,38,224,3692,13156,3730,13380
210083,201907,5607,16148,4634,15113,67,351,4360,14164,4427,14515
210087,201907,3030,8349,2661,7859,124,302,2259,6859,2383,7161
210090,201907,9466,29702,8858,28636,374,1245,7705,24846,8079,26091
210095,201907,6294,20633,5827,20069,243,1043,4900,17316,5143,18359
210100,201907,6847,20887,6171,19817,319,1125,5029,16177,5348,17302
210110,201907,3090,10802,2875,10524,62,434,2635,9532,2697,9966
210120,201907,22944,63799,19303,58983,2205,5716,12901,41739,15106,47455
210125,201907,4305,11912,3823,11305,810,1914,2661,8471,3471,10385
210130,201907,4317,11595,3595,10666,153,370,3063,9149,3216,9519
210135,201907,1475,4471,1279,4152,66,221,1033,3391,1099,3612
210140,201907,17963,49344,13999,44121,2766,8550,7750,25521,10516,34071
210150,201907,4498,10962,3975,10218,125,347,3458,8777,3583,9124
210160,201907,16600,49467,14573,46774,1358,4528,10337,34235,11695,38763
210170,201907,14950,47425,13962,46103,709,2281,12257,40664,12966,42945
210173,201907,2325,8781,2127,8427,66,422,1897,7501,1963,7923
210177,201907,3368,9395,3013,8957,113,203,2707,8337,2820,8540
210180,201907,1473,4038,1302,3816,38,116,1163,3385,1201,3501
210190,201907,5116,14529,4463,13560,92,461,3786,11259,3878,11720
210193,201907,1261,3785,1122,3565,38,147,893,2878,931,3025
210197,201907,2027,6569,1886,6360,157,550,1524,5220,1681,5770
210200,201907,7568,24784,6861,23614,556,2018,5440,18835,5996,20853
210203,201907,6949,20913,6060,19704,484,1621,4855,16041,5339,17662
210207,201907,3493,9463,3003,8878,148,363,2486,7538,2634,7901
210210,201907,8212,26741,7608,25919,128,760,6958,23580,7086,24340
210215,201907,2246,7424,2037,7116,60,302,1804,6281,1864,6583
210220,201907,6120,21315,5798,20805,219,1350,5018,17586,5237,18936
210230,201907,5222,15957,4726,15215,338,899,4007,13154,4345,14053
210232,201907,11469,36531,9495,33587,1540,5502,6019,22674,7559,28176
210235,201907,3483,10363,3039,9764,74,335,2674,8608,2748,8943
210237,201907,2585,8922,2346,8617,32,185,2175,8000,2207,8185
210240,201907,2685,8510,2465,8129,89,371,2125,6912,2214,7283
210250,201907,5591,17191,5115,16591,77,435,4561,14764,4638,15199
210255,201907,2526,7842,2143,7122,262,890,1378,4545,1640,5435
210260,201907,5500,16654,4864,15705,253,951,4125,13247,4378,14198
210270,201907,4829,13530,4314,12857,105,527,3837,11296,3942,11823
210275,201907,3627,9134,3215,8629,54,123,2943,7993,2997,8116
210280,201907,5544,16163,4459,14433,295,1268,3166,10015,3461,11283
210290,201907,7030,19575,6360,18729,141,449,5772,16993,5913,17442
210300,201907,33802,92356,27803,84014,1891,5907,20442,64047,22333,69954
210310,201907,3061,7952,2700,7419,124,294,2338,6472,2462,6766
210312,201907,2682,7009,2367,6652,46,190,2167,6009,2213,6199
210315,201907,3033,8482,2573,7948,74,195,2326,7352,2400,7547
210317,201907,4102,13080,3752,12669,119,604,3360,11269,3479,11873
210320,201907,19115,58938,17527,56817,461,2215,15425,49725,15886,51940
210325,201907,3499,10195,3060,9616,82,280,2748,8746,2830,9026
210330,201907,24368,71467,20700,66362,5778,16985,10268,37377,16046,54362
210340,201907,10049,30346,9052,28880,753,2441,6916,22521,7669,24962
210350,201907,9478,27505,8318,26067,176,660,7286,22933,7462,23593
210355,201907,4314,14731,3808,13928,116,601,3250,11940,3366,12541
210360,201907,13410,42256,12079,40290,554,2476,9587,31569,10141,34045
210370,201907,10711,24349,8363,21845,246,457,7610,20340,7856,20797
210375,201907,3308,8869,2501,7792,612,1945,1197,4094,1809,6039
210380,201907,5574,14536,4862,13663,240,600,4114,11650,4354,12250
210390,201907,2543,9221,2378,8907,133,637,1955,7269,2088,7906
210400,201907,4482,13980,4027,13410,158,507,3565,11991,3723,12498
210405,201907,7148,19518,5756,17513,1064,3061,3236,10427,4300,13488
210407,201907,1996,6657,1655,6010,84,374,1325,4748,1409,5122
210408,201907,2464,9394,2316,9159,146,743,1857,7359,2003,8102
210409,201907,3776,13176,3475,12763,113,629,2861,10514,2974,11143
210410,201907,3527,10928,2988,10004,207,774,2184,7282,2391,8056
210420,201907,3970,12700,3571,12007,214,643,2967,10098,3181,10741
210430,201907,2290,6689,2063,6404,87,254,1819,5675,1906,5929
210440,201907,4225,11783,3819,11235,68,268,3528,10304,3596,10572
210450,201907,2501,7531,2187,7048,105,386,1790,5753,1895,6139
210455,201907,4254,11332,3242,10041,954,2934,1550,5017,2504,7951
210460,201907,3569,10524,3101,9901,82,360,2708,8587,2790,8947
210462,201907,1583,4980,1375,4631,38,172,1109,3715,1147,3887
210465,201907,2625,7749,2304,7297,67,259,1991,6311,2058,6570
210467,201907,5749,18968,5170,18198,296,1218,4394,15556,4690,16774
210470,201907,2117,5531,1456,4583,85,200,1092,3566,1177,3766
210480,201907,16041,48139,13481,44916,1263,3868,9851,34992,11114,38860
210490,201907,3742,9524,3026,8505,79,249,2610,7323,2689,7572
210500,201907,6217,24473,5808,23739,372,1899,4723,19118,5095,21017
210510,201907,6039,20398,5396,19678,116,556,4818,17807,4934,18363
210515,201907,3790,11026,3300,10486,112,402,2887,9250,2999,9652
210520,201907,2508,7246,2276,6951,81,308,2003,6042,2084,6350
210530,201907,54467,133328,42739,115915,6878,23473,11519,39838,18397,63311
210535,201907,3090,10567,2874,10227,111,453,2423,8682,2534,9135
210540,201907,14518,42629,12192,39418,1449,4443,8591,28856,10040,33299
210542,201907,6453,15429,5281,14123,364,637,4414,12535,4778,13172
210545,201907,2243,7049,2112,6823,49,210,1852,5897,1901,6107
210547,201907,3554,12809,3141,11987,318,1204,2256,8864,2574,10068
210550,201907,6249,18931,5026,17033,336,1281,3769,13071,4105,14352
210560,201907,3500,10846,3162,10286,121,412,2657,8606,2778,9018
210565,201907,1480,4971,1237,4598,68,353,961,3619,1029,3972
210570,201907,10805,29749,9630,28329,319,936,8549,25507,8868,26443
210580,201907,2986,8179,2556,7663,193,372,2049,6469,2242,6841
210590,201907,4322,13032,3783,12319,88,455,3344,10839,3432,11294
210592,201907,2599,7700,2406,7368,30,146,2163,6553,2193,6699
210594,201907,2544,6917,1959,6019,91,255,1451,4602,1542,4857
210596,201907,2492,8934,2235,8403,146,595,1767,6702,1913,7297
210598,201907,1879,5449,1720,5213,35,157,1562,4698,1597,4855
210600,201907,3041,8239,2456,7391,75,195,2000,6131,2075,6326
210610,201907,2618,7609,2281,7195,69,332,1951,6086,2020,6418
210620,201907,2646,7282,2239,6783,51,141,2044,6319,2095,6460
210630,201907,3100,10522,2822,10074,142,709,2303,8084,2445,8793
210632,201907,4381,14370,3925,13697,265,1132,3060,10584,3325,11716
210635,201907,1787,6353,1683,6168,139,495,1366,5121,1505,5616
210637,201907,2327,7963,2084,7597,167,715,1555,5719,1722,6434
210640,201907,4710,16940,4469,16651,61,305,4220,15700,4281,16005
210650,201907,7344,20975,6709,20148,85,370,6221,18691,6306,19061
210660,201907,8280,24404,7320,22858,289,1104,6290,19421,6579,20525
210663,201907,2584,7720,2417,7526,118,292,2105,6720,2223,7012
210667,201907,1894,6225,1764,6034,48,190,1589,5479,1637,5669
210670,201907,4511,15539,4152,14958,142,710,3565,12749,3707,13459
210675,201907,5070,13870,4389,12960,238,585,3662,11066,3900,11651
210680,201907,4243,10831,3589,10018,123,223,3186,9097,3309,9320
210690,201907,7519,23843,6649,22839,265,1194,5816,20045,6081,21239
210700,201907,2735,7489,2219,6805,152,406,1709,5536,1861,5942
210710,201907,5036,15754,4436,14868,121,625,3868,12835,3989,13460
210720,201907,2865,9528,2639,9247,56,309,2381,8292,2437,8601
210725,201907,1357,4597,1166,4296,46,199,808,3083,854,3282
210730,201907,1207,3248,1012,2977,68,183,808,2396,876,2579
210735,201907,4650,13911,3986,13000,255,823,3343,11126,3598,11949
210740,201907,5319,14393,4652,13652,119,428,3855,11241,3974,11669
210745,201907,4504,12422,4169,11977,142,401,3761,10824,3903,11225
210750,201907,22709,58037,19829,54467,1574,4152,13922,40196,15496,44348
210760,201907,5827,15620,5093,14831,29,86,4847,14209,4876,14295
210770,201907,6159,15958,5318,15000,49,211,4976,13984,5025,14195
210780,201907,7180,23458,6411,22136,565,1764,5002,17645,5567,19409
210790,201907,4443,13927,4061,13434,230,657,3220,11288,3450,11945
210800,201907,4993,13337,4280,12388,72,284,3840,10972,3912,11256
210805,201907,3932,14455,3776,14219,114,619,3353,12537,3467,13156
210810,201907,4952,14638,4528,14084,220,524,3869,12365,4089,12889
210820,201907,7062,20331,5961,18532,776,2436,3646,11612,4422,14048
210825,201907,6744,20939,6179,20191,251,868,5349,17661,5600,18529
210830,201907,7654,22006,7150,21384,433,1010,6150,18888,6583,19898
210840,201907,3249,8653,2905,8171,83,277,2539,7020,2622,7297
210845,201907,6499,17710,5897,17046,27,87,5725,16596,5752,16683
210850,201907,5902,20347,5050,19025,273,1351,3929,14811,4202,16162
210860,201907,20583,53998,17401,49941,777,2039,14146,42417,14923,44456
210870,201907,6897,18894,5821,17589,232,692,5052,15316,5284,16008
210880,201907,4409,13557,3985,13067,225,842,3265,10718,3490,11560
210890,201907,4037,12085,3650,11621,244,651,2971,9756,3215,10407
210900,201907,4593,13575,3519,11586,1412,4946,568,2094,1980,7040
210905,201907,1943,5476,1640,5066,52,101,1478,4671,1530,4772
210910,201907,7314,22354,6211,20584,851,2919,4069,13532,4920,16451
210920,201907,3301,10872,2870,10297,82,453,2549,9062,2631,9515
210923,201907,1439,4478,1269,4196,56,204,964,3184,1020,3388
210927,201907,5236,16533,4618,15825,193,731,3945,13737,4138,14468
210930,201907,2489,8644,2224,8140,160,717,1702,6161,1862,6878
210940,201907,4005,11496,3760,11193,123,503,3418,10030,3541,10533
210945,201907,6174,18270,5648,17642,249,756,4837,15336,5086,16092
210950,201907,5162,14863,4004,13186,602,1641,2654,9347,3256,10988
210955,201907,1572,5082,1387,4754,144,491,992,3464,1136,3955
210960,201907,8985,27166,7827,25433,1290,3841,5002,17142,6292,20983
210970,201907,1277,4024,1034,3608,61,269,781,2651,842,2920
210975,201907,1678,5414,1506,5126,99,344,1184,4042,1283,4386
210980,201907,10210,23442,8931,22125,107,223,8451,21072,8558,21295
210990,201907,15481,44902,12495,40948,819,2966,9487,31470,10306,34436
211000,201907,14465,43396,12335,40882,634,2467,10031,34047,10665,36514
211003,201907,5491,16824,4676,15822,134,528,4041,13969,4175,14497
211010,201907,6452,23287,5839,22504,90,521,5282,20554,5372,21075
211020,201907,7784,23975,7079,23121,252,1054,6100,19954,6352,21008
211023,201907,1998,6649,1907,6522,98,405,1606,5439,1704,5844
211027,201907,2918,9586,2820,9420,166,625,2461,8125,2627,8750
211030,201907,3888,10862,3488,10373,242,556,2847,8724,3089,9280
211040,201907,4552,16584,4250,16064,134,785,3741,14009,3875,14794
211050,201907,9287,24021,8457,22964,149,403,7771,21107,7920,21510
211060,201907,6907,21182,6388,20479,154,609,5860,18768,6014,19377
211065,201907,2154,6160,1803,5688,86,275,1478,4768,1564,5043
211070,201907,7349,24278,6407,22795,499,1828,5009,17968,5508,19796
211080,201907,1291,3635,1031,3219,34,187,788,2317,822,2504
211085,201907,1998,5834,1729,5458,86,222,1506,4860,1592,5082
211090,201907,3244,9014,2917,8595,38,196,2659,7759,2697,7955
211100,201907,6711,17159,6238,16566,46,137,5730,15287,5776,15424
211102,201907,2974,10511,2753,10175,146,707,2364,8639,2510,9346
211105,201907,2359,7578,1972,6835,193,696,1378,4742,1571,5438
211107,201907,4522,14471,3916,13563,155,647,3188,11279,3343,11926
211110,201907,5968,16621,4632,14573,442,1290,3288,10571,3730,11861
211120,201907,42300,108012,37255,102171,4931,12596,24116,70651,29047,83247
211125,201907,2046,6129,1734,5644,48,180,1455,4747,1503,4927
211130,201907,195220,470656,175589,445724,25444,64796,76392,222190,101836,286986
211140,201907,4940,14883,4364,14100,197,615,3726,12058,3923,12673
211150,201907,9422,26134,8073,24346,346,1052,6774,20561,7120,21613
211153,201907,2553,7463,2055,6841,298,1032,1354,4724,1652,5756
211157,201907,1086,3484,901,3150,35,191,650,2240,685,2431
211160,201907,3959,11635,3172,10430,163,693,2360,7604,2523,8297
211163,201907,1710,5397,1569,5195,22,113,1428,4780,1450,4893
211167,201907,1555,4997,1454,4835,32,160,1330,4380,1362,4540
211170,201907,6363,15768,5976,15322,45,161,5685,14512,5730,14673
211172,201907,2434,6753,2085,6215,100,332,1698,4897,1798,5229
211174,201907,2818,8371,2586,8092,59,299,2348,7293,2407,7592
211176,201907,4283,12413,3333,11019,178,738,2610,8582,2788,9320
211178,201907,4685,10967,4034,10241,34,139,3792,9532,3826,9671
211180,201907,4018,13416,3734,12989,198,792,3180,11056,3378,11848
211190,201907,3045,9104,2617,8450,39,210,2252,7206,2291,7416
211195,201907,1346,3917,1156,3628,50,123,974,3126,1024,3249
211200,201907,2125,6227,1723,5695,215,725,1187,3985,1402,4710
211210,201907,6502,19836,5908,19052,271,1044,5081,16299,5352,17343
211220,201907,36187,93438,29921,85679,2880,8053,21981,64387,24861,72440
211223,201907,5023,13633,4316,12651,429,1237,3185,9415,3614,10652
211227,201907,1755,5958,1597,5724,37,178,1402,5101,1439,5279
211230,201907,7172,21699,6399,20494,410,1236,5146,16674,5556,17910
211240,201907,8250,26420,7766,25782,159,859,7104,23324,7263,24183
211245,201907,6735,17371,6276,16897,81,225,6093,16422,6174,16647
211250,201907,13338,40944,12116,39413,505,2171,10194,32727,10699,34898
211260,201907,7840,25663,7141,24703,204,909,6420,22303,6624,23212
211270,201907,10447,33699,9073,31801,395,1841,7417,26048,7812,27889
211280,201907,12864,36297,11495,34565,954,2338,9201,28861,10155,31199
211285,201907,1757,5954,1546,5628,189,738,994,3714,1183,4452
211290,201907,7318,22599,6741,21777,175,780,5807,18616,5982,19396
211300,201907,8066,22860,7235,21747,148,537,6521,19522,6669,20059
211400,201907,11305,33096,9322,30281,1232,4009,6093,20786,7325,24795
220005,201907,1817,4906,1653,4661,40,156,1368,3780,1408,3936
220010,201907,1490,4263,1237,3812,33,140,954,2899,987,3039
220020,201907,3457,10026,3033,9374,192,687,2398,7286,2590,7973
220025,201907,2224,5120,1893,4610,27,75,1585,3749,1612,3824
220027,201907,1261,3240,1088,3012,23,78,906,2459,929,2537
220030,201907,3310,8538,3125,8277,92,273,2733,7114,2825,7387
220040,201907,6947,21243,6200,19837,1353,4025,3536,11780,4889,15805
220045,201907,1474,4556,1237,4139,37,188,988,3244,1025,3432
220050,201907,4614,12861,3925,11887,88,427,3527,10510,3615,10937
220060,201907,2415,5120,2038,4684,25,59,1908,4365,1933,4424
220070,201907,2517,6427,2151,5888,81,176,1758,4810,1839,4986
220080,201907,700,1992,599,1841,28,116,512,1538,540,1654
220090,201907,1789,4375,1484,3954,20,74,1246,3410,1266,3484
220095,201907,649,1673,614,1634,19,31,558,1492,577,1523
220100,201907,1378,3836,1111,3384,49,179,880,2602,929,2781
220105,201907,2011,6311,1754,5784,149,504,1301,4308,1450,4812
220110,201907,3438,9525,3218,9113,45,221,2874,8012,2919,8233
220115,201907,2702,8059,2498,7756,68,277,2246,6857,2314,7134
220117,201907,1355,3304,1046,2861,15,62,876,2344,891,2406
220120,201907,12412,34238,11390,32941,104,410,10671,30783,10775,31193
220130,201907,1093,3013,913,2760,15,93,814,2405,829,2498
220140,201907,2012,4326,1734,3989,135,354,1479,3325,1614,3679
220150,201907,6416,19154,5968,18438,137,679,5022,15164,5159,15843
220155,201907,1108,3253,886,2838,25,101,632,1985,657,2086
220157,201907,1036,2567,878,2318,18,83,710,1801,728,1884
220160,201907,2761,7826,2376,7126,41,214,1966,5746,2007,5960
220170,201907,1531,4070,1292,3707,11,59,1146,3252,1157,3311
220173,201907,2080,5865,1624,5018,41,176,1319,3962,1360,4138
220177,201907,1953,5604,1870,5508,15,50,1829,5394,1844,5444
220180,201907,1128,2843,908,2455,2,12,687,1734,689,1746
220190,201907,6503,17049,5484,15619,377,1223,4118,11656,4495,12879
220191,201907,1420,4475,1298,4251,71,287,962,3063,1033,3350
220192,201907,1866,5041,1443,4285,32,119,1170,3396,1202,3515
220194,201907,1708,4928,1522,4618,69,287,1235,3651,1304,3938
220196,201907,1949,5230,1767,4937,31,140,1498,4077,1529,4217
220198,201907,1295,3558,1076,3275,9,32,991,3045,1000,3077
220200,201907,5023,14722,4405,13897,175,668,3665,11546,3840,12214
220202,201907,2198,6214,1877,5674,30,158,1595,4727,1625,4885
220205,201907,2543,7242,2269,6783,58,251,1908,5572,1966,5823
220207,201907,773,2331,638,2095,61,229,410,1336,471,1565
220208,201907,1680,5279,1363,4645,196,726,745,2493,941,3219
220209,201907,1585,4558,1377,4194,26,125,1114,3343,1140,3468
220210,201907,1625,4145,1393,3778,15,66,1169,3102,1184,3168
220211,201907,1566,4087,1446,3922,19,71,1263,3442,1282,3513
220213,201907,1747,4702,1513,4264,27,98,1222,3340,1249,3438
220217,201907,2072,6257,1957,6131,32,96,1829,5796,1861,5892
220220,201907,10268,27257,8533,24518,534,1392,5997,17766,6531,19158
220225,201907,1075,2802,871,2542,9,45,791,2279,800,2324
220230,201907,5803,14377,4995,13255,198,498,4256,11324,4454,11822
220240,201907,2882,8508,2646,8064,106,348,2136,6504,2242,6852
220245,201907,1640,4004,1302,3574,8,41,1187,3282,1195,3323
220250,201907,2998,8366,2620,7874,19,106,2417,7232,2436,7338
220253,201907,1626,4456,1401,4060,79,262,1151,3229,1230,3491
220255,201907,1844,4540,1557,4115,44,199,1276,3211,1320,3410
220260,201907,4259,13268,3732,12353,168,657,2969,9761,3137,10418
220265,201907,1228,4016,1110,3843,49,212,913,3103,962,3315
220270,201907,6397,20136,5995,19397,234,1074,4996,15606,5230,16680
220271,201907,1461,3770,1266,3499,29,105,1117,3078,1146,3183
220272,201907,1741,5003,1553,4653,67,212,1143,3319,1210,3531
220273,201907,1225,3510,1011,3119,41,161,766,2305,807,2466
220275,201907,2281,5493,1783,4795,32,102,1547,4164,1579,4266
220277,201907,2128,5472,1843,5027,36,119,1560,4167,1596,4286
220280,201907,1631,3912,1336,3504,28,98,1143,2930,1171,3028
220285,201907,1460,3754,1223,3457,15,72,1096,3057,1111,3129
220290,201907,6133,17975,4909,16239,374,1344,3564,11994,3938,13338
220300,201907,1974,5813,1608,5310,41,248,1326,4292,1367,4540
220310,201907,3021,8254,2377,7506,49,240,1969,6160,2018,6400
220320,201907,3022,9009,2333,7678,111,496,1765,5618,1876,6114
220323,201907,1616,4850,1295,4317,63,254,1059,3461,1122,3715
220325,201907,1284,3781,1089,3445,29,132,897,2778,926,2910
220327,201907,1461,4267,1296,3992,50,223,1050,3152,1100,3375
220330,201907,4323,10553,3591,9631,82,258,3158,8352,3240,8610
220335,201907,1754,5225,1562,4989,24,86,1412,4505,1436,4591
220340,201907,1849,4915,1436,4231,53,180,988,2801,1041,2981
220342,201907,1169,3455,1031,3242,49,231,799,2451,848,2682
220345,201907,3098,7061,2447,6124,17,53,2225,5541,2242,5594
220350,201907,3324,8592,2666,7589,130,397,1925,5451,2055,5848
220360,201907,1234,3178,974,2760,20,67,785,2198,805,2265
220370,201907,8782,25225,7969,23977,184,783,6960,20658,7144,21441
220375,201907,1570,4527,1398,4315,7,31,1324,4109,1331,4140
220380,201907,1526,3672,1241,3258,16,43,1073,2773,1089,2816
220385,201907,843,2037,670,1729,12,37,572,1451,584,1488
220390,201907,9363,25264,7328,21999,1892,5558,2907,9485,4799,15043
220400,201907,1492,3621,1130,3065,22,74,868,2287,890,2361
220410,201907,1152,3169,934,2804,45,135,753,2223,798,2358
220415,201907,816,2127,682,1906,20,60,533,1464,553,1524
220420,201907,1975,5490,1603,4785,48,144,1247,3666,1295,3810
220430,201907,2495,6800,2368,6612,86,282,2046,5620,2132,5902
220435,201907,1722,4539,1486,4174,51,169,1194,3275,1245,3444
220440,201907,2381,7578,2062,7060,111,455,1685,5677,1796,6132
220450,201907,2454,6468,2013,5911,103,361,1641,4805,1744,5166
220455,201907,1320,4058,1248,3963,23,108,1111,3516,1134,3624
220460,201907,952,2386,886,2306,29,87,770,1970,799,2057
220465,201907,2352,7354,2074,6912,169,580,1544,5226,1713,5806
220470,201907,3460,9745,3078,9123,84,258,2485,7264,2569,7522
220480,201907,2558,6765,2036,5906,157,408,1429,4100,1586,4508
220490,201907,2419,6235,2122,5840,35,159,1869,5063,1904,5222
220500,201907,2591,6894,2352,6517,46,177,1953,5229,1999,5406
220510,201907,2500,7143,1995,6236,84,256,1560,4870,1644,5126
220515,201907,1647,4004,1505,3808,38,75,1304,3293,1342,3368
220520,201907,4926,12839,4422,12116,108,326,3864,10526,3972,10852
220525,201907,1302,3347,1147,3136,18,81,1033,2775,1051,2856
220527,201907,1341,3746,1146,3446,18,66,974,2976,992,3042
220530,201907,1408,3533,1213,3282,29,98,1117,2977,1146,3075
220535,201907,797,2242,740,2167,42,164,596,1711,638,1875
220540,201907,3286,10473,3089,10102,115,434,2628,8537,2743,8971
220545,201907,1370,4277,1270,4105,76,303,1047,3322,1123,3625
220550,201907,8684,26758,7770,25218,557,1983,5809,18630,6366,20613
220551,201907,1428,4135,1250,3820,33,132,1000,2999,1033,3131
220552,201907,1598,4641,1306,4106,39,185,1032,3130,1071,3315
220553,201907,1588,4310,1393,4042,49,108,1118,3336,1167,3444
220554,201907,871,2308,628,1899,48,111,416,1257,464,1368
220555,201907,2123,6645,1968,6398,54,246,1592,5274,1646,5520
220556,201907,1226,3614,1055,3255,63,256,747,2195,810,2451
220557,201907,1616,4920,1362,4416,69,254,995,3120,1064,3374
220558,201907,1409,3670,1095,3219,26,115,924,2670,950,2785
220559,201907,1617,4184,1368,3792,5,29,1106,3104,1111,3133
220560,201907,1775,4014,1417,3548,35,73,1273,3202,1308,3275
220570,201907,7176,21672,6552,20775,436,1430,5192,16478,5628,17908
220580,201907,6909,19257,6363,18363,103,407,5718,16306,5821,16713
220585,201907,1967,6309,1704,5818,49,170,1385,4767,1434,4937
220590,201907,1311,3642,1074,3270,89,278,759,2306,848,2584
220595,201907,2490,6846,2266,6541,21,94,2031,5805,2052,5899
220600,201907,1399,3153,1172,2862,104,149,961,2427,1065,2576
220605,201907,1652,4812,1394,4356,23,125,1103,3349,1126,3474
220610,201907,2802,8435,2622,8185,31,138,2428,7568,2459,7706
220620,201907,7986,24788,7361,23947,221,1126,6602,21145,6823,22271
220630,201907,361,1083,276,926,27,91,173,590,200,681
220635,201907,1604,5110,1412,4684,53,244,1069,3461,1122,3705
220640,201907,2589,7114,2214,6566,87,349,1782,5210,1869,5559
220650,201907,2036,5681,1754,5223,35,129,1404,4158,1439,4287
220660,201907,2656,8336,2295,7709,98,474,1855,6068,1953,6542
220665,201907,1270,3880,1085,3574,36,183,873,2808,909,2991
220667,201907,1606,5058,1435,4729,71,275,1141,3735,1212,4010
220669,201907,1671,5134,1599,5012,79,343,1361,4161,1440,4504
220670,201907,2202,5806,1761,5187,26,92,1506,4424,1532,4516
220672,201907,3201,7876,2587,7135,122,372,2247,6138,2369,6510
220675,201907,1223,3347,1109,3140,39,121,898,2518,937,2639
220680,201907,2665,7366,2534,7172,109,264,2288,6508,2397,6772
220690,201907,1495,3986,1332,3744,85,226,1045,2952,1130,3178
220695,201907,876,2461,817,2349,19,67,699,1997,718,2064
220700,201907,9547,23942,7577,21161,358,1073,5780,15974,6138,17047
220710,201907,881,2462,657,2024,28,106,497,1488,525,1594
220720,201907,2148,5091,1932,4789,21,81,1656,4042,1677,4123
220730,201907,1283,3631,1098,3331,17,88,936,2772,953,2860
220735,201907,971,2294,739,1923,20,66,612,1530,632,1596
220740,201907,1394,3742,1106,3372,38,112,921,2838,959,2950
220750,201907,3790,9805,3346,9149,221,517,2879,7926,3100,8443
220755,201907,1232,3103,1022,2770,31,115,812,2116,843,2231
220760,201907,3061,8720,2681,8194,93,311,2331,7192,2424,7503
220770,201907,21533,65846,18268,60085,6017,20650,6396,21681,12413,42331
220775,201907,1116,2914,1035,2812,13,54,998,2696,1011,2750
220777,201907,1654,4226,1251,3580,34,84,941,2677,975,2761
220779,201907,1336,3309,1175,3083,26,79,1018,2649,1044,2728
220780,201907,5519,14181,4834,13091,212,694,3965,10423,4177,11117
220785,201907,1475,3262,1306,3033,9,20,1261,2920,1270,2940
220790,201907,10037,28823,9067,27419,248,1156,7600,22600,7848,23756
220793,201907,888,2358,719,2059,16,39,580,1687,596,1726
220795,201907,1388,3633,1239,3442,18,60,1092,3028,1110,3088
220800,201907,17347,40197,14597,36326,728,1826,10972,26981,11700,28807
220810,201907,2971,8353,2516,7528,52,191,2074,6100,2126,6291
220820,201907,5128,13301,4391,12265,375,909,3249,9131,3624,10040
220830,201907,7247,19378,6529,18344,253,820,5469,15165,5722,15985
220840,201907,12132,37385,10199,33388,2410,7505,4811,16411,7221,23916
220850,201907,3178,9805,2819,9348,67,355,2463,8142,2530,8497
220855,201907,658,1712,567,1570,12,57,496,1342,508,1399
220860,201907,1022,2548,874,2305,23,87,770,2000,793,2087
220865,201907,2516,6673,1951,5690,75,261,1475,4198,1550,4459
220870,201907,2923,8287,2430,7630,35,172,2207,6882,2242,7054
220880,201907,5267,12606,4565,11739,86,302,4175,10592,4261,10894
220885,201907,1370,4279,1133,3880,57,245,902,3098,959,3343
220887,201907,1507,3322,1245,2973,9,32,1158,2727,1167,2759
220890,201907,1446,4527,1245,4182,60,214,1000,3374,1060,3588
220900,201907,2027,4895,1686,4437,34,76,1466,3824,1500,3900
220910,201907,1493,4170,1265,3830,44,159,1058,3179,1102,3338
220915,201907,955,2584,761,2209,7,27,584,1636,591,1663
220920,201907,1360,4499,1174,4241,76,325,935,3369,1011,3694
220930,201907,1634,4551,1422,4228,25,93,1306,3846,1331,3939
220935,201907,1054,3025,844,2588,27,104,569,1648,596,1752
220937,201907,1362,3672,1177,3378,23,91,960,2703,983,2794
220940,201907,1472,4220,1180,3672,40,155,888,2711,928,2866
220945,201907,435,1509,378,1384,19,103,278,987,297,1090
220950,201907,1418,3295,906,2473,15,51,713,1875,728,1926
220955,201907,1584,4118,1339,3692,42,124,1102,2998,1144,3122
220960,201907,830,2116,631,1789,11,46,477,1294,488,1340
220965,201907,1757,4857,1534,4534,22,137,1313,3778,1335,3915
220970,201907,1856,4627,1390,3900,39,109,1136,3147,1175,3256
220975,201907,693,2085,602,1971,22,131,525,1635,547,1766
220980,201907,1168,3304,1037,3118,33,139,871,2574,904,2713
220985,201907,1191,3224,1051,3013,46,149,831,2288,877,2437
220987,201907,1477,4399,1273,4039,61,254,1013,3146,1074,3400
220990,201907,1734,4780,1512,4446,24,129,1249,3587,1273,3716
220995,201907,1130,3400,900,2986,46,178,650,2144,696,2322
220997,201907,2440,7194,2241,6890,49,227,2002,6067,2051,6294
221000,201907,4187,11774,3833,11268,99,490,3275,9423,3374,9913
221005,201907,1481,3935,1353,3719,35,153,1160,3058,1195,3211
221010,201907,1201,2829,973,2538,29,75,837,2134,866,2209
221020,201907,1537,4690,1418,4457,26,113,1068,3313,1094,3426
221030,201907,1595,4103,1371,3816,28,102,1190,3316,1218,3418
221035,201907,1471,3838,1265,3558,23,42,1105,3190,1128,3232
221037,201907,627,1792,523,1605,9,46,356,1040,365,1086
221038,201907,511,1459,411,1268,17,62,280,853,297,915
221039,201907,870,2365,752,2162,19,82,613,1688,632,1770
221040,201907,4083,12272,3583,11369,168,594,2827,8926,2995,9520
221050,201907,3809,10180,3369,9603,58,233,3039,8575,3097,8808
221060,201907,8480,23495,6978,21153,236,700,5627,17127,5863,17827
221062,201907,1176,3839,992,3507,40,198,797,2767,837,2965
221063,201907,1075,3085,911,2846,68,237,659,2011,727,2248
221065,201907,2615,6780,2293,6209,23,104,2002,5306,2025,5410
221070,201907,3262,10319,2741,9247,312,1029,1714,5924,2026,6953
221080,201907,3528,8623,2840,7597,58,223,2339,6132,2397,6355
221090,201907,1405,3688,1143,3229,14,53,974,2675,988,2728
221093,201907,1341,3793,1237,3568,118,342,855,2421,973,2763
221095,201907,899,2330,749,2096,9,26,608,1670,617,1696
221097,201907,816,2146,622,1790,22,71,459,1259,481,1330
221100,201907,108107,292814,91812,265835,11338,34657,59041,166900,70379,201557
221110,201907,9948,29737,9142,28702,182,934,8130,25159,8312,26093
221120,201907,4656,13149,4177,12349,194,620,3541,10383,3735,11003
221130,201907,5112,13557,3807,10969,797,2178,1817,5291,2614,7469
221135,201907,1591,4327,1426,4095,41,151,1256,3580,1297,3731
221140,201907,1298,3149,1101,2883,10,42,971,2481,981,2523
221150,201907,1088,2697,854,2288,21,92,666,1667,687,1759
221160,201907,761,1903,665,1773,23,41,539,1446,562,1487
221170,201907,971,2838,895,2706,25,80,759,2287,784,2367
230010,201907,3181,8376,2548,7255,72,243,1965,5469,2037,5712
230015,201907,2977,9763,2654,9118,192,771,1843,6260,2035,7031
230020,201907,13069,41421,12314,40212,402,1716,10312,33280,10714,34996
230030,201907,12709,32461,10856,29941,204,662,9486,26048,9690,26710
230040,201907,4474,11647,3729,10411,74,326,3070,8421,3144,8747
230050,201907,2798,8797,2080,7046,337,1103,888,2920,1225,4023
230060,201907,2323,6380,1858,5511,39,178,1479,4288,1518,4466
230070,201907,3883,10579,3165,9138,169,542,2157,6147,2326,6689
230075,201907,9164,29728,8399,28370,399,1900,6780,22368,7179,24268
230080,201907,3030,6340,2310,5440,6,21,2088,4921,2094,4942
230090,201907,4206,10561,3594,9557,157,447,2824,7440,2981,7887
230100,201907,17799,47371,15853,44612,1372,4018,11017,31039,12389,35057
230110,201907,12476,37415,10691,33810,1749,5492,5797,18401,7546,23893
230120,201907,7427,20320,6530,18816,553,1438,4721,13815,5274,15253
230125,201907,3122,8355,2561,7437,84,291,1948,5590,2032,5881
230130,201907,5697,17776,4646,15438,338,1241,3059,9973,3397,11214
230140,201907,3436,10401,2933,9351,116,474,2206,6818,2322,7292
230150,201907,1614,4830,1353,4236,208,551,784,2556,992,3107
230160,201907,6533,17157,5613,15710,208,770,4551,12436,4759,13206
230170,201907,6079,17583,5072,15529,300,946,3663,10984,3963,11930
230180,201907,1662,4634,1410,4137,25,117,1120,3161,1145,3278
230185,201907,4238,12326,3597,11232,265,919,2637,8212,2902,9131
230190,201907,13074,38606,11151,34965,1648,5319,6088,19009,7736,24328
230195,201907,5135,15273,4673,14411,329,1046,3578,10961,3907,12007
230200,201907,5002,13838,4245,12371,151,501,3229,9198,3380,9699
230205,201907,3997,12297,3575,11607,157,636,2708,8639,2865,9275
230210,201907,10407,25376,8789,23128,394,1273,6782,17504,7176,18777
230220,201907,13597,34686,12107,32451,525,1471,10075,26688,10600,28159
230230,201907,6900,20935,6178,19425,395,1279,4522,14102,4917,15381
230240,201907,12591,33939,11133,31575,308,1152,9204,25643,9512,26795
230250,201907,9083,26052,8674,25394,301,1082,6779,19249,7080,20331
230260,201907,14494,44172,12700,40880,1579,5116,7401,24109,8980,29225
230270,201907,7442,20442,5753,17233,507,1495,3816,11471,4323,12966
230280,201907,20586,55235,16810,48823,555,2319,13185,36812,13740,39131
230290,201907,4800,13457,4041,11973,323,851,2994,8919,3317,9770
230300,201907,4707,12894,4320,12331,79,302,3760,10574,3839,10876
230310,201907,4675,13377,3968,12138,143,612,2829,8407,2972,9019
230320,201907,7709,22342,6609,20286,292,1165,4997,15013,5289,16178
230330,201907,4702,12924,3832,11246,178,578,2817,8097,2995,8675
230340,201907,3601,11328,3062,10207,292,1004,2018,6669,2310,7673
230350,201907,18076,50666,16013,47330,1015,3488,10289,30607,11304,34095
230360,201907,2812,7782,2255,6745,145,440,1493,4441,1638,4881
230365,201907,3063,7609,2538,6791,44,214,2139,5644,2183,5858
230370,201907,56525,161122,48321,148372,7988,24846,27121,84992,35109,109838
230380,201907,6441,18006,5087,15450,161,604,3701,11032,3862,11636
230390,201907,3314,9891,2901,9208,116,478,2218,6968,2334,7446
230393,201907,3084,9380,2519,8232,90,499,1931,6026,2021,6525
230395,201907,5797,15824,5051,14545,370,1022,3477,10031,3847,11053
230400,201907,5713,15947,5064,14855,133,650,3964,11223,4097,11873
230410,201907,14440,43088,11846,38149,1032,3570,7837,25139,8869,28709
230420,201907,28014,78580,23054,69479,2984,9343,12719,38116,15703,47459
230423,201907,4778,14237,4154,12955,91,402,3314,10127,3405,10529
230425,201907,5557,17299,5063,16268,430,1445,3574,11438,4004,12883
230426,201907,2687,7202,1973,5777,31,120,1482,4230,1513,4350
230427,201907,1849,5254,1298,4035,67,228,877,2631,944,2859
230428,201907,9590,26317,8377,24412,1163,3417,4914,14173,6077,17590
230430,201907,4788,13686,3846,12050,159,593,2887,8874,3046,9467
230435,201907,5666,15219,4805,13732,579,1646,3014,8574,3593,10220
230440,201907,404338,1024282,336988,921914,39612,114642,206251,557467,245863,672109
230445,201907,4298,11477,3513,10098,198,544,2402,6778,2600,7322
230450,201907,3666,10709,3174,9925,263,1043,2274,6891,2537,7934
230460,201907,2139,5994,1861,5544,75,282,1517,4498,1592,4780
230465,201907,3999,11314,3426,10233,105,437,2510,7201,2615,7638
230470,201907,11192,37338,10050,35156,845,3541,7205,24739,8050,28280
230480,201907,1414,4137,1196,3736,97,385,843,2527,940,2912
230490,201907,2465,6939,2088,6226,181,593,1304,3666,1485,4259
230495,201907,5844,17503,5134,16184,389,1503,3337,10338,3726,11841
230500,201907,9193,30017,8381,28494,302,1258,6734,22772,7036,24030
230510,201907,1644,5109,1226,4142,204,730,556,1849,760,2579
230520,201907,4522,12959,3946,11892,312,927,2763,8280,3075,9207
230523,201907,14784,44177,12030,38173,2816,8894,3180,10663,5996,19557
230526,201907,3897,11135,3271,10005,163,557,2399,7273,2562,7830
230530,201907,5322,16651,4504,15060,335,1232,3210,10630,3545,11862
230533,201907,4211,10604,3599,9559,96,267,2945,7725,3041,7992
230535,201907,5286,14805,4492,13442,222,689,3187,9608,3409,10297
230540,201907,16050,44238,14008,41141,247,1055,11694,33873,11941,34928
230550,201907,20475,55456,16646,48696,1648,5011,10259,29757,11907,34768
230560,201907,7932,19811,6461,17379,67,284,5495,14634,5562,14918
230565,201907,3040,8515,2535,7571,85,374,1907,5572,1992,5946
230570,201907,3534,8986,3027,8319,71,223,2540,6935,2611,7158
230580,201907,10583,28068,9202,26094,340,1062,7672,21564,8012,22626
230590,201907,8960,25872,7432,22983,454,1625,5319,15892,5773,17517
230600,201907,3663,9648,2833,8105,89,280,1927,5540,2016,5820
230610,201907,6651,18451,5887,17197,477,1357,4551,13263,5028,14620
230620,201907,2086,5695,1583,4688,122,401,964,2771,1086,3172
230625,201907,7872,22872,6683,20611,2042,6512,1770,5837,3812,12349
230630,201907,10690,32184,9299,29249,1769,5278,4875,15896,6644,21174
230640,201907,27970,85105,25217,80557,1494,5865,19543,61436,21037,67301
230650,201907,5142,14156,4349,12721,157,661,3448,9792,3605,10453
230655,201907,9431,32376,8913,31416,689,2630,6919,24513,7608,27143
230660,201907,6127,18288,4986,16189,175,903,4011,12718,4186,13621
230670,201907,6095,14755,4496,12112,142,451,3568,9375,3710,9826
230680,201907,2596,7238,2222,6567,158,471,1551,4589,1709,5060
230690,201907,6914,20730,6060,18981,422,1498,3809,11675,4231,13173
230700,201907,9729,25269,8215,22504,344,1021,6134,16354,6478,17375
230710,201907,6802,21516,5888,19574,594,2077,4000,13065,4594,15142
230720,201907,1961,5800,1581,5007,128,394,1041,3213,1169,3607
230725,201907,3895,11926,3458,11068,444,1547,1828,5750,2272,7297
230730,201907,55984,154793,44794,136934,10389,34273,14770,47365,25159,81638
230740,201907,6070,17127,5224,15710,139,577,4164,12385,4303,12962
230750,201907,8414,22732,7042,20424,178,688,5496,15452,5674,16140
230760,201907,11099,29871,9803,27809,618,2040,7237,19978,7855,22018
230763,201907,4606,12976,3919,11673,140,610,3092,8908,3232,9518
230765,201907,41123,114265,34422,102985,5893,18397,15896,47269,21789,65666
230770,201907,25446,64351,21463,58917,2401,6858,13815,37855,16216,44713
230780,201907,6069,21678,5660,20785,812,3042,3351,12591,4163,15633
230790,201907,2978,8695,2641,8118,118,518,1965,5846,2083,6364
230800,201907,7980,25791,7110,23984,822,3074,4210,13879,5032,16953
230810,201907,11826,35527,10519,33351,443,1668,7993,24821,8436,26489
230820,201907,3292,10850,2758,9612,279,1153,1646,5441,1925,6594
230830,201907,7699,21116,6521,19048,166,705,5278,15011,5444,15716
230835,201907,4185,10084,3185,8484,81,254,2596,6790,2677,7044
230837,201907,3110,9690,2684,8904,120,569,2111,6798,2231,7367
230840,201907,8910,26576,7739,24620,625,2057,5643,18011,6268,20068
230850,201907,9451,27788,8021,24912,418,1492,5669,17388,6087,18880
230860,201907,5124,13373,4312,12163,84,298,3701,10322,3785,10620
230870,201907,16568,40992,14297,37229,450,1258,11535,29713,11985,30971
230880,201907,2098,6437,1903,6090,51,275,1480,4597,1531,4872
230890,201907,4520,14676,4158,13947,345,1287,2994,9861,3339,11148
230900,201907,3029,8887,2597,8024,214,743,1697,5091,1911,5834
230910,201907,2976,8131,2435,7229,69,338,1934,5639,2003,5977
230920,201907,4531,12967,3853,11862,156,617,2924,8792,3080,9409
230930,201907,6498,18507,5467,16548,334,1053,3771,11356,4105,12409
230940,201907,7700,20171,6762,18726,192,552,5687,15592,5879,16144
230945,201907,6575,19026,5647,17155,368,1284,3884,11649,4252,12933
230950,201907,6291,15887,5651,15060,134,304,4968,13407,5102,13711
230960,201907,12926,38270,11547,35648,1773,5537,5873,18358,7646,23895
230970,201907,13503,36645,11370,33279,1973,5857,5929,17528,7902,23385
230980,201907,2741,8090,2396,7441,432,1282,1407,4496,1839,5778
230990,201907,1696,4831,1423,4281,77,320,960,2730,1037,3050
231000,201907,2476,6657,2054,5823,76,212,1479,4101,1555,4313
231010,201907,3389,8117,2719,6966,55,200,2305,5711,2360,5911
231020,201907,8025,25719,7185,23970,1277,3991,4129,14276,5406,18267
231025,201907,7446,21067,6519,19513,808,2376,4393,13244,5201,15620
231030,201907,7222,21773,5728,18554,946,3025,2990,9711,3936,12736
231040,201907,3020,8857,2626,8112,108,387,2016,6085,2124,6472
231050,201907,11845,31009,9533,26778,686,1933,6918,19013,7604,20946
231060,201907,2747,7924,2435,7396,78,288,1957,5896,2035,6184
231070,201907,8077,23796,6828,21531,844,2721,4114,12882,4958,15603
231080,201907,3993,11540,3468,10655,144,646,2591,7773,2735,8419
231085,201907,6457,16186,5224,14661,230,641,3996,11200,4226,11841
231090,201907,4343,11480,3231,9279,105,412,2253,6242,2358,6654
231095,201907,2179,6629,1741,5651,140,476,1178,3802,1318,4278
231100,201907,3028,8875,2505,7881,137,490,1879,5854,2016,6344
231110,201907,3518,10605,3245,10080,135,526,2424,7388,2559,7914
231120,201907,2189,6530,1851,5928,91,353,1282,4034,1373,4387
231123,201907,1914,5042,1600,4490,79,214,1148,3184,1227,3398
231126,201907,5592,15597,4462,13376,239,743,3216,9463,3455,10206
231130,201907,20639,54358,17304,49993,1176,4303,12413,35093,13589,39396
231135,201907,4174,11781,3469,10410,157,558,2479,7288,2636,7846
231140,201907,16653,47541,13478,41819,702,2957,9272,27856,9974,30813
231150,201907,5535,15654,4369,13278,741,2281,1960,6057,2701,8338
231160,201907,6010,18609,5358,17358,872,2662,3020,10047,3892,12709
231170,201907,4425,13121,3616,11489,213,768,2446,7506,2659,8274
231180,201907,14131,40822,11685,35491,3108,9251,4150,12854,7258,22105
231190,201907,3835,10932,3230,9795,100,441,2492,7326,2592,7767
231195,201907,4779,14752,4008,13119,217,847,2943,9428,3160,10275
231200,201907,7857,24884,6860,22772,263,1305,5231,16809,5494,18114
231210,201907,4810,14302,4116,13103,191,708,3059,9511,3250,10219
231220,201907,12012,31942,9413,26891,487,1516,6728,18467,7215,19983
231230,201907,9209,29468,8198,27706,478,1919,6055,20429,6533,22348
231240,201907,11617,34474,10250,31780,1621,4965,5918,18508,7539,23473
231250,201907,2060,5383,1339,3755,107,289,790,2168,897,2457
231260,201907,3243,9344,2825,8673,288,851,1869,5875,2157,6726
231270,201907,6485,17035,5339,15138,136,533,4038,11182,4174,11715
231280,201907,1672,5320,1565,5113,112,376,1146,3712,1258,4088
231290,201907,37578,113663,31677,101297,5520,17684,14427,45861,19947,63545
231300,201907,4039,11320,3185,9553,249,789,2026,5975,2275,6764
231310,201907,7230,19135,5833,16497,506,1464,3900,10828,4406,12292
231320,201907,7742,21484,6086,18460,92,428,4703,14069,4795,14497
231325,201907,2508,6781,2041,6027,200,527,1320,3974,1520,4501
231330,201907,9660,29454,8024,26123,1482,4672,4214,14173,5696,18845
231335,201907,5781,15204,4858,13688,84,377,4232,11726,4316,12103
231340,201907,17719,55463,15850,52124,1394,4686,11227,37289,12621,41975
231350,201907,15777,43070,14317,41008,345,1191,12726,36093,13071,37284
231355,201907,4414,13287,3940,12426,232,814,2998,9388,3230,10202
231360,201907,7401,22633,6423,20883,392,1414,4854,15724,5246,17138
231370,201907,2222,6062,1768,5236,36,122,1361,3986,1397,4108
231375,201907,4447,13932,4045,13245,152,697,3311,10686,3463,11383
231380,201907,5933,16153,5421,15464,196,538,4399,12714,4595,13252
231390,201907,3381,9954,3028,9365,158,592,2183,6555,2341,7147
231395,201907,4008,11972,3344,10894,525,1677,1841,6134,2366,7811
231400,201907,9298,27087,7927,24518,311,1271,6006,18171,6317,19442
231410,201907,14687,46149,13250,43736,755,2824,10366,33763,11121,36587
240010,201907,2513,6769,1942,5698,205,652,1163,3307,1368,3959
240020,201907,11779,33821,10141,30906,750,2738,6644,19840,7394,22578
240030,201907,2793,7083,2566,6746,114,349,2225,5752,2339,6101
240040,201907,822,2329,664,2037,25,93,482,1427,507,1520
240050,201907,3122,8418,2598,7458,48,142,2053,5790,2101,5932
240060,201907,1385,3745,1170,3350,36,117,934,2625,970,2742
240070,201907,2121,6276,1972,5969,205,659,1450,4285,1655,4944
240080,201907,2841,7771,2394,6938,57,222,1841,5209,1898,5431
240090,201907,2248,5599,1819,4865,21,71,1517,3996,1538,4067
240100,201907,9680,24423,7881,21052,278,857,6130,15801,6408,16658
240110,201907,4417,12800,3804,11670,205,768,2735,8211,2940,8979
240120,201907,3530,9560,2614,8494,208,785,1753,5825,1961,6610
240130,201907,3607,7606,3039,6851,42,119,2760,6113,2802,6232
240140,201907,1907,5719,1624,5180,181,639,1058,3294,1239,3933
240145,201907,6528,18497,5396,16460,783,2437,3092,9514,3875,11951
240150,201907,875,2586,798,2429,54,189,618,1819,672,2008
240160,201907,1439,4377,1218,3940,53,259,887,2850,940,3109
240165,201907,953,2623,807,2338,52,170,623,1764,675,1934
240170,201907,2372,6607,2012,5943,215,714,1324,3776,1539,4490
240180,201907,3061,9087,2446,7848,556,1717,1137,3818,1693,5535
240185,201907,1242,3989,1130,3808,64,258,917,3052,981,3310
240190,201907,1028,3052,906,2845,27,122,748,2329,775,2451
240200,201907,10755,28271,8782,24799,964,2911,4885,13537,5849,16448
240210,201907,2975,7569,2586,6978,30,142,2181,5685,2211,5827
240220,201907,7378,22316,6609,21101,407,1781,5039,15698,5446,17479
240230,201907,5833,14927,4718,13042,221,618,3710,10215,3931,10833
240240,201907,1900,5500,1185,3714,126,417,456,1247,582,1664
240250,201907,2847,7695,2559,7267,135,346,2095,5989,2230,6335
240260,201907,13753,41089,11952,37929,1711,5211,7374,24446,9085,29657
240270,201907,2226,6653,1957,6230,112,349,1470,4777,1582,5126
240280,201907,1667,4311,1420,3915,53,158,1135,3077,1188,3235
240290,201907,1208,3531,987,3033,31,128,681,1959,712,2087
240300,201907,2167,5650,1550,4450,72,223,1004,2800,1076,3023
240310,201907,8692,23292,6963,20187,889,2678,3689,10555,4578,13233
240320,201907,2048,5579,1487,4476,30,140,1121,3220,1151,3360
240325,201907,30045,82386,23480,70653,4827,15197,9065,27701,13892,42898
240330,201907,1671,4572,1298,3853,46,160,904,2564,950,2724
240340,201907,1972,4632,1620,4075,48,116,1323,3243,1371,3359
240350,201907,2078,5454,1926,5279,28,123,1728,4724,1756,4847
240360,201907,8301,23549,7446,22176,943,2787,4934,15038,5877,17825
240370,201907,1933,5189,1507,4298,80,231,1026,2862,1106,3093
240375,201907,899,2289,753,2006,29,109,601,1522,630,1631
240380,201907,2259,6413,1656,5063,135,397,986,2940,1121,3337
240390,201907,986,2488,678,1873,27,67,431,1115,458,1182
240400,201907,1377,3462,1077,2918,35,132,747,1904,782,2036
240410,201907,563,1753,474,1553,50,214,287,886,337,1100
240420,201907,4616,16444,4063,15175,513,2295,2274,8294,2787,10589
240430,201907,3355,9003,2833,7984,213,677,2021,5474,2234,6151
240440,201907,2598,5811,2176,5210,148,332,1697,3994,1845,4326
240450,201907,4390,12259,3513,10621,337,1176,2088,6031,2425,7207
240460,201907,2929,8440,2679,8033,278,892,2057,6132,2335,7024
240470,201907,3542,10753,2745,9109,427,1386,1476,4993,1903,6379
240480,201907,554,1545,386,1175,29,96,174,515,203,611
240485,201907,2091,6021,1717,5285,149,467,1147,3532,1296,3999
240490,201907,1681,4284,1317,3616,73,175,1005,2767,1078,2942
240500,201907,2107,5730,1852,5328,74,237,1542,4398,1616,4635
240510,201907,1684,4473,1504,4216,76,263,1244,3391,1320,3654
240520,201907,1339,3414,1064,3018,48,154,827,2312,875,2466
240530,201907,2029,6088,1863,5804,110,368,1476,4553,1586,4921
240540,201907,2232,5608,1941,5156,66,157,1672,4407,1738,4564
240550,201907,688,1947,625,1826,28,111,486,1363,514,1474
240560,201907,3274,8651,2797,7999,276,716,2046,5949,2322,6665
240570,201907,2855,7528,1908,5411,278,831,789,2053,1067,2884
240580,201907,7863,23104,7087,21700,543,1664,5665,17354,6208,19018
240590,201907,699,1876,613,1727,12,45,468,1295,480,1340
240600,201907,1802,4864,1319,3854,54,184,876,2454,930,2638
240610,201907,4239,11640,3576,10401,143,509,2680,7625,2823,8134
240615,201907,1138,3102,903,2628,56,206,627,1719,683,1925
240620,201907,1833,5182,1560,4689,85,245,1248,3721,1333,3966
240630,201907,2053,5946,1851,5579,131,332,1294,4032,1425,4364
240640,201907,925,2502,737,2178,29,130,539,1546,568,1676
240650,201907,3953,10989,3470,10105,209,619,2660,7685,2869,8304
240660,201907,2982,7769,2662,7344,58,187,2408,6618,2466,6805
240670,201907,2424,6826,1985,5926,141,438,1287,3758,1428,4196
240680,201907,1617,4359,1295,3793,58,197,965,2736,1023,2933
240690,201907,946,2422,746,2085,13,55,603,1623,616,1678
240700,201907,2375,6903,1991,6205,63,247,1565,4774,1628,5021
240710,201907,16163,42324,13581,37767,2097,5659,7965,22294,10062,27953
240720,201907,5195,13228,4508,12170,501,1432,3109,8243,3610,9675
240725,201907,1089,3155,841,2638,37,133,559,1698,596,1831
240730,201907,2113,6013,1791,5383,77,253,1361,4017,1438,4270
240740,201907,1829,4957,1503,4350,50,204,1096,2991,1146,3195
240750,201907,2239,7452,1871,6656,268,1060,1002,3579,1270,4639
240760,201907,1532,3736,1085,3047,54,117,845,2418,899,2535
240770,201907,3189,8825,2706,8127,141,562,2121,6210,2262,6772
240780,201907,5164,14173,4116,12397,521,1593,2491,7651,3012,9244
240790,201907,852,2447,706,2149,14,56,527,1570,541,1626
240800,201907,44854,111802,35546,97283,4949,14124,17672,48139,22621,62263
240810,201907,83947,223740,72351,203975,11391,32627,42788,119439,54179,152066
240820,201907,5732,17400,4947,15949,731,2394,2959,9667,3690,12061
240830,201907,8700,25338,7884,24055,285,1280,6410,19165,6695,20445
240840,201907,1133,2865,897,2462,43,116,625,1648,668,1764
240850,201907,1257,3509,913,2760,42,138,525,1549,567,1687
240860,201907,1232,3357,927,2796,17,77,684,1950,701,2027
240870,201907,1130,2876,870,2419,106,306,521,1434,627,1740
240880,201907,1276,4045,1143,3782,83,346,906,2928,989,3274
240890,201907,4557,12536,3442,10352,507,1652,1687,4865,2194,6517
240895,201907,2687,8528,2440,8153,162,592,2056,6844,2218,7436
240910,201907,3197,8944,2767,8111,62,217,2248,6490,2310,6707
240920,201907,819,2341,697,2122,67,186,391,1242,458,1428
240930,201907,3704,8533,3085,7772,193,281,2354,6172,2547,6453
240933,201907,1782,4326,1452,3825,48,189,1236,3194,1284,3383
240940,201907,6135,15267,4867,13095,366,1033,3295,8555,3661,9588
240950,201907,969,2912,855,2691,32,141,698,2141,730,2282
240960,201907,693,2112,615,1950,31,115,475,1467,506,1582
240970,201907,1860,4832,1517,4235,54,196,1258,3415,1312,3611
240980,201907,3144,9550,2843,8993,146,607,2243,6919,2389,7526
240990,201907,2588,7378,2336,6875,281,924,1636,4632,1917,5556
241000,201907,945,2499,755,2131,38,90,543,1532,581,1622
241010,201907,2795,8948,2567,8441,173,697,1885,6059,2058,6756
241020,201907,2049,5543,1507,4423,160,473,948,2722,1108,3195
241025,201907,1723,4966,1360,4247,52,215,958,2939,1010,3154
241030,201907,2511,7930,2045,6931,241,837,1324,4471,1565,5308
241040,201907,2263,7196,2022,6788,98,465,1617,5358,1715,5823
241050,201907,1303,3620,1058,3156,42,143,794,2308,836,2451
241060,201907,724,2064,647,1897,34,107,452,1269,486,1376
241070,201907,644,1772,567,1638,18,61,442,1227,460,1288
241080,201907,1121,3196,866,2682,9,39,634,1944,643,1983
241090,201907,2024,5864,1622,5180,51,259,1274,3998,1325,4257
241100,201907,1148,3247,900,2704,60,184,614,1786,674,1970
241105,201907,1032,3131,831,2739,264,854,260,899,524,1753
241110,201907,910,2617,684,2120,37,137,455,1342,492,1479
241120,201907,7530,21547,6437,19587,1035,3095,3628,11386,4663,14481
241140,201907,3261,8720,2623,7427,162,459,1899,5251,2061,5710
241142,201907,761,2064,559,1662,32,118,317,864,349,982
241150,201907,5891,15592,5236,14479,174,606,4256,11483,4430,12089
241160,201907,1273,3461,1061,3075,140,416,700,1965,840,2381
241170,201907,1317,3364,1151,3086,36,138,951,2419,987,2557
241180,201907,1027,2675,740,2112,70,191,430,1195,500,1386
241190,201907,1108,2922,911,2527,22,81,665,1764,687,1845
241200,201907,18944,50330,16388,46339,2675,7664,9395,26528,12070,34192
241210,201907,1374,3780,1009,3040,118,399,577,1677,695,2076
241220,201907,8731,26274,7647,24378,1881,5941,3444,11491,5325,17432
241230,201907,2898,7762,2576,7237,103,350,2135,5865,2238,6215
241240,201907,1188,3369,709,2266,60,206,330,1047,390,1253
241250,201907,5209,15526,4290,13745,184,834,3156,9706,3340,10540
241255,201907,2068,6684,1821,6140,129,552,1316,4294,1445,4846
241260,201907,4855,12850,3797,11032,102,435,2948,8335,3050,8770
241270,201907,1773,5168,1459,4544,130,453,1011,3095,1141,3548
241280,201907,2144,5440,1860,4918,71,198,1548,4033,1619,4231
241290,201907,3441,8444,2574,6999,85,321,2004,5260,2089,5581
241300,201907,1439,3901,1156,3390,44,152,771,2197,815,2349
241310,201907,2047,5231,1743,4811,18,85,1464,4038,1482,4123
241320,201907,999,3223,823,2861,92,372,515,1785,607,2157
241330,201907,1802,4626,1395,4109,24,99,1181,3473,1205,3572
241335,201907,3087,8751,2764,8148,98,351,2298,6693,2396,7044
241340,201907,1616,4664,1261,3904,268,843,524,1599,792,2442
241350,201907,1982,5806,1760,5399,108,371,1331,4005,1439,4376
241355,201907,1306,3548,1083,3124,19,69,833,2363,852,2432
241360,201907,2077,5397,1563,4336,51,153,1127,3016,1178,3169
241370,201907,1356,3762,1049,3139,59,197,707,2016,766,2213
241380,201907,632,1780,500,1512,78,224,265,823,343,1047
241390,201907,2714,8169,2436,7729,179,580,1882,5990,2061,6570
241400,201907,3498,9757,3147,9237,173,564,2552,7418,2725,7982
241410,201907,2351,7023,1901,6093,348,1141,967,3102,1315,4243
241415,201907,1633,4855,1340,4270,67,264,960,2983,1027,3247
241420,201907,2198,7240,1869,6626,460,1755,816,2890,1276,4645
241430,201907,574,1608,395,1178,27,95,249,711,276,806
241440,201907,7302,23199,6575,21875,397,1587,5163,16883,5560,18470
241445,201907,1088,2817,986,2688,24,59,887,2471,911,2530
241450,201907,2666,6772,2318,6209,324,764,1611,4377,1935,5141
241460,201907,3647,10010,3035,8710,178,561,2136,5953,2314,6514
241470,201907,1423,3725,1130,3289,27,98,925,2666,952,2764
241475,201907,1195,3410,938,2916,29,150,677,2003,706,2153
241480,201907,2809,8901,2363,7943,788,2628,700,2669,1488,5297
241490,201907,669,1615,534,1419,23,68,360,924,383,992
241500,201907,822,2342,722,2210,9,36,640,1973,649,2009
250010,201907,2612,7812,2154,6840,58,234,1556,4798,1614,5032
250020,201907,1585,4307,1115,3375,42,112,809,2410,851,2522
250030,201907,6831,18895,6105,17752,500,1529,4594,13157,5094,14686
250040,201907,4061,12555,3516,11545,229,912,2497,8014,2726,8926
250050,201907,3506,9578,3206,9144,120,442,2624,7394,2744,7836
250053,201907,1162,3357,1051,3178,71,230,773,2343,844,2573
250057,201907,654,2316,618,2260,6,28,555,2062,561,2090
250060,201907,5364,14348,4895,13752,366,984,3902,11073,4268,12057
250070,201907,3962,11259,3460,10362,54,243,2743,8003,2797,8246
250073,201907,744,2015,611,1805,5,24,501,1426,506,1450
250077,201907,2225,6044,1671,5117,72,252,1222,3708,1294,3960
250080,201907,4659,11950,4085,11189,84,337,3517,9477,3601,9814
250090,201907,3140,7858,2770,7359,57,185,2388,6218,2445,6403
250100,201907,3674,11353,3374,10776,173,670,2666,8275,2839,8945
250110,201907,4859,13671,4382,12974,316,1150,3377,9742,3693,10892
250115,201907,565,1617,475,1471,11,62,351,1059,362,1121
250120,201907,1876,5481,1562,4958,37,168,1221,3845,1258,4013
250130,201907,5489,15285,4660,14068,82,438,3846,11393,3928,11831
250135,201907,1181,3231,1057,3029,14,56,954,2720,968,2776
250140,201907,2176,6539,2048,6362,129,592,1722,5201,1851,5793
250150,201907,4811,15205,4339,14348,166,733,3455,11189,3621,11922
250153,201907,1446,3756,1204,3391,30,100,973,2695,1003,2795
250157,201907,1729,5203,1543,4831,86,326,1200,3681,1286,4007
250160,201907,3869,9786,3122,8764,33,141,2788,7777,2821,7918
250170,201907,1812,4671,1620,4393,33,123,1389,3701,1422,3824
250180,201907,18989,47584,16525,44347,869,2743,12699,33279,13568,36022
250190,201907,4026,11014,3418,10056,390,1114,2241,6519,2631,7633
250200,201907,1902,5165,1626,4742,53,176,1375,3983,1428,4159
250205,201907,822,2611,716,2433,24,123,590,1981,614,2104
250210,201907,1584,4809,1428,4549,52,253,1129,3521,1181,3774
250215,201907,1581,4463,1299,3989,73,248,786,2381,859,2629
250220,201907,665,1882,542,1688,39,150,348,1023,387,1173
250230,201907,1590,3660,1155,2999,25,87,914,2280,939,2367
250240,201907,2257,6843,2008,6403,39,168,1706,5372,1745,5540
250250,201907,4572,12729,3967,11831,95,307,3327,9916,3422,10223
250260,201907,1709,4759,1428,4285,43,137,1129,3354,1172,3491
250270,201907,1199,3630,1076,3475,68,228,803,2685,871,2913
250280,201907,3248,9228,2853,8604,105,331,2252,6767,2357,7098
250290,201907,1620,4271,1374,3930,27,81,1084,3125,1111,3206
250300,201907,5437,14707,4989,14182,197,867,4128,11294,4325,12161
250310,201907,1143,3200,969,2904,35,116,744,2190,779,2306
250320,201907,10780,25441,9449,23845,326,949,8223,20436,8549,21385
250330,201907,2311,6612,1949,6134,116,412,1546,4810,1662,5222
250340,201907,1101,2817,967,2633,7,22,859,2313,866,2335
250350,201907,4013,11236,3614,10617,147,382,2913,8788,3060,9170
250355,201907,1968,6018,1755,5721,28,156,1585,5137,1613,5293
250360,201907,1772,4988,1605,4737,36,121,1311,3853,1347,3974
250370,201907,12740,33662,10644,30483,334,1263,8675,24360,9009,25623
250375,201907,1169,3038,955,2772,6,18,889,2610,895,2628
250380,201907,1608,4209,1479,4038,34,144,1262,3318,1296,3462
250390,201907,1771,4608,1506,4175,110,286,1141,3161,1251,3447
250400,201907,70464,173999,50742,143326,13793,41014,15688,46140,29481,87154
250403,201907,1673,4767,1519,4563,70,352,1194,3426,1264,3778
250407,201907,1216,3090,990,2759,60,141,722,2039,782,2180
250410,201907,597,1644,524,1523,3,18,436,1244,439,1262
250415,201907,1815,5192,1610,4849,39,171,1363,4065,1402,4236
250420,201907,1225,3464,1107,3306,14,64,1032,3078,1046,3142
250430,201907,6231,15523,5347,14306,156,506,4410,11563,4566,12069
250435,201907,1555,4333,1265,3827,22,97,945,2800,967,2897
250440,201907,4506,12017,3871,11231,73,259,3374,9758,3447,10017
250450,201907,1804,4887,1515,4487,35,142,1250,3676,1285,3818
250460,201907,7303,19801,6528,18681,354,1061,5295,15094,5649,16155
250470,201907,1562,4025,1293,3623,54,176,993,2710,1047,2886
250480,201907,4115,11115,3563,10458,17,73,3224,9565,3241,9638
250485,201907,728,1666,536,1397,35,72,387,975,422,1047
250490,201907,4929,12143,4430,11549,195,627,3838,9805,4033,10432
250500,201907,1977,5449,1756,5079,79,256,1424,4112,1503,4368
250510,201907,5461,13732,4719,12760,89,271,4146,11234,4235,11505
250520,201907,1798,4942,1557,4593,138,442,1088,3178,1226,3620
250523,201907,2226,5461,1987,5158,76,323,1660,4162,1736,4485
250527,201907,1664,4338,1516,4159,32,93,1320,3644,1352,3737
250530,201907,613,1645,529,1531,9,26,462,1332,471,1358
250535,201907,1346,3980,1235,3765,28,121,997,2948,1025,3069
250540,201907,2985,6879,2458,6285,72,144,2144,5566,2216,5710
250550,201907,760,2465,669,2286,20,89,515,1717,535,1806
250560,201907,1664,4641,1488,4388,47,182,1231,3526,1278,3708
250570,201907,2633,7912,2264,7239,82,334,1781,5584,1863,5918
250580,201907,1050,2746,948,2599,54,178,774,2086,828,2264
250590,201907,821,2322,726,2181,19,93,603,1793,622,1886
250600,201907,8150,20979,6818,19223,316,968,5592,15665,5908,16633
250610,201907,3024,8447,2724,8009,114,431,2254,6518,2368,6949
250620,201907,734,1984,619,1777,14,61,470,1312,484,1373
250625,201907,2551,7386,2287,6959,43,233,1898,5595,1941,5828
250630,201907,9625,27334,8024,24365,885,2780,5217,15435,6102,18215
250640,201907,3309,9371,3036,8987,77,372,2573,7421,2650,7793
250650,201907,928,2287,773,2075,19,60,660,1724,679,1784
250660,201907,1578,3973,1347,3654,41,124,1129,2986,1170,3110
250670,201907,2327,7286,2142,6969,55,252,1836,5836,1891,6088
250680,201907,5946,13635,5269,12856,95,346,4765,11379,4860,11725
250690,201907,6734,15464,5852,14330,105,275,5197,12592,5302,12867
250700,201907,4327,12237,3792,11404,334,1018,2793,8316,3127,9334
250710,201907,4432,12782,3827,11944,297,1038,2759,8581,3056,9619
250720,201907,2762,7326,2495,6941,41,194,2194,5999,2235,6193
250730,201907,4078,10912,3594,10255,114,415,2969,8211,3083,8626
250740,201907,1965,4981,1602,4486,103,297,1235,3421,1338,3718
250750,201907,99337,251887,85733,232547,7532,22136,61115,162295,68647,184431
250760,201907,2362,6117,2068,5640,103,307,1605,4242,1708,4549
250770,201907,3911,12015,3547,11511,349,1165,2552,8283,2901,9448
250780,201907,1718,4702,1443,4186,75,260,1058,2989,1133,3249
250790,201907,2440,7340,2124,6869,200,770,1394,4410,1594,5180
250800,201907,2462,6568,2125,6021,88,184,1741,4969,1829,5153
250810,201907,1275,3450,1036,3094,24,65,878,2642,902,2707
250820,201907,1917,5476,1794,5335,42,187,1623,4787,1665,4974
250830,201907,5717,17160,4800,15322,321,1205,3256,10098,3577,11303
250840,201907,792,2504,670,2253,19,77,482,1629,501,1706
250850,201907,1804,5462,1632,5163,38,195,1352,4166,1390,4361
250855,201907,954,2786,826,2568,65,224,614,1893,679,2117
250860,201907,3081,9359,2586,8468,478,1636,1394,4550,1872,6186
250870,201907,1045,2865,882,2588,36,132,709,2051,745,2183
250880,201907,1585,4127,1304,3712,136,386,917,2606,1053,2992
250890,201907,9845,26579,8928,25305,447,1886,7147,19246,7594,21132
250900,201907,2795,7996,2398,7245,74,271,2005,5931,2079,6202
250905,201907,2341,6734,2144,6442,50,211,1919,5736,1969,5947
250910,201907,5929,14807,4868,13562,108,389,4107,11501,4215,11890
250915,201907,2015,4825,1485,4251,13,30,1332,3875,1345,3905
250920,201907,3484,8953,3054,8285,329,836,2199,5891,2528,6727
250930,201907,2155,5881,1973,5633,57,229,1698,4738,1755,4967
250933,201907,1159,3450,1026,3197,20,109,770,2324,790,2433
250937,201907,712,1937,592,1736,23,83,432,1278,455,1361
250939,201907,1732,4700,1510,4381,61,211,1192,3403,1253,3614
250940,201907,3845,10478,3418,9890,49,191,2949,8472,2998,8663
250950,201907,1671,4292,1346,3876,22,90,1136,3233,1158,3323
250960,201907,1098,3250,966,3037,24,128,785,2370,809,2498
250970,201907,8311,21793,7257,20069,297,962,5823,15728,6120,16690
250980,201907,2478,6650,2229,6255,43,167,1870,5108,1913,5275
250990,201907,1988,6164,1689,5600,74,334,1251,4081,1325,4415
251000,201907,2083,5851,1705,5225,36,153,1406,4264,1442,4417
251010,201907,2619,7403,2381,7024,26,114,2155,6330,2181,6444
251020,201907,1668,4494,1511,4260,35,148,1324,3654,1359,3802
251030,201907,998,2684,834,2373,34,98,578,1608,612,1706
251040,201907,1846,5346,1562,4853,48,228,1220,3741,1268,3969
251050,201907,1098,2991,916,2642,47,161,659,1827,706,1988
251060,201907,1063,2282,789,1942,10,46,646,1539,656,1585
251065,201907,453,1245,364,1094,12,34,261,755,273,789
251070,201907,739,1987,635,1842,11,39,531,1524,542,1563
251080,201907,18687,48407,15386,43435,1849,5541,10003,28196,11852,33737
251090,201907,2612,7636,2227,6920,50,184,1828,5643,1878,5827
251100,201907,793,2500,711,2355,27,105,546,1744,573,1849
251110,201907,1690,4603,1460,4183,54,158,1119,3173,1173,3331
251120,201907,7024,20348,5992,19012,259,1075,4713,14776,4972,15851
251130,201907,3935,8963,3495,8464,151,385,3071,7386,3222,7771
251140,201907,4237,11923,3829,11329,88,354,3164,9234,3252,9588
251150,201907,2700,7859,2432,7432,116,490,1952,5783,2068,6273
251160,201907,2071,6148,1824,5791,91,355,1506,4713,1597,5068
251170,201907,1524,4228,1366,4035,42,168,1178,3450,1220,3618
251180,201907,2605,7123,2170,6523,183,543,1437,4288,1620,4831
251190,201907,4335,11393,4011,11018,51,248,3631,9771,3682,10019
251200,201907,4192,12483,3771,11933,91,383,3251,10314,3342,10697
251203,201907,933,3063,870,2928,31,134,654,2141,685,2275
251207,201907,1075,3006,843,2604,18,93,586,1753,604,1846
251210,201907,7442,19339,6054,17506,275,718,4610,13483,4885,14201
251220,201907,1180,2897,911,2524,50,119,706,1983,756,2102
251230,201907,4656,12909,4034,11859,138,535,3188,9107,3326,9642
251240,201907,3619,10027,3018,9052,152,490,2257,6601,2409,7091
251250,201907,9931,27162,8815,25290,840,2549,6391,17734,7231,20283
251260,201907,469,1391,430,1317,13,65,331,976,344,1041
251270,201907,4180,13075,3759,12512,105,433,3127,10578,3232,11011
251272,201907,1345,3686,1220,3508,42,180,1036,2872,1078,3052
251274,201907,893,2516,735,2245,53,194,495,1431,548,1625
251275,201907,1236,3455,1057,3178,46,217,788,2259,834,2476
251276,201907,1342,3593,1177,3379,33,165,953,2648,986,2813
251278,201907,563,1600,498,1496,37,106,370,1114,407,1220
251280,201907,2247,6231,2009,5848,52,205,1658,4731,1710,4936
251290,201907,5823,14069,5385,13511,174,629,4678,11273,4852,11902
251300,201907,812,2433,752,2345,9,31,636,1987,645,2018
251310,201907,2779,8008,2429,7444,60,310,1914,5692,1974,6002
251315,201907,1691,5346,1557,5107,68,238,1170,3784,1238,4022
251320,201907,1646,4364,1159,3521,33,116,838,2522,871,2638
251330,201907,2026,4767,1685,4363,24,86,1524,3963,1548,4049
251335,201907,1016,3115,924,2972,25,95,789,2489,814,2584
251340,201907,3661,9041,2918,8013,120,365,2171,5844,2291,6209
251350,201907,1072,3154,954,2959,30,136,790,2383,820,2519
251360,201907,1815,5125,1491,4679,23,102,1277,4008,1300,4110
251365,201907,702,1985,560,1686,10,34,429,1285,439,1319
251370,201907,22803,62133,20096,58288,2389,7194,13171,38385,15560,45579
251380,201907,1182,3432,1055,3212,19,111,881,2578,900,2689
251385,201907,726,1890,571,1616,16,50,424,1154,440,1204
251390,201907,6407,19075,5610,17746,589,2003,3526,11065,4115,13068
251392,201907,978,2685,809,2423,28,134,625,1821,653,1955
251394,201907,598,1772,488,1573,24,100,364,1144,388,1244
251396,201907,701,1893,598,1719,18,48,409,1157,427,1205
251398,201907,924,2396,665,1928,18,77,501,1409,519,1486
251400,201907,1189,3003,968,2692,28,98,749,1999,777,2097
251410,201907,1506,3559,1238,3171,22,98,1057,2609,1079,2707
251420,201907,1916,5160,1583,4774,45,175,1227,3654,1272,3829
251430,201907,1530,4712,1370,4444,33,162,1181,3793,1214,3955
251440,201907,1110,3137,908,2748,32,99,719,2181,751,2280
251445,201907,1502,4337,1396,4179,44,187,1158,3352,1202,3539
251450,201907,4392,13091,3954,12424,95,419,3295,10234,3390,10653
251455,201907,903,2731,815,2572,29,112,615,1914,644,2026
251460,201907,904,2608,802,2441,23,83,657,1995,680,2078
251465,201907,440,1310,377,1175,6,27,280,857,286,884
251470,201907,1166,3249,864,2613,75,248,528,1519,603,1767
251480,201907,996,2640,828,2345,21,91,631,1708,652,1799
251490,201907,1890,5082,1500,4536,57,187,1096,3307,1153,3494
251500,201907,1912,5484,1762,5261,48,197,1541,4543,1589,4740
251510,201907,2679,8138,2230,7214,124,456,1461,4606,1585,5062
251520,201907,953,2538,724,2103,69,186,469,1332,538,1518
251530,201907,14252,34698,11722,31516,122,685,10364,27316,10486,28001
251540,201907,2814,8347,2577,7898,109,427,2073,6200,2182,6627
251550,201907,3713,8927,2966,7973,82,217,2476,6642,2558,6859
251560,201907,576,1727,507,1614,74,246,334,1016,408,1262
251570,201907,910,2634,756,2309,21,94,577,1706,598,1800
251580,201907,1917,4599,1707,4292,64,219,1463,3549,1527,3768
251590,201907,1598,4084,1359,3804,62,196,1086,2937,1148,3133
251593,201907,885,2661,820,2552,85,284,530,1597,615,1881
251597,201907,2078,5841,1894,5597,26,108,1659,4831,1685,4939
251600,201907,6366,17388,5652,16285,172,566,4718,13382,4890,13948
251610,201907,3302,9396,2811,8475,300,869,1897,5766,2197,6635
251615,201907,1229,3097,993,2716,23,70,784,2095,807,2165
251620,201907,18263,42890,14380,38193,192,644,12021,32390,12213,33034
251630,201907,4663,11088,3776,9870,202,584,2906,7484,3108,8068
251640,201907,2069,5865,1870,5508,41,205,1593,4552,1634,4757
251650,201907,4070,10811,3559,10169,137,453,3032,8630,3169,9083
251660,201907,3453,10345,3043,9607,85,409,2517,7775,2602,8184
251670,201907,4106,11565,3617,10884,51,266,3200,9520,3251,9786
251675,201907,658,1909,592,1822,87,285,383,1181,470,1466
251680,201907,2558,6903,2134,6329,43,165,1707,5045,1750,5210
251690,201907,3169,9007,2683,8138,85,273,2000,5959,2085,6232
251700,201907,1953,5779,1722,5484,45,214,1457,4538,1502,4752
251710,201907,787,2068,540,1545,50,174,300,842,350,1016
251720,201907,1322,3773,1085,3347,26,112,827,2470,853,2582
251740,201907,620,1750,497,1514,35,140,349,1013,384,1153
260005,201907,29558,62768,24244,55948,1775,4162,18411,41554,20186,45716
260010,201907,10010,26515,8262,23699,497,1517,4935,14236,5432,15753
260020,201907,6768,16090,5819,14694,131,570,4810,11910,4941,12480
260030,201907,6512,17025,5527,15518,180,590,4428,12312,4608,12902
260040,201907,7782,20893,6439,18790,571,1622,4272,12723,4843,14345
260050,201907,13394,35507,11533,33422,236,864,10363,30201,10599,31065
260060,201907,3937,10089,3390,9195,184,490,2677,7207,2861,7697
260070,201907,10447,26750,8955,24540,445,1521,6989,18643,7434,20164
260080,201907,6519,15060,5706,13925,127,410,4731,11271,4858,11681
260090,201907,4819,12523,4301,11837,578,1568,2935,8150,3513,9718
260100,201907,3060,8299,2600,7603,75,317,2097,6009,2172,6326
260105,201907,5099,13827,4526,13028,142,522,3711,10515,3853,11037
260110,201907,22414,61495,20044,58067,1104,3673,16316,46526,17420,50199
260120,201907,14458,39262,12148,35709,1638,4757,7402,22182,9040,26939
260130,201907,3006,7955,2693,7472,204,608,1993,5416,2197,6024
260140,201907,13135,30152,11277,27851,634,1781,9297,22566,9931,24347
260150,201907,3552,8437,3051,7815,106,350,2613,6572,2719,6922
260160,201907,6631,17440,5590,16112,110,451,4909,14236,5019,14687
260170,201907,18807,46313,16034,42416,1272,3298,12272,32217,13544,35515
260180,201907,3382,9285,2945,8684,94,355,2491,7202,2585,7557
260190,201907,18464,37439,15506,33952,190,547,13584,29053,13774,29600
260200,201907,11079,26804,9567,24877,454,1108,8033,20999,8487,22107
260210,201907,11889,33932,10058,30931,354,1404,7963,24274,8317,25678
260220,201907,10351,25182,9567,24172,191,657,8360,20712,8551,21369
260230,201907,10650,26614,9284,24738,229,744,7715,20188,7944,20932
260240,201907,2724,8149,2382,7500,152,531,1813,5659,1965,6190
260250,201907,2194,5856,1920,5441,116,295,1443,4060,1559,4355
260260,201907,12899,34104,11416,31737,459,1586,8941,24263,9400,25849
260270,201907,4071,10207,3571,9569,146,574,2888,7517,3034,8091
260280,201907,12891,39082,11575,37235,535,2239,9710,30815,10245,33054
260290,201907,39083,102061,33885,94184,3909,11126,22361,61572,26270,72698
260300,201907,9817,26321,8497,24477,247,1030,7017,20054,7264,21084
260310,201907,4780,12635,4294,11992,307,820,3328,9397,3635,10217
260320,201907,7596,22043,6523,20206,275,832,5284,16408,5559,17240
260330,201907,2538,7815,2246,7213,72,277,1814,5682,1886,5959
260340,201907,2045,5527,1764,5091,35,167,1479,4150,1514,4317
260345,201907,24674,66086,20869,60356,3344,10360,10556,29803,13900,40163
260350,201907,5150,12545,4548,11815,106,322,3992,10288,4098,10610
260360,201907,2524,6642,2292,6204,41,186,1580,4186,1621,4372
260370,201907,5507,15955,4781,14700,238,844,3638,11083,3876,11927
260380,201907,4922,14741,4227,13580,179,653,3116,9847,3295,10500
260390,201907,4380,13277,3703,11892,209,704,2525,7918,2734,8622
260392,201907,3453,11011,3055,10502,133,774,2406,8240,2539,9014
260400,201907,16897,40338,14735,37467,587,1740,11483,28093,12070,29833
260410,201907,71953,176494,55205,152792,10121,29572,24763,69953,34884,99525
260415,201907,4486,12410,3863,11314,83,356,3081,8814,3164,9170
260420,201907,12841,26959,10868,24729,138,388,9893,22242,10031,22630
260430,201907,2815,8701,2405,7902,119,466,1676,5448,1795,5914
260440,201907,3683,9829,3223,9057,98,358,2616,7170,2714,7528
260450,201907,5665,14483,5106,13784,297,680,4176,11458,4473,12138
260460,201907,5198,15802,4447,14396,490,1817,2611,8235,3101,10052
260470,201907,4988,13038,4213,12136,109,273,3780,11079,3889,11352
260480,201907,4062,10782,3381,9792,236,844,2298,6673,2534,7517
260490,201907,5286,12336,4672,11389,51,185,4170,9950,4221,10135
260500,201907,6128,15638,5259,14377,453,1218,3654,10040,4107,11258
260510,201907,9571,23785,8060,21660,143,546,7035,18649,7178,19195
260515,201907,4262,11891,3318,10043,154,493,2168,6380,2322,6873
260520,201907,17332,40576,15204,37762,911,2293,12165,29806,13076,32099
260530,201907,9756,28108,8387,25952,187,871,7074,21556,7261,22427
260540,201907,7027,15474,6254,14471,302,689,5420,12470,5722,13159
260545,201907,42,138,16,77,3,12,4,18,7,30
260550,201907,3039,8599,2510,7665,138,567,1639,4882,1777,5449
260560,201907,5947,15359,5083,14092,147,597,4200,11356,4347,11953
260570,201907,7657,21167,6750,19904,447,1443,5215,15339,5662,16782
260580,201907,4442,10616,3959,9963,27,109,3614,9039,3641,9148
260590,201907,6692,15719,5636,14512,244,639,4631,12009,4875,12648
260600,201907,30328,79978,24823,71277,1273,4080,18453,52064,19726,56144
260610,201907,7111,18885,6452,17987,418,1273,4790,13196,5208,14469
260620,201907,15819,42332,13969,39591,1463,4619,9724,26919,11187,31538
260630,201907,2323,6373,1916,5705,39,167,1525,4430,1564,4597
260640,201907,20847,48445,17703,44747,920,2414,14028,35104,14948,37518
260650,201907,5833,15915,4807,14574,177,740,4032,12090,4209,12830
260660,201907,7213,19199,6198,17813,177,769,5203,14589,5380,15358
260670,201907,2184,5739,1803,5157,82,200,1345,3810,1427,4010
260680,201907,26777,65244,22527,58945,1811,5084,15196,38871,17007,43955
260690,201907,3632,9369,2962,8352,109,398,2323,6451,2432,6849
260700,201907,5970,17398,5645,17022,23,72,5469,16629,5492,16701
260710,201907,1331,3565,1183,3368,46,170,894,2538,940,2708
260720,201907,22208,58331,19540,54461,2390,6955,12998,35631,15388,42586
260730,201907,7359,21769,6531,20569,314,1188,5344,16538,5658,17726
260740,201907,1353,3775,1120,3392,11,62,881,2710,892,2772
260750,201907,6916,19420,5927,18115,131,430,5276,16346,5407,16776
260760,201907,5630,13498,4858,12545,214,625,3914,10112,4128,10737
260765,201907,7793,23037,6830,21666,495,2055,4722,14568,5217,16623
260770,201907,3855,9950,3274,8966,90,306,2603,7017,2693,7323
260775,201907,5243,14114,4645,13187,220,827,3538,9696,3758,10523
260780,201907,3649,10941,3260,10306,293,1127,2075,6333,2368,7460
260790,201907,116910,266998,97622,241132,15247,36909,59631,146842,74878,183751
260795,201907,3024,7999,2605,7411,114,395,1964,5564,2078,5959
260800,201907,5397,12695,4838,11888,168,538,4204,9961,4372,10499
260805,201907,3619,10433,3042,9383,181,669,2200,6637,2381,7306
260810,201907,6649,18086,5856,16559,542,1504,4162,11525,4704,13029
260820,201907,4420,10579,3904,9912,134,481,3192,7891,3326,8372
260825,201907,2946,8837,2543,8111,120,455,1887,5927,2007,6382
260830,201907,4306,12565,3587,11252,466,1324,2279,7327,2745,8651
260840,201907,4189,11010,3727,10331,207,558,3080,8528,3287,9086
260845,201907,4192,11293,3768,10522,259,718,2792,7710,3051,8428
260850,201907,4866,13766,4141,12341,374,1197,2647,7660,3021,8857
260860,201907,3501,9957,2955,8994,92,346,2357,6976,2449,7322
260870,201907,4475,10779,3861,10011,95,367,3401,8632,3496,8999
260875,201907,6853,17399,5657,15583,638,1794,3766,10315,4404,12109
260880,201907,9752,27482,8491,25236,490,1432,6635,19781,7125,21213
260890,201907,13241,34492,11599,31985,727,2221,8265,22188,8992,24409
260900,201907,5249,15155,4405,13844,298,1095,2951,9116,3249,10211
260910,201907,3161,8721,2738,8068,105,360,2143,6241,2248,6601
260915,201907,5201,15262,4583,14528,58,285,4145,13164,4203,13449
260920,201907,3325,8453,2851,7910,96,279,2412,6717,2508,6996
260930,201907,3573,11512,3100,10631,165,701,2318,7765,2483,8466
260940,201907,14591,35422,12709,32670,813,2260,9591,24105,10404,26365
260950,201907,6680,18362,5408,16033,442,1527,3290,9256,3732,10783
260960,201907,66963,154825,54108,137605,6604,17574,33195,82854,39799,100428
260970,201907,5304,14263,4734,13492,177,476,3629,10340,3806,10816
260980,201907,4498,13201,4033,12599,66,243,3629,11424,3695,11667
260990,201907,17988,50307,15246,46557,906,3143,11642,35188,12548,38331
261000,201907,16159,38831,13654,35475,463,1676,10708,27115,11171,28791
261010,201907,2430,6346,2121,5930,74,196,1839,5145,1913,5341
261020,201907,6144,16919,5262,15337,252,894,4173,11677,4425,12571
261030,201907,4094,11717,3537,10781,158,591,2777,8246,2935,8837
261040,201907,5202,15454,4219,13483,204,802,3061,9574,3265,10376
261050,201907,7703,20477,6988,19292,475,1078,5100,14106,5575,15184
261060,201907,13777,35115,12134,33037,377,1216,9971,26820,10348,28036
261070,201907,61014,135211,50682,121338,3091,7248,37870,88901,40961,96149
261080,201907,6280,15657,5777,14993,157,417,5275,13655,5432,14072
261090,201907,18395,44681,16398,42090,353,1237,14081,35490,14434,36727
261100,201907,8237,23190,7115,21497,565,1852,5094,15395,5659,17247
261110,201907,62105,176060,52164,158506,8759,27851,28437,86205,37196,114056
261120,201907,3820,9477,3276,8742,91,246,2810,7489,2901,7735
261130,201907,7411,18055,6518,16865,130,382,5726,14724,5856,15106
261140,201907,3565,8322,3185,7809,176,473,2541,6095,2717,6568
261150,201907,5313,14134,4693,13170,96,377,4025,11116,4121,11493
261153,201907,1880,5627,1637,5178,64,254,1123,3542,1187,3796
261160,201907,207723,492545,170097,439655,42317,112559,68960,180665,111277,293224
261170,201907,5985,15112,5347,14143,362,923,4203,11001,4565,11924
261180,201907,9798,24897,8611,23324,508,1456,6155,16596,6663,18052
261190,201907,4680,13977,4188,13116,242,1023,3135,9468,3377,10491
261200,201907,3375,7824,3009,7334,146,384,2496,5957,2642,6341
261210,201907,1941,4705,1638,4283,72,221,1360,3493,1432,3714
261220,201907,13771,39513,11423,34995,1459,4816,6412,19312,7871,24128
261230,201907,4181,12021,3481,11041,66,282,2859,9142,2925,9424
261240,201907,5157,13229,4544,12263,252,708,3730,9924,3982,10632
261245,201907,3574,10203,3030,9227,93,425,2380,6994,2473,7419
261247,201907,2921,8808,2443,7917,143,527,1676,5362,1819,5889
261250,201907,21582,49961,18604,46424,1728,3995,14014,35773,15742,39768
261255,201907,4012,11938,3331,10606,145,632,2442,7490,2587,8122
261260,201907,13035,34910,11214,32566,405,1654,9427,26951,9832,28605
261270,201907,4120,10654,3663,10027,171,589,3040,8127,3211,8716
261280,201907,2581,7296,2276,6760,86,336,1776,5138,1862,5474
261290,201907,2958,7770,2515,7240,85,340,2033,5865,2118,6205
261300,201907,11956,34119,10147,30962,594,2225,7239,21575,7833,23800
261310,201907,8616,22383,7346,20553,768,2376,5156,14031,5924,16407
261320,201907,5985,17037,5221,15713,94,419,4332,12791,4426,13210
261330,201907,5961,14803,5395,14038,144,499,4669,11923,4813,12422
261340,201907,4190,12151,3648,11409,171,694,2882,8865,3053,9559
261350,201907,8731,25642,7771,24015,132,645,6303,19067,6435,19712
261360,201907,8260,20256,7011,18476,261,827,5519,14042,5780,14869
261370,201907,22194,56837,18787,52074,2360,6571,11787,32804,14147,39375
261380,201907,4007,12302,3576,11521,477,1679,2326,7347,2803,9026
261390,201907,16287,46922,13759,42761,1263,4245,8889,27420,10152,31665
261400,201907,4671,14883,4047,13579,175,812,2989,9717,3164,10529
261410,201907,9420,24050,7832,21503,546,1520,6016,16233,6562,17753
261420,201907,7314,22447,6669,21622,805,3035,4598,14742,5403,17777
261430,201907,3460,9773,2903,8898,79,311,2375,7161,2454,7472
261440,201907,1473,4411,1244,3954,40,199,875,2649,915,2848
261450,201907,15115,40826,13456,38202,246,988,11150,31429,11396,32417
261460,201907,7470,20624,6634,19372,182,693,5530,15957,5712,16650
261470,201907,4226,10553,3721,9883,40,189,3148,8341,3188,8530
261480,201907,4990,15481,4317,14320,222,917,3280,10653,3502,11570
261485,201907,5012,14302,4296,13156,382,1281,2953,8884,3335,10165
261500,201907,5708,14937,5010,13976,430,1071,3463,9976,3893,11047
261510,201907,1870,5650,1609,5191,67,249,1184,3871,1251,4120
261520,201907,2416,7423,2205,6986,98,355,1518,4806,1616,5161
261530,201907,11438,34260,9343,30208,1073,4064,4557,14242,5630,18306
261540,201907,8038,23319,7217,22074,1101,3349,4073,13015,5174,16364
261550,201907,3625,9740,3168,9015,219,717,2251,6247,2470,6964
261560,201907,7747,23225,6737,21706,357,1389,4992,16059,5349,17448
261570,201907,3488,9448,2797,8320,211,765,1905,5501,2116,6266
261580,201907,6624,17575,5832,16509,125,578,5177,14435,5302,15013
261590,201907,2700,6994,2157,6197,72,237,1597,4553,1669,4790
261600,201907,5139,13257,4308,11991,400,1011,2873,8281,3273,9292
261610,201907,2344,6486,1934,5801,96,366,1373,4060,1469,4426
261618,201907,2570,6499,2241,6015,85,263,1770,4683,1855,4946
261620,201907,4061,11685,3768,11246,883,2351,2269,7163,3152,9514
261630,201907,6465,18217,5509,16399,398,1438,3622,10272,4020,11710
261640,201907,36845,83657,31685,77153,1742,3595,24226,60366,25968,63961
261650,201907,4189,10462,3638,9739,155,531,2714,7157,2869,7688
270010,201907,4278,14587,3730,13610,176,977,2910,10341,3086,11318
270020,201907,3898,9922,3446,9334,182,589,2864,7591,3046,8180
270030,201907,33331,92222,28446,84378,4036,11799,18438,54922,22474,66721
270040,201907,11139,30075,9594,28225,425,1726,7797,22595,8222,24321
270050,201907,5557,12838,4718,11900,195,497,4144,10477,4339,10974
270060,201907,2052,5352,1734,4979,123,331,1375,3991,1498,4322
270070,201907,4603,13084,4020,12251,152,585,3347,10010,3499,10595
270080,201907,1439,3983,1193,3557,45,150,903,2579,948,2729
270090,201907,1890,5754,1667,5326,74,325,1325,4099,1399,4424
270100,201907,5579,15023,4854,13939,202,778,3918,10962,4120,11740
270110,201907,3269,7888,2629,7119,142,358,2058,5790,2200,6148
270120,201907,2931,7963,2542,7462,79,325,2156,6244,2235,6569
270130,201907,5155,13496,4456,12667,151,502,3770,10741,3921,11243
270135,201907,2052,4928,1736,4571,61,191,1542,4031,1603,4222
270140,201907,9897,23112,7971,20422,362,1340,6274,15176,6636,16516
270150,201907,2742,8167,2549,7889,5,23,2437,7532,2442,7555
270160,201907,5888,16532,5180,15683,65,391,4771,14298,4836,14689
270170,201907,3446,10134,2935,9421,212,966,2166,6676,2378,7642
270180,201907,2250,6985,2047,6713,46,226,1803,5833,1849,6059
270190,201907,1665,4965,1491,4743,49,240,1281,4011,1330,4251
270200,201907,2430,7409,2107,6956,133,516,1517,4923,1650,5439
270210,201907,5751,13734,4967,12840,114,439,4511,11478,4625,11917
270220,201907,1444,3881,1165,3482,218,665,633,1890,851,2555
270230,201907,9292,26421,7726,23963,710,2511,5274,16040,5984,18551
270235,201907,5896,18226,5111,16933,166,737,4086,13332,4252,14069
270240,201907,10639,29028,8643,26424,921,3110,6173,18790,7094,21900
270250,201907,2834,7279,2494,6804,219,564,1911,5265,2130,5829
270255,201907,4592,13199,3538,11231,139,563,2592,8058,2731,8621
270260,201907,5638,16775,5134,15944,117,606,4402,13246,4519,13852
270270,201907,1032,2732,878,2533,111,323,620,1764,731,2087
270280,201907,3942,9507,3131,8477,491,820,2148,6288,2639,7108
270290,201907,7734,24607,6959,23305,230,1030,5910,19543,6140,20573
270300,201907,4133,11025,3255,10063,173,549,2452,7682,2625,8231
270310,201907,7113,19913,6134,18460,139,702,5154,15071,5293,15773
270320,201907,5603,16435,4898,15088,517,1648,3394,10195,3911,11843
270330,201907,3856,12780,3449,12148,261,1111,2637,9189,2898,10300
270340,201907,1643,4533,1411,4219,63,200,1153,3411,1216,3611
270350,201907,1836,4478,1525,4103,183,538,1032,2793,1215,3331
270360,201907,2482,6425,2217,6116,76,209,2007,5552,2083,5761
270370,201907,1408,4409,1276,4150,50,221,1023,3272,1073,3493
270375,201907,3096,7308,2612,6753,17,52,2444,6324,2461,6376
270380,201907,5635,16148,4744,14944,643,2030,2992,9748,3635,11778
270390,201907,1206,3073,987,2808,24,110,796,2239,820,2349
270400,201907,6235,16751,5273,15236,220,717,4101,11600,4321,12317
270410,201907,4601,13516,4014,12561,183,667,3252,10077,3435,10744
270420,201907,5541,16604,5052,15890,160,760,4268,13118,4428,13878
270430,201907,138682,339127,110243,302248,22556,64516,50810,140938,73366,205454
270440,201907,4816,13101,4141,12269,100,448,3531,10309,3631,10757
270450,201907,6820,18796,6094,17915,274,1015,5088,14871,5362,15886
270460,201907,3813,8428,3330,7872,109,265,3029,7075,3138,7340
270470,201907,11120,31503,9691,29410,846,2778,7142,21654,7988,24432
270480,201907,2865,7774,2463,7182,127,504,1958,5523,2085,6027
270490,201907,969,2737,845,2583,50,186,665,1989,715,2175
270500,201907,4955,15174,4412,14327,244,985,3468,11061,3712,12046
270510,201907,5559,15249,4759,14160,395,1565,3481,9849,3876,11414
270520,201907,3918,11363,3093,9891,663,2165,1229,4106,1892,6271
270530,201907,1201,3524,1042,3272,49,149,763,2409,812,2558
270540,201907,2167,6451,1905,6109,68,318,1632,5127,1700,5445
270550,201907,6737,17767,5504,16396,568,1408,4111,12724,4679,14132
270560,201907,3083,8200,2703,7670,169,532,2082,5815,2251,6347
270570,201907,4096,11630,3480,10679,114,457,2831,8544,2945,9001
270580,201907,2319,6591,2111,6282,103,314,1804,5338,1907,5652
270590,201907,1614,4813,1489,4645,16,84,1403,4358,1419,4442
270600,201907,2759,8577,2490,8151,59,311,2183,7030,2242,7341
270610,201907,3724,9773,3185,9054,94,354,2805,7865,2899,8219
270620,201907,1226,3814,1126,3630,47,193,945,2955,992,3148
270630,201907,17032,42543,14842,39477,697,2275,12289,31954,12986,34229
270640,201907,5448,15753,4754,14659,186,749,3839,11532,4025,12281
270642,201907,2474,8037,2197,7583,151,712,1672,5577,1823,6289
270644,201907,3588,9015,2927,8144,242,640,2192,6192,2434,6832
270650,201907,3155,9417,2786,8876,427,1500,1840,5694,2267,7194
270660,201907,2088,5260,1705,4713,86,310,1271,3440,1357,3750
270670,201907,15794,37442,13269,34359,503,1569,11069,28042,11572,29611
270680,201907,5358,13232,4792,12596,134,218,4463,11888,4597,12106
270690,201907,9046,22765,7514,20836,847,2245,5453,15177,6300,17422
270700,201907,538,1620,470,1500,25,105,350,1110,375,1215
270710,201907,5554,16847,5029,16053,249,1097,4097,12747,4346,13844
270720,201907,3464,10406,3065,9722,70,394,2681,8321,2751,8715
270730,201907,8086,18348,7193,17359,273,639,5689,14986,5962,15625
270740,201907,2353,6292,2090,5973,106,381,1714,4776,1820,5157
270750,201907,5578,15050,4914,14176,140,592,4229,12082,4369,12674
270760,201907,3324,9433,2892,8841,62,326,2428,7305,2490,7631
270770,201907,21362,52212,16831,46647,2868,7306,9988,29236,12856,36542
270780,201907,1755,5132,1626,4948,98,372,1325,3946,1423,4318
270790,201907,1541,4477,1305,4125,111,370,847,2641,958,3011
270800,201907,10776,29819,9647,28228,374,1463,8200,23437,8574,24900
270810,201907,3284,9469,2583,8264,194,769,1774,5534,1968,6303
270820,201907,1677,5039,1411,4597,63,274,1093,3464,1156,3738
270830,201907,5288,12830,4293,11598,192,648,3409,9078,3601,9726
270840,201907,8185,24434,7324,23220,201,1091,6372,19649,6573,20740
270850,201907,8983,21817,8045,20646,637,1924,6618,16559,7255,18483
270860,201907,12462,29751,10394,27289,407,1344,8619,22107,9026,23451
270870,201907,2115,6092,1799,5552,216,709,1213,3762,1429,4471
270880,201907,8133,24349,7283,23088,232,1044,5987,18597,6219,19641
270890,201907,2690,7430,2316,6912,186,623,1623,4764,1809,5387
270895,201907,2970,9513,2741,9201,83,457,2413,7910,2496,8367
270900,201907,1795,4653,1350,3937,43,135,1065,3069,1108,3204
270910,201907,3892,11430,3347,10515,114,450,2628,8129,2742,8579
270915,201907,9219,27103,7566,24270,724,2723,5041,15726,5765,18449
270920,201907,5260,16472,4776,15645,213,1013,3850,12147,4063,13160
270930,201907,17294,40990,13540,36562,1849,4500,9177,25687,11026,30187
270940,201907,6322,17331,5498,16314,238,1152,4364,12487,4602,13639
280010,201907,675,1852,547,1580,17,73,382,983,399,1056
280020,201907,4784,12402,4093,11309,521,1374,2703,7520,3224,8894
280030,201907,74032,176717,57931,153748,13349,35702,24346,67251,37695,102953
280040,201907,3023,8507,2633,7912,269,852,1744,5164,2013,6016
280050,201907,3932,11265,3383,10360,555,1789,1984,6070,2539,7859
280060,201907,5514,14894,4424,13202,795,2444,2190,6781,2985,9225
280067,201907,6954,17530,5904,15908,345,988,4235,11123,4580,12111
280070,201907,1916,5813,1793,5594,93,341,1490,4559,1583,4900
280100,201907,3883,10601,3280,9612,336,1018,2271,6619,2607,7637
280110,201907,1363,3735,1188,3466,22,106,1023,2913,1045,3019
280120,201907,7496,22041,6721,20759,748,2134,4911,15439,5659,17573
280130,201907,9110,21649,7997,20052,496,1332,6349,15759,6845,17091
280140,201907,5509,13426,4857,12537,251,708,4036,10304,4287,11012
280150,201907,4012,10176,3486,9490,207,565,2841,7691,3048,8256
280160,201907,1264,3636,1043,3247,110,366,677,2047,787,2413
280170,201907,5163,13683,4597,12921,245,727,3663,10228,3908,10955
280190,201907,1215,2761,1037,2512,64,166,810,1914,874,2080
280200,201907,1322,3499,1071,3094,102,360,733,2054,835,2414
280210,201907,16059,41190,13976,38207,1708,4952,8694,23635,10402,28587
280220,201907,1755,4717,1491,4349,40,217,1202,3479,1242,3696
280230,201907,4010,10271,3479,9491,275,697,2510,6806,2785,7503
280240,201907,3396,9096,3047,8572,62,312,2565,7002,2627,7314
280250,201907,845,2149,684,1891,75,227,407,1086,482,1313
280260,201907,2126,5218,1899,4941,41,106,1741,4543,1782,4649
280270,201907,2308,6509,2047,6094,125,452,1693,4906,1818,5358
280280,201907,4121,12590,3680,11957,447,1364,2594,8689,3041,10053
280290,201907,17389,47078,15068,43739,1475,4631,10021,29237,11496,33868
280300,201907,11412,28470,9926,26844,256,855,7662,22060,7918,22915
280310,201907,1360,3536,1121,3122,39,132,830,2234,869,2366
280320,201907,8700,23848,7531,22051,859,2561,4953,14263,5812,16824
280330,201907,4730,11867,3973,10742,274,750,2892,7747,3166,8497
280340,201907,5529,11494,4679,10569,240,419,4026,9248,4266,9667
280350,201907,25000,60116,21817,55733,1317,3667,16784,42024,18101,45691
280360,201907,5919,16630,5174,15336,847,2540,2922,8723,3769,11263
280370,201907,2229,5496,1816,4773,67,183,1423,3652,1490,3835
280380,201907,983,2725,847,2537,88,284,543,1614,631,1898
280390,201907,3596,9118,2973,8086,136,376,2320,6226,2456,6602
280400,201907,3988,10335,3419,9497,473,1207,2121,6117,2594,7324
280410,201907,2220,6279,1771,5494,191,634,1050,3158,1241,3792
280420,201907,4345,11695,3943,11148,93,341,3551,9982,3644,10323
280430,201907,2067,5107,1804,4748,73,292,1441,3658,1514,3950
280440,201907,4387,11864,3833,11015,210,715,3127,8741,3337,9456
280445,201907,2305,5869,2033,5381,52,181,1515,3816,1567,3997
280450,201907,10371,23784,9053,22037,607,1179,7096,17593,7703,18772
280460,201907,6839,16492,6190,15567,449,1093,5085,12709,5534,13802
280470,201907,1738,4959,1488,4498,57,221,1086,3197,1143,3418
280480,201907,40725,100411,35317,92823,2938,8468,25076,64456,28014,72924
280490,201907,3798,10869,3275,9978,88,394,2497,7332,2585,7726
280500,201907,989,2392,837,2180,35,138,691,1758,726,1896
280510,201907,2561,6722,2203,6191,82,304,1680,4623,1762,4927
280520,201907,1623,4165,1426,3898,76,216,1132,3048,1208,3264
280530,201907,2642,6522,2256,6021,312,718,1572,4295,1884,5013
280540,201907,9022,24312,8208,23114,247,933,7108,19614,7355,20547
280550,201907,6775,15911,5472,14027,244,813,4327,10674,4571,11487
280560,201907,7117,20212,6665,19536,151,575,5795,16750,5946,17325
280570,201907,6444,15930,5212,14341,220,766,3811,10328,4031,11094
280580,201907,5579,15245,4793,14014,522,1458,3325,9777,3847,11235
280590,201907,3011,6904,2519,6311,126,486,1909,4515,2035,5001
280600,201907,3531,9608,3120,9003,171,552,2211,6344,2382,6896
280610,201907,2520,6269,2267,5904,150,388,1827,4709,1977,5097
280620,201907,5374,13457,4563,12353,421,988,3205,8989,3626,9977
280630,201907,3792,10903,3449,10396,171,623,2771,8265,2942,8888
280640,201907,2421,6541,2159,6247,70,214,1904,5514,1974,5728
280650,201907,1254,3282,982,2862,105,348,678,1886,783,2234
280660,201907,3252,7566,2861,7091,114,286,2497,6140,2611,6426
280670,201907,19572,44620,16960,41257,964,2552,13417,32267,14381,34819
280680,201907,2761,6769,2356,6165,194,386,1693,4443,1887,4829
280690,201907,948,2431,790,2209,28,86,592,1616,620,1702
280700,201907,1136,2894,971,2631,22,91,758,2009,780,2100
280710,201907,15136,34109,12803,31435,501,979,10985,27451,11486,28430
280720,201907,2712,6082,2195,5477,88,261,1474,3866,1562,4127
280730,201907,1068,2757,944,2549,52,160,704,1837,756,1997
280740,201907,14288,35063,12160,31803,925,2523,8469,21686,9394,24209
280750,201907,3571,10114,3125,9323,175,605,2243,6559,2418,7164
280760,201907,6234,17137,5486,15957,555,1555,3676,10915,4231,12470
290010,201907,3137,6678,2075,5009,9,31,1683,3858,1692,3889
290020,201907,5466,14519,4966,13855,374,731,4134,11914,4508,12645
290030,201907,4342,10388,3606,9555,177,436,3013,8046,3190,8482
290035,201907,5260,11585,4272,10294,375,620,3336,8399,3711,9019
290040,201907,4285,10478,3641,9687,120,320,2853,7875,2973,8195
290050,201907,2096,6691,1741,5925,124,516,1169,3870,1293,4386
290060,201907,1318,3242,972,2656,78,273,648,1707,726,1980
290070,201907,36046,81034,30997,74594,1988,5055,23260,55242,25248,60297
290080,201907,5416,16039,4605,14810,502,1734,3128,10151,3630,11885
290090,201907,2177,4224,1565,3566,31,82,1406,3171,1437,3253
290100,201907,9883,26307,8108,23595,1211,3315,4562,13711,5773,17026
290110,201907,5124,13824,4590,12891,394,1164,3243,9007,3637,10171
290115,201907,4126,11966,3501,10869,236,812,2593,7960,2829,8772
290120,201907,6598,16328,5501,14896,126,458,4747,12630,4873,13088
290130,201907,4614,11290,3653,10080,143,465,2873,7839,3016,8304
290135,201907,4308,10195,3478,8814,231,599,2587,6344,2818,6943
290140,201907,4603,12297,3624,10979,112,438,3045,9151,3157,9589
290150,201907,2467,6522,2144,6110,157,486,1610,4552,1767,5038
290160,201907,3175,7584,2850,7154,304,679,2169,5474,2473,6153
290170,201907,3296,8555,2930,8136,113,336,2592,7242,2705,7578
290180,201907,2995,8136,2457,7285,80,294,1969,5773,2049,6067
290190,201907,4143,11982,3650,11306,167,699,2962,9009,3129,9708
290195,201907,2356,5947,1878,5266,34,163,1541,4288,1575,4451
290200,201907,4073,11416,3348,10212,229,770,2531,7647,2760,8417
290205,201907,3415,8825,3004,8214,142,541,2360,6223,2502,6764
290210,201907,13333,37301,11745,34886,940,2556,8962,27169,9902,29725
290220,201907,2811,7139,2479,6715,147,431,1984,5309,2131,5740
290225,201907,3341,7160,2628,6396,187,354,2192,5425,2379,5779
290230,201907,2529,6689,2301,6421,35,125,2051,5684,2086,5809
290240,201907,3653,9287,2977,8413,95,326,2470,6928,2565,7254
290250,201907,4067,11836,3465,10956,131,462,2785,8956,2916,9418
290260,201907,5459,13628,4467,12203,201,691,3587,9549,3788,10240
290265,201907,3538,10429,2852,9069,149,571,2091,6548,2240,7119
290270,201907,11314,38583,10671,37460,570,2549,8509,29424,9079,31973
290280,201907,6035,18207,5223,16606,340,1245,3699,11577,4039,12822
290290,201907,10057,29553,8221,26108,861,3012,5377,16760,6238,19772
290300,201907,4255,11680,3173,9619,180,606,2226,6743,2406,7349
290310,201907,1558,3970,1285,3617,81,326,966,2618,1047,2944
290320,201907,24519,65214,19680,57663,4400,12823,9353,28677,13753,41500
290323,201907,3742,10220,3261,9492,101,314,2597,7498,2698,7812
290327,201907,4274,12348,3606,11047,275,796,2499,7615,2774,8411
290330,201907,2117,4530,1679,4050,48,94,1482,3590,1530,3684
290340,201907,5715,14831,4498,13295,499,1550,3211,9596,3710,11146
290350,201907,4700,13140,3881,11745,300,951,2733,8292,3033,9243
290360,201907,5057,13408,4431,12577,130,393,3803,10798,3933,11191
290370,201907,5319,12920,3928,11117,187,451,2897,8352,3084,8803
290380,201907,5606,14983,4758,13810,120,335,4132,12108,4252,12443
290390,201907,14482,41083,12180,37606,1256,3819,8188,25650,9444,29469
290395,201907,2789,8264,2309,7419,74,366,1773,5576,1847,5942
290400,201907,3692,10042,2986,8878,89,386,2273,6567,2362,6953
290405,201907,4594,13565,3900,12333,305,1012,2690,8654,2995,9666
290410,201907,5754,15929,4447,13743,121,575,3343,9960,3464,10535
290420,201907,3012,8488,2468,7612,80,302,1897,5807,1977,6109
290430,201907,3127,8748,2560,7841,263,842,1676,5101,1939,5943
290440,201907,2787,7118,1996,5862,42,139,1433,4265,1475,4404
290450,201907,3336,8836,2698,7881,159,522,2013,5834,2172,6356
290460,201907,11819,33399,10053,30018,2097,6334,4626,13729,6723,20063
290470,201907,4486,11302,3333,9673,352,1126,1915,5591,2267,6717
290475,201907,6498,18950,5479,17097,119,606,4386,13349,4505,13955
290480,201907,1775,4549,1493,4137,102,321,1021,2698,1123,3019
290485,201907,4526,13398,4005,12605,126,634,3377,10407,3503,11041
290490,201907,9152,21771,8159,20411,512,1248,6401,16114,6913,17362
290500,201907,3952,12043,3074,10093,537,1861,1388,4423,1925,6284
290510,201907,3404,8660,2859,7948,82,288,2437,6676,2519,6964
290515,201907,3731,10158,3191,9452,63,187,2800,8460,2863,8647
290520,201907,11260,32539,8774,27682,509,1860,5541,17127,6050,18987
290530,201907,4999,14315,4265,13105,153,557,3536,10844,3689,11401
290540,201907,3486,9313,3123,8870,72,248,2832,7998,2904,8246
290550,201907,4327,11314,3765,10655,19,71,3466,9938,3485,10009
290560,201907,6605,17253,5073,14940,456,1622,3299,9351,3755,10973
290570,201907,43211,108353,38896,102802,2627,7200,30990,81248,33617,88448
290580,201907,7828,23315,6811,21800,647,2085,4914,16064,5561,18149
290590,201907,7065,21908,6016,20019,152,636,4860,16175,5012,16811
290600,201907,18616,52222,16626,49076,687,2227,13225,38897,13912,41124
290610,201907,2531,8021,1990,6908,105,447,1371,4686,1476,5133
290620,201907,6603,18498,5693,16978,208,631,4722,14009,4930,14640
290630,201907,9112,22387,7281,19987,613,1631,5567,15396,6180,17027
290640,201907,2757,7203,2099,6213,76,246,1544,4563,1620,4809
290650,201907,12600,32541,11332,30995,2826,7331,6438,18637,9264,25968
290660,201907,3711,9530,3106,8651,53,123,2306,6693,2359,6816
290670,201907,6683,18885,5731,17298,427,1245,4334,13219,4761,14464
290680,201907,10706,30051,9094,27659,219,1150,7418,21983,7637,23133
290682,201907,4670,12329,4102,11532,136,322,3450,9758,3586,10080
290685,201907,3429,7838,2440,6419,188,481,1531,4276,1719,4757
290687,201907,6723,18403,5443,16267,742,2130,3395,10410,4137,12540
290689,201907,2785,7930,2255,6982,124,389,1661,5156,1785,5545
290690,201907,5722,14841,4627,13291,371,1099,3284,9326,3655,10425
290700,201907,2612,7200,2315,6806,85,284,1880,5556,1965,5840
290710,201907,8554,24064,7264,22258,176,741,6116,18646,6292,19387
290720,201907,19040,52029,17302,49387,982,3222,13666,38453,14648,41675
290730,201907,7259,17501,6184,16225,304,663,4768,12609,5072,13272
290740,201907,1065,2905,809,2462,39,156,622,1888,661,2044
290750,201907,11062,28258,9582,25737,787,2278,6812,17679,7599,19957
290755,201907,2088,5911,1689,5164,104,352,1177,3576,1281,3928
290760,201907,3828,11256,3047,9744,239,707,1951,6429,2190,7136
290770,201907,2630,8501,2379,8194,59,308,1981,6865,2040,7173
290780,201907,8402,20838,7217,19235,316,706,5669,15321,5985,16027
290790,201907,4677,12871,4068,12026,148,446,3406,10171,3554,10617
290800,201907,7241,15041,5185,12636,352,805,3795,9366,4147,10171
290810,201907,5639,14977,4497,13256,117,411,3303,9819,3420,10230
290820,201907,4990,13519,4478,12737,219,665,3296,9466,3515,10131
290830,201907,4615,10492,4142,9876,52,146,3593,8432,3645,8578
290840,201907,16816,45572,14695,42212,1886,4578,9478,28633,11364,33211
290850,201907,6411,15942,5786,15247,302,739,4847,12954,5149,13693
290860,201907,5972,17622,5230,16726,223,753,4378,14219,4601,14972
290870,201907,4817,13358,3698,11296,116,413,2616,7878,2732,8291
290880,201907,1397,3533,1112,3152,71,186,776,2257,847,2443
290890,201907,8959,18491,8032,17419,153,369,7488,16106,7641,16475
290900,201907,2354,6266,1789,5305,102,291,1142,3319,1244,3610
290910,201907,5116,12439,3922,10616,45,169,3239,8639,3284,8808
290920,201907,5137,12795,4688,12262,58,131,4389,11535,4447,11666
290930,201907,7904,22153,6358,19439,191,874,4944,14633,5135,15507
290940,201907,3774,10583,3122,9646,175,659,2437,7530,2612,8189
290950,201907,1498,3817,1234,3424,64,177,877,2444,941,2621
290960,201907,5482,14608,4914,13902,153,439,4125,11652,4278,12091
290970,201907,3527,10268,2868,9100,133,472,2158,6820,2291,7292
290980,201907,11853,29066,10015,26176,870,2448,6126,15567,6996,18015
290990,201907,9416,25469,8234,23513,303,1187,6769,18650,7072,19837
291000,201907,3440,9083,2726,8184,155,436,2178,6635,2333,7071
291005,201907,15177,37392,13365,35030,930,2454,10718,27924,11648,30378
291010,201907,3057,9273,2451,7994,132,478,1610,5122,1742,5600
291020,201907,1299,3243,1028,2729,27,96,733,1833,760,1929
291030,201907,2433,6036,1694,4721,100,265,1090,2948,1190,3213
291040,201907,5338,15024,4544,13868,195,826,3555,10702,3750,11528
291050,201907,7507,20317,6474,18814,779,2457,4461,12742,5240,15199
291060,201907,5882,18726,5091,17576,407,1712,3741,12805,4148,14517
291070,201907,15851,43195,13305,39149,523,1815,10643,31036,11166,32851
291072,201907,24349,63887,17630,51759,3422,10406,7282,21525,10704,31931
291075,201907,5317,13578,4718,12606,127,366,3841,10036,3968,10402
291077,201907,1593,4192,1251,3579,48,130,889,2531,937,2661
291080,201907,90726,239171,73113,213162,24471,73157,17150,53243,41621,126400
291085,201907,5693,14444,4766,13050,201,635,3949,10706,4150,11341
291090,201907,1980,3745,1458,3172,33,77,1220,2615,1253,2692
291100,201907,3141,7000,2189,5843,116,353,1671,4375,1787,4728
291110,201907,5978,17929,5071,16341,330,1353,3773,11672,4103,13025
291120,201907,7725,19164,6579,17662,358,1033,4937,13207,5295,14240
291125,201907,2183,3876,1599,3225,135,197,1191,2505,1326,2702
291130,201907,3169,9192,2359,7581,91,415,1671,5174,1762,5589
291140,201907,4810,13211,3527,10786,417,1125,2229,6857,2646,7982
291150,201907,2309,5228,1912,4773,11,33,1789,4452,1800,4485
291160,201907,5105,14244,4251,12968,410,1346,2761,8331,3171,9677
291165,201907,2189,6017,1681,5054,42,185,1198,3440,1240,3625
291170,201907,20938,53383,17578,47721,1029,3026,11383,30451,12412,33477
291180,201907,5952,14224,4519,12194,360,905,3369,9145,3729,10050
291185,201907,3180,8662,2762,7951,84,264,2106,6018,2190,6282
291190,201907,7622,18949,6301,17182,340,1058,4903,13316,5243,14374
291200,201907,2821,7854,2088,6438,92,325,1271,3794,1363,4119
291210,201907,6950,15319,5320,13403,170,562,3951,9946,4121,10508
291220,201907,4065,11711,3669,11087,234,848,2824,8409,3058,9257
291230,201907,4422,9648,3426,8542,56,123,3049,7700,3105,7823
291240,201907,4241,10982,3659,10009,64,229,3136,8433,3200,8662
291250,201907,3442,10164,2688,8786,172,561,1732,5694,1904,6255
291260,201907,1422,3352,1214,3084,34,105,981,2512,1015,2617
291270,201907,5158,13911,4126,12315,626,1850,2635,7987,3261,9837
291280,201907,2545,6499,1936,5545,144,489,1196,3280,1340,3769
291290,201907,5854,15709,4626,13745,401,1307,3108,9137,3509,10444
291300,201907,3980,10697,2984,9043,126,437,2204,6562,2330,6999
291310,201907,5127,13802,4385,12416,119,405,3653,10137,3772,10542
291320,201907,6156,17459,4774,14824,1101,3180,2307,7579,3408,10759
291330,201907,1810,4620,1496,4087,78,212,1084,2888,1162,3100
291340,201907,4191,10913,3474,9710,84,280,2663,7285,2747,7565
291345,201907,2994,9094,2732,8688,128,441,2235,7113,2363,7554
291350,201907,6823,17227,5318,15298,73,233,4510,13206,4583,13439
291360,201907,36051,85159,28806,76134,3337,9050,17918,48203,21255,57253
291370,201907,7915,21881,7103,20670,529,1678,5270,15150,5799,16828
291380,201907,3391,9549,3023,9003,91,429,2488,7266,2579,7695
291390,201907,13062,28753,10284,25650,388,1011,8506,21137,8894,22148
291400,201907,13608,35739,11370,32338,1583,4046,6707,20418,8290,24464
291410,201907,2885,7639,2209,6497,51,224,1617,4631,1668,4855
291420,201907,1943,4830,1534,4319,37,146,1313,3671,1350,3817
291430,201907,2883,8169,2486,7517,103,462,1949,5701,2052,6163
291440,201907,6329,18405,5449,16914,322,1108,4271,13241,4593,14349
291450,201907,8854,22705,7393,20990,112,213,6451,18907,6563,19120
291460,201907,15307,41234,13488,38506,704,2253,10086,28538,10790,30791
291465,201907,9033,23013,7214,20892,197,885,6063,17387,6260,18272
291470,201907,15774,36780,13380,34081,651,1599,9965,26061,10616,27660
291480,201907,41104,92709,30221,77621,3936,10611,15536,39748,19472,50359
291490,201907,5558,14118,4880,13289,170,545,4351,11793,4521,12338
291500,201907,5013,12364,4174,11229,68,281,3744,10028,3812,10309
291510,201907,3990,10336,3075,9113,70,334,2486,7330,2556,7664
291520,201907,4531,10412,3466,9006,172,481,2634,6813,2806,7294
291530,201907,2248,5280,1616,4428,291,728,945,2803,1236,3531
291535,201907,3227,9711,2966,9262,170,512,2290,7253,2460,7765
291540,201907,2262,5157,1586,4333,57,223,1299,3444,1356,3667
291550,201907,5575,12980,4382,11408,409,937,2962,7841,3371,8778
291560,201907,19393,44804,13622,37572,1131,3029,8749,25056,9880,28085
291570,201907,2405,5727,1915,5113,64,159,1566,4307,1630,4466
291580,201907,6244,16522,4924,14711,248,883,3617,10602,3865,11485
291590,201907,1945,5118,1734,4835,113,386,1456,3962,1569,4348
291600,201907,5084,12626,3822,10625,453,1398,2393,6429,2846,7827
291610,201907,5696,15341,5272,14857,101,367,4836,13597,4937,13964
291620,201907,3153,7061,2311,6116,117,308,1783,4796,1900,5104
291630,201907,3246,7428,2409,6342,224,661,1771,4580,1995,5241
291640,201907,15540,39397,11865,33929,1914,5323,5055,15207,6969,20530
291650,201907,9287,23812,8204,22474,518,1083,6867,19216,7385,20299
291660,201907,2077,5125,1513,4221,142,488,972,2544,1114,3032
291670,201907,2090,5469,1768,5025,107,259,1355,3904,1462,4163
291680,201907,4130,10339,3348,9146,312,868,2357,6387,2669,7255
291685,201907,4675,11251,3723,10020,224,465,2816,7857,3040,8322
291690,201907,4230,9417,2869,7451,214,476,2190,5678,2404,6154
291700,201907,8604,25094,7635,23389,404,1404,6161,18588,6565,19992
291710,201907,5284,12868,3944,10942,257,821,2807,7614,3064,8435
291720,201907,4402,13635,3681,12157,416,1489,2412,7743,2828,9232
291730,201907,6343,16564,5480,15415,293,901,4438,12439,4731,13340
291733,201907,2944,7523,2477,6890,68,202,1811,5258,1879,5460
291735,201907,2925,7633,2345,6646,91,266,1794,5038,1885,5304
291740,201907,3868,10053,2918,8378,106,318,2117,5946,2223,6264
291750,201907,19813,47889,16044,42232,1555,4136,10693,28164,12248,32300
291760,201907,10383,30518,8191,26825,2543,9402,2142,7009,4685,16411
291770,201907,7099,19422,5902,17286,434,1336,4262,12169,4696,13505
291780,201907,5071,13629,4577,12891,97,371,3955,10987,4052,11358
291790,201907,2674,7595,2451,7297,264,671,1811,5538,2075,6209
291800,201907,29259,75077,22269,64407,3451,9658,11473,34275,14924,43933
291810,201907,10731,25842,8891,23560,251,738,7623,20077,7874,20815
291820,201907,3824,10179,3322,9493,108,350,2606,7486,2714,7836
291830,201907,4275,10458,3626,9545,210,547,2870,7572,3080,8119
291835,201907,6387,19208,4966,16403,678,2337,2934,9867,3612,12204
291840,201907,47529,131011,41046,121238,4686,14699,28119,82847,32805,97546
291845,201907,2406,6485,1957,5928,97,313,1589,4857,1686,5170
291850,201907,3945,11317,3277,10185,263,762,2336,7455,2599,8217
291855,201907,2199,4433,1732,3893,49,128,1548,3453,1597,3581
291860,201907,2242,5892,1546,4538,41,135,1037,2916,1078,3051
291870,201907,1320,3330,876,2549,60,182,572,1619,632,1801
291875,201907,2737,8267,2395,7576,74,288,1802,5543,1876,5831
291880,201907,5599,16140,4827,14792,258,807,3574,10926,3832,11733
291890,201907,1582,3357,1035,2708,134,319,688,1797,822,2116
291900,201907,1176,2976,914,2549,23,89,718,1942,741,2031
291905,201907,2644,6650,2064,5694,86,285,1534,4101,1620,4386
291910,201907,2926,7446,2462,6888,69,242,2114,5922,2183,6164
291915,201907,7357,21104,6045,18845,242,882,4501,14027,4743,14909
291920,201907,25739,69086,22190,64068,2469,7686,14900,42172,17369,49858
291930,201907,2506,6909,2134,6350,255,805,1377,4063,1632,4868
291940,201907,3860,10045,2565,7819,205,629,1494,4472,1699,5101
291950,201907,9213,27962,7882,25358,408,1505,5345,17016,5753,18521
291955,201907,14896,37891,13376,35902,1219,3382,10347,27920,11566,31302
291960,201907,3128,8376,2553,7556,138,457,1950,5844,2088,6301
291970,201907,4373,11381,3732,10530,164,565,2786,7848,2950,8413
291980,201907,10048,28513,7950,25054,775,2318,5104,16331,5879,18649
291990,201907,2173,5701,1878,5367,22,100,1778,5078,1800,5178
291992,201907,4036,9884,3116,8640,259,623,2432,6859,2691,7482
291995,201907,2148,5804,1725,5173,51,239,1332,3878,1383,4117
292000,201907,2664,6384,2162,5747,117,449,1665,4339,1782,4788
292010,201907,5961,13847,4846,12270,205,592,3954,9813,4159,10405
292020,201907,4555,13296,3797,11935,227,841,2742,8355,2969,9196
292030,201907,1781,5587,1674,5400,76,299,1056,3308,1132,3607
292040,201907,4294,11255,3428,9977,252,683,2624,7816,2876,8499
292045,201907,4027,10649,2991,9110,53,141,2618,8141,2671,8282
292050,201907,6518,18543,5234,16155,268,958,3292,9980,3560,10938
292060,201907,11823,27476,10952,26393,579,1313,9402,22415,9981,23728
292070,201907,5885,15328,5174,14454,292,869,4435,12284,4727,13153
292080,201907,3238,8077,2649,7329,83,273,2331,6424,2414,6697
292090,201907,4558,9903,3279,8381,259,695,2473,6378,2732,7073
292100,201907,10447,26050,8886,24035,1074,3077,5772,15462,6846,18539
292105,201907,3431,8805,3007,8196,87,239,2438,6630,2525,6869
292110,201907,6086,15183,4304,12231,997,2875,1938,5514,2935,8389
292120,201907,6938,17992,5649,15770,390,1169,4202,11490,4592,12659
292130,201907,3423,8275,2798,7499,114,356,2168,5722,2282,6078
292140,201907,5195,12216,4287,10894,298,738,3397,8593,3695,9331
292145,201907,2340,6835,1966,6168,62,198,1483,4679,1545,4877
292150,201907,13669,37973,12081,35419,302,1252,9969,28754,10271,30006
292160,201907,2978,7330,2274,6432,59,172,1844,5374,1903,5546
292170,201907,8301,22367,6915,20024,437,1422,5000,14230,5437,15652
292180,201907,2843,7788,2084,6426,215,643,1258,3802,1473,4445
292190,201907,2912,7768,2491,7131,139,436,1850,5265,1989,5701
292200,201907,8052,20785,6055,17872,1071,3268,3152,9483,4223,12751
292205,201907,3875,10715,3341,9919,62,296,2922,8579,2984,8875
292210,201907,6323,15034,5145,13510,96,432,4562,11768,4658,12200
292220,201907,2112,5164,1859,4784,65,188,1441,3580,1506,3768
292225,201907,3213,9470,2835,8896,77,357,2375,7318,2452,7675
292230,201907,8550,20492,7627,19280,198,712,6440,15910,6638,16622
292240,201907,4762,13936,4102,12703,334,1020,2791,8634,3125,9654
292250,201907,5281,14387,4752,13553,531,1478,3236,9307,3767,10785
292260,201907,3371,8929,3022,8480,131,351,2594,7307,2725,7658
292265,201907,3346,9273,2819,8450,78,363,2180,6374,2258,6737
292270,201907,4360,10028,3485,8980,174,436,2813,7273,2987,7709
292273,201907,2672,5801,2127,5134,66,121,1587,4037,1653,4158
292275,201907,1653,4357,1309,3868,56,138,991,2973,1047,3111
292280,201907,2616,6235,2115,5654,100,212,1759,4853,1859,5065
292285,201907,2585,6300,2027,5523,83,213,1616,4427,1699,4640
292290,201907,7317,19661,5868,17580,179,686,4771,14240,4950,14926
292300,201907,10185,26232,8005,23344,820,2567,5362,15575,6182,18142
292303,201907,2921,8385,2561,7815,77,195,2153,6623,2230,6818
292305,201907,2467,6606,2275,6333,48,216,2009,5479,2057,5695
292310,201907,6753,17276,5802,16097,168,564,4943,13567,5111,14131
292320,201907,6175,16860,4935,14552,246,788,3649,10478,3895,11266
292330,201907,2795,6136,2193,5460,110,255,1687,4314,1797,4569
292335,201907,4774,12382,4250,11633,260,652,3548,9788,3808,10440
292340,201907,5760,16079,4813,14250,219,695,3561,10394,3780,11089
292350,201907,2571,6882,2097,6236,82,316,1694,5007,1776,5323
292360,201907,4890,13172,4084,11774,286,951,2837,7918,3123,8869
292370,201907,10932,25086,9404,23042,136,487,8643,20779,8779,21266
292380,201907,6878,19365,6139,18045,428,1252,4585,13392,5013,14644
292390,201907,4456,8677,3248,7268,105,226,2838,6357,2943,6583
292400,201907,22176,64068,19323,59379,1853,6001,13278,40671,15131,46672
292405,201907,4207,10522,3548,9509,122,316,2882,7669,3004,7985
292410,201907,2173,5182,1861,4795,64,179,1630,4198,1694,4377
292420,201907,3646,10988,3304,10423,136,642,2763,8501,2899,9143
292430,201907,4832,14575,3705,12535,310,1137,2421,8149,2731,9286
292440,201907,8508,27104,7856,26097,126,660,7020,23253,7146,23913
292450,201907,3877,11301,3104,9771,102,393,2401,7526,2503,7919
292460,201907,4889,13592,4011,12077,389,1124,2813,8486,3202,9610
292465,201907,2607,6854,2174,6258,98,236,1491,4593,1589,4829
292467,201907,1836,5233,1643,4970,229,620,1123,3532,1352,4152
292470,201907,3006,7625,2333,6547,65,140,1804,5060,1869,5200
292480,201907,6473,15328,5154,13727,74,295,4608,12104,4682,12399
292490,201907,2107,5573,1754,5050,113,301,1310,3828,1423,4129
292500,201907,6450,17931,5279,15776,564,1738,3423,10088,3987,11826
292510,201907,12605,34234,10014,30290,512,1894,7250,21797,7762,23691
292520,201907,6951,17419,6141,16234,550,1509,4628,12149,5178,13658
292525,201907,5724,13773,4780,12684,110,304,4148,11075,4258,11379
292530,201907,27248,73317,21182,63071,5570,16822,7747,23800,13317,40622
292540,201907,4264,8114,3381,7157,115,204,2989,6339,3104,6543
292550,201907,8034,21642,6185,19333,454,1491,4512,14586,4966,16077
292560,201907,4282,10880,3703,10101,87,281,3035,8261,3122,8542
292570,201907,3778,9827,3189,8857,73,265,2721,7377,2794,7642
292575,201907,6975,20097,6424,19354,324,1005,5201,15711,5525,16716
292580,201907,7520,19116,6315,17321,139,456,5298,14362,5437,14818
292590,201907,7417,19665,6388,17965,266,843,5350,14736,5616,15579
292593,201907,2869,7109,2369,6275,79,200,1952,5144,2031,5344
292595,201907,5481,14578,4716,13635,170,569,3917,11201,4087,11770
292600,201907,11147,30232,9565,27837,384,1053,7472,21828,7856,22881
292610,201907,4178,10988,3521,9816,201,487,2569,7259,2770,7746
292620,201907,6472,17774,5414,16525,108,259,5017,15552,5125,15811
292630,201907,8576,21077,6991,18536,612,1635,4667,12355,5279,13990
292640,201907,8202,24439,7153,22690,208,907,5075,16066,5283,16973
292650,201907,4613,11288,4116,10638,125,360,3708,9430,3833,9790
292660,201907,11328,30908,9688,28454,487,1571,7458,21797,7945,23368
292665,201907,2190,6519,1941,6206,82,256,1625,5282,1707,5538
292670,201907,3566,9665,2742,8117,124,412,1872,5443,1996,5855
292680,201907,3993,10730,3188,9243,195,552,2295,6497,2490,7049
292690,201907,2658,6961,1855,5629,192,556,1107,3521,1299,4077
292700,201907,9887,27034,8602,25027,799,2193,5830,17446,6629,19639
292710,201907,2469,7734,2281,7478,51,196,2038,6727,2089,6923
292720,201907,9071,21845,7680,20265,266,749,6070,16226,6336,16975
292730,201907,4445,10455,4173,10121,203,323,3650,8990,3853,9313
292740,201907,323647,801887,285005,744558,43017,113697,174004,450632,217021,564329
292750,201907,6306,16839,5482,15601,259,760,4129,11873,4388,12633
292760,201907,3873,11269,3386,10398,248,839,2448,7439,2696,8278
292770,201907,6115,16418,4912,14688,775,2428,2990,9216,3765,11644
292780,201907,2022,4198,1508,3539,43,145,1198,2668,1241,2813
292790,201907,4161,8817,3198,7774,160,427,2692,6529,2852,6956
292800,201907,11088,28030,9573,25699,348,970,7877,20879,8225,21849
292805,201907,3410,8342,2680,7354,119,350,2088,5687,2207,6037
292810,201907,10685,28516,8443,25016,248,1029,6227,17914,6475,18943
292820,201907,7565,20764,5428,17264,502,1671,3632,11394,4134,13065
292830,201907,2917,6856,2472,6300,91,296,2105,5333,2196,5629
292840,201907,8805,23159,7547,21441,169,661,6481,17973,6650,18634
292850,201907,2548,6841,2138,6215,147,478,1469,4182,1616,4660
292860,201907,16972,38060,15130,35773,648,1574,12604,29431,13252,31005
292870,201907,17497,44538,15182,41240,1042,3108,10086,26971,11128,30079
292880,201907,11192,30561,9637,28214,325,1375,7487,21156,7812,22531
292890,201907,6845,19243,6036,18013,243,943,5104,15042,5347,15985
292895,201907,2977,6494,2179,5280,98,242,1718,4093,1816,4335
292900,201907,2608,7196,2401,6861,51,211,1947,5387,1998,5598
292905,201907,4417,11670,3458,10229,177,621,2485,7231,2662,7852
292910,201907,4959,13619,4504,12931,249,792,3379,9598,3628,10390
292920,201907,9804,27020,9158,26097,272,1045,7915,22078,8187,23123
292925,201907,5425,15355,4620,13937,227,702,3370,10003,3597,10705
292930,201907,6612,19733,5652,17855,508,1843,3476,10624,3984,12467
292935,201907,2375,6051,1850,5461,32,142,1637,4840,1669,4982
292937,201907,3026,7365,2648,6898,71,217,2337,6071,2408,6288
292940,201907,3000,7637,2388,6710,197,465,1687,4904,1884,5369
292950,201907,9753,25055,8543,23182,501,1284,6412,17247,6913,18531
292960,201907,5281,12822,4459,11664,131,378,3537,9085,3668,9463
292970,201907,3854,11237,3378,10518,101,479,2806,8716,2907,9195
292975,201907,4490,9751,3979,9167,171,327,3553,8276,3724,8603
292980,201907,3341,8114,2693,7132,96,300,2148,5571,2244,5871
292990,201907,11453,31375,9619,28103,685,2188,7070,20359,7755,22547
293000,201907,2603,6274,2254,5765,42,160,1770,4525,1812,4685
293010,201907,18231,47110,14718,41447,1979,5751,8904,24948,10883,30699
293015,201907,8093,25174,6384,21786,439,1724,4313,14724,4752,16448
293020,201907,9949,28945,8965,27550,150,706,7931,24579,8081,25285
293030,201907,5397,14484,4106,12491,113,395,2791,8656,2904,9051
293040,201907,3980,10998,3413,10207,84,320,2937,8745,3021,9065
293050,201907,21879,54623,19471,51120,1122,3132,14506,37596,15628,40728
293060,201907,3491,9228,2856,8114,244,744,1963,5453,2207,6197
293070,201907,25222,61982,21465,56959,2487,6869,14412,38365,16899,45234
293075,201907,3396,10843,2987,10158,196,827,2337,7914,2533,8741
293076,201907,3618,8947,3236,8469,82,219,2791,7353,2873,7572
293077,201907,6113,16990,4905,15094,471,1523,3110,9826,3581,11349
293080,201907,4787,14136,4138,13046,116,512,3290,10153,3406,10665
293090,201907,3254,9504,2482,8226,230,806,1597,5285,1827,6091
293100,201907,5688,15425,4642,13528,243,764,3595,10335,3838,11099
293105,201907,3673,11658,3235,10759,206,748,2345,7684,2551,8432
293110,201907,2429,6066,2043,5515,66,248,1673,4382,1739,4630
293120,201907,4364,11970,3889,11209,126,346,3226,9299,3352,9645
293130,201907,3805,10458,3351,9857,85,341,2859,8326,2944,8667
293135,201907,29767,71398,22039,60658,3606,10835,10059,27801,13665,38636
293140,201907,2358,5338,2031,4926,74,181,1683,4048,1757,4229
293150,201907,5386,16214,4487,14514,378,1298,3047,9844,3425,11142
293160,201907,3889,9453,3307,8788,275,483,2690,7524,2965,8007
293170,201907,4645,10085,4042,9300,140,303,3459,7907,3599,8210
293180,201907,4482,12470,3668,11046,109,465,2899,8479,3008,8944
293190,201907,14232,38918,12402,36278,198,854,10819,31415,11017,32269
293200,201907,8160,20482,6592,18000,219,841,5239,13956,5458,14797
293210,201907,5305,14016,4471,12680,321,902,3392,9635,3713,10537
293220,201907,5071,13429,3776,11150,881,2627,1490,4523,2371,7150
293230,201907,3931,10168,2936,8721,242,791,1984,5943,2226,6734
293240,201907,4485,11840,3597,10378,83,235,2741,8134,2824,8369
293245,201907,3865,10420,3470,9855,158,482,2920,8204,3078,8686
293250,201907,5687,13613,4794,12436,195,508,3948,10201,4143,10709
293260,201907,4448,12218,3653,10977,130,408,2556,7626,2686,8034
293270,201907,7027,15896,5654,14408,436,723,4393,11930,4829,12653
293280,201907,4716,12472,4112,11621,255,624,3163,9014,3418,9638
293290,201907,13886,41845,12380,39434,2142,6869,7421,24148,9563,31017
293300,201907,5814,14191,5013,12992,285,705,3668,9551,3953,10256
293305,201907,4001,9903,3512,9263,39,113,3131,8216,3170,8329
293310,201907,2183,5566,1795,4911,54,160,1389,3738,1443,3898
293315,201907,4168,10046,3396,8850,175,416,2749,7138,2924,7554
293317,201907,2547,6256,2242,5815,155,339,1736,4541,1891,4880
293320,201907,11263,28358,10302,27243,329,896,9090,23948,9419,24844
293325,201907,1706,4355,1351,3854,190,556,862,2467,1052,3023
293330,201907,46777,141664,39201,127926,8565,28396,17134,57266,25699,85662
293340,201907,2301,6490,1911,5807,118,429,1296,3867,1414,4296
293345,201907,3371,9348,2702,8351,317,759,1850,6127,2167,6886
293350,201907,6711,19080,5882,18135,65,263,5384,16850,5449,17113
293360,201907,15431,39003,13132,36016,371,1457,11457,30847,11828,32304
310010,201907,846,2022,580,1643,53,180,268,710,321,890
310020,201907,2346,6665,1692,5447,365,1290,301,906,666,2196
310030,201907,2002,5824,1566,5030,241,863,938,2894,1179,3757
310040,201907,941,2480,761,2175,40,152,506,1370,546,1522
310050,201907,1549,4746,1343,4414,167,666,812,2570,979,3236
310060,201907,3209,9183,2794,8641,120,496,2272,6938,2392,7434
310070,201907,353,805,245,642,6,14,182,471,188,485
310080,201907,800,2169,536,1631,84,294,211,588,295,882
310090,201907,4584,12443,3738,11036,296,976,2687,7768,2983,8744
310100,201907,3332,9458,2816,8586,100,459,2240,6589,2340,7048
310110,201907,4747,12731,3723,10901,801,2545,1576,4409,2377,6954
310120,201907,655,1635,415,1229,53,188,231,612,284,800
310130,201907,376,1023,320,936,40,146,211,577,251,723
310140,201907,260,775,186,638,40,154,70,215,110,369
310150,201907,5060,13692,3792,11344,608,2060,1670,4707,2278,6767
310160,201907,7378,19200,5375,15873,1167,3748,1746,5125,2913,8873
310163,201907,1041,3102,827,2699,218,799,261,777,479,1576
310170,201907,9028,23473,7269,20700,683,2007,5083,14443,5766,16450
310180,201907,1724,4410,1297,3708,133,453,831,2272,964,2725
310190,201907,2862,8653,2275,7523,533,1951,292,874,825,2825
310200,201907,1795,5432,1310,4420,228,865,537,1766,765,2631
310205,201907,1103,3058,818,2598,157,557,334,1053,491,1610
310210,201907,2682,7128,2192,6290,111,331,1616,4530,1727,4861
310220,201907,1140,3127,885,2668,89,304,595,1732,684,2036
310230,201907,2279,6480,1847,5636,250,868,1086,3088,1336,3956
310240,201907,893,2854,756,2607,53,228,523,1762,576,1990
310250,201907,1033,2785,835,2470,27,116,590,1705,617,1821
310260,201907,2863,7670,1786,5740,537,1999,400,948,937,2947
310270,201907,2729,6848,2129,6016,110,411,1723,4798,1833,5209
310280,201907,2353,5607,1807,4803,292,834,977,2458,1269,3292
310285,201907,1876,6125,1600,5628,180,740,938,3256,1118,3996
310290,201907,1140,3041,946,2695,213,702,497,1263,710,1965
310300,201907,1476,4435,1271,4074,176,696,685,2017,861,2713
310310,201907,304,780,196,581,33,100,101,298,134,398
310320,201907,515,1334,336,1025,27,105,175,516,202,621
310330,201907,479,1133,284,778,38,129,118,281,156,410
310340,201907,7681,21264,6158,18640,957,2803,3018,9422,3975,12225
310350,201907,12546,30931,8512,24250,1817,5482,3271,9011,5088,14493
310360,201907,482,1144,363,988,12,39,266,703,278,742
310370,201907,1283,4066,1066,3637,223,830,326,1132,549,1962
310375,201907,844,2173,565,1747,102,321,241,739,343,1060
310380,201907,397,931,213,612,32,94,90,235,122,329
310390,201907,451,1391,359,1212,96,355,92,246,188,601
310400,201907,9652,23876,6770,19428,869,2883,3773,10472,4642,13355
310410,201907,860,2506,552,1924,101,381,175,558,276,939
310420,201907,4207,10938,2766,8089,406,1346,1028,2703,1434,4049
310430,201907,1493,4132,968,3131,200,731,320,918,520,1649
310440,201907,585,1506,405,1184,30,124,236,663,266,787
310445,201907,1339,3913,1003,3247,48,180,715,2254,763,2434
310450,201907,4755,12070,3555,10136,189,701,2634,7258,2823,7959
310460,201907,1622,4375,1120,3426,207,677,339,992,546,1669
310470,201907,3892,8481,3024,7344,300,775,2222,5374,2522,6149
310480,201907,969,2576,729,2138,109,350,451,1280,560,1630
310490,201907,2875,8016,2247,6902,288,1051,1165,3336,1453,4387
310500,201907,1402,3997,1024,3305,187,680,500,1559,687,2239
310510,201907,1991,5343,1255,3927,253,882,434,1363,687,2245
310520,201907,1265,3252,901,2616,135,365,494,1439,629,1804
310530,201907,760,1980,435,1332,65,237,122,295,187,532
310540,201907,3223,9347,2664,8338,617,2013,1122,3355,1739,5368
310550,201907,1255,3258,857,2563,73,267,495,1396,568,1663
310560,201907,14323,38235,10288,31165,1881,6444,3850,10443,5731,16887
310570,201907,1096,2944,863,2603,70,262,584,1718,654,1980
310590,201907,4134,11156,3306,9648,256,866,1869,5126,2125,5992
310600,201907,1392,4144,1123,3598,173,624,558,1654,731,2278
310610,201907,488,1306,302,985,54,199,153,458,207,657
310620,201907,168854,441493,123154,357774,21123,70249,54517,141598,75640,211847
310630,201907,4424,12331,3576,10696,282,958,2307,6670,2589,7628
310640,201907,1013,3088,848,2753,188,687,325,978,513,1665
310650,201907,2433,7087,1773,5815,205,720,965,3050,1170,3770
310660,201907,1250,3454,1051,3198,38,134,879,2635,917,2769
310665,201907,1370,3572,1077,3143,37,142,884,2553,921,2695
310670,201907,52974,140167,44515,125241,4806,15601,29217,77784,34023,93385
310680,201907,701,1719,585,1549,21,72,473,1211,494,1283
310690,201907,1766,4790,1281,3952,130,459,699,2047,829,2506
310700,201907,492,1110,380,978,36,124,272,659,308,783
310710,201907,5408,15775,3873,13522,920,3713,518,1667,1438,5380
310720,201907,941,2314,740,2050,44,140,537,1443,581,1583
310730,201907,9564,26478,8212,24221,449,1695,5912,17001,6361,18696
310740,201907,5710,16073,3820,11995,668,2277,1219,3527,1887,5804
310750,201907,1229,3009,873,2480,130,423,391,1010,521,1433
310760,201907,565,1506,406,1252,27,91,207,658,234,749
310770,201907,1081,3032,740,2490,92,368,360,1132,452,1500
310780,201907,4077,10177,3389,9114,97,302,2584,6872,2681,7174
310790,201907,1805,5740,1567,5232,411,1464,349,1095,760,2559
310800,201907,2249,6813,1625,5517,390,1544,102,308,492,1852
310810,201907,1147,2976,924,2561,45,152,642,1711,687,1863
310820,201907,1189,3115,711,2257,150,510,164,512,314,1022
310825,201907,2443,7736,1977,6920,88,500,1545,5179,1633,5679
310830,201907,1579,4621,1072,3546,217,806,438,1341,655,2147
310840,201907,1915,5288,1353,4302,372,1304,323,909,695,2213
310850,201907,1502,4152,1269,3828,60,296,966,2761,1026,3057
310855,201907,3191,8584,2465,7410,204,692,1673,4896,1877,5588
310860,201907,6949,20278,5526,17433,556,1891,3341,10550,3897,12441
310870,201907,1039,2496,792,2130,75,208,565,1530,640,1738
310880,201907,1003,3016,775,2555,102,340,447,1440,549,1780
310890,201907,2293,6528,1464,4914,296,1070,204,603,500,1673
310900,201907,4115,11624,2889,9018,439,1454,1218,3497,1657,4951
310910,201907,1896,4802,1267,3733,121,447,227,586,348,1033
310920,201907,1857,4961,1413,4250,236,748,751,2235,987,2983
310925,201907,957,2700,782,2393,88,305,511,1486,599,1791
310930,201907,5737,15463,4101,12767,806,2625,1944,6184,2750,8809
310940,201907,6395,15949,5119,14029,264,944,3714,9804,3978,10748
310945,201907,1280,3377,1018,2966,110,368,572,1603,682,1971
310950,201907,1861,5593,1236,4175,244,913,424,1281,668,2194
310960,201907,717,1881,431,1347,64,214,149,463,213,677
310970,201907,1180,3542,817,2754,203,742,155,476,358,1218
310980,201907,314,752,207,579,23,66,127,346,150,412
310990,201907,1258,3607,949,3030,189,625,429,1333,618,1958
311000,201907,4052,11587,2996,9761,775,2690,1157,3620,1932,6310
311010,201907,821,2512,655,2148,242,860,212,660,454,1520
311020,201907,997,2648,651,2002,60,197,316,940,376,1137
311030,201907,1571,4027,1059,3120,219,738,460,1232,679,1970
311040,201907,324,1038,253,865,70,252,70,219,140,471
311050,201907,2620,6742,1988,5781,391,1279,939,2599,1330,3878
311060,201907,2953,7859,2060,6060,327,1131,804,2136,1131,3267
311070,201907,2214,5750,1592,4722,191,714,785,2184,976,2898
311080,201907,1055,2512,867,2197,39,146,659,1567,698,1713
311090,201907,2039,6621,1596,5782,357,1454,491,1721,848,3175
311100,201907,2125,6170,1283,4450,279,1092,197,610,476,1702
311110,201907,3660,7667,2024,5330,392,1103,757,2025,1149,3128
311115,201907,1306,3123,1071,2790,73,188,836,2139,909,2327
311120,201907,6524,17430,4853,14294,773,2575,1719,4494,2492,7069
311130,201907,1885,5034,1424,4381,135,535,769,2260,904,2795
311140,201907,1395,3478,1038,2966,76,248,653,1848,729,2096
311150,201907,1552,4942,1221,4296,198,787,643,2169,841,2956
311160,201907,3716,10892,2586,8760,696,2640,718,2352,1414,4992
311170,201907,871,2290,694,2037,41,116,439,1354,480,1470
311180,201907,1324,3042,838,2315,168,499,369,1012,537,1511
311190,201907,991,2748,723,2214,110,379,282,772,392,1151
311200,201907,1872,5155,1296,4014,296,992,382,1061,678,2053
311205,201907,876,2692,723,2379,45,206,429,1344,474,1550
311210,201907,1016,3014,884,2843,119,356,642,2115,761,2471
311220,201907,737,2097,607,1864,62,217,350,1004,412,1221
311230,201907,7721,23464,5731,19398,990,3534,2102,7240,3092,10774
311240,201907,982,2658,755,2343,171,576,342,1037,513,1613
311250,201907,889,2575,692,2219,162,528,297,921,459,1449
311260,201907,2502,6308,1569,4667,269,851,618,1730,887,2581
311265,201907,1284,3409,954,2837,44,165,665,1901,709,2066
311270,201907,3003,9052,2604,8385,175,786,1906,5831,2081,6617
311280,201907,1184,3143,530,1748,102,365,70,211,172,576
311290,201907,1880,5811,1725,5473,173,573,1158,3653,1331,4226
311300,201907,4676,13394,3843,11946,215,918,2964,8960,3179,9878
311310,201907,575,1630,483,1458,54,179,260,745,314,924
311320,201907,3108,9666,2626,8564,419,1558,1185,3551,1604,5109
311330,201907,4866,13210,3963,11702,435,1419,2190,6541,2625,7960
311340,201907,10145,29224,7985,25246,2302,7833,1957,5900,4259,13733
311350,201907,2260,5770,1560,4456,150,508,843,2155,993,2663
311360,201907,1118,2781,703,2122,222,756,191,534,413,1290
311370,201907,4486,11213,3321,9275,176,703,2087,5472,2263,6175
311380,201907,379,1167,292,990,73,252,105,369,178,621
311390,201907,1684,5300,1333,4816,563,2318,325,1008,888,3326
311400,201907,1399,3993,1019,3246,142,499,408,1159,550,1658
311410,201907,1608,4792,1324,4391,217,816,712,2383,929,3199
311420,201907,1535,4575,1040,3512,184,680,194,532,378,1212
311430,201907,3561,9716,2309,7172,472,1491,662,2085,1134,3576
311440,201907,2491,7266,1755,5939,381,1490,579,1901,960,3391
311450,201907,1723,5322,1261,4418,312,1218,306,922,618,2140
311455,201907,978,2280,659,1798,182,500,237,662,419,1162
311460,201907,487,1544,328,1217,68,323,88,288,156,611
311470,201907,444,1424,310,1104,78,330,52,167,130,497
311480,201907,1161,3184,993,2941,46,123,797,2400,843,2523
311490,201907,243,725,188,611,41,160,85,237,126,397
311500,201907,413,1051,307,884,29,99,190,527,219,626
311510,201907,3019,8112,1990,6218,326,1180,766,2189,1092,3369
311520,201907,565,1662,512,1553,97,334,281,819,378,1153
311530,201907,8744,20848,5475,15461,1347,4232,1380,3764,2727,7996
311535,201907,747,2062,496,1560,74,260,161,468,235,728
311540,201907,510,1618,446,1504,82,300,274,908,356,1208
311545,201907,2033,5844,1761,5458,98,383,1340,4071,1438,4454
311547,201907,1468,3824,1288,3544,45,144,897,2506,942,2650
311550,201907,2722,7768,2153,6676,327,1169,884,2608,1211,3777
311560,201907,288,643,192,513,29,89,104,248,133,337
311570,201907,1778,4178,1270,3465,52,154,986,2735,1038,2889
311580,201907,2212,4116,1423,3190,159,321,933,2142,1092,2463
311590,201907,489,1339,398,1204,69,236,208,607,277,843
311600,201907,1740,3943,1467,3610,61,159,1248,3015,1309,3174
311610,201907,2314,7755,1918,6842,275,1047,970,3415,1245,4462
311615,201907,3008,8910,2470,7995,157,586,1860,5910,2017,6496
311620,201907,434,1179,372,1098,21,81,299,868,320,949
311630,201907,1346,3747,1078,3220,92,307,701,1996,793,2303
311640,201907,540,1561,424,1342,75,282,200,588,275,870
311650,201907,1884,4968,1565,4460,129,442,1050,2869,1179,3311
311660,201907,2782,8043,2017,6602,378,1357,480,1337,858,2694
311670,201907,1537,4056,1118,3315,163,550,497,1480,660,2030
311680,201907,2161,6319,1615,5289,225,755,985,3207,1210,3962
311690,201907,575,1248,437,1074,45,102,312,810,357,912
311700,201907,2264,5465,1768,4763,33,146,1461,3804,1494,3950
311710,201907,1480,4350,1033,3484,248,912,383,1266,631,2178
311720,201907,409,1251,322,1083,28,121,179,582,207,703
311730,201907,4132,10608,2593,7724,775,2494,446,1348,1221,3842
311740,201907,852,2360,718,2185,37,101,619,1929,656,2030
311750,201907,3866,11904,3159,10648,472,1739,1704,5503,2176,7242
311760,201907,608,1791,509,1608,85,345,228,603,313,948
311770,201907,1993,5885,1529,4998,276,1000,645,1994,921,2994
311780,201907,1284,3796,860,2914,167,636,238,704,405,1340
311783,201907,2189,6143,1786,5422,57,256,1402,4097,1459,4353
311787,201907,703,2066,513,1632,77,286,190,513,267,799
311790,201907,1459,3898,954,2993,243,844,266,791,509,1635
311800,201907,4844,14796,3935,12787,770,2721,656,1888,1426,4609
311810,201907,967,2994,758,2598,55,217,465,1576,520,1793
311820,201907,780,1970,583,1651,84,268,330,870,414,1138
311830,201907,8410,24734,5745,18804,1598,5594,677,2119,2275,7713
311840,201907,3301,8730,2781,7977,288,881,2005,5697,2293,6578
311850,201907,326,884,264,771,17,49,170,477,187,526
311860,201907,56392,145762,43080,122900,6793,20762,23365,63903,30158,84665
311870,201907,1949,5239,1271,3986,210,730,458,1287,668,2017
311880,201907,6207,16357,5197,14913,294,794,3946,11450,4240,12244
311890,201907,1550,3913,1202,3411,104,352,804,2175,908,2527
311900,201907,727,1911,550,1656,67,241,356,1033,423,1274
311910,201907,4162,10825,3118,9445,597,1797,1534,4751,2131,6548
311920,201907,2028,5659,1622,5031,135,401,971,3056,1106,3457
311930,201907,3286,8140,2460,6948,870,2640,723,1894,1593,4534
311940,201907,14263,38514,10504,31284,1557,5073,4739,13221,6296,18294
311950,201907,2133,6024,1567,5031,89,403,998,3108,1087,3511
311960,201907,530,1349,430,1194,28,124,269,648,297,772
311970,201907,432,1414,287,1045,57,227,56,173,113,400
311980,201907,438,1232,226,777,30,113,62,210,92,323
311990,201907,547,1333,357,1055,79,280,146,385,225,665
311995,201907,991,2785,510,1650,19,63,64,141,83,204
312000,201907,603,1618,499,1465,43,142,325,947,368,1089
312010,201907,898,2559,688,2190,65,231,401,1217,466,1448
312015,201907,1333,4021,1183,3756,66,304,909,2788,975,3092
312020,201907,1218,3804,955,3289,236,856,288,951,524,1807
312030,201907,2028,5010,1763,4705,25,106,1624,4298,1649,4404
312040,201907,791,2520,596,2073,60,228,257,868,317,1096
312050,201907,1223,3944,961,3401,222,908,266,823,488,1731
312060,201907,851,2144,556,1758,141,455,247,786,388,1241
312070,201907,889,2640,634,2121,70,270,307,970,377,1240
312080,201907,2735,6869,2044,5827,134,449,1291,3513,1425,3962
312083,201907,858,2303,644,1967,64,229,405,1184,469,1413
312087,201907,2364,6344,1957,5704,64,216,1513,4415,1577,4631
312090,201907,9557,25905,7317,22189,1230,4176,3421,10069,4651,14245
312100,201907,1561,4688,1153,3924,118,534,573,1849,691,2383
312110,201907,1021,3234,857,2893,217,848,273,826,490,1674
312120,201907,767,2134,531,1713,157,579,159,430,316,1009
312125,201907,1666,4426,1396,4016,124,396,1002,2783,1126,3179
312130,201907,930,2330,684,1918,65,195,277,736,342,931
312140,201907,736,2175,608,1913,127,435,252,717,379,1152
312150,201907,456,1293,383,1131,13,63,270,732,283,795
312160,201907,8059,23010,6085,19410,845,3099,2769,8284,3614,11383
312170,201907,915,2486,682,2038,37,140,464,1336,501,1476
312180,201907,1360,3760,1070,3174,171,537,519,1471,690,2008
312190,201907,582,1722,410,1370,88,310,100,327,188,637
312200,201907,4731,12778,3726,11175,1094,3272,1395,4304,2489,7576
312210,201907,1349,3168,967,2602,51,163,676,1762,727,1925
312220,201907,1786,5563,1524,5067,121,433,942,3137,1063,3570
312230,201907,12307,32955,8076,25086,2120,7282,1451,3925,3571,11207
312235,201907,1857,4952,1490,4373,91,333,1042,2971,1133,3304
312240,201907,667,2234,509,1887,109,434,144,524,253,958
312245,201907,2551,6807,2098,6102,76,266,1677,4843,1753,5109
312247,201907,905,2295,640,1885,125,387,315,935,440,1322
312250,201907,988,2642,633,1930,85,267,258,776,343,1043
312260,201907,868,2487,698,2206,43,186,494,1489,537,1675
312270,201907,706,1967,535,1632,32,137,289,795,321,932
312280,201907,422,1252,329,1082,102,341,39,116,141,457
312290,201907,730,2213,584,1928,124,470,199,621,323,1091
312300,201907,905,2747,622,2081,161,581,120,331,281,912
312310,201907,799,2607,656,2307,99,389,290,981,389,1370
312320,201907,1814,4815,1322,3933,353,1095,271,779,624,1874
312330,201907,863,2596,686,2236,67,232,433,1374,500,1606
312340,201907,262,682,183,549,46,161,62,160,108,321
312350,201907,266,555,196,477,19,56,133,310,152,366
312352,201907,1622,4863,1423,4512,107,357,868,2910,975,3267
312360,201907,2556,7638,1862,6188,381,1377,500,1589,881,2966
312370,201907,1755,4806,1449,4273,226,753,760,2129,986,2882
312380,201907,2177,4965,1802,4492,14,47,1591,3930,1605,3977
312385,201907,1276,3580,976,3016,153,531,465,1368,618,1899
312390,201907,1884,5558,1402,4631,221,818,480,1426,701,2244
312400,201907,2796,8385,2267,7367,729,2478,676,2235,1405,4713
312410,201907,11607,33007,9495,29290,1759,5655,4911,14884,6670,20539
312420,201907,3627,10221,3042,9197,581,1890,1582,4671,2163,6561
312430,201907,7999,21307,6357,18367,499,1653,4253,11996,4752,13649
312440,201907,906,2940,693,2436,361,1332,68,204,429,1536
312450,201907,1174,3529,889,2998,262,943,284,978,546,1921
312460,201907,431,1134,292,914,34,122,159,507,193,629
312470,201907,484,1196,309,890,44,148,119,294,163,442
312480,201907,1124,2866,781,2368,111,355,376,1100,487,1455
312490,201907,2047,5075,1530,4282,228,654,790,2132,1018,2786
312500,201907,906,2280,718,2003,43,159,491,1347,534,1506
312510,201907,3649,9952,2691,8123,724,2099,751,2310,1475,4409
312520,201907,156,479,133,434,36,116,60,193,96,309
312530,201907,566,1438,490,1342,17,58,430,1177,447,1235
312540,201907,1514,4381,995,3257,166,591,498,1572,664,2163
312550,201907,767,2074,568,1659,38,127,363,971,401,1098
312560,201907,1971,5097,1602,4543,72,236,1231,3481,1303,3717
312570,201907,2130,5498,1641,4858,490,1517,610,1840,1100,3357
312580,201907,598,1713,442,1369,60,214,200,576,260,790
312590,201907,1631,4873,1323,4261,108,460,772,2311,880,2771
312595,201907,1722,5290,1499,4892,299,932,869,2971,1168,3903
312600,201907,1038,2569,531,1696,80,307,172,548,252,855
312610,201907,6282,16441,4008,12075,593,1933,1310,3707,1903,5640
312620,201907,2501,6530,1821,5574,53,234,1446,4491,1499,4725
312630,201907,266,824,198,695,37,158,76,250,113,408
312640,201907,556,1554,376,1241,50,167,128,439,178,606
312650,201907,2073,5450,1404,4138,78,248,951,2661,1029,2909
312660,201907,1352,3354,1019,2781,85,297,675,1733,760,2030
312670,201907,4953,13399,4082,11986,214,918,2862,7963,3076,8881
312675,201907,1220,3343,997,2985,59,224,787,2294,846,2518
312680,201907,1382,3952,1155,3603,63,287,913,2757,976,3044
312690,201907,2590,5840,2038,5143,81,233,1703,4218,1784,4451
312695,201907,940,2682,794,2428,43,104,595,1840,638,1944
312700,201907,2074,5539,1487,4449,154,528,831,2352,985,2880
312705,201907,1313,3370,1104,3035,24,89,946,2568,970,2657
312707,201907,1359,4085,1053,3512,71,362,641,1999,712,2361
312710,201907,6561,15142,3784,10729,1036,3171,998,2919,2034,6090
312720,201907,1037,2929,780,2498,102,369,445,1362,547,1731
312730,201907,1645,3968,1193,3345,92,287,694,1872,786,2159
312733,201907,1446,3825,1084,3155,40,151,711,1956,751,2107
312735,201907,638,1768,538,1573,74,258,339,877,413,1135
312737,201907,825,1932,556,1525,78,246,309,767,387,1013
312738,201907,604,1604,420,1268,48,168,214,606,262,774
312740,201907,433,1093,245,768,54,184,59,146,113,330
312750,201907,1385,4319,1102,3767,207,782,422,1350,629,2132
312760,201907,1843,5576,1325,4491,247,891,443,1442,690,2333
312770,201907,43935,106900,27066,78007,5975,18284,8525,24041,14500,42325
312780,201907,2440,7459,2055,6803,243,923,1295,4233,1538,5156
312790,201907,263,654,157,496,8,39,54,141,62,180
312800,201907,4911,14279,3781,12053,905,3077,1326,4102,2231,7179
312810,201907,1658,4498,1077,3505,263,969,349,991,612,1960
312820,201907,1779,4887,1445,4262,58,228,1044,2976,1102,3204
312825,201907,1328,3175,1135,2907,24,88,955,2394,979,2482
312830,201907,2811,8020,1601,5438,336,1275,376,1210,712,2485
312840,201907,1241,3545,947,3008,123,491,440,1285,563,1776
312850,201907,882,2209,613,1789,39,157,340,905,379,1062
312860,201907,1295,3326,853,2627,220,723,191,553,411,1276
312870,201907,6327,17501,3771,12303,643,2303,832,2561,1475,4864
312880,201907,1388,3556,1084,3056,43,163,596,1688,639,1851
312890,201907,2119,5565,1473,4410,132,411,703,2115,835,2526
312900,201907,1187,3141,951,2827,91,298,546,1718,637,2016
312910,201907,1624,3028,834,1983,149,310,318,720,467,1030
312920,201907,1013,2819,683,2224,145,540,258,768,403,1308
312930,201907,2143,5555,1701,4875,364,1075,736,2094,1100,3169
312940,201907,918,2609,717,2293,90,347,344,1045,434,1392
312950,201907,3144,7949,2042,6115,524,1717,670,1900,1194,3617
312960,201907,1882,4998,1556,4506,106,275,1158,3466,1264,3741
312965,201907,1672,4835,1394,4354,137,468,906,2769,1043,3237
312970,201907,1191,3448,927,2997,170,662,464,1363,634,2025
312980,201907,22483,63811,18220,55965,3203,10834,9182,26573,12385,37407
312990,201907,450,1177,272,866,57,213,115,351,172,564
313000,201907,452,1334,342,1132,37,155,182,566,219,721
313005,201907,2533,7395,2137,6729,136,463,1544,4751,1680,5214
313010,201907,4710,13451,3819,11930,719,2502,2191,6595,2910,9097
313020,201907,933,2876,615,2127,110,414,108,312,218,726
313030,201907,1163,2822,784,2225,84,309,483,1284,567,1593
313040,201907,788,2496,631,2141,49,205,356,1136,405,1341
313050,201907,1769,5087,1243,4284,211,882,355,1073,566,1955
313055,201907,1851,5116,1664,4827,60,188,1388,4006,1448,4194
313060,201907,979,2453,655,1922,206,675,139,337,345,1012
313065,201907,1640,5057,1443,4716,69,295,1066,3356,1135,3651
313070,201907,972,2575,728,2133,75,234,413,1184,488,1418
313080,201907,380,1043,270,824,57,193,86,212,143,405
313090,201907,4736,13175,4065,12007,495,1652,2507,7257,3002,8909
313100,201907,1364,3576,1037,3091,43,168,756,2215,799,2383
313110,201907,1466,3955,1039,3159,98,375,573,1592,671,1967
313115,201907,2475,7449,2045,6601,301,1080,1013,3053,1314,4133
313120,201907,3656,8767,2692,7480,289,887,1639,4521,1928,5408
313130,201907,28853,77391,22216,64740,2726,9042,12046,33006,14772,42048
313140,201907,574,1305,352,970,25,80,227,617,252,697
313150,201907,1364,3926,1003,3209,281,956,274,814,555,1770
313160,201907,1011,2643,777,2241,38,141,570,1592,608,1733
313170,201907,11417,33625,7990,26830,1448,5212,2923,9245,4371,14457
313180,201907,2218,6021,1550,4669,199,648,821,2400,1020,3048
313190,201907,4330,12663,3112,10113,572,1996,1039,3132,1611,5128
313200,201907,1065,3042,920,2785,22,96,765,2226,787,2322
313210,201907,3764,11195,3085,9949,387,1430,1800,5568,2187,6998
313220,201907,1755,4726,1158,3554,182,634,424,1125,606,1759
313230,201907,2952,8318,2447,7711,76,272,1994,6371,2070,6643
313240,201907,9167,23060,5623,17252,1031,3590,2280,6404,3311,9994
313250,201907,6078,18168,4725,15405,735,2491,2256,7205,2991,9696
313260,201907,604,1601,419,1256,51,187,197,549,248,736
313270,201907,5569,14910,4465,13184,672,2050,2740,8149,3412,10199
313280,201907,435,1242,287,934,43,146,109,343,152,489
313290,201907,902,2877,688,2521,230,913,219,766,449,1679
313300,201907,1611,4503,1164,3671,318,1068,216,584,534,1652
313310,201907,1058,3235,833,2732,138,527,218,611,356,1138
313320,201907,2131,5693,1478,4626,281,992,633,1973,914,2965
313330,201907,3979,10843,3044,9404,181,760,1950,5921,2131,6681
313340,201907,1326,3045,937,2485,103,281,653,1722,756,2003
313350,201907,2216,6367,1471,4705,209,768,552,1583,761,2351
313360,201907,1312,3344,883,2632,154,546,449,1242,603,1788
313370,201907,1312,3831,1141,3498,150,541,647,1832,797,2373
313375,201907,1690,4449,1027,3225,194,686,237,695,431,1381
313380,201907,5867,15213,4116,11901,800,2549,1782,4631,2582,7180
313390,201907,859,2801,753,2625,54,249,481,1598,535,1847
313400,201907,3687,9270,2851,8125,183,590,2170,6032,2353,6622
313410,201907,1284,3405,971,2846,61,200,711,2054,772,2254
313420,201907,15263,34715,7561,21468,1688,5266,984,2785,2672,8051
313430,201907,859,2551,654,2146,114,452,264,778,378,1230
313440,201907,6044,13253,3947,10479,296,835,2554,6747,2850,7582
313450,201907,640,1815,459,1439,95,326,143,386,238,712
313460,201907,2122,6264,1703,5594,354,1348,779,2407,1133,3755
313470,201907,2936,7546,2312,6644,255,712,1465,4288,1720,5000
313480,201907,912,2659,519,1774,78,285,138,421,216,706
313490,201907,1880,4486,899,2830,311,1113,100,338,411,1451
313500,201907,425,1272,331,1051,34,112,126,377,160,489
313505,201907,9649,25942,8216,24010,325,1176,6679,19404,7004,20580
313507,201907,1462,3889,1205,3493,31,130,950,2701,981,2831
313510,201907,12708,35595,10299,31085,1294,4176,5127,14983,6421,19159
313520,201907,13628,39424,11020,34821,718,2661,7937,24546,8655,27207
313530,201907,532,1559,406,1307,32,113,179,535,211,648
313535,201907,2352,6468,2019,5848,157,401,1403,4018,1560,4419
313540,201907,794,2447,608,1966,112,368,236,710,348,1078
313545,201907,1187,3995,1002,3615,165,614,534,1858,699,2472
313550,201907,1729,5338,1437,4650,347,1251,662,2028,1009,3279
313560,201907,2599,5222,1911,4385,73,137,1612,3695,1685,3832
313570,201907,946,2866,764,2520,185,657,299,922,484,1579
313580,201907,5468,14656,4151,12434,523,1699,2327,7044,2850,8743
313590,201907,951,2788,749,2484,223,792,311,1067,534,1859
313600,201907,3776,10420,3153,9425,110,457,2591,7586,2701,8043
313610,201907,1002,2584,808,2238,103,294,489,1289,592,1583
313620,201907,5398,14662,4286,12643,649,2123,2307,6524,2956,8647
313630,201907,8406,20916,5795,16907,675,2285,3206,9120,3881,11405
313640,201907,1025,2448,629,1912,200,618,178,568,378,1186
313650,201907,1743,5309,1420,4765,96,381,931,3135,1027,3516
313652,201907,779,2537,705,2369,128,485,422,1369,550,1854
313655,201907,1110,2904,894,2609,48,151,700,2031,748,2182
313657,201907,1245,3344,970,2900,50,206,696,1964,746,2170
313660,201907,865,2466,703,2158,93,349,405,1148,498,1497
313665,201907,4560,12536,3517,10663,495,1680,1987,5748,2482,7428
313670,201907,46386,116895,29393,87395,4879,15957,12122,33968,17001,49925
313680,201907,1004,2734,840,2475,66,224,542,1538,608,1762
313690,201907,835,2693,641,2295,151,585,185,620,336,1205
313695,201907,1701,4767,1314,4125,81,294,903,2815,984,3109
313700,201907,3011,9826,2628,9336,258,981,1967,6971,2225,7952
313710,201907,1371,3273,966,2691,80,230,650,1816,730,2046
313720,201907,5361,15119,3850,11993,589,2085,1636,4675,2225,6760
313730,201907,1283,2997,966,2566,88,204,630,1660,718,1864
313740,201907,1659,5946,1335,5089,339,1462,217,714,556,2176
313750,201907,1916,5328,1478,4462,302,1013,621,1747,923,2760
313753,201907,2119,5142,1412,4001,146,442,791,2154,937,2596
313760,201907,5046,14173,3708,11528,860,2858,1432,4190,2292,7048
313770,201907,3821,10946,3048,9689,211,732,2174,6942,2385,7674
313780,201907,4067,11102,2942,9142,276,1012,764,2411,1040,3423
313790,201907,477,1509,421,1400,50,188,233,739,283,927
313800,201907,1320,3139,984,2634,133,411,521,1308,654,1719
313810,201907,1594,4160,1253,3663,67,248,913,2610,980,2858
313820,201907,14874,35883,9677,26534,1594,4739,3365,8909,4959,13648
313830,201907,354,1021,264,821,54,176,104,297,158,473
313835,201907,911,2741,738,2402,68,263,384,1179,452,1442
313840,201907,6595,17644,4758,14437,1255,4020,993,3078,2248,7098
313850,201907,930,2332,742,2060,120,406,389,964,509,1370
313860,201907,2598,7205,1921,5843,308,1037,736,2084,1044,3121
313862,201907,1476,3251,713,2059,53,169,349,963,402,1132
313865,201907,2296,6300,1956,5756,118,360,1483,4281,1601,4641
313867,201907,1126,3536,952,3201,161,565,580,1953,741,2518
313868,201907,1718,5353,1412,4730,54,260,1067,3455,1121,3715
313870,201907,794,2209,586,1824,109,355,208,591,317,946
313880,201907,1475,3983,1080,3308,184,623,479,1330,663,1953
313890,201907,1984,4487,1461,3806,69,211,1016,2582,1085,2793
313900,201907,3883,11636,2828,9480,745,2771,671,2073,1416,4844
313910,201907,600,1825,442,1516,102,376,91,300,193,676
313920,201907,2929,9262,2450,8255,511,1712,1200,4043,1711,5755
313925,201907,1577,4113,1262,3538,202,546,772,2155,974,2701
313930,201907,4770,14485,3851,12830,307,1193,2502,8157,2809,9350
313940,201907,8386,24941,5995,20650,1025,4197,1441,5367,2466,9564
313950,201907,5006,11439,3547,9563,467,1608,2068,5443,2535,7051
313960,201907,5429,13697,3640,10602,821,2640,1136,3044,1957,5684
313970,201907,1398,3931,1207,3592,27,95,762,2245,789,2340
313980,201907,1350,3578,872,2789,131,476,318,973,449,1449
313990,201907,1826,6008,1317,4792,353,1426,381,1216,734,2642
314000,201907,9478,25245,7929,22563,544,1972,5309,14797,5853,16769
314010,201907,1354,3392,1078,3009,48,168,802,2166,850,2334
314015,201907,2001,5639,1530,4865,223,860,789,2398,1012,3258
314020,201907,488,1366,296,986,57,239,53,187,110,426
314030,201907,762,2240,608,1937,70,238,309,961,379,1199
314040,201907,643,1760,517,1512,90,298,262,731,352,1029
314050,201907,1724,4692,1232,3777,165,587,629,1788,794,2375
314053,201907,1811,5447,1441,4696,269,858,717,2445,986,3303
314055,201907,2287,6254,1953,5748,56,216,1581,4658,1637,4874
314060,201907,1223,3301,921,2820,42,162,627,1884,669,2046
314070,201907,4536,12730,3554,10933,755,2348,1478,4436,2233,6784
314080,201907,2152,5795,1386,4360,202,760,519,1439,721,2199
314085,201907,2083,6145,1713,5557,288,977,889,2905,1177,3882
314090,201907,4144,11830,3523,10828,242,973,2284,6936,2526,7909
314100,201907,3150,7479,2436,6490,70,193,1862,4961,1932,5154
314110,201907,4348,12697,3571,11163,441,1600,1962,5705,2403,7305
314120,201907,853,2001,326,998,79,281,56,168,135,449
314130,201907,670,1780,391,1225,33,127,205,623,238,750
314140,201907,4603,13323,3541,11186,535,1778,1663,5114,2198,6892
314150,201907,1498,3789,1099,3085,95,277,718,1951,813,2228
314160,201907,2216,5997,1587,4845,239,786,640,1962,879,2748
314170,201907,973,2780,773,2373,61,211,465,1334,526,1545
314180,201907,5399,15341,4407,13707,407,1401,2546,7879,2953,9280
314190,201907,601,1544,421,1267,83,285,186,501,269,786
314200,201907,2865,8169,2337,7246,130,501,1665,4989,1795,5490
314210,201907,1965,5240,1548,4479,164,504,812,2284,976,2788
314220,201907,1314,3682,926,2994,216,819,326,958,542,1777
314225,201907,1110,3208,927,2923,80,239,656,2103,736,2342
314230,201907,766,2034,631,1863,84,274,390,1176,474,1450
314240,201907,1025,2797,787,2443,186,593,309,980,495,1573
314250,201907,516,1459,316,1031,44,159,118,348,162,507
314260,201907,940,2711,752,2419,166,585,385,1185,551,1770
314270,201907,3250,9254,2622,8260,95,380,1921,5960,2016,6340
314280,201907,3349,7866,2142,5955,286,889,1036,2689,1322,3578
314290,201907,4503,11841,3719,10453,347,991,2504,6919,2851,7910
314300,201907,1741,5163,1193,3927,261,946,368,1159,629,2105
314310,201907,4386,11853,3026,9457,943,3151,522,1501,1465,4652
314315,201907,908,3204,776,2917,61,299,519,1879,580,2178
314320,201907,2788,7666,1806,5827,344,1212,650,2018,994,3230
314330,201907,47752,135019,35838,114014,10197,33834,7744,25602,17941,59436
314340,201907,2277,5760,1262,3866,266,963,307,764,573,1727
314345,201907,1383,4203,1137,3757,160,546,659,2134,819,2680
314350,201907,902,2531,600,1975,128,463,139,410,267,873
314360,201907,576,1663,350,1168,59,210,101,312,160,522
314370,201907,692,1911,545,1682,34,137,389,1152,423,1289
314380,201907,1102,3121,751,2448,183,686,160,497,343,1183
314390,201907,12283,32310,7814,23820,1666,5423,2218,6011,3884,11434
314400,201907,3978,11947,3067,10198,830,2884,1089,3711,1919,6595
314410,201907,2747,7725,1857,5999,279,1005,636,2150,915,3155
314420,201907,800,1973,602,1702,24,111,427,1134,451,1245
314430,201907,7021,17986,4955,14359,810,2497,2130,5886,2940,8383
314435,201907,1603,4395,1280,3835,54,208,934,2753,988,2961
314437,201907,940,2447,655,1962,65,228,308,906,373,1134
314440,201907,587,1702,421,1374,112,395,89,246,201,641
314450,201907,1341,3666,1117,3304,111,373,675,1930,786,2303
314460,201907,3294,10266,2368,8186,596,2178,448,1511,1044,3689
314465,201907,2186,6450,1880,5840,53,217,1416,4230,1469,4447
314467,201907,840,2317,725,2120,29,89,575,1643,604,1732
314470,201907,2185,6423,1745,5470,324,1121,755,2208,1079,3329
314480,201907,6223,18342,4439,14457,764,2754,1416,4108,2180,6862
314490,201907,967,2705,714,2159,73,247,423,1231,496,1478
314500,201907,1670,4233,1205,3500,237,702,489,1413,726,2115
314505,201907,1959,4888,1602,4385,104,296,1145,3072,1249,3368
314510,201907,1832,4858,1256,3957,265,927,547,1671,812,2598
314520,201907,4580,14367,3244,11342,639,2434,399,1216,1038,3650
314530,201907,5488,17970,4911,16830,402,1668,3453,11573,3855,13241
314535,201907,2572,6799,2074,6049,113,416,1549,4451,1662,4867
314537,201907,1122,3238,861,2787,57,229,595,1875,652,2104
314540,201907,418,1090,284,837,22,80,132,369,154,449
314545,201907,1774,4456,1566,4194,40,108,1315,3643,1355,3751
314550,201907,649,1626,487,1385,41,159,256,648,297,807
314560,201907,4024,12464,2991,10078,493,1794,964,2995,1457,4789
314570,201907,290,806,220,679,28,103,101,312,129,415
314580,201907,437,1332,327,1104,96,337,85,294,181,631
314585,201907,648,2067,487,1696,60,267,235,769,295,1036
314587,201907,2010,5559,1522,4779,207,592,832,2672,1039,3264
314590,201907,3644,10211,2515,7988,374,1328,994,2944,1368,4272
314600,201907,1797,5080,1048,3586,216,811,120,368,336,1179
314610,201907,8723,22777,6024,18737,1150,4137,2432,7398,3582,11535
314620,201907,2162,5175,1685,4553,52,191,1380,3648,1432,3839
314625,201907,1508,4279,1279,3948,48,269,1042,3124,1090,3393
314630,201907,5161,13538,4248,12278,130,520,3489,10073,3619,10593
314640,201907,639,1583,453,1276,69,228,235,599,304,827
314650,201907,894,2148,544,1594,55,185,262,671,317,856
314655,201907,1574,4364,1117,3529,183,557,526,1643,709,2200
314660,201907,335,799,215,569,9,16,129,324,138,340
314670,201907,1684,3897,1170,3168,32,107,730,1952,762,2059
314675,201907,1719,4657,1486,4262,100,359,1133,3132,1233,3491
314690,201907,2060,5948,1575,5168,470,1669,453,1489,923,3158
314700,201907,9997,28749,6377,21383,1295,4751,1675,5417,2970,10168
314710,201907,7705,21989,5476,17239,1120,3796,1445,4040,2565,7836
314720,201907,2123,6393,1428,4904,305,1177,350,1149,655,2326
314730,201907,2059,5790,1469,4618,345,1123,419,1263,764,2386
314740,201907,2801,8030,2209,6973,302,1042,1115,3443,1417,4485
314750,201907,325,906,250,751,22,82,138,370,160,452
314760,201907,1826,5617,1171,4056,180,703,283,802,463,1505
314770,201907,1081,3211,548,1785,51,173,155,451,206,624
314780,201907,345,834,226,656,44,156,118,302,162,458
314790,201907,9712,26824,6556,20826,1613,5808,1844,5380,3457,11188
314795,201907,1433,3877,1219,3506,38,172,949,2602,987,2774
314800,201907,10836,27991,6299,19363,1223,4100,1314,3619,2537,7719
314810,201907,8432,23077,6084,18877,1640,5417,1825,5581,3465,10998
314820,201907,1060,2695,824,2326,54,211,529,1421,583,1632
314830,201907,1434,4462,1208,4005,252,903,553,1817,805,2720
314840,201907,890,2881,694,2556,63,317,470,1652,533,1969
314850,201907,1958,4800,1574,4279,45,154,1346,3662,1391,3816
314860,201907,3136,9582,2593,8505,311,1214,1627,5155,1938,6369
314870,201907,6207,16242,4705,14136,332,1103,3388,10180,3720,11283
314875,201907,1719,5233,1523,4972,111,310,1228,4067,1339,4377
314880,201907,876,2141,684,1865,29,84,448,1257,477,1341
314890,201907,415,1238,301,975,54,197,109,320,163,517
314900,201907,646,1758,496,1500,99,320,190,557,289,877
314910,201907,1619,4710,1202,4020,258,1003,553,1714,811,2717
314915,201907,2213,6635,1853,5998,128,449,1221,3867,1349,4316
314920,201907,474,1233,303,965,11,41,203,639,214,680
314930,201907,5266,15460,3971,12971,773,2744,1443,4416,2216,7160
314940,201907,403,1045,336,927,36,94,208,540,244,634
314950,201907,460,1208,296,931,27,120,139,376,166,496
314960,201907,796,2014,615,1681,32,100,444,1150,476,1250
314970,201907,843,2444,663,2103,124,416,314,943,438,1359
314980,201907,1340,3598,963,3006,234,830,351,1063,585,1893
314990,201907,2373,6950,1584,5103,345,1231,324,890,669,2121
314995,201907,1635,4668,1296,4051,67,280,830,2469,897,2749
315000,201907,1091,2895,786,2405,69,235,504,1488,573,1723
315010,201907,382,1083,280,890,48,188,131,383,179,571
315015,201907,2196,6363,1922,5900,191,646,1229,3734,1420,4380
315020,201907,779,2344,554,1829,72,297,230,661,302,958
315030,201907,572,1585,372,1196,92,310,78,232,170,542
315040,201907,799,2367,681,2083,89,301,426,1289,515,1590
315050,201907,1125,2952,854,2555,65,253,473,1376,538,1629
315053,201907,1148,3037,868,2536,59,188,499,1398,558,1586
315057,201907,1620,5163,1387,4707,158,545,888,3042,1046,3587
315060,201907,560,1730,397,1384,78,286,99,325,177,611
315070,201907,553,1483,386,1179,98,334,98,266,196,600
315080,201907,2700,8089,2084,6803,349,1174,1070,3388,1419,4562
315090,201907,781,2445,566,2003,91,353,204,686,295,1039
315100,201907,1181,3639,728,2564,140,542,280,886,420,1428
315110,201907,1640,4213,1224,3520,143,406,586,1706,729,2112
315120,201907,11591,27801,8328,22751,1182,3086,4212,11970,5394,15056
315130,201907,1327,3857,1069,3365,142,528,425,1252,567,1780
315140,201907,2848,8062,2158,6781,403,1394,1055,3092,1458,4486
315150,201907,4275,10642,2953,8438,453,1464,1310,3596,1763,5060
315160,201907,1642,4167,1062,3199,235,733,447,1315,682,2048
315170,201907,1394,4506,948,3404,227,848,187,662,414,1510
315180,201907,16703,41678,8559,26016,1253,4286,2421,6430,3674,10716
315190,201907,2083,4746,1630,4135,233,564,1164,2962,1397,3526
315200,201907,3670,10809,2657,8930,819,2982,612,1970,1431,4952
315210,201907,7981,21299,5547,16029,688,2170,2600,6800,3288,8970
315213,201907,1125,2991,964,2759,22,66,776,2201,798,2267
315217,201907,2594,7875,2020,6878,104,504,1348,4409,1452,4913
315220,201907,7968,22125,6382,19309,1402,4492,2569,7760,3971,12252
315230,201907,3082,7268,2569,6629,166,292,2009,5454,2175,5746
315240,201907,2336,7117,1991,6489,483,1676,1017,3258,1500,4934
315250,201907,11151,31140,7994,25164,1370,4686,3328,9994,4698,14680
315260,201907,979,2806,512,1722,83,270,38,116,121,386
315270,201907,808,2384,540,1850,74,284,162,457,236,741
315280,201907,2907,7395,1672,5071,393,1293,253,757,646,2050
315290,201907,1180,2998,708,2239,204,708,180,568,384,1276
315300,201907,676,1623,434,1283,119,398,165,487,284,885
315310,201907,1287,3669,938,2991,82,279,508,1532,590,1811
315320,201907,692,2053,483,1638,65,273,204,630,269,903
315330,201907,747,2608,403,1636,71,315,115,417,186,732
315340,201907,3065,7615,2226,6393,158,524,1374,3892,1532,4416
315350,201907,1528,4258,1172,3659,170,610,633,1942,803,2552
315360,201907,1673,5104,1207,4054,174,628,480,1509,654,2137
315370,201907,437,1273,342,1072,67,202,139,427,206,629
315380,201907,173,526,128,412,31,100,24,55,55,155
315390,201907,1139,3370,873,2835,171,626,339,1008,510,1634
315400,201907,3967,11233,3113,9640,442,1411,1584,4729,2026,6140
315410,201907,2265,5316,1732,4526,452,1271,312,843,764,2114
315415,201907,1238,3440,982,3041,222,815,399,1231,621,2046
315420,201907,1202,3499,767,2625,153,570,129,397,282,967
315430,201907,3552,8802,2466,7117,454,1548,1015,2721,1469,4269
315440,201907,990,2693,800,2366,79,286,451,1234,530,1520
315445,201907,2005,4926,1438,4090,116,371,995,2787,1111,3158
315450,201907,2166,6241,1790,5641,240,742,1102,3493,1342,4235
315460,201907,33968,98221,28150,87499,5543,18999,13354,38986,18897,57985
315470,201907,483,1392,378,1179,31,111,225,671,256,782
315480,201907,1241,3661,864,2829,171,587,267,845,438,1432
315490,201907,2968,7469,2003,5962,289,888,700,2044,989,2932
315500,201907,499,1364,300,923,34,128,127,332,161,460
315510,201907,1229,3343,1057,3083,26,114,901,2568,927,2682
315520,201907,1060,2943,834,2558,57,214,602,1788,659,2002
315530,201907,587,1754,451,1480,149,528,180,557,329,1085
315540,201907,1338,3695,903,2858,109,404,371,1143,480,1547
315550,201907,1835,4888,1174,3680,261,906,289,884,550,1790
315560,201907,6269,19530,5366,17851,335,1128,3503,11750,3838,12878
315570,201907,1895,5341,1562,4768,99,406,929,2712,1028,3118
315580,201907,2420,6002,1828,5045,307,995,693,1806,1000,2801
315590,201907,889,2379,698,2066,86,305,346,961,432,1266
315600,201907,2400,7756,1739,6436,257,928,910,3490,1167,4418
315610,201907,883,2293,663,1872,119,407,296,714,415,1121
315620,201907,380,1131,313,1014,43,154,196,640,239,794
315630,201907,891,2460,700,2131,147,485,264,728,411,1213
315640,201907,340,910,281,832,29,106,173,481,202,587
315645,201907,957,2532,638,1987,162,543,154,455,316,998
315650,201907,1738,4359,1382,3841,36,146,1120,2987,1156,3133
315660,201907,2421,5956,1800,4880,105,307,1275,3328,1380,3635
315670,201907,13453,38124,10345,32363,2154,7013,4427,13361,6581,20374
315680,201907,3027,9103,2204,7463,359,1358,1006,3239,1365,4597
315690,201907,2845,7417,1740,5325,382,1175,523,1747,905,2922
315700,201907,7603,21643,5734,17874,963,3209,2562,7641,3525,10850
315710,201907,1849,4719,1331,3924,48,219,927,2607,975,2826
315720,201907,4266,12163,3597,10952,178,766,2515,7335,2693,8101
315725,201907,1913,5340,1463,4486,154,462,966,3024,1120,3486
315727,201907,552,1466,409,1224,60,203,161,450,221,653
315730,201907,611,1887,534,1734,79,291,225,692,304,983
315733,201907,1356,3524,928,2741,146,514,339,936,485,1450
315737,201907,1122,3278,877,2792,44,180,599,1848,643,2028
315740,201907,894,2559,698,2149,89,331,406,1155,495,1486
315750,201907,1236,3381,987,2954,80,256,630,1894,710,2150
315760,201907,1153,2775,1040,2633,43,120,887,2209,930,2329
315765,201907,1855,4991,1517,4551,37,132,1316,3925,1353,4057
315770,201907,970,2873,782,2604,304,1117,181,515,485,1632
315780,201907,27596,78018,23240,70105,1799,6669,15012,43028,16811,49697
315790,201907,3553,11155,3017,10121,288,1037,1837,6256,2125,7293
315800,201907,1208,4433,840,3387,148,655,207,760,355,1415
315810,201907,1300,3289,1085,2935,49,184,852,2188,901,2372
315820,201907,2550,7195,2078,6459,204,740,1394,4256,1598,4996
315830,201907,1057,3103,777,2571,66,243,339,1078,405,1321
315840,201907,823,2037,524,1476,49,170,250,637,299,807
315850,201907,1118,3399,893,2984,175,639,446,1402,621,2041
315860,201907,498,1487,344,1195,78,292,87,285,165,577
315870,201907,462,1213,359,1059,28,96,237,648,265,744
315880,201907,1088,2837,715,2189,90,348,174,469,264,817
315890,201907,1595,4729,1273,4251,336,1214,599,1933,935,3147
315895,201907,5955,16449,4474,13482,486,1666,2252,6315,2738,7981
315900,201907,807,2118,696,1961,59,184,514,1405,573,1589
315910,201907,520,1509,433,1361,66,250,284,840,350,1090
315920,201907,1558,4116,836,2612,139,483,243,695,382,1178
315930,201907,1077,2508,714,1956,128,351,307,846,435,1197
315935,201907,787,2407,634,2110,119,406,213,711,332,1117
315940,201907,584,1689,467,1488,52,179,242,743,294,922
315950,201907,1179,3293,985,2981,100,283,743,2273,843,2556
315960,201907,4081,11617,2379,8161,794,3134,163,333,957,3467
315970,201907,631,1684,486,1491,61,210,322,982,383,1192
315980,201907,4234,9418,2265,6139,391,1116,765,1894,1156,3010
315990,201907,3550,9149,2750,7794,293,896,1590,4385,1883,5281
316000,201907,525,1405,397,1220,63,236,173,496,236,732
316010,201907,814,2191,609,1849,41,153,365,1020,406,1173
316020,201907,955,2936,772,2566,83,344,460,1407,543,1751
316030,201907,2827,7901,2074,6563,230,764,1294,4156,1524,4920
316040,201907,2483,7400,1798,6049,313,1159,410,1227,723,2386
316045,201907,2047,5408,1845,5141,83,186,1543,4415,1626,4601
316050,201907,373,1082,276,907,41,153,147,457,188,610
316060,201907,680,1843,508,1567,24,114,342,976,366,1090
316070,201907,5399,15454,4410,13516,808,2611,1989,5882,2797,8493
316080,201907,706,2230,542,1878,133,494,73,242,206,736
316090,201907,416,1268,295,998,36,151,134,389,170,540
316095,201907,1260,3975,1017,3383,248,871,353,1141,601,2012
316100,201907,2490,7567,1760,5910,333,1207,568,1722,901,2929
316105,201907,851,2276,653,1974,47,160,446,1364,493,1524
316110,201907,12873,38293,10769,34675,934,3408,7192,22898,8126,26306
316120,201907,1091,3225,675,2177,122,420,174,440,296,860
316130,201907,1211,2729,736,1965,58,183,415,1072,473,1255
316140,201907,1125,3054,730,2326,113,394,363,1126,476,1520
316150,201907,1785,4056,1464,3644,196,604,599,1378,795,1982
316160,201907,1023,2860,828,2518,58,204,533,1562,591,1766
316165,201907,899,2260,672,1894,107,364,344,905,451,1269
316170,201907,1092,2803,814,2377,68,248,534,1491,602,1739
316180,201907,1251,3647,828,2741,162,618,161,463,323,1081
316190,201907,2594,7524,1508,4897,227,757,530,1518,757,2275
316200,201907,3222,9532,2327,7786,533,1965,470,1489,1003,3454
316210,201907,4373,13065,3141,10227,1083,3792,264,743,1347,4535
316220,201907,611,1873,399,1375,94,359,46,181,140,540
316225,201907,1523,3489,1127,2826,39,155,848,1978,887,2133
316230,201907,414,1137,319,980,34,105,179,563,213,668
316240,201907,5627,16539,4949,15377,412,1396,3699,11295,4111,12691
316245,201907,2911,9830,2608,9307,148,875,1944,6570,2092,7445
316250,201907,9794,24395,6823,19546,1581,4913,2197,6106,3778,11019
316255,201907,2909,8217,2528,7607,168,573,1826,5506,1994,6079
316257,201907,1245,3059,873,2458,133,388,449,1240,582,1628
316260,201907,1874,4984,1403,4206,131,416,738,2307,869,2723
316265,201907,1145,3147,898,2721,39,141,621,1834,660,1975
316270,201907,3551,11284,3015,10060,542,1905,1383,4400,1925,6305
316280,201907,2908,8665,2483,7850,352,1230,1332,4064,1684,5294
316290,201907,3423,9639,2693,8226,335,1200,1115,3307,1450,4507
316292,201907,4870,13242,3967,11741,501,1653,2635,7542,3136,9195
316294,201907,810,2437,593,2054,110,437,133,442,243,879
316295,201907,2804,8040,2310,7152,132,535,1610,4710,1742,5245
316300,201907,945,2885,799,2633,53,213,542,1767,595,1980
316310,201907,864,2263,522,1661,92,354,88,239,180,593
316320,201907,581,1679,447,1443,55,214,206,632,261,846
316330,201907,1051,2898,776,2374,55,215,539,1569,594,1784
316340,201907,1019,2891,749,2369,79,333,398,1172,477,1505
316350,201907,1206,3570,1035,3281,101,332,704,2219,805,2551
316360,201907,642,1684,509,1468,53,172,360,1010,413,1182
316370,201907,4849,13458,3618,11102,731,2569,1187,3205,1918,5774
316380,201907,1642,4003,1290,3510,48,102,936,2571,984,2673
316390,201907,839,2298,602,1859,215,750,124,361,339,1111
316400,201907,1180,3424,768,2581,130,483,255,773,385,1256
316410,201907,1085,3224,914,2948,62,219,706,2241,768,2460
316420,201907,1850,5255,1623,4969,63,243,1333,3991,1396,4234
316430,201907,873,2393,544,1762,108,387,150,460,258,847
316440,201907,716,2271,559,2001,131,522,97,331,228,853
316443,201907,538,1557,411,1313,110,385,83,254,193,639
316447,201907,1833,5075,1597,4689,50,193,1300,3743,1350,3936
316450,201907,2202,6785,1652,5623,221,807,977,3272,1198,4079
316460,201907,990,2604,790,2271,162,508,445,1199,607,1707
316470,201907,6400,18762,4602,14948,826,3035,1642,4921,2468,7956
316480,201907,216,598,177,534,39,118,87,252,126,370
316490,201907,293,799,217,669,25,86,89,235,114,321
316500,201907,1188,3866,782,2836,164,640,153,520,317,1160
316510,201907,704,2369,560,2088,116,451,242,916,358,1367
316520,201907,1089,2852,856,2455,132,444,399,1045,531,1489
316530,201907,1042,2809,760,2291,98,406,371,967,469,1373
316540,201907,789,2152,634,1908,116,404,292,806,408,1210
316550,201907,1348,4060,1163,3689,76,291,863,2686,939,2977
316553,201907,3540,10796,2466,8194,477,1741,727,2169,1204,3910
316555,201907,2521,8241,2296,7918,143,547,1762,6151,1905,6698
316556,201907,566,1384,396,1101,22,62,227,579,249,641
316557,201907,969,3128,826,2864,308,1112,241,834,549,1946
316560,201907,287,859,209,747,60,252,57,176,117,428
316570,201907,1161,3496,992,3179,248,806,361,1145,609,1951
316580,201907,396,868,246,614,42,118,112,255,154,373
316590,201907,1293,3428,930,2711,150,420,494,1373,644,1793
316600,201907,958,3014,817,2709,142,501,415,1344,557,1845
316610,201907,575,1864,487,1724,56,259,295,994,351,1253
316620,201907,1996,5565,1717,5182,88,292,1264,3844,1352,4136
316630,201907,1555,4693,1240,4089,334,1097,482,1730,816,2827
316640,201907,140,377,108,329,18,59,50,131,68,190
316650,201907,1019,3322,815,2994,72,287,504,1885,576,2172
316660,201907,201,516,90,280,8,26,12,40,20,66
316670,201907,1828,4722,1342,3916,340,1075,452,1267,792,2342
316680,201907,2141,5579,1629,4685,124,379,1199,3388,1323,3767
316690,201907,1212,3604,955,3100,189,676,418,1317,607,1993
316695,201907,990,2925,814,2610,32,139,555,1754,587,1893
316700,201907,379,918,317,846,16,59,238,587,254,646
316710,201907,2899,9719,2199,8221,490,1936,827,3088,1317,5024
316720,201907,20134,56864,14685,46047,2854,9579,5711,17013,8565,26592
316730,201907,407,1163,322,991,52,180,147,403,199,583
316740,201907,696,2091,607,1943,61,258,385,1205,446,1463
316750,201907,395,1205,300,1012,63,249,124,371,187,620
316760,201907,3623,11637,2937,10198,1193,4445,719,2387,1912,6832
316770,201907,1546,3691,1222,3247,28,98,1030,2766,1058,2864
316780,201907,554,1691,434,1461,149,565,67,196,216,761
316790,201907,703,1927,481,1479,116,368,128,363,244,731
316800,201907,5982,17255,4796,15075,449,1629,2600,7891,3049,9520
316805,201907,1001,2224,810,2013,52,138,654,1645,706,1783
316810,201907,679,1920,452,1424,95,354,205,595,300,949
316820,201907,325,808,162,501,15,55,58,176,73,231
316830,201907,677,1959,553,1753,83,315,330,998,413,1313
316840,201907,2707,7348,2213,6477,263,917,1388,3866,1651,4783
316850,201907,2001,5321,1424,4272,212,691,616,1803,828,2494
316860,201907,17861,47897,13413,41080,2351,8261,6144,18297,8495,26558
316870,201907,7201,20334,5366,16737,894,3125,2258,6493,3152,9618
316880,201907,790,2174,640,1965,135,471,288,845,423,1316
316890,201907,1108,2521,648,1888,116,410,348,892,464,1302
316900,201907,2227,6205,1731,5214,356,1194,559,1529,915,2723
316905,201907,511,1541,395,1304,92,332,158,527,250,859
316910,201907,879,2391,568,1844,141,525,53,158,194,683
316920,201907,1588,4112,1044,3221,212,695,390,1193,602,1888
316930,201907,7996,24089,5779,19790,1165,4211,1259,4145,2424,8356
316935,201907,3908,10843,2801,8752,528,1738,1064,3209,1592,4947
316940,201907,6538,19716,4951,16274,854,3082,1763,5368,2617,8450
316950,201907,1821,4340,1403,3759,59,183,1119,2950,1178,3133
316960,201907,5105,11863,3703,9841,428,1247,2362,6106,2790,7353
316970,201907,3466,10193,3004,9269,640,2035,1080,3207,1720,5242
316980,201907,720,2202,519,1791,159,615,72,264,231,879
316990,201907,10530,29616,7385,22898,2012,6635,920,2554,2932,9189
317000,201907,2527,7724,2246,7298,166,516,1639,5334,1805,5850
317005,201907,2593,7586,2047,6424,343,1109,1034,3164,1377,4273
317010,201907,23265,55777,14188,41771,3282,10501,4654,14181,7936,24682
317020,201907,62507,151210,35304,102971,6623,20970,10125,27176,16748,48146
317030,201907,647,1810,522,1636,24,104,398,1226,422,1330
317040,201907,10577,27582,7477,22160,1784,5596,2690,8137,4474,13733
317043,201907,813,1909,594,1597,72,200,396,1077,468,1277
317047,201907,1165,2823,780,2189,102,294,461,1265,563,1559
317050,201907,1202,3759,831,2875,118,429,322,982,440,1411
317052,201907,2354,6805,1898,6042,283,942,1140,3602,1423,4544
317057,201907,1654,4202,1166,3345,50,199,700,1961,750,2160
317060,201907,448,1215,271,837,45,157,107,299,152,456
317065,201907,1229,3627,999,3180,53,207,633,1870,686,2077
317070,201907,7592,21298,5180,16524,1075,3887,1246,3697,2321,7584
317075,201907,907,2498,622,1953,111,383,196,555,307,938
317080,201907,5950,14364,4340,11702,1280,3688,1278,3216,2558,6904
317090,201907,4358,13497,3933,12782,343,1088,2828,9168,3171,10256
317100,201907,2415,5814,1603,4555,400,1223,589,1610,989,2833
317103,201907,1873,5684,1613,5203,133,670,1116,3331,1249,4001
317107,201907,1338,3706,1045,3117,56,239,643,1682,699,1921
317110,201907,698,1576,341,1031,51,193,110,336,161,529
317115,201907,1091,3143,918,2818,54,152,642,1974,696,2126
317120,201907,12171,34761,9542,30273,1316,4773,5082,15508,6398,20281
317130,201907,10225,24397,6262,17893,1129,3517,2039,5738,3168,9255
317140,201907,697,1916,544,1670,46,146,340,1071,386,1217
317150,201907,1010,2475,773,2171,32,110,600,1640,632,1750
317160,201907,3559,8766,2364,6903,198,616,1323,3856,1521,4472
317170,201907,1910,4895,1329,3849,216,739,494,1212,710,1951
317180,201907,1787,5782,1326,4619,276,1033,342,1125,618,2158
317190,201907,1221,3351,908,2845,114,360,516,1603,630,1963
317200,201907,4915,13196,3669,10973,1015,3289,706,1918,1721,5207
317210,201907,1157,2899,892,2527,40,150,641,1833,681,1983
317220,201907,275,884,236,800,64,222,76,266,140,488
320010,201907,4460,13250,3620,11572,390,1376,2303,7221,2693,8597
320013,201907,1589,4719,1058,3527,172,555,497,1686,669,2241
320016,201907,3014,7850,2367,6885,120,326,1862,5389,1982,5715
320020,201907,3917,10597,2892,8797,727,2361,969,3025,1696,5386
320030,201907,1530,4513,1058,3513,216,795,354,1082,570,1877
320035,201907,1738,4925,1437,4401,374,1248,618,1851,992,3099
320040,201907,3720,10966,3041,9664,453,1570,1624,5031,2077,6601
320050,201907,1786,4094,1531,3714,241,680,876,2050,1117,2730
320060,201907,11317,32209,8360,26195,1407,4889,3653,10716,5060,15605
320070,201907,1447,4189,992,3224,187,670,330,1024,517,1694
320080,201907,5464,14365,3858,11191,837,2550,1356,3776,2193,6326
320090,201907,7610,20815,5161,15731,1135,3746,2034,5776,3169,9522
320100,201907,2687,7766,2124,6722,420,1439,1035,3204,1455,4643
320110,201907,1474,3785,1094,3136,199,591,503,1413,702,2004
320115,201907,1754,5801,1502,5354,646,2421,441,1619,1087,4040
320120,201907,18769,49474,12885,38716,2062,6711,5433,15617,7495,22328
320130,201907,40373,116839,33578,104253,5050,17153,18761,56524,23811,73677
320140,201907,2974,8705,2204,7095,391,1425,887,2807,1278,4232
320150,201907,13187,35089,9143,26983,2485,7860,1589,4299,4074,12159
320160,201907,5428,15820,4043,13093,677,2316,1869,5972,2546,8288
320170,201907,1453,4328,1070,3546,295,989,411,1388,706,2377
320180,201907,707,2305,572,2017,192,726,145,474,337,1200
320190,201907,2769,9031,2105,7473,510,1914,509,1738,1019,3652
320200,201907,1099,3101,799,2532,206,738,260,819,466,1557
320210,201907,4398,11473,3397,9715,571,1772,1786,4889,2357,6661
320220,201907,2584,7180,1956,6051,372,1245,913,2736,1285,3981
320225,201907,1324,4211,905,3165,348,1294,143,488,491,1782
320230,201907,4606,13150,3472,11227,834,2937,1343,4238,2177,7175
320240,201907,14071,37405,10601,31642,2448,7793,4063,11915,6511,19708
320245,201907,2937,9053,2370,7861,946,3262,514,1648,1460,4910
320250,201907,2001,5745,1310,4073,312,1087,330,920,642,2007
320255,201907,1712,5555,1500,5170,500,1750,674,2426,1174,4176
320260,201907,1029,3095,721,2328,178,654,199,541,377,1195
320265,201907,2328,7400,1954,6635,929,3320,377,1247,1306,4567
320270,201907,2210,6470,1661,5340,366,1264,704,2264,1070,3528
320280,201907,6198,17267,4986,15088,1197,3812,1921,5764,3118,9576
320290,201907,1327,4042,865,2894,242,886,204,626,446,1512
320300,201907,3464,10932,2813,9499,875,3184,556,1743,1431,4927
320305,201907,4942,14414,3891,12273,807,2735,1826,5562,2633,8297
320310,201907,1880,5393,1300,4113,246,816,546,1676,792,2492
320313,201907,2329,6069,1446,4295,318,1038,306,848,624,1886
320316,201907,1433,4223,1204,3780,197,636,689,2156,886,2792
320320,201907,20949,56279,14777,45504,3576,11544,5460,16771,9036,28315
320330,201907,2915,8114,2283,6958,502,1503,1103,3458,1605,4961
320332,201907,5629,16294,4557,14362,1154,3904,2116,6597,3270,10501
320334,201907,1854,5507,1292,4277,297,1160,277,735,574,1895
320335,201907,1522,4530,978,3268,249,892,204,627,453,1519
320340,201907,4758,12363,3959,11110,542,1618,2221,6293,2763,7911
320350,201907,5098,12953,3516,10033,468,1402,1788,4882,2256,6284
320360,201907,1463,3751,1068,2981,140,373,508,1364,648,1737
320370,201907,2380,7649,1881,6523,562,2008,639,2163,1201,4171
320380,201907,2312,6442,1930,5790,253,820,1170,3431,1423,4251
320390,201907,7373,20487,5429,16480,1178,3748,2068,5991,3246,9739
320400,201907,3218,9360,2531,7906,693,2301,959,2868,1652,5169
320405,201907,4408,11909,3308,9997,550,1761,1532,4551,2082,6312
320410,201907,4773,12693,3612,10795,650,1938,1771,5518,2421,7456
320420,201907,2849,7799,2216,6728,672,2234,530,1561,1202,3795
320425,201907,2009,4856,1549,4107,101,297,1042,2666,1143,2963
320430,201907,2845,7321,2204,6084,313,957,1376,3621,1689,4578
320435,201907,2293,7329,1787,6285,647,2361,513,1842,1160,4203
320440,201907,1338,3793,966,3059,151,526,418,1268,569,1794
320450,201907,1605,4776,1259,4098,295,1069,545,1664,840,2733
320455,201907,3897,12020,2588,8897,703,2532,744,2433,1447,4965
320460,201907,2117,6494,1481,5055,357,1276,366,1160,723,2436
320465,201907,1210,3520,905,2911,136,470,484,1547,620,2017
320470,201907,3774,10546,2564,7972,612,2084,592,1689,1204,3773
320480,201907,1636,4715,1362,4206,222,784,723,2151,945,2935
320490,201907,20030,53750,14543,43797,2670,8920,5742,16945,8412,25865
320495,201907,1394,3852,941,2974,197,695,326,967,523,1662
320500,201907,49542,135830,40120,119052,6288,20096,22392,63783,28680,83879
320501,201907,4391,12900,3156,10626,880,3276,993,3259,1873,6535
320503,201907,2051,6320,1460,5036,446,1661,464,1461,910,3122
320506,201907,2708,8218,1865,6297,533,1924,183,611,716,2535
320510,201907,9751,27230,7869,23785,1039,3537,4578,13312,5617,16849
320515,201907,1730,4784,1326,3960,394,1260,417,1200,811,2460
320517,201907,2081,6449,1632,5479,537,1945,415,1368,952,3313
320520,201907,34332,92291,25569,77137,4763,15664,10618,30953,15381,46617
320530,201907,30088,82377,23562,70476,2622,9310,14025,39296,16647,48606
330010,201907,20638,56859,16849,50295,2710,8540,10056,29383,12766,37923
330015,201907,1462,3713,1129,3160,192,616,606,1594,798,2210
330020,201907,20041,50952,17337,47086,2218,6921,12526,33036,14744,39957
330022,201907,1929,5233,1455,4400,239,742,844,2514,1083,3256
330023,201907,4697,11442,3255,9314,624,1919,1573,4363,2197,6282
330025,201907,5009,12424,3337,9602,995,3071,1027,2882,2022,5953
330030,201907,10293,28351,7722,23877,912,3327,4543,13286,5455,16613
330040,201907,14260,38208,11324,33036,1233,4041,7297,20377,8530,24418
330045,201907,82343,199375,68288,180921,6042,15963,52691,138248,58733,154211
330050,201907,2407,6514,1781,5438,388,1261,802,2319,1190,3580
330060,201907,4890,13303,4052,11841,862,2765,1759,4769,2621,7534
330070,201907,22067,58380,18082,52241,3276,10082,9911,28297,13187,38379
330080,201907,8637,22512,7479,20797,999,2885,4994,13677,5993,16562
330090,201907,3457,7332,2241,5679,166,452,1479,3708,1645,4160
330093,201907,2473,6260,1823,5254,145,450,1312,3760,1457,4210
330095,201907,1205,3514,929,2981,89,345,534,1572,623,1917
330100,201907,68304,185623,57951,169759,3903,13728,43024,123543,46927,137271
330110,201907,2006,5907,1731,5427,295,1013,878,2650,1173,3663
330115,201907,2097,5369,1590,4605,247,786,920,2573,1167,3359
330120,201907,3477,7978,2543,6713,239,706,1745,4455,1984,5161
330130,201907,3800,10731,3165,9751,470,1542,1937,5912,2407,7454
330140,201907,3510,9378,2802,8322,418,1408,1708,4883,2126,6291
330150,201907,2125,5819,1636,4997,340,1097,707,2096,1047,3193
330160,201907,1325,3697,1038,3208,192,657,543,1594,735,2251
330170,201907,98100,256621,81139,232863,11718,33521,52798,152903,64516,186424
330180,201907,2091,5241,1614,4507,116,372,1073,2893,1189,3265
330185,201907,9366,24649,7798,22225,688,2336,5821,16029,6509,18365
330187,201907,3909,10248,3113,9020,453,1458,1868,5377,2321,6835
330190,201907,30916,77717,26739,71805,2203,6371,20761,54847,22964,61218
330200,201907,14944,39760,12441,36540,2550,7160,7681,23170,10231,30330
330205,201907,2057,5234,1571,4408,103,356,1066,2878,1169,3234
330210,201907,3331,8568,2392,6841,368,1171,1058,2788,1426,3959
330220,201907,11130,28733,7919,23109,1783,5681,2578,6919,4361,12600
330225,201907,3634,9643,2808,8353,248,889,1931,5576,2179,6465
330227,201907,16839,42170,14464,39133,744,2339,12158,32311,12902,34650
330230,201907,1676,3908,1189,3276,85,247,809,2202,894,2449
330240,201907,22586,60189,18284,53128,2811,8896,11080,31216,13891,40112
330245,201907,1670,4241,964,2999,208,665,308,973,516,1638
330250,201907,35529,94583,29923,85999,6109,17814,16560,47912,22669,65726
330260,201907,4047,10697,3132,9358,432,1431,1884,5371,2316,6802
330270,201907,25406,53840,15511,39430,2802,7688,6591,16401,9393,24089
330280,201907,2375,6358,1767,5285,202,670,1011,2884,1213,3554
330285,201907,21546,53595,17213,47251,1704,5327,12088,32057,13792,37384
330290,201907,3607,9191,2905,8179,392,1219,1845,5008,2237,6227
330300,201907,5565,13538,3958,11103,377,1198,2570,7033,2947,8231
330310,201907,2289,5907,1728,4954,100,261,1161,3330,1261,3591
330320,201907,15386,38248,12239,34138,1616,4523,8585,24022,10201,28545
330330,201907,33355,77214,26295,67305,2827,7963,18358,45799,21185,53762
330340,201907,14224,36349,10357,30023,1853,5935,5022,13839,6875,19774
330350,201907,113794,278636,95191,255134,7326,20631,75192,200345,82518,220976
330360,201907,7524,18530,6469,17241,301,847,5408,14299,5709,15146
330370,201907,4708,13752,3476,11552,814,2791,1380,4739,2194,7530
330380,201907,5199,14545,3943,12264,805,2805,1788,5322,2593,8127
330385,201907,3918,11691,3229,10641,809,2893,1452,4782,2261,7675
330390,201907,24990,71051,19394,60608,3103,10875,10214,30266,13317,41141
330395,201907,3137,8049,2594,7306,196,617,1784,4898,1980,5515
330400,201907,3065,8415,2667,7737,169,627,1967,5372,2136,5999
330410,201907,2890,8073,2172,6771,439,1515,956,2806,1395,4321
330411,201907,2803,7709,2205,6541,161,555,1518,4303,1679,4858
330412,201907,1488,4411,1216,3922,159,581,695,2086,854,2667
330414,201907,22963,59586,18670,53552,1984,5786,13033,37068,15017,42854
330415,201907,3745,10452,2911,9006,349,1093,1683,5227,2032,6320
330420,201907,10190,25677,6838,20104,931,3049,3115,8589,4046,11638
330430,201907,9102,22752,7808,20843,501,1629,5857,15018,6358,16647
330440,201907,2255,6280,1690,5329,355,1286,849,2535,1204,3821
330450,201907,1325,3918,1063,3429,149,522,529,1669,678,2191
330452,201907,15483,40421,12244,35327,1810,5820,7337,20477,9147,26297
330455,201907,545596,1331351,415225,1136226,65473,190376,249711,670019,315184,860395
330460,201907,1184,3342,890,2880,171,596,445,1408,616,2004
330470,201907,4758,12264,3505,10289,1058,3195,1187,3519,2245,6714
330475,201907,8900,23779,7179,21454,1263,4251,4382,12774,5645,17025
330480,201907,5889,15657,4998,14295,461,1473,3327,9217,3788,10690
330490,201907,113470,269003,93770,241470,10663,29022,65980,167207,76643,196229
330500,201907,6544,16987,5510,15533,664,2088,3889,10768,4553,12856
330510,201907,38482,100225,29772,87613,6382,19672,16304,47414,22686,67086
330513,201907,1263,3327,993,2928,206,653,506,1486,712,2139
330515,201907,2513,6909,2053,6180,504,1599,970,2825,1474,4424
330520,201907,10705,29490,8782,26319,1284,4289,5056,14634,6340,18923
330530,201907,1659,4173,1198,3416,271,830,503,1385,774,2215
330540,201907,2877,7830,2218,6647,586,1797,866,2546,1452,4343
330550,201907,8292,23457,6670,21027,2144,7255,2285,7062,4429,14317
330555,201907,15180,34443,12658,31298,1095,3065,9643,23768,10738,26833
330560,201907,4278,11628,3453,10193,536,1622,2006,5752,2542,7374
330570,201907,2861,7960,2330,7061,386,1269,1419,4229,1805,5498
330575,201907,5396,14321,4675,13049,342,1109,3605,9693,3947,10802
330580,201907,15065,41678,11454,34885,2413,7956,5086,14795,7499,22751
330590,201907,1463,4072,1266,3822,199,604,837,2561,1036,3165
330600,201907,11528,31282,9088,27158,1221,3968,5217,15301,6438,19269
330610,201907,9195,25145,7516,22437,710,2475,5015,14520,5725,16995
330615,201907,2060,5731,1565,5026,307,1054,943,3058,1250,4112
330620,201907,3902,11588,3137,10200,800,2836,1234,3733,2034,6569
330630,201907,24462,63269,19130,54521,1742,5890,12990,35431,14732,41321
350010,201907,2106,5582,1023,3177,230,739,127,294,357,1033
350020,201907,696,1841,364,1151,49,152,131,366,180,518
350030,201907,3808,10969,2769,8977,690,2388,983,3048,1673,5436
350040,201907,677,1988,398,1372,61,234,125,351,186,585
350050,201907,1052,2787,729,2180,172,580,236,569,408,1149
350055,201907,917,2409,681,2029,77,253,381,1055,458,1308
350060,201907,109,292,74,233,13,43,37,113,50,156
350070,201907,3714,9905,2243,7089,446,1528,631,1784,1077,3312
350075,201907,597,1822,437,1493,187,677,42,131,229,808
350080,201907,675,1787,402,1263,55,189,154,438,209,627
350090,201907,636,1547,364,1049,78,240,125,326,203,566
350100,201907,2102,5775,1407,4476,144,553,764,2293,908,2846
350110,201907,472,1242,323,970,21,78,180,533,201,611
350115,201907,1318,3899,1056,3306,188,676,539,1520,727,2196
350120,201907,651,1543,331,916,45,136,148,368,193,504
350130,201907,3108,8502,2454,7252,429,1334,1189,3332,1618,4666
350140,201907,745,2194,479,1633,53,232,225,699,278,931
350150,201907,511,1589,417,1408,96,318,99,316,195,634
350160,201907,10884,27358,7122,20590,892,3011,4234,11468,5126,14479
350170,201907,1893,5660,1464,4657,290,965,569,1715,859,2680
350180,201907,1080,2715,525,1592,118,356,122,349,240,705
350190,201907,2898,8358,2025,6528,404,1502,796,2123,1200,3625
350200,201907,425,1199,335,1030,21,73,224,653,245,726
350210,201907,5337,12617,3569,9915,587,1729,2025,5422,2612,7151
350220,201907,2797,7661,1844,5777,428,1411,620,1738,1048,3149
350230,201907,968,2634,802,2371,165,521,408,1167,573,1688
350240,201907,703,2079,445,1464,86,272,131,407,217,679
350250,201907,2394,7269,1782,6158,627,2357,311,1129,938,3486
350260,201907,782,1946,503,1432,57,168,303,836,360,1004
350270,201907,4609,12765,3632,10836,609,1953,1789,4948,2398,6901
350275,201907,2347,6534,1868,5682,319,1085,1011,2881,1330,3966
350280,201907,19004,43227,10957,29941,2028,5860,3874,10237,5902,16097
350290,201907,3119,8686,2078,6538,406,1424,811,2345,1217,3769
350300,201907,675,1885,481,1474,86,294,221,617,307,911
350310,201907,821,2433,604,1957,103,407,231,643,334,1050
350315,201907,561,1494,372,1143,32,119,167,456,199,575
350320,201907,13207,35179,10001,29452,2399,7713,3283,9103,5682,16816
350330,201907,13906,34988,9826,26898,1249,3717,5823,14977,7072,18694
350335,201907,350,996,256,810,19,74,150,453,169,527
350340,201907,1089,2877,630,2020,114,397,213,662,327,1059
350350,201907,745,1969,582,1785,87,309,305,900,392,1209
350360,201907,1104,3341,852,2796,227,735,235,777,462,1512
350370,201907,626,1624,426,1246,139,387,108,317,247,704
350380,201907,4491,12268,2954,9201,819,2566,708,2275,1527,4841
350390,201907,9541,26292,7505,22690,1892,5896,3006,8923,4898,14819
350395,201907,423,1088,202,653,22,66,61,179,83,245
350400,201907,7998,20419,5478,16079,1359,4318,1556,4349,2915,8667
350410,201907,9288,26692,6679,21454,1557,5546,2177,6421,3734,11967
350420,201907,683,1891,492,1531,93,322,114,322,207,644
350430,201907,660,1835,537,1627,67,246,332,901,399,1147
350440,201907,1818,4738,1447,4154,119,420,939,2596,1058,3016
350450,201907,6698,18893,5207,16222,1176,3952,2065,6051,3241,10003
350460,201907,1694,4421,829,2607,127,429,171,459,298,888
350470,201907,274,700,202,570,10,41,130,333,140,374
350480,201907,877,2356,552,1726,120,426,76,203,196,629
350490,201907,1868,5034,1309,4058,305,966,390,1120,695,2086
350500,201907,667,1812,508,1509,80,256,239,660,319,916
350510,201907,1108,2959,792,2362,116,392,404,1131,520,1523
350520,201907,2031,6412,1560,5417,261,1043,685,2162,946,3205
350530,201907,2694,6866,1951,5427,245,761,1117,2921,1362,3682
350535,201907,1429,4015,1232,3715,191,644,750,2177,941,2821
350540,201907,1755,4526,1261,3733,204,631,689,1988,893,2619
350550,201907,8499,21395,5829,16842,664,2262,3246,8742,3910,11004
350560,201907,3848,11056,3046,9537,300,984,1837,5558,2137,6542
350570,201907,23290,66809,18627,57430,3870,13018,8810,25777,12680,38795
350580,201907,1908,5360,1019,3325,249,867,145,392,394,1259
350590,201907,4671,13111,3379,10126,504,1731,1899,5199,2403,6930
350600,201907,37537,89267,22973,62897,3349,10089,10729,26847,14078,36936
350610,201907,6528,18380,4703,14659,925,3079,2030,6075,2955,9154
350620,201907,408,1033,242,772,27,100,134,403,161,503
350630,201907,1463,3898,1059,3160,75,295,648,1794,723,2089
350635,201907,7770,20067,5869,16993,1052,3399,3227,8843,4279,12242
350640,201907,938,2570,503,1570,61,195,164,431,225,626
350650,201907,7855,21610,5198,16075,1053,3508,1720,4897,2773,8405
350660,201907,4523,12118,3473,10317,627,1888,1735,5144,2362,7032
350670,201907,1883,5137,1551,4648,167,548,1005,2982,1172,3530
350680,201907,1127,3086,730,2315,148,493,288,868,436,1361
350690,201907,1242,3376,898,2764,155,526,468,1365,623,1891
350700,201907,4981,12674,3223,9914,542,1909,1393,3992,1935,5901
350710,201907,2746,7711,2287,6891,323,1132,1265,3600,1588,4732
350715,201907,859,2488,692,2163,73,288,329,922,402,1210
350720,201907,164,411,116,328,21,58,37,93,58,151
350730,201907,548,1567,435,1348,35,146,294,850,329,996
350740,201907,1609,4487,1056,3300,198,637,288,824,486,1461
350745,201907,578,1575,332,1044,33,119,148,422,181,541
350750,201907,9820,26427,7377,21994,1377,4629,3060,8072,4437,12701
350760,201907,13489,34825,9480,27776,2338,7463,3010,7843,5348,15306
350770,201907,926,2339,569,1702,48,151,332,970,380,1121
350775,201907,671,1659,461,1319,43,131,208,579,251,710
350780,201907,1980,5104,1394,4188,259,872,472,1588,731,2460
350790,201907,1714,4708,1045,3413,204,732,234,623,438,1355
350800,201907,3244,9690,2766,8808,361,1258,1661,5141,2022,6399
350810,201907,2501,6376,1974,5608,288,850,1073,3079,1361,3929
350820,201907,924,2187,502,1413,49,151,225,577,274,728
350830,201907,863,2437,464,1527,86,282,129,362,215,644
350840,201907,2934,8940,2146,7347,547,2043,795,2465,1342,4508
350850,201907,6628,19209,5029,16112,1198,4100,1878,5813,3076,9913
350860,201907,3413,9502,2998,8886,142,546,2243,6506,2385,7052
350870,201907,2667,7682,1942,6479,307,1153,982,3160,1289,4313
350880,201907,1228,3652,959,3066,224,724,299,938,523,1662
350890,201907,569,1497,352,1045,49,157,119,308,168,465
350900,201907,6695,18819,4198,13260,1122,3836,985,2817,2107,6653
350910,201907,883,2292,745,2055,105,326,500,1336,605,1662
350920,201907,11746,30112,9946,27046,518,1744,7808,20304,8326,22048
350925,201907,4390,12331,3122,9895,603,2023,1379,3999,1982,6022
350930,201907,1454,3791,969,2858,115,362,529,1501,644,1863
350940,201907,2139,5945,1691,5144,210,687,1038,3070,1248,3757
350945,201907,868,2469,642,2020,108,409,306,863,414,1272
350950,201907,82847,220802,63519,182476,9002,28460,37064,101002,46066,129462
350960,201907,5965,16676,4598,14063,634,2191,2658,7691,3292,9882
350970,201907,3624,10766,2669,8742,843,3041,431,1207,1274,4248
350980,201907,611,1710,481,1459,147,471,189,563,336,1034
350990,201907,1742,5098,1296,4338,311,1161,452,1422,763,2583
350995,201907,766,2436,687,2272,52,209,469,1483,521,1692
351000,201907,2794,7403,1962,5880,392,1258,649,1843,1041,3101
351010,201907,315,791,203,587,20,64,103,286,123,350
351015,201907,768,2321,615,2014,91,348,292,848,383,1196
351020,201907,8997,25003,6735,21079,1397,4547,3255,9906,4652,14453
351030,201907,2575,7843,2071,6791,310,1145,1095,3461,1405,4606
351040,201907,4748,12108,3971,10876,225,789,3161,8331,3386,9120
351050,201907,17488,43374,11780,34152,2484,7658,4723,13392,7207,21050
351060,201907,46639,120026,35538,100520,4264,13159,22705,61988,26969,75147
351070,201907,1355,3532,787,2503,228,774,109,334,337,1108
351080,201907,2682,6807,1940,5874,299,1071,1154,3280,1453,4351
351090,201907,331,999,228,794,49,171,56,196,105,367
351100,201907,2302,6337,1479,4664,359,1166,388,1284,747,2450
351110,201907,5892,15309,3755,11272,702,2276,1493,4176,2195,6452
351120,201907,751,1984,506,1540,68,209,209,609,277,818
351130,201907,1075,2822,461,1493,96,322,84,244,180,566
351140,201907,1886,5491,1329,4375,309,1127,465,1365,774,2492
351150,201907,2010,5948,1284,4296,277,996,441,1301,718,2297
351160,201907,1128,3647,879,3058,196,719,263,818,459,1537
351170,201907,1382,3940,1191,3558,119,387,782,2245,901,2632
351190,201907,1036,2910,634,2043,111,361,202,578,313,939
351200,201907,1624,3984,1221,3362,102,320,813,2111,915,2431
351210,201907,1540,3859,892,2541,85,275,506,1338,591,1613
351220,201907,3159,9192,2703,8406,337,1093,1718,5281,2055,6374
351230,201907,1809,5094,1331,4220,264,962,568,1598,832,2560
351240,201907,2151,5645,1387,4021,262,790,605,1604,867,2394
351250,201907,1105,2969,626,1962,75,251,230,725,305,976
351260,201907,930,2438,671,1953,151,425,227,671,378,1096
351270,201907,398,1139,327,1021,44,167,185,504,229,671
351280,201907,3951,10804,2999,8954,544,1749,1344,3822,1888,5571
351290,201907,1104,2859,749,2216,135,406,372,1062,507,1468
351300,201907,15603,43881,10631,34033,2111,7274,4211,13083,6322,20357
351310,201907,3182,8247,2400,6938,224,783,1586,4273,1810,5056
351320,201907,911,2727,654,2136,127,463,237,697,364,1160
351330,201907,540,1291,454,1132,39,119,334,755,373,874
351340,201907,6344,18667,5054,16353,1254,4186,2063,6676,3317,10862
351350,201907,11516,30021,9639,26829,1088,3267,6963,18708,8051,21975
351360,201907,3810,10440,3151,9367,797,2555,1096,3003,1893,5558
351370,201907,2155,6188,1424,4619,377,1273,443,1277,820,2550
351380,201907,46570,116847,33151,92375,4895,14523,17779,47308,22674,61831
351385,201907,290,749,152,458,29,81,42,116,71,197
351390,201907,1395,3516,849,2671,139,510,462,1349,601,1859
351400,201907,939,2681,749,2274,154,467,409,1214,563,1681
351410,201907,2577,7297,1820,5804,328,1060,692,2151,1020,3211
351420,201907,368,907,195,587,37,97,93,280,130,377
351430,201907,915,2578,723,2256,75,243,478,1462,553,1705
351440,201907,3381,9119,2166,6514,402,1300,561,1416,963,2716
351450,201907,1753,4715,1139,3544,243,831,207,544,450,1375
351460,201907,797,2158,613,1829,157,454,315,938,472,1392
351470,201907,1195,3132,902,2608,97,333,549,1489,646,1822
351480,201907,2578,7743,2048,6803,362,1313,868,2709,1230,4022
351490,201907,1930,5656,1651,5115,85,343,1248,3679,1333,4022
351492,201907,345,957,280,813,14,52,185,516,199,568
351495,201907,200,552,143,433,18,54,71,199,89,253
351500,201907,35776,91429,26455,74748,4586,13877,14421,38668,19007,52545
351510,201907,12447,31904,8982,25582,1214,3927,5387,14587,6601,18514
351512,201907,491,1359,323,970,55,160,100,271,155,431
351515,201907,3241,7408,1886,5183,360,1105,524,1462,884,2567
351518,201907,2390,6180,1516,4585,221,772,804,2196,1025,2968
351519,201907,743,2070,414,1350,76,249,64,194,140,443
351520,201907,1163,2946,443,1403,52,176,172,485,224,661
351530,201907,356,996,200,635,33,105,70,173,103,278
351535,201907,2031,4957,1422,3922,198,600,748,1934,946,2534
351540,201907,2255,5786,1441,4332,369,1261,376,968,745,2229
351550,201907,6343,16291,4236,12190,448,1521,2390,6327,2838,7848
351560,201907,441,1300,354,1122,91,324,96,275,187,599
351565,201907,192,583,152,506,39,152,40,122,79,274
351570,201907,19287,53345,14296,42632,1742,5666,8614,24512,10356,30178
351580,201907,270,702,157,480,15,47,63,197,78,244
351590,201907,503,1148,257,702,29,102,133,309,162,411
351600,201907,1447,3828,1094,3165,112,370,654,1747,766,2117
351610,201907,767,1835,485,1341,30,103,254,628,284,731
351620,201907,21562,59837,15866,49147,2778,9755,6718,18591,9496,28346
351630,201907,26114,71700,20952,62387,3588,11143,12372,35713,15960,46856
351640,201907,16063,43850,12317,36597,1383,4647,7982,22700,9365,27347
351650,201907,404,1087,177,580,22,78,38,100,60,178
351660,201907,760,2201,460,1469,87,291,70,191,157,482
351670,201907,5373,14901,3740,11274,740,2265,1699,4762,2439,7027
351680,201907,417,1243,258,836,52,147,61,180,113,327
351685,201907,445,1319,357,1163,99,319,115,344,214,663
351690,201907,1066,2766,618,1817,99,316,246,645,345,961
351700,201907,1251,3214,903,2575,126,360,508,1376,634,1736
351710,201907,765,2083,517,1621,45,165,257,718,302,883
351720,201907,1479,3957,942,2950,168,565,331,968,499,1533
351730,201907,936,2544,767,2243,79,286,477,1302,556,1588
351740,201907,3633,9314,2797,7658,504,1468,1331,3351,1835,4819
351750,201907,1319,3624,805,2662,158,557,272,881,430,1438
351760,201907,3296,9417,2324,7369,493,1763,807,2322,1300,4085
351770,201907,1824,5510,1482,4816,339,1133,694,2207,1033,3340
351780,201907,1408,3647,737,2246,127,451,220,619,347,1070
351790,201907,1277,3116,1010,2750,163,424,608,1679,771,2103
351800,201907,518,1208,251,716,31,90,84,204,115,294
351810,201907,999,2701,814,2391,47,142,581,1628,628,1770
351820,201907,2495,7182,1715,5605,454,1619,332,1029,786,2648
351830,201907,4304,11858,3289,10035,342,1241,1951,5647,2293,6888
351840,201907,8081,23334,6109,19560,987,3519,2908,8738,3895,12257
351850,201907,1765,4748,1086,3421,211,753,316,868,527,1621
351860,201907,2818,8370,2196,7150,395,1337,1168,3829,1563,5166
351870,201907,22990,60805,17544,51560,5271,15877,6386,19330,11657,35207
351880,201907,115669,314311,86089,260100,23114,75449,31138,89070,54252,164519
351885,201907,876,2463,685,2098,97,329,391,1130,488,1459
351890,201907,675,1893,486,1561,110,353,67,187,177,540
351900,201907,1065,2955,826,2569,143,450,411,1274,554,1724
351905,201907,398,1123,264,838,23,82,98,265,121,347
351907,201907,21822,58196,16687,48743,1908,6108,10663,29975,12571,36083
351910,201907,1272,3389,880,2555,85,272,474,1253,559,1525
351920,201907,856,2296,623,1832,79,281,301,807,380,1088
351925,201907,898,2518,687,2099,104,351,320,902,424,1253
351930,201907,3173,9111,2875,8544,471,1460,2028,5908,2499,7368
351940,201907,1112,2933,791,2370,121,399,393,1140,514,1539
351950,201907,1572,3725,1125,3046,69,203,728,1913,797,2116
351960,201907,5163,13436,3799,11017,834,2608,1631,4411,2465,7019
351970,201907,6372,19858,5249,17824,875,3343,2841,9296,3716,12639
351980,201907,1053,2524,661,1863,84,286,375,977,459,1263
351990,201907,1427,3458,989,2763,80,277,438,1106,518,1383
352000,201907,2527,7378,2141,6561,268,949,1359,3866,1627,4815
352010,201907,2159,6036,1748,5305,449,1480,323,1026,772,2506
352020,201907,1464,4108,1142,3547,196,639,539,1602,735,2241
352030,201907,5446,14788,4310,12925,879,2866,2175,6325,3054,9191
352040,201907,2651,7328,1679,5281,281,936,505,1372,786,2308
352042,201907,3187,7996,1929,5794,400,1299,768,2268,1168,3567
352044,201907,2121,5805,1172,3935,209,763,226,692,435,1455
352050,201907,12330,33739,7737,24312,1907,6704,1233,3343,3140,10047
352060,201907,741,2041,526,1610,74,243,230,644,304,887
352070,201907,765,1570,531,1260,67,179,302,670,369,849
352080,201907,474,1234,285,843,33,106,107,277,140,383
352090,201907,1461,4407,1174,3789,159,587,480,1382,639,1969
352100,201907,3055,8754,2525,7753,596,1956,1132,3288,1728,5244
352110,201907,584,1806,448,1509,103,367,165,510,268,877
352115,201907,527,1507,435,1359,59,199,247,767,306,966
352120,201907,859,2648,677,2253,75,294,390,1194,465,1488
352130,201907,1899,5413,1221,3717,226,701,471,1337,697,2038
352140,201907,1279,3461,831,2557,138,462,386,1145,524,1607
352150,201907,824,2275,613,1884,118,382,342,1019,460,1401
352160,201907,992,2490,716,2061,87,297,379,1028,466,1325
352170,201907,2988,8224,2332,6871,400,1320,1240,3314,1640,4634
352180,201907,2644,7297,2065,6181,521,1731,617,1601,1138,3332
352190,201907,1181,3225,886,2754,150,464,405,1283,555,1747
352200,201907,379,1162,262,911,36,138,92,305,128,443
352210,201907,18503,45189,14442,39567,1277,3823,10653,28725,11930,32548
352215,201907,535,1429,462,1331,53,175,317,879,370,1054
352220,201907,17451,45315,11518,34244,2896,8965,3839,10954,6735,19919
352230,201907,12875,38846,9768,32681,2412,8890,3341,10366,5753,19256
352240,201907,10894,28780,8193,24106,1856,6166,3306,8803,5162,14969
352250,201907,23079,66255,18521,57902,3660,12150,10134,30973,13794,43123
352260,201907,4831,12574,3305,9479,493,1668,1845,4762,2338,6430
352265,201907,921,2624,810,2442,56,215,590,1714,646,1929
352270,201907,1492,4612,1113,3775,242,898,366,1150,608,2048
352280,201907,2363,6171,1796,5309,184,681,1019,2775,1203,3456
352290,201907,1119,3372,911,2936,152,556,444,1272,596,1828
352300,201907,938,2572,642,1953,98,348,312,846,410,1194
352310,201907,45528,123064,33260,100815,8458,26097,13921,42304,22379,68401
352320,201907,6285,17152,4785,14061,768,2507,2386,6328,3154,8835
352330,201907,2165,5931,1642,5174,336,1231,781,2295,1117,3526
352340,201907,5283,14388,3798,11669,682,2371,1736,4885,2418,7256
352350,201907,2120,6248,1647,5138,209,799,847,2332,1056,3131
352360,201907,1237,3345,1050,3015,102,358,781,2138,883,2496
352370,201907,1060,3086,910,2806,29,126,703,2106,732,2232
352380,201907,809,2302,623,1941,137,464,211,619,348,1083
352390,201907,15862,39716,10672,30650,1719,5373,5728,15460,7447,20833
352400,201907,3477,9794,2938,8772,510,1824,1743,4839,2253,6663
352410,201907,3093,8257,2331,6924,242,855,1398,3955,1640,4810
352420,201907,866,2149,599,1722,109,337,203,545,312,882
352430,201907,7273,18890,5137,15080,1348,4390,2068,5643,3416,10033
352440,201907,17493,48766,13162,40220,3126,9921,5120,15067,8246,24988
352450,201907,818,2115,403,1317,53,182,123,368,176,550
352460,201907,2938,8301,1970,6436,418,1498,674,2077,1092,3575
352470,201907,3420,8652,2453,7045,295,972,1354,3611,1649,4583
352480,201907,3448,8476,2268,6328,372,1192,1072,2734,1444,3926
352490,201907,723,2196,567,1875,112,412,243,751,355,1163
352500,201907,10359,27329,7012,20955,3168,10257,798,1459,3966,11716
352510,201907,3484,9676,2590,8091,593,2036,1046,3052,1639,5088
352520,201907,2537,7060,1965,6019,430,1482,979,2692,1409,4174
352530,201907,9478,25785,5989,18570,1254,4364,1174,2862,2428,7226
352540,201907,535,1619,383,1258,74,260,104,312,178,572
352550,201907,969,2829,668,2210,128,469,197,587,325,1056
352560,201907,591,1681,435,1354,70,231,177,501,247,732
352570,201907,2029,5991,1307,4470,330,1190,173,519,503,1709
352580,201907,733,1974,593,1719,91,321,318,852,409,1173
352585,201907,252,732,185,589,17,66,100,287,117,353
352590,201907,13301,35658,9201,27639,2653,8563,3697,10269,6350,18832
352600,201907,1966,5434,1499,4506,219,716,820,2280,1039,2996
352610,201907,3055,8683,2267,7252,500,1774,870,2612,1370,4386
352620,201907,5721,15132,4417,13106,1378,4140,1573,4729,2951,8869
352630,201907,848,2149,639,1826,113,372,278,716,391,1088
352640,201907,2987,7903,2123,6373,230,754,1219,3501,1449,4255
352650,201907,573,1659,402,1258,61,219,145,429,206,648
352660,201907,1029,3124,827,2692,178,601,360,1131,538,1732
352670,201907,8815,24592,5572,17916,1532,5233,854,2653,2386,7886
352680,201907,3261,9922,2284,7574,370,1432,1083,3290,1453,4722
352690,201907,27520,70873,20539,58167,1788,5868,13351,35897,15139,41765
352700,201907,557,1435,412,1227,152,502,90,240,242,742
352710,201907,5002,13246,3544,10518,883,2892,1443,3953,2326,6845
352720,201907,7888,22426,6076,18795,2864,8994,803,2176,3667,11170
352725,201907,537,1380,280,844,18,54,128,366,146,420
352730,201907,2791,8045,2343,7011,356,1215,1350,3672,1706,4887
352740,201907,2241,5400,1650,4501,199,626,938,2417,1137,3043
352750,201907,416,1052,223,686,39,128,85,225,124,353
352760,201907,1600,4538,1198,3698,161,525,581,1756,742,2281
352770,201907,915,2487,601,1855,120,380,222,644,342,1024
352780,201907,651,1905,446,1488,89,318,139,453,228,771
352790,201907,476,1303,315,960,32,98,116,308,148,406
352800,201907,1295,4090,912,3161,239,871,143,442,382,1313
352810,201907,1104,2662,678,1876,89,267,387,1008,476,1275
352820,201907,516,1364,333,1046,74,240,75,248,149,488
352830,201907,596,1532,259,797,31,96,50,129,81,225
352840,201907,3883,11484,3196,10187,1122,3854,975,2974,2097,6828
352850,201907,10396,26289,6880,20446,1961,6259,2034,5586,3995,11845
352860,201907,1019,2824,714,2242,147,495,223,665,370,1160
352870,201907,893,2291,612,1683,43,143,393,1022,436,1165
352880,201907,1844,4513,1273,3462,175,506,737,1860,912,2366
352885,201907,290,831,214,690,31,108,117,354,148,462
352890,201907,720,1738,442,1162,53,154,238,548,291,702
352900,201907,17954,47803,11861,35608,2026,6537,5183,14454,7209,20991
352910,201907,457,1220,214,675,25,75,52,151,77,226
352920,201907,2654,7013,1917,5664,174,580,1232,3475,1406,4055
352930,201907,5697,15827,4167,12756,769,2525,1828,5206,2597,7731
352940,201907,22504,64354,16506,51140,3987,13538,5599,16242,9586,29780
352950,201907,473,1266,259,841,64,209,30,91,94,300
352960,201907,729,2018,376,1234,61,215,71,217,132,432
352965,201907,268,724,150,493,43,147,30,84,73,231
352970,201907,3074,7399,2302,6140,271,762,1466,3870,1737,4632
352980,201907,1403,3845,1084,3330,266,866,516,1528,782,2394
352990,201907,4054,11513,3245,10177,647,2236,1618,4882,2265,7118
353000,201907,467,1290,223,705,35,117,52,139,87,256
353010,201907,2520,6415,1629,4782,399,1287,573,1519,972,2806
353020,201907,3701,9662,2065,6189,295,1004,708,1934,1003,2938
353030,201907,4235,11158,2842,8568,712,2295,669,1960,1381,4255
353040,201907,608,1483,442,1223,62,189,248,642,310,831
353050,201907,5095,15091,3699,12149,792,2810,1583,4939,2375,7749
353060,201907,47404,123780,38713,109547,3003,10280,28203,76492,31206,86772
353070,201907,9309,27076,6537,21132,1414,4914,2316,6958,3730,11872
353080,201907,4198,12040,2876,9360,581,2104,1016,2908,1597,5012
353090,201907,578,1782,429,1449,41,153,239,773,280,926
353100,201907,311,854,127,418,27,92,29,81,56,173
353110,201907,7491,20922,6073,18780,1115,3528,3430,10852,4545,14380
353120,201907,469,1193,303,878,45,139,121,318,166,457
353130,201907,2380,5907,1581,4595,439,1400,508,1358,947,2758
353140,201907,2591,6561,1855,5197,156,500,1181,3086,1337,3586
353150,201907,1483,3772,1042,3036,212,645,430,1168,642,1813
353160,201907,578,1538,409,1249,79,275,166,451,245,726
353170,201907,511,1458,401,1293,75,275,180,543,255,818
353180,201907,9745,24565,7564,20895,836,2580,5333,14304,6169,16884
353190,201907,3312,9057,2598,7634,284,928,1588,4338,1872,5266
353200,201907,2051,5544,942,3107,149,519,219,667,368,1186
353205,201907,340,1051,284,912,60,206,129,410,189,616
353210,201907,986,2371,616,1740,35,115,386,1061,421,1176
353215,201907,399,1143,309,955,50,158,135,370,185,528
353220,201907,775,2136,453,1429,102,308,53,153,155,461
353230,201907,776,2212,627,1976,170,593,254,716,424,1309
353240,201907,2248,6266,1806,5458,262,904,1045,3022,1307,3926
353250,201907,1287,2930,750,2015,105,285,385,991,490,1276
353260,201907,1084,2589,607,1778,107,353,248,685,355,1038
353270,201907,693,1843,567,1607,46,147,381,1022,427,1169
353280,201907,727,2003,503,1566,101,321,152,436,253,757
353282,201907,1793,5194,1512,4638,176,624,882,2526,1058,3150
353284,201907,357,867,178,508,26,94,68,163,94,257
353286,201907,164,429,97,312,22,72,37,118,59,190
353290,201907,1568,4160,940,2864,114,387,393,1095,507,1482
353300,201907,1782,4881,1302,3899,212,743,577,1508,789,2251
353310,201907,399,1006,278,780,26,96,170,448,196,544
353320,201907,653,1673,553,1506,12,37,463,1251,475,1288
353325,201907,643,1916,433,1446,100,340,148,470,248,810
353330,201907,562,1474,348,1022,46,141,175,482,221,623
353340,201907,2844,7860,1958,6120,484,1641,772,2269,1256,3910
353350,201907,3297,8963,2221,6666,486,1619,518,1314,1004,2933
353360,201907,584,1686,460,1455,51,164,234,730,285,894
353370,201907,556,1681,456,1505,37,133,303,959,340,1092
353380,201907,272,843,216,726,38,145,96,295,134,440
353390,201907,5658,14447,4123,11713,565,1784,2150,5724,2715,7508
353400,201907,409,1178,306,968,52,199,87,219,139,418
353410,201907,535,1463,411,1234,78,256,224,668,302,924
353420,201907,467,1273,276,842,57,162,21,45,78,207
353430,201907,2229,6358,1611,5180,379,1346,631,1856,1010,3202
353440,201907,63470,177172,44727,139186,8106,27000,22129,65125,30235,92125
353450,201907,382,1012,258,792,45,164,109,296,154,460
353460,201907,3295,9042,2350,7118,169,615,1092,3193,1261,3808
353470,201907,7666,20622,5348,16201,984,3371,2083,5722,3067,9093
353475,201907,1419,3778,975,2824,136,427,456,1214,592,1641
353480,201907,1665,4516,1291,3813,80,282,839,2374,919,2656
353490,201907,978,2668,636,1947,119,397,272,779,391,1176
353500,201907,1006,2417,770,2055,183,497,418,1121,601,1618
353510,201907,837,2532,605,1953,134,465,143,399,277,864
353520,201907,1115,2976,701,2189,90,315,307,903,397,1218
353530,201907,2467,6659,1882,5554,237,781,955,2615,1192,3396
353540,201907,2008,5612,1635,4984,307,976,879,2591,1186,3567
353550,201907,5834,15486,4601,13375,850,2585,2358,6581,3208,9166
353560,201907,2028,5800,1495,4903,486,1733,346,1045,832,2778
353570,201907,572,1510,416,1234,56,164,252,711,308,875
353580,201907,2047,5484,1601,4655,392,1108,691,1966,1083,3074
353590,201907,712,1977,453,1421,112,402,139,417,251,819
353600,201907,1791,4541,1355,3753,172,467,701,1900,873,2367
353610,201907,563,1740,402,1397,92,361,104,337,196,698
353620,201907,2623,7191,1818,5701,377,1326,555,1540,932,2866
353625,201907,512,1278,325,944,23,80,211,605,234,685
353630,201907,1225,3949,982,3366,236,903,297,916,533,1819
353640,201907,1390,3677,1097,3209,138,429,629,1816,767,2245
353650,201907,8818,24331,6317,19160,755,2545,3483,9803,4238,12348
353657,201907,388,1032,262,802,29,92,107,299,136,391
353660,201907,1190,2604,808,2068,328,841,229,557,557,1398
353670,201907,4001,11406,3083,9562,640,2211,1488,4218,2128,6429
353680,201907,706,1955,525,1679,97,326,278,856,375,1182
353690,201907,451,1168,166,535,9,25,17,44,26,69
353700,201907,1951,5356,1628,4762,146,480,1131,3176,1277,3656
353710,201907,4361,9786,2403,6323,241,663,1449,3485,1690,4148
353715,201907,473,1246,267,840,16,61,66,181,82,242
353720,201907,1877,5178,1463,4557,185,659,913,2758,1098,3417
353730,201907,4320,11891,3184,9685,525,1767,1456,4095,1981,5862
353740,201907,1963,5292,1332,4116,322,1100,413,1177,735,2277
353750,201907,828,2582,578,2077,145,548,93,373,238,921
353760,201907,12207,29556,9451,25641,1689,4805,5489,14477,7178,19282
353770,201907,689,2096,342,1177,62,222,45,122,107,344
353780,201907,5078,14817,3879,12292,847,2957,1597,4625,2444,7582
353790,201907,2505,7820,1835,6370,509,1982,397,1212,906,3194
353800,201907,17197,46807,13143,39874,2134,6933,6792,20434,8926,27367
353810,201907,1122,3084,740,2293,112,385,292,840,404,1225
353820,201907,1736,4923,1192,3765,267,891,384,1178,651,2069
353830,201907,631,1586,440,1262,72,206,185,514,257,720
353850,201907,1639,4693,1241,3883,311,992,403,1267,714,2259
353860,201907,2574,7429,2001,6315,504,1775,851,2445,1355,4220
353870,201907,28889,77520,19831,59558,2849,9580,9643,26351,12492,35931
353880,201907,2935,8447,2312,7173,210,771,1360,4024,1570,4795
353890,201907,2383,5357,1542,4144,158,449,1000,2554,1158,3003
353900,201907,726,2033,516,1604,99,337,205,594,304,931
353910,201907,1916,5556,1584,4993,205,780,1032,3152,1237,3932
353920,201907,1987,5565,1330,4243,296,1083,317,852,613,1935
353930,201907,4220,11446,2795,8824,575,2030,932,2593,1507,4623
353940,201907,1118,3309,748,2514,154,523,231,720,385,1243
353950,201907,3020,8477,2367,7269,449,1514,1269,3577,1718,5091
353960,201907,755,2039,491,1516,98,314,175,517,273,831
353970,201907,711,1743,518,1454,46,141,318,853,364,994
353980,201907,14718,38503,11238,32052,1057,3391,7545,20660,8602,24051
353990,201907,889,2201,520,1504,75,244,246,667,321,911
354000,201907,2537,6291,1361,3985,298,896,206,599,504,1495
354010,201907,354,950,259,792,35,115,151,450,186,565
354020,201907,3472,10030,2707,8322,694,2305,989,2716,1683,5021
354025,201907,744,2062,467,1505,81,296,88,246,169,542
354030,201907,485,1063,233,629,42,115,94,235,136,350
354040,201907,797,1901,496,1379,27,90,339,901,366,991
354050,201907,947,2788,654,2222,166,583,169,587,335,1170
354060,201907,3585,10508,2421,7947,574,1974,734,2226,1308,4200
354070,201907,3433,9575,2352,7396,487,1716,793,2114,1280,3830
354075,201907,2448,7376,1847,6204,254,1009,994,3247,1248,4256
354080,201907,1419,3977,910,2939,177,613,223,665,400,1278
354085,201907,412,889,324,779,2,5,229,514,231,519
354090,201907,1500,4282,1312,3890,97,320,980,2841,1077,3161
354100,201907,17957,51256,12506,41214,2873,10106,4778,15606,7651,25712
354105,201907,1523,3855,985,2850,128,370,430,1176,558,1546
354110,201907,509,1397,338,1077,63,221,104,322,167,543
354120,201907,1533,4191,1005,3047,188,600,342,908,530,1508
354130,201907,5733,15355,3685,11332,1007,3331,217,400,1224,3731
354140,201907,19328,48024,12499,35499,2403,7373,4861,12726,7264,20099
354150,201907,3143,7690,2298,6275,533,1485,878,2378,1411,3863
354160,201907,3076,9118,2239,7365,668,2345,631,1921,1299,4266
354165,201907,608,1831,452,1512,80,307,221,689,301,996
354170,201907,1569,4493,1280,3897,89,319,780,2258,869,2577
354180,201907,436,1227,303,933,57,181,117,320,174,501
354190,201907,1470,4243,1029,3332,91,334,391,1237,482,1571
354200,201907,885,2275,687,1960,89,267,394,1052,483,1319
354210,201907,715,1971,570,1714,45,159,388,1078,433,1237
354220,201907,3088,8534,2218,6733,426,1398,998,2859,1424,4257
354230,201907,712,1825,554,1621,42,161,384,1057,426,1218
354240,201907,1579,4464,1025,3275,189,660,303,854,492,1514
354250,201907,524,1346,330,1035,92,299,93,299,185,598
354260,201907,8233,22348,6181,18724,1408,4422,2317,6853,3725,11275
354270,201907,1041,3217,817,2758,190,625,278,924,468,1549
354280,201907,756,1966,628,1776,62,230,391,1017,453,1247
354290,201907,891,2869,739,2529,131,455,357,1245,488,1700
354300,201907,3561,10747,3010,9684,947,3089,977,3099,1924,6188
354310,201907,625,1934,504,1660,121,435,155,453,276,888
354320,201907,900,2283,563,1678,75,266,224,589,299,855
354323,201907,481,1206,312,885,37,91,126,342,163,433
354325,201907,1225,3715,859,2900,157,533,325,1066,482,1599
354330,201907,8676,22572,5593,16094,768,2629,3164,8387,3932,11016
354340,201907,28737,75375,19527,58629,3824,12658,8870,25253,12694,37911
354350,201907,1174,3080,928,2627,105,312,604,1619,709,1931
354360,201907,607,1592,329,1095,55,180,53,174,108,354
354370,201907,980,2965,802,2652,138,477,428,1391,566,1868
354380,201907,756,2026,522,1626,92,340,123,315,215,655
354390,201907,13516,33759,8385,24507,1618,4964,2862,7944,4480,12908
354400,201907,1591,5195,1218,4297,214,802,435,1523,649,2325
354410,201907,5420,15258,4019,12354,958,3142,1645,4839,2603,7981
354420,201907,1451,3907,1052,3129,140,443,622,1773,762,2216
354425,201907,2601,6520,1818,5098,439,1266,701,1990,1140,3256
354430,201907,1558,4262,1204,3645,156,550,658,1823,814,2373
354440,201907,579,1591,359,1113,43,150,166,472,209,622
354450,201907,417,1110,224,743,36,123,56,164,92,287
354460,201907,922,2395,590,1789,85,272,297,862,382,1134
354470,201907,505,1296,310,894,20,65,141,360,161,425
354480,201907,1083,2497,726,1931,61,174,491,1242,552,1416
354490,201907,802,2415,583,1922,124,419,226,690,350,1109
354500,201907,2002,5797,1664,5272,525,1812,382,1210,907,3022
354510,201907,756,2121,598,1773,62,191,322,875,384,1066
354515,201907,310,942,225,754,41,160,84,258,125,418
354520,201907,6618,18765,4353,13602,667,2352,2284,6604,2951,8956
354530,201907,4136,12217,3145,10171,746,2523,1186,3763,1932,6286
354540,201907,1296,3528,933,2860,233,761,311,952,544,1713
354550,201907,528,1418,403,1171,57,169,235,648,292,817
354560,201907,2049,5123,1089,3166,150,449,542,1500,692,1949
354570,201907,1163,3013,466,1389,87,278,65,188,152,466
354580,201907,9198,24488,5896,18126,968,3271,2740,7969,3708,11240
354600,201907,1746,4936,1334,4114,160,572,824,2408,984,2980
354610,201907,409,1092,216,670,30,102,80,241,110,343
354620,201907,440,1292,282,971,47,177,104,313,151,490
354625,201907,331,934,181,610,27,106,43,113,70,219
354630,201907,1879,5738,1505,4959,550,1880,226,714,776,2594
354640,201907,3154,9261,2263,7353,394,1444,714,2134,1108,3578
354650,201907,902,2398,715,2067,63,184,435,1239,498,1423
354660,201907,3597,8597,1873,5626,178,634,925,2615,1103,3249
354670,201907,1056,3020,730,2322,162,568,265,780,427,1348
354680,201907,4720,13026,3741,11352,917,2871,1852,5716,2769,8587
354690,201907,567,1798,379,1355,86,330,106,365,192,695
354700,201907,881,2375,615,1831,96,316,283,761,379,1077
354710,201907,502,1378,350,1063,48,165,148,392,196,557
354720,201907,328,804,140,418,44,137,25,74,69,211
354730,201907,9746,28000,7201,22950,1048,3670,3891,11907,4939,15577
354740,201907,323,888,122,429,16,65,17,53,33,118
354750,201907,2449,6606,1539,4806,304,1028,591,1618,895,2646
354760,201907,1941,5436,1330,4216,347,1172,376,1112,723,2284
354765,201907,355,959,137,454,18,63,27,75,45,138
354770,201907,2326,5859,1663,4720,339,1021,728,1930,1067,2951
354780,201907,53957,140460,40410,112767,5158,16053,23608,61482,28766,77535
354790,201907,975,2791,768,2427,106,370,439,1326,545,1696
354800,201907,2601,7005,1996,5952,514,1548,786,2229,1300,3777
354805,201907,1346,3206,888,2460,109,310,454,1121,563,1431
354810,201907,666,1940,357,1263,49,194,75,237,124,431
354820,201907,941,2791,666,2216,137,514,154,433,291,947
354830,201907,479,1194,303,866,66,182,95,257,161,439
354840,201907,931,2365,499,1479,48,146,259,731,307,877
354850,201907,20861,55935,14354,43688,1937,6799,8111,23081,10048,29880
354860,201907,1616,4625,1027,3368,196,709,315,897,511,1606
354870,201907,54665,140950,42134,117181,5230,15932,24759,64919,29989,80851
354880,201907,5724,14556,2607,7645,327,1094,883,2079,1210,3173
354890,201907,16769,42894,12863,36088,1842,5817,7396,19868,9238,25685
354900,201907,412,1095,265,826,44,145,65,181,109,326
354910,201907,5197,14108,3004,9896,693,2433,378,1157,1071,3590
354920,201907,446,1197,184,636,26,99,33,108,59,207
354925,201907,291,856,161,554,26,90,33,106,59,196
354930,201907,407,985,219,655,18,66,89,231,107,297
354940,201907,2095,6507,1463,5042,477,1776,222,707,699,2483
354950,201907,1472,4013,1167,3538,73,319,792,2240,865,2559
354960,201907,877,2355,670,2049,76,275,369,1055,445,1330
354970,201907,4118,11894,3187,10172,437,1500,1868,5784,2305,7284
354980,201907,30859,75062,19921,55668,2427,7963,11107,28699,13534,36662
354990,201907,60829,158415,44605,128119,4482,14579,27136,73575,31618,88154
354995,201907,2646,6295,1982,5381,227,718,1343,3436,1570,4154
355000,201907,1522,3997,1171,3459,190,642,492,1325,682,1967
355010,201907,3690,10270,2142,6929,708,2354,186,631,894,2985
355020,201907,3444,9993,2456,8135,714,2590,686,2107,1400,4697
355030,201907,1341307,3366358,948761,2573472,157765,466889,454116,1132239,611881,1599128
355040,201907,2813,7478,2243,6664,369,1119,1433,4272,1802,5391
355050,201907,972,2368,688,1910,190,541,230,591,420,1132
355060,201907,5794,16302,4221,13192,739,2646,1998,5629,2737,8275
355070,201907,8207,22066,6487,19179,799,2770,3944,10888,4743,13658
355080,201907,890,2605,544,1901,114,438,64,160,178,598
355090,201907,1139,3351,848,2817,226,729,234,810,460,1539
355100,201907,21787,58517,16887,51093,3003,9642,9910,29544,12913,39186
355110,201907,941,2697,702,2290,216,764,124,395,340,1159
355120,201907,684,1845,468,1490,46,159,156,461,202,620
355130,201907,870,1937,375,1003,18,52,217,538,235,590
355140,201907,1692,4071,1449,3720,113,366,1158,2853,1271,3219
355150,201907,4251,11565,3352,9916,403,1300,2009,5680,2412,6980
355160,201907,1873,5308,1346,4366,335,1227,305,935,640,2162
355170,201907,9612,25298,7360,21418,1661,5138,3540,9972,5201,15110
355180,201907,2733,7525,1910,6073,428,1542,650,1835,1078,3377
355190,201907,1883,5025,1481,4385,342,1059,754,2316,1096,3375
355200,201907,837,2641,702,2414,200,785,257,796,457,1581
355210,201907,2860,8161,2298,6933,355,1222,1233,3480,1588,4702
355220,201907,44010,120420,34327,101133,8725,27055,13185,35710,21910,62765
355230,201907,1168,2955,610,1820,116,346,189,518,305,864
355240,201907,22625,60585,15508,46316,2315,7527,7875,22373,10190,29900
355250,201907,36287,99461,26216,79555,6731,21617,9312,26757,16043,48374
355255,201907,812,2111,423,1318,81,256,136,404,217,660
355260,201907,1396,3626,1004,2936,132,471,583,1582,715,2053
355270,201907,1217,3636,907,2947,224,761,273,830,497,1591
355280,201907,28236,74945,19544,57647,3187,10056,8867,24686,12054,34742
355290,201907,874,2478,639,2016,134,390,257,778,391,1168
355300,201907,1254,3719,976,3156,171,587,303,930,474,1517
355310,201907,1038,2865,772,2406,97,295,427,1345,524,1640
355320,201907,544,1473,400,1194,72,250,159,400,231,650
355330,201907,2369,6388,1806,5361,144,525,1268,3568,1412,4093
355340,201907,3757,8388,2936,7265,383,867,1847,4642,2230,5509
355350,201907,1347,3999,989,3260,215,741,333,1081,548,1822
355360,201907,1248,3326,962,2873,127,398,577,1711,704,2109
355365,201907,372,1026,186,658,41,131,30,107,71,238
355370,201907,5702,14638,4305,12486,1023,2841,1888,5950,2911,8791
355380,201907,2932,8031,2145,6456,390,1259,714,1854,1104,3113
355385,201907,1426,3892,1164,3495,127,476,696,1900,823,2376
355390,201907,807,2279,567,1735,124,393,224,636,348,1029
355395,201907,1995,5646,1341,4254,213,699,454,1291,667,1990
355400,201907,9108,27335,7221,23375,1919,6904,2352,6804,4271,13708
355410,201907,21782,60600,14012,45403,3278,11671,3292,10522,6570,22193
355420,201907,660,2197,540,1938,145,593,132,438,277,1031
355430,201907,3738,9587,2784,7892,714,1966,1193,3392,1907,5358
355440,201907,836,2310,483,1523,86,287,143,424,229,711
355450,201907,3456,9184,2126,6508,388,1256,794,2221,1182,3477
355460,201907,531,1319,323,960,42,144,152,411,194,555
355465,201907,390,1111,291,915,48,156,121,377,169,533
355470,201907,1160,3064,628,1942,173,575,187,519,360,1094
355475,201907,350,857,278,745,15,36,198,518,213,554
355480,201907,3599,10345,2955,9327,475,1696,1828,5576,2303,7272
355490,201907,975,2683,522,1656,43,141,247,740,290,881
355495,201907,789,2302,569,1889,81,300,197,614,278,914
355500,201907,6735,17904,3849,11928,587,1963,1179,3346,1766,5309
355510,201907,1328,3417,818,2461,118,400,304,812,422,1212
355520,201907,383,854,172,493,28,75,44,110,72,185
355530,201907,422,972,141,419,22,80,54,138,76,218
355535,201907,515,1450,387,1238,84,325,156,442,240,767
355540,201907,9933,26282,8110,23502,1451,4548,4777,13399,6228,17947
355550,201907,654,1995,540,1777,79,284,256,795,335,1079
355560,201907,1136,3005,610,1961,128,457,42,129,170,586
355570,201907,236,693,126,430,24,82,24,74,48,156
355580,201907,1211,3016,784,2288,123,415,373,1009,496,1424
355590,201907,181,448,136,377,16,47,83,215,99,262
355600,201907,1487,3729,978,2832,213,651,401,1127,614,1778
355610,201907,1753,4487,1163,3398,150,455,549,1534,699,1989
355620,201907,4490,12564,3277,10057,438,1624,1688,4683,2126,6307
355630,201907,2293,6449,1562,4993,270,900,749,2341,1019,3241
355635,201907,919,2747,680,2263,124,462,224,690,348,1152
355640,201907,2729,7976,1844,6140,395,1399,433,1391,828,2790
355645,201907,4261,12333,3176,10348,410,1452,1795,5756,2205,7208
355650,201907,6636,18445,5310,15959,1522,4740,2100,5775,3622,10515
355660,201907,1308,3528,888,2702,124,457,307,923,431,1380
355670,201907,3436,9726,2245,6911,310,1150,1088,2912,1398,4062
355680,201907,3120,8845,1228,4120,333,1148,135,477,468,1625
355690,201907,775,2399,500,1824,125,465,10,20,135,485
355695,201907,239,703,139,464,11,48,21,43,32,91
355700,201907,7006,20638,5644,17527,1058,3391,2801,8192,3859,11583
355710,201907,8304,19957,5077,13947,862,2527,2140,5321,3002,7848
355715,201907,467,1226,243,754,52,179,42,101,94,280
355720,201907,1477,4321,1142,3674,197,680,571,1686,768,2366
355730,201907,958,2754,754,2329,180,600,286,792,466,1392
410010,201907,1269,3532,951,2859,212,710,196,556,408,1266
410020,201907,991,3114,771,2587,277,873,193,664,470,1537
410030,201907,1472,4201,1243,3820,187,652,642,1961,829,2613
410040,201907,11526,33175,8520,27213,1867,6414,2697,8034,4564,14448
410045,201907,930,2466,613,1879,91,312,200,573,291,885
410050,201907,2492,6339,1570,4653,329,1078,414,1108,743,2186
410060,201907,2083,6154,1574,5047,384,1265,430,1339,814,2604
410070,201907,1811,4733,1279,3699,231,741,450,1210,681,1951
410080,201907,1378,3716,970,2939,156,485,393,1204,549,1689
410090,201907,1036,2816,914,2610,85,236,551,1645,636,1881
410100,201907,1946,5769,1324,4236,181,676,216,657,397,1333
410105,201907,482,1270,252,783,40,143,62,177,102,320
410110,201907,3098,8130,2125,6141,304,947,864,2334,1168,3281
410115,201907,551,1420,383,1122,63,206,126,349,189,555
410120,201907,2353,7109,2045,6578,576,2017,796,2467,1372,4484
410130,201907,1129,3107,978,2808,239,768,430,1126,669,1894
410140,201907,14477,35825,8627,24991,1690,5269,1917,5026,3607,10295
410150,201907,16436,39712,7698,21994,1364,4207,1625,4315,2989,8522
410160,201907,2932,8306,2360,7258,495,1688,844,2577,1339,4265
410165,201907,715,2010,590,1727,53,188,342,934,395,1122
410170,201907,2581,6890,1661,4844,384,1212,142,416,526,1628
410180,201907,14573,41736,11224,34472,1651,5545,5843,16740,7494,22285
410185,201907,442,1235,312,955,48,161,103,284,151,445
410190,201907,2225,5717,1614,4583,347,1003,443,1220,790,2223
410200,201907,4920,11822,2636,7679,448,1517,521,1487,969,3004
410210,201907,2920,7605,1821,5517,315,1095,596,1548,911,2643
410220,201907,537,1422,330,1003,48,163,47,138,95,301
410230,201907,1638,4566,1259,3752,169,605,679,1885,848,2490
410240,201907,4593,12577,3199,9830,856,2913,221,627,1077,3540
410250,201907,2566,6296,1839,5041,161,557,850,2249,1011,2806
410260,201907,1835,4693,1149,3394,229,710,454,1306,683,2016
410270,201907,463,1224,326,969,56,194,115,308,171,502
410275,201907,671,1955,426,1387,58,200,197,583,255,783
410280,201907,2281,6219,1477,4548,231,777,567,1629,798,2406
410290,201907,3006,8661,2046,6530,472,1517,602,1919,1074,3436
410300,201907,641,1637,505,1398,52,158,230,596,282,754
410302,201907,363,957,186,587,30,93,91,272,121,365
410304,201907,1175,3198,999,2845,142,396,552,1542,694,1938
410305,201907,1699,4208,1158,3399,167,539,645,1818,812,2357
410310,201907,2559,7494,1986,6277,398,1362,787,2464,1185,3826
410315,201907,734,1803,375,1187,127,409,78,239,205,648
410320,201907,1106,3117,718,2264,114,417,103,313,217,730
410322,201907,560,1537,287,891,27,99,126,357,153,456
410330,201907,1484,3738,1022,2823,160,495,296,802,456,1297
410335,201907,836,2356,663,2008,91,299,296,831,387,1130
410337,201907,816,2010,554,1485,53,147,240,604,293,751
410340,201907,486,1352,318,943,32,110,156,390,188,500
410345,201907,2360,6236,1208,3673,251,767,321,881,572,1648
410347,201907,697,1796,493,1405,53,196,136,376,189,572
410350,201907,1295,3393,913,2711,96,316,395,1097,491,1413
410360,201907,4176,10282,3225,8642,269,850,2030,5168,2299,6018
410370,201907,12242,33595,7957,23532,1035,3425,3100,8096,4135,11521
410380,201907,1427,3797,1044,3023,124,399,425,1126,549,1525
410390,201907,2587,6883,1635,5019,413,1392,405,1140,818,2532
410395,201907,864,2539,705,2191,141,466,303,919,444,1385
410400,201907,5400,14832,4002,12078,676,2161,1735,5006,2411,7167
410405,201907,801,1983,610,1697,129,405,257,665,386,1070
410410,201907,1178,3267,1117,3179,172,602,690,2012,862,2614
410420,201907,8305,24138,6355,20097,1181,4139,2078,5894,3259,10033
410425,201907,2935,8544,2073,6738,381,1349,706,2062,1087,3411
410430,201907,12837,32973,8616,24919,1460,4588,2888,7911,4348,12499
410440,201907,2386,7284,2011,6543,342,1253,1010,3208,1352,4461
410442,201907,2199,6915,1823,6046,535,1763,534,1782,1069,3545
410445,201907,2284,6799,1749,5745,350,1286,458,1577,808,2863
410450,201907,1474,3880,1058,3106,207,690,321,855,528,1545
410460,201907,1874,4782,1472,4172,172,517,707,1939,879,2456
410465,201907,2605,7873,2007,6568,397,1329,628,1933,1025,3262
410470,201907,1944,5591,1361,4398,354,1294,244,813,598,2107
410480,201907,36104,87448,19091,56610,3124,10356,3971,10030,7095,20386
410490,201907,10891,30965,7562,23711,1470,4964,2675,7861,4145,12825
410500,201907,1716,4745,1175,3618,254,912,321,844,575,1756
410510,201907,1996,5055,1290,3656,252,690,373,1080,625,1770
410520,201907,3053,9805,2741,9169,869,2957,1043,3549,1912,6506
410530,201907,1632,4164,750,2213,112,336,159,368,271,704
410540,201907,2581,7127,1824,5606,308,1053,876,2625,1184,3678
410550,201907,6991,19041,4427,13227,790,2565,1145,2991,1935,5556
410560,201907,1440,3848,1074,3100,217,676,396,998,613,1674
410570,201907,2500,7119,1856,5931,539,2009,147,521,686,2530
410580,201907,24093,64422,17674,52197,3709,11635,7289,20054,10998,31689
410590,201907,1474,4326,951,2974,154,496,260,709,414,1205
410600,201907,1806,4931,1353,4029,298,843,483,1493,781,2336
410610,201907,739,1980,521,1552,55,196,221,635,276,831
410620,201907,2125,6397,1335,4448,302,1090,221,676,523,1766
410630,201907,2377,6476,1511,4610,295,990,267,667,562,1657
410640,201907,4646,11207,2943,8214,695,2219,392,1094,1087,3313
410645,201907,1017,3023,837,2763,270,918,340,1139,610,2057
410650,201907,2030,5788,1345,4283,301,1037,412,1186,713,2223
410655,201907,905,2251,630,1745,30,108,308,804,338,912
410657,201907,631,1719,401,1237,60,220,159,425,219,645
410660,201907,3231,8532,1754,5197,318,982,381,1065,699,2047
410670,201907,1064,2680,607,1744,121,351,255,679,376,1030
410680,201907,2677,8229,1885,6226,476,1558,406,1379,882,2937
410685,201907,566,1472,431,1228,96,308,179,458,275,766
410690,201907,121986,310163,79189,227834,13616,44251,27168,68218,40784,112469
410700,201907,2383,6141,2013,5568,284,820,1059,2828,1343,3648
410710,201907,797,2056,517,1549,63,209,260,742,323,951
410712,201907,650,1973,544,1729,131,458,196,582,327,1040
410715,201907,870,2613,519,1767,95,331,156,513,251,844
410720,201907,3170,8328,2345,6627,337,1111,478,1213,815,2324
410725,201907,1106,2813,633,1891,124,404,99,237,223,641
410730,201907,612,1652,450,1345,88,306,97,278,185,584
410740,201907,926,2625,664,2131,103,349,261,831,364,1180
410750,201907,1751,4548,1391,3903,220,690,571,1519,791,2209
410752,201907,352,894,158,477,16,54,69,197,85,251
410753,201907,238,737,166,576,22,94,37,118,59,212
410754,201907,1129,2969,923,2648,59,159,610,1854,669,2013
410755,201907,587,1532,416,1184,60,196,184,455,244,651
410760,201907,3268,8620,2322,6900,637,2128,492,1358,1129,3486
410765,201907,12706,36888,9806,30970,1656,5747,1716,4930,3372,10677
410770,201907,1005,2444,679,1877,73,219,346,937,419,1156
410773,201907,1271,3403,1089,3107,129,415,673,1842,802,2257
410775,201907,1434,3746,1249,3465,82,257,741,2016,823,2273
410780,201907,611,1540,381,1065,56,155,96,269,152,424
410785,201907,741,2087,576,1769,97,329,211,622,308,951
410790,201907,680,1976,542,1684,149,512,64,142,213,654
410800,201907,3266,7412,2589,6367,68,231,1612,3840,1680,4071
410810,201907,370,1021,283,847,35,116,125,340,160,456
410820,201907,797,2319,423,1323,90,287,79,218,169,505
410830,201907,31223,78656,20917,60758,4729,15540,6827,18601,11556,34141
410832,201907,984,2627,794,2283,111,375,434,1152,545,1527
410840,201907,7457,19705,4388,13594,899,3075,962,2651,1861,5726
410845,201907,1130,3011,883,2592,177,553,343,975,520,1528
410850,201907,2264,6701,1958,6117,343,1164,905,2746,1248,3910
410855,201907,750,1909,486,1403,41,127,223,595,264,722
410860,201907,4074,10474,3204,8908,462,1438,1529,4000,1991,5438
410865,201907,1367,4195,1198,3838,171,613,684,2226,855,2839
410870,201907,1284,3507,1080,3160,60,188,750,2168,810,2356
410880,201907,4202,11839,2982,9435,528,1874,442,1527,970,3401
410890,201907,969,2763,691,2184,158,543,189,584,347,1127
410895,201907,982,3239,809,2830,289,1099,127,418,416,1517
410900,201907,903,2439,587,1805,98,299,118,299,216,598
410910,201907,374,909,214,589,8,29,135,339,143,368
410920,201907,863,2092,581,1630,89,291,255,705,344,996
410930,201907,1509,4112,1094,3337,274,963,237,716,511,1679
410940,201907,21866,61859,15625,49976,3366,11780,4381,13882,7747,25662
410950,201907,1933,5714,1714,5360,65,242,1395,4285,1460,4527
410960,201907,7109,18570,4527,13895,1055,3581,1590,4766,2645,8347
410965,201907,974,2626,716,2118,102,327,381,1095,483,1422
410970,201907,3855,10622,2685,8303,627,2333,366,954,993,3287
410975,201907,1287,3332,965,2773,133,421,374,1049,507,1470
410980,201907,6743,17447,4214,12693,545,1819,1720,4821,2265,6640
410990,201907,1294,3318,834,2535,251,887,201,537,452,1424
411000,201907,543,1507,363,1142,51,181,101,272,152,453
411005,201907,421,1137,259,777,53,169,50,132,103,301
411007,201907,2189,6337,1793,5593,395,1298,596,1881,991,3179
411010,201907,4251,12971,3307,10917,863,3056,343,1022,1206,4078
411020,201907,2309,6756,1886,5987,545,1832,513,1561,1058,3393
411030,201907,720,1798,480,1295,41,144,249,602,290,746
411040,201907,927,2391,421,1243,54,172,130,323,184,495
411050,201907,1838,5934,1506,5133,412,1495,222,645,634,2140
411060,201907,1738,4653,1103,3384,253,904,177,506,430,1410
411065,201907,349,959,247,760,41,131,104,307,145,438
411070,201907,6547,17318,5157,14828,815,2633,2355,6486,3170,9119
411080,201907,2150,5831,1689,4963,470,1521,340,936,810,2457
411090,201907,844,2237,517,1580,47,176,125,358,172,534
411095,201907,1558,3727,1041,2880,115,360,363,939,478,1299
411100,201907,1106,2901,740,2239,81,283,226,691,307,974
411110,201907,634,1670,261,816,39,109,22,47,61,156
411120,201907,1232,3568,985,3044,335,1157,210,533,545,1690
411125,201907,5082,15203,4484,13978,955,3027,2112,6800,3067,9827
411130,201907,680,1871,481,1465,83,246,184,582,267,828
411140,201907,2246,7017,1851,6092,532,1872,516,1678,1048,3550
411150,201907,3758,9962,2561,7426,527,1762,231,495,758,2257
411155,201907,976,2541,559,1718,61,186,237,673,298,859
411160,201907,346,812,219,614,32,101,41,116,73,217
411170,201907,710,2168,520,1710,115,358,170,556,285,914
411180,201907,5297,14501,4036,12142,682,2259,1749,4910,2431,7169
411190,201907,1552,4127,1146,3376,185,572,416,1164,601,1736
411200,201907,5005,13806,3337,10496,886,2998,610,1719,1496,4717
411210,201907,2774,6284,1825,4796,334,1026,543,1295,877,2321
411220,201907,866,2340,628,1841,139,434,181,523,320,957
411230,201907,841,2309,571,1762,119,387,206,625,325,1012
411240,201907,1590,3878,939,2600,103,335,454,1156,557,1491
411250,201907,2121,5759,1559,4720,328,1164,461,1348,789,2512
411260,201907,331,896,211,644,29,86,82,223,111,309
411270,201907,1943,5399,1484,4448,231,711,683,1931,914,2642
411275,201907,1367,3284,933,2532,153,489,400,996,553,1485
411280,201907,1337,3713,868,2774,222,729,111,340,333,1069
411290,201907,759,2068,500,1542,51,150,245,767,296,917
411295,201907,1187,2991,874,2376,97,276,416,1085,513,1361
411300,201907,1036,2624,628,1801,66,204,248,623,314,827
411310,201907,862,2058,647,1737,43,114,276,733,319,847
411320,201907,5321,14268,3817,11417,752,2354,1473,4036,2225,6390
411325,201907,1478,4224,1234,3787,214,639,675,2128,889,2767
411330,201907,3294,9123,2387,7402,575,1945,686,2143,1261,4088
411340,201907,865,2405,506,1577,72,250,171,504,243,754
411342,201907,982,2410,577,1593,96,267,251,681,347,948
411345,201907,1083,2866,798,2378,80,256,535,1597,615,1853
411350,201907,2547,7177,1648,5264,431,1485,185,571,616,2056
411360,201907,662,1637,466,1324,56,161,164,461,220,622
411370,201907,50419,127050,35854,101594,2953,10155,20672,54665,23625,64820
411373,201907,1365,3537,1100,3115,100,337,580,1648,680,1985
411375,201907,1081,2776,770,2173,122,355,292,763,414,1118
411380,201907,1065,2509,732,1847,38,107,470,1105,508,1212
411390,201907,1607,4508,1224,3638,191,628,475,1221,666,1849
411400,201907,2215,5670,1692,4664,222,741,818,2105,1040,2846
411410,201907,2219,6339,1629,4982,374,1263,343,999,717,2262
411420,201907,4031,10187,2166,6483,328,1127,377,878,705,2005
411430,201907,3351,9291,2566,7754,558,1854,936,2577,1494,4431
411435,201907,438,1257,272,885,48,150,96,264,144,414
411440,201907,2550,7427,2052,6399,434,1484,684,2111,1118,3595
411450,201907,2561,6907,1949,5866,274,800,1017,3090,1291,3890
411460,201907,3819,10240,2182,6852,399,1439,368,1056,767,2495
411470,201907,736,1996,530,1568,86,278,183,485,269,763
411480,201907,4456,12367,3140,9793,672,2423,930,2617,1602,5040
411490,201907,1610,4258,1224,3577,161,550,471,1217,632,1767
411500,201907,1372,3751,896,2716,143,494,194,512,337,1006
411510,201907,2243,5955,1779,5098,392,1298,379,1094,771,2392
411520,201907,29658,73314,16329,46977,2169,6993,5755,14785,7924,21778
411530,201907,908,2431,545,1713,116,419,88,240,204,659
411535,201907,473,1410,237,809,25,93,44,114,69,207
411540,201907,2845,7190,1872,5262,246,786,808,2181,1054,2967
411545,201907,942,2772,776,2470,77,248,496,1584,573,1832
411550,201907,701,1850,496,1438,84,272,87,253,171,525
411560,201907,1943,5273,1100,3435,165,592,80,195,245,787
411570,201907,6918,16696,4485,12730,964,2976,917,2573,1881,5549
411573,201907,765,2114,640,1899,90,278,337,971,427,1249
411575,201907,1822,5113,1348,4113,277,912,312,910,589,1822
411580,201907,4385,10321,2445,7222,347,1212,381,993,728,2205
411585,201907,673,2006,281,962,71,251,43,129,114,380
411590,201907,398,1138,273,848,21,77,152,418,173,495
411600,201907,296,779,177,569,42,138,57,175,99,313
411605,201907,1575,3728,933,2600,126,442,478,1293,604,1735
411610,201907,2389,6022,1655,4561,97,332,1021,2622,1118,2954
411620,201907,2842,7741,2405,7043,415,1326,1323,3794,1738,5120
411630,201907,746,1963,496,1471,82,293,158,405,240,698
411640,201907,538,1493,361,1071,48,153,129,342,177,495
411650,201907,221,650,142,474,31,109,28,85,59,194
411660,201907,906,2305,633,1798,45,137,298,810,343,947
411670,201907,1273,3255,861,2392,101,299,377,956,478,1255
411680,201907,1514,4119,1142,3384,144,496,547,1588,691,2084
411690,201907,3582,9442,2679,7852,559,1699,787,2388,1346,4087
411695,201907,682,2122,432,1437,51,188,167,539,218,727
411700,201907,1580,4201,1023,3102,236,790,129,346,365,1136
411705,201907,1869,5914,1570,5385,328,1119,833,3054,1161,4173
411710,201907,1843,4815,1266,3707,319,976,172,495,491,1471
411720,201907,1074,2582,747,1979,123,344,312,772,435,1116
411721,201907,908,2376,669,1916,131,373,152,440,283,813
411722,201907,762,2092,407,1210,65,222,145,348,210,570
411725,201907,1181,3465,799,2652,188,652,163,549,351,1201
411727,201907,1496,4228,950,3042,234,777,134,394,368,1171
411729,201907,708,1738,441,1220,55,197,160,387,215,584
411730,201907,5265,14390,3889,11575,922,2873,1477,4293,2399,7166
411740,201907,535,1408,268,818,50,156,62,161,112,317
411745,201907,768,2245,490,1576,61,197,89,216,150,413
411750,201907,4985,13393,3513,10408,460,1466,1656,4569,2116,6035
411760,201907,7006,19055,5350,16061,1803,5599,1035,3409,2838,9008
411770,201907,3049,9030,2176,7037,540,1885,289,847,829,2732
411780,201907,2880,8348,2418,7380,670,2175,809,2448,1479,4623
411790,201907,2911,7215,1525,4589,346,1154,191,472,537,1626
411800,201907,998,2848,675,2086,110,352,137,403,247,755
411810,201907,1597,4234,1163,3349,178,534,553,1512,731,2046
411820,201907,10792,32366,8840,28581,2459,8455,3369,10552,5828,19007
411830,201907,595,1481,396,1125,73,218,88,274,161,492
411840,201907,11679,31665,7575,22832,1322,4320,2005,5511,3327,9831
411845,201907,492,1425,257,832,37,141,44,130,81,271
411850,201907,7439,19725,5121,15400,1360,4502,762,2049,2122,6551
411860,201907,716,2095,516,1653,91,318,132,377,223,695
411870,201907,640,1948,433,1439,97,350,88,251,185,601
411880,201907,2075,5454,1501,4461,253,831,411,1180,664,2011
411885,201907,1051,2750,741,2170,99,332,249,692,348,1024
411890,201907,1174,3224,793,2456,146,499,65,171,211,670
411900,201907,813,2334,480,1562,108,376,58,185,166,561
411910,201907,967,2967,689,2328,178,643,195,596,373,1239
411915,201907,15716,39361,9884,28492,1624,5192,3363,8632,4987,13824
411920,201907,1039,3172,866,2792,203,733,277,833,480,1566
411925,201907,485,1286,324,975,69,231,116,332,185,563
411930,201907,5086,16129,4287,14509,1855,6842,226,889,2081,7731
411940,201907,3262,9974,2487,8139,628,2171,708,2073,1336,4244
411950,201907,13337,37028,10820,32682,1841,6121,5688,16516,7529,22637
411960,201907,5666,15733,4563,13405,939,3030,1591,4365,2530,7395
411965,201907,425,1184,297,923,37,123,115,319,152,442
411970,201907,1038,2509,798,2165,170,433,326,1015,496,1448
411980,201907,1464,3805,1056,3077,271,820,355,978,626,1798
411990,201907,37388,100982,23718,74689,4756,16431,7862,23472,12618,39903
411995,201907,2912,7598,2172,6386,637,2071,604,1650,1241,3721
412000,201907,2005,4660,1411,3635,44,136,974,2347,1018,2483
412010,201907,618,1951,428,1505,57,212,101,292,158,504
412015,201907,555,1592,456,1411,56,189,261,807,317,996
412020,201907,450,1282,270,875,39,152,107,319,146,471
412030,201907,632,1804,428,1396,77,251,114,373,191,624
412033,201907,850,2290,581,1702,73,208,204,533,277,741
412035,201907,794,2154,499,1621,65,245,257,782,322,1027
412040,201907,593,1640,371,1158,68,217,66,195,134,412
412050,201907,1716,4406,1170,3387,217,709,279,808,496,1517
412060,201907,7108,21699,5922,19284,1742,6340,1468,4494,3210,10834
412065,201907,628,1782,436,1344,89,285,122,385,211,670
412070,201907,1136,2967,857,2381,127,372,343,902,470,1274
412080,201907,2003,5807,1231,4050,190,648,159,440,349,1088
412085,201907,297,759,95,309,11,29,14,34,25,63
412090,201907,5750,15233,4388,12660,1238,3679,1575,4647,2813,8326
412100,201907,1689,4746,1246,3901,358,1212,241,813,599,2025
412110,201907,861,2332,607,1791,90,271,206,591,296,862
412120,201907,1896,5722,1469,4822,301,1115,416,1188,717,2303
412125,201907,667,1934,475,1507,100,320,144,443,244,763
412130,201907,704,1842,488,1413,72,226,119,352,191,578
412135,201907,605,1627,263,793,39,114,91,249,130,363
412140,201907,1622,4108,1050,3046,215,742,193,500,408,1242
412150,201907,2848,7680,2355,6772,350,1125,1380,3777,1730,4902
412160,201907,1016,3176,599,2071,122,455,90,273,212,728
412170,201907,4237,12122,3544,10905,755,2472,1429,4090,2184,6562
412175,201907,1288,3905,1057,3471,243,804,434,1454,677,2258
412180,201907,1678,4745,1213,3839,176,675,512,1440,688,2115
412190,201907,3373,8577,2484,6954,321,995,1108,3095,1429,4090
412200,201907,1769,5408,1260,4153,340,1200,208,632,548,1832
412210,201907,621,1559,343,1014,60,204,95,249,155,453
412215,201907,3497,9580,2788,8207,753,2165,1123,3746,1876,5911
412217,201907,953,2545,791,2266,68,211,516,1427,584,1638
412220,201907,5877,16673,4700,14376,1177,3574,1502,4839,2679,8413
412230,201907,2654,8080,2117,6964,395,1464,566,1577,961,3041
412240,201907,6805,17735,4294,12746,753,2437,1269,3490,2022,5927
412250,201907,2000,5194,1506,4284,351,1019,356,960,707,1979
412260,201907,1238,3357,858,2532,144,420,241,661,385,1081
412265,201907,811,2356,685,2109,141,473,286,834,427,1307
412270,201907,878,2496,562,1765,70,235,221,605,291,840
412280,201907,458,1332,360,1156,77,250,95,279,172,529
412290,201907,985,2556,655,1926,101,316,206,581,307,897
412300,201907,1447,4021,1134,3393,252,778,266,809,518,1587
412310,201907,757,2079,624,1835,47,196,340,941,387,1137
412320,201907,839,2176,551,1591,72,273,190,546,262,819
412330,201907,1473,4057,993,3085,192,639,336,1075,528,1714
412340,201907,1123,3231,685,2202,118,417,124,375,242,792
412350,201907,2820,7535,1777,5424,375,1163,356,1062,731,2225
412360,201907,255,718,161,499,8,33,84,248,92,281
412370,201907,811,2351,531,1753,109,408,32,109,141,517
412380,201907,1577,4355,1062,3251,296,949,151,508,447,1457
412382,201907,526,1330,341,993,49,165,121,296,170,461
412385,201907,2161,6042,1765,5260,566,1617,519,1693,1085,3310
412390,201907,2396,6038,1926,5287,336,923,778,2148,1114,3071
412395,201907,723,2088,489,1541,61,191,200,611,261,802
412400,201907,898,2429,637,1902,135,424,158,488,293,912
412402,201907,1877,4749,1279,3722,289,878,152,446,441,1324
412405,201907,3137,8502,2016,6213,507,1842,56,146,563,1988
412410,201907,5566,15026,3981,12204,791,2801,1157,3280,1948,6081
412420,201907,513,1346,314,926,27,92,131,336,158,428
412430,201907,538,1417,353,1051,29,94,157,443,186,537
412440,201907,2723,7667,1793,5781,490,1679,278,902,768,2581
412450,201907,384,1154,249,796,47,146,20,41,67,187
412460,201907,1005,2738,800,2382,149,498,342,998,491,1496
412470,201907,1552,5088,1245,4352,335,1214,280,1012,615,2226
412480,201907,956,2660,603,1841,114,370,158,437,272,807
412490,201907,1196,3069,938,2576,102,280,534,1405,636,1685
412500,201907,1896,4904,1411,3947,318,874,383,1010,701,1884
412510,201907,1979,6130,1345,4442,307,1092,116,327,423,1419
412520,201907,1309,3461,689,2059,163,488,44,113,207,601
412530,201907,659,1798,473,1402,70,235,111,316,181,551
412535,201907,825,2203,558,1675,109,341,113,305,222,646
412540,201907,1211,3221,827,2430,92,341,264,791,356,1132
412545,201907,705,1850,473,1350,74,228,132,335,206,563
412550,201907,30329,83768,20694,63504,3723,12308,7357,20792,11080,33100
412555,201907,260,699,165,482,17,49,49,112,66,161
412560,201907,4790,14266,3486,11114,589,2025,1046,3340,1635,5365
412570,201907,4201,10940,2323,7149,540,1816,299,1003,839,2819
412575,201907,970,2541,765,2149,88,267,434,1157,522,1424
412580,201907,1397,3760,955,2873,112,387,466,1350,578,1737
412590,201907,414,1108,212,678,28,104,18,45,46,149
412600,201907,1398,3956,1034,3197,182,636,399,1173,581,1809
412610,201907,805,2193,538,1575,53,168,263,677,316,845
412620,201907,1269,3477,940,2895,194,685,281,795,475,1480
412625,201907,8691,23628,5349,16742,789,2779,322,902,1111,3681
412627,201907,1083,3102,685,2237,148,527,178,570,326,1097
412630,201907,2868,8450,2016,6534,416,1355,617,1803,1033,3158
412635,201907,353,945,234,683,33,112,75,182,108,294
412640,201907,1054,2883,574,1774,77,261,144,387,221,648
412650,201907,1588,4479,1253,3750,227,746,445,1156,672,1902
412660,201907,2505,6699,1731,5126,293,939,497,1326,790,2265
412665,201907,418,1130,307,895,59,178,113,308,172,486
412667,201907,1693,4532,1234,3602,173,549,501,1381,674,1930
412670,201907,781,1945,517,1468,98,325,157,406,255,731
412680,201907,1650,4599,1098,3464,145,517,427,1206,572,1723
412690,201907,912,2512,675,2010,102,323,250,705,352,1028
412700,201907,2071,5576,1659,4895,233,831,831,2322,1064,3153
412710,201907,5906,17749,4492,14632,948,3407,1246,3717,2194,7124
412720,201907,1228,3701,919,2972,143,500,180,489,323,989
412730,201907,2143,5924,1274,4020,247,848,328,981,575,1829
412740,201907,1783,5046,1173,3719,217,762,166,535,383,1297
412750,201907,3848,10422,3219,9466,365,1265,2051,5708,2416,6973
412760,201907,2898,8052,2391,7151,426,1418,1225,3436,1651,4854
412770,201907,10298,26513,5356,16494,797,2587,1112,2965,1909,5552
412780,201907,1201,3283,907,2744,193,623,339,992,532,1615
412785,201907,1972,5027,1354,3882,181,546,770,2157,951,2703
412788,201907,1316,3791,1061,3288,277,842,446,1371,723,2213
412790,201907,1263,3371,664,2084,111,412,202,545,313,957
412795,201907,1344,3570,696,2149,121,417,128,362,249,779
412796,201907,2332,6969,1911,6055,394,1327,608,1791,1002,3118
412800,201907,3421,8556,2287,6356,287,902,966,2364,1253,3266
412810,201907,10929,28212,6564,19110,886,2951,2279,5825,3165,8776
412820,201907,6398,17915,4528,14087,1056,3452,1323,4079,2379,7531
412830,201907,345,1006,226,729,30,91,47,145,77,236
412840,201907,1833,4732,1304,3679,176,542,460,1221,636,1763
412850,201907,2888,7791,2089,6342,348,1116,792,2326,1140,3442
412853,201907,1644,4312,1359,3730,179,541,682,1691,861,2232
412855,201907,1218,3309,767,2302,162,541,208,578,370,1119
412860,201907,823,2133,565,1694,79,261,276,785,355,1046
412862,201907,711,1712,455,1267,71,206,197,526,268,732
412863,201907,1207,3737,1114,3581,157,522,759,2424,916,2946
412865,201907,730,2040,524,1632,107,351,169,522,276,873
412870,201907,885,2357,648,1953,181,606,129,405,310,1011
412880,201907,844,2372,538,1710,96,324,78,212,174,536
420005,201907,453,1365,242,860,36,133,107,388,143,521
420010,201907,3390,8427,2203,6334,164,508,1567,4523,1731,5031
420020,201907,491,1541,304,1068,52,212,56,160,108,372
420030,201907,92,310,66,257,21,90,17,61,38,151
420040,201907,566,1761,333,1228,52,212,25,77,77,289
420050,201907,675,1630,418,1160,44,151,261,662,305,813
420055,201907,168,505,87,304,19,80,30,87,49,167
420060,201907,110,316,64,199,12,44,16,33,28,77
420070,201907,751,2399,554,1935,123,449,188,644,311,1093
420075,201907,78,216,36,116,8,26,7,12,15,38
420080,201907,342,1029,266,857,81,284,86,265,167,549
420090,201907,425,1365,254,926,61,241,56,195,117,436
420100,201907,1155,3143,972,2866,50,164,768,2234,818,2398
420110,201907,253,832,229,783,46,181,95,299,141,480
420120,201907,468,1332,300,963,60,215,115,325,175,540
420125,201907,319,1033,242,860,65,248,102,338,167,586
420127,201907,285,806,97,334,20,71,22,75,42,146
420130,201907,2552,7346,1917,6191,292,1182,990,2992,1282,4174
420140,201907,3449,9532,2465,7785,660,2379,325,1006,985,3385
420150,201907,588,1563,381,1195,57,195,197,595,254,790
420160,201907,232,587,101,321,9,29,32,100,41,129
420165,201907,160,464,92,304,24,82,25,75,49,157
420170,201907,264,799,166,558,24,74,35,100,59,174
420180,201907,181,562,102,369,14,53,31,105,45,158
420190,201907,170,550,103,375,35,139,21,65,56,204
420195,201907,1353,3657,981,3028,286,998,124,319,410,1317
420200,201907,3590,9306,2062,6329,326,1249,740,1905,1066,3154
420205,201907,1503,4109,1047,3248,158,499,581,1822,739,2321
420207,201907,1704,4629,1063,3355,207,750,410,1227,617,1977
420208,201907,348,992,201,719,36,145,82,285,118,430
420209,201907,139,461,84,294,21,86,27,86,48,172
420210,201907,2567,6797,1655,5293,355,1230,735,2302,1090,3532
420213,201907,761,2411,623,2112,133,486,302,1002,435,1488
420215,201907,216,653,145,499,39,150,17,47,56,197
420220,201907,242,741,150,522,32,128,66,211,98,339
420230,201907,4419,12433,3324,10340,488,1659,1739,5209,2227,6868
420240,201907,12046,33461,7368,22954,984,3566,3656,10025,4640,13591
420243,201907,379,1099,303,947,47,157,174,521,221,678
420245,201907,1283,3448,892,2744,83,338,494,1424,577,1762
420250,201907,430,1265,371,1157,71,261,188,531,259,792
420253,201907,513,1307,371,1093,32,101,200,580,232,681
420257,201907,188,477,109,328,22,77,57,161,79,238
420260,201907,1095,3000,785,2525,135,487,443,1410,578,1897
420270,201907,477,1266,215,648,34,116,77,213,111,329
420280,201907,1219,3540,849,2808,173,632,254,812,427,1444
420285,201907,80,211,43,134,7,33,11,28,18,61
420287,201907,462,1126,318,903,92,269,102,290,194,559
420290,201907,4079,11751,3066,9441,458,1686,1638,4532,2096,6218
420300,201907,6734,19309,3832,12491,760,2707,979,2851,1739,5558
420310,201907,844,2021,406,1152,60,176,206,531,266,707
420315,201907,824,2432,563,1909,122,454,224,754,346,1208
420320,201907,4258,12364,3250,10543,999,3570,734,2219,1733,5789
420325,201907,247,749,185,639,40,134,65,223,105,357
420330,201907,870,2668,562,1967,110,425,172,537,282,962
420340,201907,970,2840,694,2281,172,582,63,193,235,775
420350,201907,1313,3515,902,2726,98,327,576,1699,674,2026
420360,201907,2576,7359,1360,4593,266,971,132,422,398,1393
420370,201907,1047,2933,837,2563,96,350,550,1604,646,1954
420380,201907,4611,12513,2990,9414,647,2183,996,2990,1643,5173
420390,201907,1086,2717,718,1923,118,397,322,624,440,1021
420395,201907,985,2910,632,2144,101,362,69,190,170,552
420400,201907,915,2691,601,1985,111,411,187,576,298,987
420410,201907,509,1421,379,1149,39,141,239,679,278,820
420415,201907,300,918,227,757,64,232,77,263,141,495
420417,201907,628,1903,499,1626,125,414,179,598,304,1012
420419,201907,148,520,112,424,41,166,9,29,50,195
420420,201907,10457,28056,6922,21451,2138,7352,1688,4749,3826,12101
420425,201907,680,1834,456,1390,45,167,203,590,248,757
420430,201907,2979,8367,1806,5702,457,1565,527,1465,984,3030
420435,201907,273,704,117,393,17,60,54,179,71,239
420440,201907,688,2003,408,1341,115,420,135,380,250,800
420445,201907,303,780,175,518,35,114,62,167,97,281
420450,201907,678,2042,482,1596,92,376,162,469,254,845
420455,201907,1984,5080,1440,4197,190,683,723,1979,913,2662
420460,201907,8518,23409,6332,19310,1031,3570,3037,8820,4068,12390
420470,201907,615,1629,331,1068,69,258,73,199,142,457
420475,201907,53,153,27,93,10,33,3,13,13,46
420480,201907,5472,13870,3289,10062,676,2231,981,2963,1657,5194
420490,201907,362,1078,247,828,56,222,82,268,138,490
420500,201907,1345,3939,903,3043,170,620,362,1217,532,1837
420510,201907,168,485,88,294,14,51,28,89,42,140
420515,201907,43,121,29,91,1,1,12,42,13,43
420517,201907,756,2106,647,1919,42,122,489,1452,531,1574
420519,201907,312,749,205,587,25,76,107,315,132,391
420520,201907,368,1000,169,588,25,83,14,45,39,128
420530,201907,809,2403,558,1857,109,403,172,506,281,909
420535,201907,219,642,84,286,19,76,22,70,41,146
420540,201907,30212,73593,18753,53424,3075,9787,6569,15950,9644,25737
420543,201907,225,684,170,545,27,83,87,273,114,356
420545,201907,1111,3351,849,2765,172,599,326,975,498,1574
420550,201907,3427,9622,2170,7316,413,1562,869,2939,1282,4501
420555,201907,306,904,205,676,31,118,107,329,138,447
420560,201907,414,1061,281,852,68,212,140,412,208,624
420570,201907,2073,5995,1560,4969,326,1143,559,1687,885,2830
420580,201907,1750,4557,1207,3694,276,894,451,1378,727,2272
420590,201907,2904,7892,1668,5169,328,1190,398,888,726,2078
420600,201907,963,2878,734,2408,121,442,357,1129,478,1571
420610,201907,364,1072,196,682,49,164,59,214,108,378
420620,201907,611,1551,390,1174,95,291,148,441,243,732
420630,201907,909,2753,654,2097,113,408,332,977,445,1385
420640,201907,515,1473,242,861,63,219,23,69,86,288
420650,201907,3110,8551,1830,5707,298,1040,681,1829,979,2869
420660,201907,354,951,227,689,46,146,65,189,111,335
420665,201907,539,1431,331,1057,64,217,131,371,195,588
420670,201907,1395,3836,896,2869,144,564,336,932,480,1496
420675,201907,138,394,80,281,22,95,24,72,46,167
420680,201907,335,792,170,557,30,115,75,239,105,354
420690,201907,836,2583,502,1731,73,301,121,326,194,627
420700,201907,2745,7428,2058,6224,282,967,1063,3062,1345,4029
420710,201907,760,2285,569,1852,71,301,326,965,397,1266
420720,201907,1282,3594,909,2954,213,689,396,1267,609,1956
420730,201907,2707,7331,2065,6284,336,1068,1134,3338,1470,4406
420740,201907,570,1757,355,1264,99,370,39,158,138,528
420750,201907,1858,5560,1204,3996,201,755,460,1399,661,2154
420757,201907,70,182,32,114,2,9,14,42,16,51
420760,201907,362,1083,153,490,37,135,31,77,68,212
420765,201907,398,1235,216,753,28,105,93,321,121,426
420768,201907,1218,3634,1037,3304,150,483,724,2278,874,2761
420770,201907,420,1164,192,688,31,126,83,278,114,404
420775,201907,359,1059,227,773,46,182,47,130,93,312
420780,201907,927,2626,547,1809,119,418,97,278,216,696
420785,201907,194,523,135,401,17,52,59,148,76,200
420790,201907,1018,3213,746,2623,156,631,368,1213,524,1844
420800,201907,703,1806,324,1021,85,289,71,219,156,508
420810,201907,1460,4757,1185,4158,351,1389,341,1017,692,2406
420820,201907,10648,27421,7458,22076,1515,5067,3303,8815,4818,13882
420830,201907,3162,8706,2346,7197,505,1692,926,2737,1431,4429
420840,201907,542,1674,252,936,68,263,39,132,107,395
420845,201907,2096,5520,1239,3964,232,860,472,1459,704,2319
420850,201907,1062,3517,645,2385,136,551,92,309,228,860
420860,201907,291,752,156,502,38,135,38,115,76,250
420870,201907,811,2228,616,1877,172,619,263,738,435,1357
420880,201907,948,2969,741,2544,159,622,261,821,420,1443
420890,201907,7587,20673,4339,13886,699,2462,1375,3797,2074,6259
420895,201907,157,475,96,313,25,82,28,94,53,176
420900,201907,1374,3539,814,2521,110,419,338,907,448,1326
420910,201907,26413,71284,16271,51262,2660,9424,5939,16791,8599,26215
420915,201907,551,2003,390,1530,61,242,186,738,247,980
420917,201907,338,900,174,513,25,84,78,221,103,305
420920,201907,79,216,26,95,0,0,4,10,4,10
420930,201907,16965,44970,11848,35836,2142,7148,5217,14952,7359,22100
420940,201907,2466,6243,1466,4483,360,1233,227,549,587,1782
420945,201907,128,386,100,318,25,92,35,95,60,187
420950,201907,314,926,170,579,26,106,35,97,61,203
420960,201907,977,2481,672,1941,113,394,282,708,395,1102
420970,201907,2397,6974,1586,5296,464,1611,243,839,707,2450
420980,201907,285,902,241,833,112,388,75,285,187,673
420985,201907,322,944,158,564,33,125,48,148,81,273
420990,201907,380,1162,195,712,37,137,31,85,68,222
421000,201907,508,1648,330,1206,78,313,78,244,156,557
421003,201907,484,1136,151,445,14,45,25,61,39,106
421005,201907,59,182,51,171,14,46,23,74,37,120
421010,201907,3278,9215,2348,7476,499,1782,586,1627,1085,3409
421020,201907,375,1163,293,1018,41,165,151,502,192,667
421030,201907,768,2415,601,2057,172,655,172,540,344,1195
421040,201907,699,1651,416,1215,37,118,248,715,285,833
421050,201907,1064,3001,655,2058,118,397,216,612,334,1009
421055,201907,170,470,81,256,13,45,31,81,44,126
421060,201907,566,1698,355,1160,64,228,136,402,200,630
421070,201907,543,1676,301,1071,74,273,53,195,127,468
421080,201907,460,1349,392,1217,52,180,250,778,302,958
421085,201907,384,1133,135,503,24,93,19,57,43,150
421090,201907,293,772,171,514,17,53,59,168,76,221
421100,201907,935,2132,383,1135,94,312,64,168,158,480
421105,201907,1487,4163,1048,3291,179,561,466,1446,645,2007
421110,201907,1032,2945,867,2696,41,117,617,2001,658,2118
421120,201907,909,2901,644,2255,91,349,207,667,298,1016
421125,201907,260,700,206,615,74,247,68,160,142,407
421130,201907,4232,12768,3508,11321,772,2810,1907,5873,2679,8683
421140,201907,287,799,186,590,35,117,65,182,100,299
421145,201907,443,1265,277,889,62,225,123,362,185,587
421150,201907,555,1527,304,996,62,220,94,294,156,514
421160,201907,527,1415,361,1119,39,136,230,695,269,831
421165,201907,190,582,118,400,27,89,47,159,74,248
421170,201907,1073,2870,830,2482,131,370,517,1574,648,1944
421175,201907,1071,2798,667,2143,134,501,271,810,405,1311
421180,201907,369,970,198,615,35,129,67,196,102,325
421185,201907,303,828,198,606,30,100,108,326,138,426
421187,201907,299,912,181,603,32,104,58,179,90,283
421189,201907,349,1021,262,836,41,127,97,296,138,423
421190,201907,9535,26348,6201,20025,1291,4584,1700,5105,2991,9689
421200,201907,651,1988,524,1722,88,322,270,842,358,1164
421205,201907,191,516,141,434,28,90,71,210,99,300
421210,201907,1039,2750,625,2015,157,510,199,649,356,1159
421220,201907,1328,4216,1049,3557,246,913,278,849,524,1762
421223,201907,357,1041,226,771,57,188,92,315,149,503
421225,201907,895,2748,770,2515,147,533,431,1408,578,1941
421227,201907,946,2513,543,1692,95,324,236,735,331,1059
421230,201907,596,1600,371,1179,94,310,114,370,208,680
421240,201907,281,861,114,428,13,63,15,57,28,120
421250,201907,1627,4254,1084,3338,174,582,496,1490,670,2072
421260,201907,173,512,45,171,10,42,11,40,21,82
421265,201907,603,1697,561,1638,13,44,522,1526,535,1570
421270,201907,402,1061,177,621,30,104,61,198,91,302
421280,201907,1569,4621,1172,3862,219,853,560,1705,779,2558
421290,201907,800,2234,424,1336,83,278,89,263,172,541
421300,201907,251,688,138,446,21,73,29,97,50,170
421310,201907,176,513,124,405,25,87,57,190,82,277
421315,201907,212,613,131,414,34,104,30,93,64,197
421320,201907,633,1887,304,1026,43,153,44,111,87,264
421330,201907,616,1842,432,1463,88,328,116,367,204,695
421335,201907,363,1130,295,1005,62,237,110,369,172,606
421340,201907,1309,3822,944,3100,198,728,363,1117,561,1845
421350,201907,1212,3318,820,2603,162,624,349,1015,511,1639
421360,201907,2234,6196,1326,4334,275,1083,469,1321,744,2404
421370,201907,489,1606,288,1064,62,243,74,239,136,482
421380,201907,812,2238,695,2027,91,306,419,1178,510,1484
421390,201907,173,474,64,219,15,48,18,50,33,98
421400,201907,274,898,191,693,38,156,88,292,126,448
421410,201907,237,644,97,334,17,65,23,74,40,139
421415,201907,216,660,114,376,30,99,24,67,54,166
421420,201907,494,1417,411,1253,52,178,253,732,305,910
421430,201907,123,395,97,333,11,38,31,92,42,130
421440,201907,607,1624,374,1206,76,237,170,543,246,780
421450,201907,389,1192,241,828,32,131,39,148,71,279
421460,201907,317,940,195,686,29,95,36,106,65,201
421470,201907,254,764,142,502,25,102,54,193,79,295
421480,201907,2710,7429,1755,5581,393,1442,615,1741,1008,3183
421490,201907,105,343,66,240,6,24,18,50,24,74
421500,201907,2114,6405,1472,5046,416,1641,319,982,735,2623
421505,201907,288,867,254,808,33,113,158,488,191,601
421507,201907,406,1197,225,776,61,221,65,213,126,434
421510,201907,270,780,158,503,30,98,72,211,102,309
421520,201907,505,1362,312,928,39,134,174,478,213,612
421530,201907,321,1016,185,674,40,173,41,118,81,291
421535,201907,398,1090,242,790,40,155,126,380,166,535
421540,201907,254,625,128,408,18,66,43,122,61,188
421545,201907,689,2062,505,1704,107,416,240,756,347,1172
421550,201907,1899,5393,1535,4820,305,1048,792,2416,1097,3464
421555,201907,197,618,72,270,14,59,11,28,25,87
421560,201907,78,260,49,187,12,43,13,47,25,90
421565,201907,891,2371,614,1918,156,539,179,562,335,1101
421567,201907,449,1550,286,1056,113,432,64,211,177,643
421568,201907,328,1001,235,776,36,138,108,336,144,474
421569,201907,186,538,75,256,20,72,31,101,51,173
421570,201907,935,2644,665,2120,181,629,145,452,326,1081
421575,201907,272,832,212,672,41,145,83,220,124,365
421580,201907,3095,8918,2046,6699,398,1538,721,1994,1119,3532
421590,201907,142,461,109,373,36,131,29,85,65,216
421600,201907,516,1431,349,1077,84,272,87,227,171,499
421605,201907,737,1968,508,1574,100,289,210,670,310,959
421610,201907,1067,2981,655,2145,129,449,167,538,296,987
421620,201907,3874,10575,2220,7411,537,1934,526,1693,1063,3627
421625,201907,185,518,75,244,13,39,15,48,28,87
421630,201907,2407,6578,1420,4530,248,931,406,1100,654,2031
421635,201907,233,653,154,474,21,72,84,238,105,310
421640,201907,684,1913,491,1586,106,363,162,531,268,894
421650,201907,2187,6172,1384,4613,349,1335,339,935,688,2270
421660,201907,8140,23446,5931,19179,973,3587,2389,7018,3362,10605
421670,201907,748,2210,521,1676,99,359,250,771,349,1130
421680,201907,971,2802,745,2364,202,687,314,902,516,1589
421690,201907,1209,3569,839,2745,165,613,279,917,444,1530
421700,201907,460,1434,250,898,46,186,70,223,116,409
421710,201907,222,706,91,307,21,75,22,70,43,145
421715,201907,103,294,79,236,20,57,49,140,69,197
421720,201907,1903,5308,1082,3525,298,1066,282,780,580,1846
421725,201907,213,523,107,336,21,72,40,97,61,169
421730,201907,375,1120,194,592,18,59,98,279,116,338
421740,201907,628,1832,432,1395,121,402,100,293,221,695
421750,201907,868,2093,407,1212,89,297,153,400,242,697
421755,201907,177,490,98,298,15,58,47,128,62,186
421760,201907,866,2404,535,1765,99,363,164,463,263,826
421770,201907,2248,6133,1645,5052,409,1286,571,1899,980,3185
421775,201907,214,564,136,401,19,65,64,167,83,232
421780,201907,788,2435,525,1853,108,423,197,649,305,1072
421790,201907,721,1884,412,1333,94,317,193,603,287,920
421795,201907,215,622,136,420,27,96,47,131,74,227
421800,201907,2422,6922,1786,5691,284,1027,910,2747,1194,3774
421810,201907,627,1770,430,1379,58,217,231,713,289,930
421820,201907,911,2715,499,1691,100,382,135,380,235,762
421825,201907,1299,3727,1152,3494,134,452,795,2346,929,2798
421830,201907,1935,6055,1629,5468,337,1225,692,2235,1029,3460
421835,201907,213,556,116,368,23,86,34,90,57,176
421840,201907,217,702,142,521,28,111,35,118,63,229
421850,201907,383,1120,210,736,41,157,67,178,108,335
421860,201907,302,883,180,622,22,90,62,184,84,274
421870,201907,3630,9448,2525,7288,479,1575,1177,3101,1656,4676
421875,201907,221,672,108,388,19,75,26,74,45,149
421880,201907,499,1410,347,1117,96,361,65,215,161,576
421885,201907,210,563,128,402,34,110,32,83,66,193
421890,201907,753,2393,580,2033,115,458,256,832,371,1290
421895,201907,388,1024,318,930,37,128,207,620,244,748
421900,201907,949,2486,626,1830,100,343,280,736,380,1079
421910,201907,321,972,220,752,50,194,47,131,97,325
421915,201907,374,1064,202,654,43,136,25,72,68,208
421917,201907,546,1353,316,1029,108,383,76,248,184,631
421920,201907,415,1282,293,1037,130,483,83,292,213,775
421930,201907,2390,6310,1125,3735,312,1149,197,583,509,1732
421935,201907,409,1324,319,1112,62,231,171,564,233,795
421940,201907,315,953,124,416,17,67,36,109,53,176
421950,201907,2996,7618,1485,4686,309,1090,340,937,649,2027
421960,201907,163,421,90,291,21,76,16,47,37,123
421970,201907,1891,5031,1081,3354,230,794,342,922,572,1716
421985,201907,256,668,154,466,19,67,51,146,70,213
422000,201907,1702,4650,1380,4082,155,525,896,2628,1051,3153
430003,201907,528,1503,343,1137,67,244,135,440,202,684
430005,201907,265,720,164,527,39,130,72,219,111,349
430010,201907,1675,4298,1347,3723,156,476,927,2461,1083,2937
430020,201907,578,1350,436,1157,60,187,270,675,330,862
430030,201907,1010,2446,566,1650,158,494,162,431,320,925
430040,201907,9568,23857,5612,16594,1478,4751,496,1604,1974,6355
430045,201907,549,1406,371,1064,27,88,219,604,246,692
430047,201907,255,558,96,277,20,63,26,78,46,141
430050,201907,851,2214,472,1428,109,346,116,339,225,685
430055,201907,257,653,111,335,14,53,59,159,73,212
430057,201907,95,214,32,88,6,21,7,16,13,37
430060,201907,16141,44972,12562,39120,2839,9417,5531,17191,8370,26608
430063,201907,862,2430,674,2021,130,387,363,1079,493,1466
430064,201907,971,2765,731,2238,205,666,263,756,468,1422
430066,201907,101,232,72,184,4,11,52,118,56,129
430070,201907,704,1790,91,304,6,21,12,34,18,55
430080,201907,762,1931,456,1310,73,249,211,517,284,766
430085,201907,864,2004,518,1431,88,250,220,593,308,843
430087,201907,498,1365,403,1226,71,214,227,710,298,924
430090,201907,565,1471,183,589,16,70,54,162,70,232
430100,201907,650,1622,353,1038,73,235,129,329,202,564
430105,201907,1063,2874,661,2167,126,459,312,1021,438,1480
430107,201907,181,538,111,358,22,77,30,79,52,156
430110,201907,2072,5217,1503,4351,226,702,839,2396,1065,3098
430120,201907,1323,4024,808,2675,150,517,353,1185,503,1702
430130,201907,3368,8123,2529,6922,991,2734,470,1501,1461,4235
430140,201907,897,2560,608,1975,153,493,255,821,408,1314
430150,201907,577,1506,306,945,69,226,97,291,166,517
430155,201907,244,643,114,357,16,50,20,53,36,103
430160,201907,17866,44558,14084,38883,2301,6800,7124,19694,9425,26494
430163,201907,2548,6393,1744,5063,119,363,1173,3409,1292,3772
430165,201907,333,810,79,257,12,26,14,38,26,64
430170,201907,903,2437,324,1115,56,203,60,189,116,392
430175,201907,658,2023,539,1758,143,461,253,806,396,1267
430180,201907,640,1657,506,1416,65,192,345,938,410,1130
430185,201907,452,1084,272,766,60,169,87,219,147,388
430187,201907,656,1618,460,1341,76,241,217,654,293,895
430190,201907,1407,3858,1130,3394,257,832,493,1390,750,2222
430192,201907,126,362,52,153,7,21,13,33,20,54
430195,201907,401,1201,54,192,8,25,5,20,13,45
430200,201907,1086,3307,880,2924,281,971,258,874,539,1845
430205,201907,488,1315,407,1147,16,53,340,931,356,984
430210,201907,4754,12386,3209,9166,643,1947,1027,2374,1670,4321
430215,201907,309,813,187,559,37,119,74,222,111,341
430220,201907,644,1604,166,564,30,127,40,104,70,231
430222,201907,181,537,135,439,16,61,53,163,69,224
430223,201907,239,657,194,573,24,73,115,330,139,403
430225,201907,15,33,12,28,1,2,9,17,10,19
430230,201907,1719,4894,1495,4556,136,410,1124,3431,1260,3841
430235,201907,278,843,189,634,47,177,58,168,105,345
430237,201907,529,1315,363,1020,20,73,240,640,260,713
430240,201907,1127,2552,638,1735,78,252,354,901,432,1153
430245,201907,666,2017,513,1700,157,519,233,783,390,1302
430250,201907,945,2505,725,2147,235,759,36,86,271,845
430258,201907,107,293,82,243,4,8,45,142,49,150
430260,201907,618,1683,437,1318,76,236,225,669,301,905
430265,201907,202,577,140,454,27,93,44,129,71,222
430270,201907,2672,6861,2132,5988,379,1155,1270,3449,1649,4604
430280,201907,4887,11965,3433,9344,745,2077,1426,3817,2171,5894
430290,201907,2082,4983,1770,4594,50,161,1507,3831,1557,3992
430300,201907,8890,23728,6876,20024,1201,3799,3461,9872,4662,13671
430310,201907,10346,26716,6816,19767,964,3200,3170,8520,4134,11720
430320,201907,951,2565,507,1616,71,205,272,890,343,1095
430330,201907,625,1588,399,1119,75,218,179,455,254,673
430340,201907,704,1586,369,1054,53,166,210,573,263,739
430350,201907,6645,17855,4893,14468,981,3016,2312,6624,3293,9640
430355,201907,333,865,109,363,23,71,17,53,40,124
430360,201907,828,2065,547,1561,124,393,204,533,328,926
430367,201907,331,816,175,511,42,129,65,193,107,322
430370,201907,485,1349,215,690,38,132,54,149,92,281
430380,201907,669,1709,329,1057,78,296,77,236,155,532
430390,201907,2998,7485,1621,4838,298,967,130,283,428,1250
430400,201907,1087,2346,836,1980,68,171,608,1383,676,1554
430410,201907,551,1353,370,1048,58,186,208,561,266,747
430420,201907,2713,7580,2036,6047,562,1741,757,2142,1319,3883
430430,201907,665,1736,312,968,72,215,65,202,137,417
430435,201907,1511,3909,1121,3250,237,721,500,1450,737,2171
430440,201907,3615,10357,2696,8509,403,1446,1474,4554,1877,6000
430450,201907,6668,17323,5277,14786,705,2230,2944,7977,3649,10207
430460,201907,28926,76174,20453,61777,4099,13648,9021,25894,13120,39542
430461,201907,385,969,101,313,10,31,29,76,39,107
430462,201907,245,674,145,479,19,63,47,163,66,226
430463,201907,4823,13533,3679,11448,740,2535,1736,5241,2476,7776
430465,201907,459,1226,377,1066,56,171,228,619,284,790
430466,201907,3824,9890,2999,8454,759,2225,1391,3715,2150,5940
430467,201907,494,1230,341,981,50,166,168,453,218,619
430468,201907,1316,3296,1029,2861,114,336,619,1683,733,2019
430469,201907,649,1833,77,271,12,41,11,15,23,56
430470,201907,5419,14390,3644,11142,1142,3748,897,2582,2039,6330
430471,201907,520,1564,438,1403,72,236,215,659,287,895
430480,201907,821,2189,421,1320,62,200,81,216,143,416
430485,201907,170,466,65,218,16,55,7,21,23,76
430490,201907,412,1083,222,660,26,86,106,288,132,374
430495,201907,364,1018,206,686,30,104,71,218,101,322
430500,201907,1013,2670,705,2130,212,689,217,589,429,1278
430510,201907,23434,62693,16453,48536,3201,10646,6677,17907,9878,28553
430511,201907,324,959,123,429,14,52,15,44,29,96
430512,201907,922,2149,715,1831,176,447,252,663,428,1110
430513,201907,781,1986,366,1054,55,161,179,503,234,664
430515,201907,382,1093,266,845,39,116,126,399,165,515
430517,201907,1035,3228,785,2627,145,485,389,1343,534,1828
430520,201907,1311,3473,669,2058,117,360,140,396,257,756
430530,201907,1060,2759,396,1243,80,261,87,262,167,523
430535,201907,3033,8081,2156,6435,331,1039,1058,3072,1389,4111
430537,201907,314,1123,283,1020,27,83,218,790,245,873
430540,201907,567,1401,340,1021,46,133,164,486,210,619
430543,201907,657,1267,392,954,63,127,197,515,260,642
430544,201907,639,1899,445,1441,105,361,192,605,297,966
430545,201907,2020,5424,1503,4624,309,965,724,2279,1033,3244
430550,201907,408,1170,256,825,42,131,82,256,124,387
430558,201907,115,270,51,145,8,21,14,39,22,60
430560,201907,341,768,140,424,14,48,40,117,54,165
430570,201907,742,1794,545,1481,99,294,298,759,397,1053
430580,201907,906,2267,621,1821,149,483,254,703,403,1186
430583,201907,197,489,36,116,4,12,6,18,10,30
430585,201907,226,556,116,317,19,55,51,120,70,175
430587,201907,200,573,141,440,24,77,59,185,83,262
430590,201907,1381,3355,1163,3016,54,154,976,2494,1030,2648
430593,201907,19,68,13,46,1,3,6,20,7,23
430595,201907,430,1046,94,306,6,24,21,48,27,72
430597,201907,375,1013,212,645,25,81,73,168,98,249
430600,201907,1813,4731,806,2405,153,483,226,633,379,1116
430605,201907,1115,3141,812,2523,113,420,343,1009,456,1429
430607,201907,558,1311,420,1086,26,74,295,763,321,837
430610,201907,5600,13829,3724,10840,1061,3320,680,2046,1741,5366
430613,201907,259,605,72,205,9,30,18,43,27,73
430620,201907,557,1441,420,1168,62,195,229,595,291,790
430630,201907,433,1221,127,415,19,65,27,75,46,140
430632,201907,525,1416,237,731,29,92,107,315,136,407
430635,201907,524,1349,377,1069,48,141,264,744,312,885
430637,201907,452,1156,356,1005,43,136,211,567,254,703
430640,201907,1070,2791,603,1824,94,291,198,570,292,861
430642,201907,342,947,249,735,45,130,127,357,172,487
430645,201907,217,492,74,204,17,49,14,40,31,89
430650,201907,1537,4651,1270,4184,331,1098,597,2041,928,3139
430655,201907,259,641,148,417,22,64,65,163,87,227
430660,201907,4820,12847,3630,10720,857,2708,1567,4556,2424,7264
430670,201907,619,1535,473,1278,25,70,315,855,340,925
430673,201907,556,1294,211,641,42,131,74,214,116,345
430675,201907,204,584,55,194,17,66,18,60,35,126
430676,201907,4469,11515,3485,9933,459,1436,2131,5914,2590,7350
430680,201907,960,2614,575,1804,161,526,136,416,297,942
430690,201907,2966,8220,2354,7066,780,2462,612,1777,1392,4239
430692,201907,211,653,157,559,12,50,111,395,123,445
430693,201907,1010,2709,579,1799,113,411,136,378,249,789
430695,201907,487,1279,272,816,36,106,143,407,179,513
430697,201907,388,985,292,833,71,194,136,411,207,605
430700,201907,6651,16837,3602,11036,840,2740,489,1454,1329,4194
430705,201907,403,1006,193,586,27,92,77,217,104,309
430710,201907,1641,3671,1140,2935,170,484,627,1575,797,2059
430720,201907,737,1785,385,1159,58,162,173,517,231,679
430730,201907,1054,2912,722,2255,113,333,354,1111,467,1444
430740,201907,597,1689,305,1036,48,173,84,298,132,471
430745,201907,438,1218,239,750,39,140,70,186,109,326
430750,201907,1307,3463,921,2760,197,612,472,1352,669,1964
430755,201907,456,1114,287,767,17,56,161,396,178,452
430760,201907,1918,4978,1514,4315,381,1131,639,1762,1020,2893
430770,201907,5906,15150,4517,13018,657,2116,2746,7663,3403,9779
430780,201907,2008,5007,1131,3466,234,756,354,1067,588,1823
430781,201907,426,1204,227,722,35,112,58,155,93,267
430783,201907,415,967,238,683,30,106,132,348,162,454
430786,201907,37,128,22,90,5,20,4,20,9,40
430790,201907,4414,11171,2955,8477,401,1337,1644,4341,2045,5678
430800,201907,757,1831,556,1496,46,141,361,951,407,1092
430805,201907,418,1140,251,751,23,86,151,407,174,493
430807,201907,370,841,198,541,12,38,106,263,118,301
430810,201907,810,1977,263,843,35,131,80,242,115,373
430820,201907,1353,3619,724,2361,154,534,166,554,320,1088
430825,201907,265,686,89,250,16,44,23,54,39,98
430830,201907,1650,4855,1345,4259,64,247,945,2959,1009,3206
430840,201907,921,2436,707,2050,99,312,466,1323,565,1635
430843,201907,120,293,40,119,4,12,19,48,23,60
430845,201907,391,949,252,710,69,208,82,212,151,420
430850,201907,2272,6056,1611,4765,269,861,715,2097,984,2958
430860,201907,813,1876,425,1208,60,205,198,482,258,687
430865,201907,502,1294,387,1090,63,193,202,544,265,737
430870,201907,638,1697,261,839,41,149,83,233,124,382
430880,201907,1284,3056,858,2378,159,471,428,1139,587,1610
430885,201907,199,489,87,283,8,30,51,162,59,192
430890,201907,998,2651,671,2045,58,262,109,299,167,561
430900,201907,2909,6605,1982,5218,176,552,1264,3122,1440,3674
430905,201907,770,2005,479,1437,88,295,177,507,265,802
430910,201907,1472,3989,1021,3049,164,574,469,1243,633,1817
430912,201907,484,1343,321,1021,34,105,205,665,239,770
430915,201907,504,1551,359,1265,112,399,108,381,220,780
430920,201907,22672,58634,17289,49572,2508,7978,10044,27852,12552,35830
430925,201907,133,302,48,143,10,30,16,52,26,82
430930,201907,9658,23143,5916,17257,1262,3842,2258,6827,3520,10669
430940,201907,1112,3066,629,1949,191,631,111,257,302,888
430950,201907,716,1768,446,1266,45,158,263,673,308,831
430955,201907,229,621,72,236,15,47,19,54,34,101
430957,201907,176,608,165,580,30,111,92,316,122,427
430960,201907,1348,3219,774,2187,172,534,323,878,495,1412
430965,201907,1659,4059,1255,3414,69,211,945,2558,1014,2769
430970,201907,380,971,189,572,30,103,86,235,116,338
430975,201907,482,1498,361,1197,85,299,154,495,239,794
430980,201907,387,922,206,603,37,117,82,212,119,329
430990,201907,570,1671,339,1085,42,147,170,530,212,677
430995,201907,566,1489,410,1225,58,185,197,571,255,756
431000,201907,1331,3196,528,1564,92,298,36,86,128,384
431010,201907,2089,5509,1235,3975,233,796,161,446,394,1242
431020,201907,8204,18289,4784,12907,1131,3368,1533,3677,2664,7045
431030,201907,322,875,145,488,26,93,23,74,49,167
431033,201907,3331,8101,2058,6034,514,1560,672,1991,1186,3551
431036,201907,344,744,70,200,8,19,20,47,28,66
431040,201907,916,2400,594,1785,96,328,253,693,349,1021
431041,201907,464,1078,336,888,32,83,196,506,228,589
431043,201907,388,951,199,629,48,166,76,239,124,405
431046,201907,108,283,44,133,3,8,11,32,14,40
431050,201907,1375,3456,977,2813,165,488,514,1480,679,1968
431053,201907,580,1616,310,1025,64,218,93,291,157,509
431055,201907,584,1460,490,1319,43,113,365,968,408,1081
431057,201907,270,786,124,422,19,67,37,115,56,182
431060,201907,5061,13724,3475,10857,930,3138,765,2422,1695,5560
431065,201907,460,1206,310,935,64,198,107,313,171,511
431070,201907,439,1287,243,818,61,227,41,125,102,352
431075,201907,220,663,140,472,26,89,39,133,65,222
431080,201907,614,1716,417,1303,90,315,127,373,217,688
431085,201907,706,1919,460,1332,73,214,227,633,300,847
431087,201907,452,1292,356,1079,26,73,237,739,263,812
431090,201907,424,993,151,477,28,100,40,114,68,214
431100,201907,3166,7247,2243,5975,353,1005,1106,2946,1459,3951
431110,201907,1375,3252,940,2491,257,677,385,988,642,1665
431112,201907,513,1541,421,1350,77,267,218,671,295,938
431113,201907,341,971,297,885,56,178,174,513,230,691
431115,201907,1044,2992,812,2554,122,441,455,1341,577,1782
431120,201907,2290,6609,1585,5116,528,1877,354,1027,882,2904
431123,201907,371,1070,237,773,49,137,120,413,169,550
431125,201907,1032,3102,778,2545,297,957,233,814,530,1771
431127,201907,248,658,56,185,8,25,6,17,14,42
431130,201907,2966,7956,2134,6428,394,1323,1005,2928,1399,4251
431140,201907,4978,11989,2758,7720,363,1072,1149,2863,1512,3935
431142,201907,489,1338,355,1085,50,160,204,624,254,784
431150,201907,999,2744,689,2134,146,481,270,825,416,1306
431160,201907,678,1937,464,1481,87,310,148,457,235,767
431162,201907,523,1287,254,769,22,81,129,361,151,442
431164,201907,195,454,41,126,10,30,5,13,15,43
431170,201907,525,1459,356,1110,100,295,92,275,192,570
431171,201907,626,1545,515,1399,84,211,318,866,402,1077
431173,201907,402,1068,287,881,89,304,103,299,192,603
431175,201907,1057,2608,639,1870,123,369,200,567,323,936
431177,201907,698,2027,529,1737,145,522,261,834,406,1356
431179,201907,350,775,81,244,15,49,16,36,31,85
431180,201907,2281,5926,1378,4129,373,1109,314,938,687,2047
431190,201907,453,1239,232,736,30,89,61,168,91,257
431198,201907,311,959,268,879,103,349,67,245,170,594
431200,201907,372,951,73,222,14,38,4,12,18,50
431205,201907,185,534,88,307,22,84,31,108,53,192
431210,201907,610,1581,486,1398,121,334,235,707,356,1041
431213,201907,248,692,181,560,12,44,90,278,102,322
431215,201907,551,1349,238,731,27,89,100,280,127,369
431217,201907,157,427,101,314,6,23,61,171,67,194
431220,201907,600,1583,339,1050,34,130,181,516,215,646
431225,201907,1525,3727,1153,3088,127,373,752,1993,879,2366
431230,201907,666,1973,483,1517,65,231,274,816,339,1047
431235,201907,155,400,23,76,2,5,5,19,7,24
431237,201907,319,1028,269,905,49,181,140,447,189,628
431238,201907,26,67,20,53,6,14,6,15,12,29
431240,201907,3904,10100,3017,8658,563,1766,1489,4146,2052,5912
431242,201907,287,793,235,692,64,201,107,308,171,509
431244,201907,334,810,157,440,22,81,56,122,78,203
431245,201907,1309,3122,802,2207,103,297,385,1016,488,1313
431247,201907,226,625,113,368,25,90,28,73,53,163
431250,201907,1582,4239,1177,3635,265,831,566,1806,831,2637
431260,201907,226,646,130,447,21,89,44,140,65,229
431261,201907,234,747,188,661,20,80,96,316,116,396
431262,201907,384,1077,172,566,12,39,107,353,119,392
431265,201907,1502,3590,563,1679,68,241,193,484,261,725
431267,201907,267,735,147,444,5,21,99,269,104,290
431270,201907,2618,6126,1390,3976,347,1069,383,1113,730,2182
431275,201907,145,419,76,249,19,62,9,23,28,85
431280,201907,235,645,63,213,7,26,7,15,14,41
431290,201907,302,882,204,657,33,114,49,125,82,239
431295,201907,72,195,25,78,2,5,6,17,8,22
431300,201907,369,931,61,198,5,17,13,36,18,53
431301,201907,298,865,68,234,10,28,5,10,15,38
431303,201907,583,1567,330,1008,29,110,132,371,161,481
431306,201907,2143,5164,1230,3586,200,634,456,1178,656,1812
431308,201907,25,80,22,70,14,47,6,17,20,64
431310,201907,552,1582,367,1148,43,150,169,498,212,648
431320,201907,585,1627,279,938,40,131,50,145,90,276
431330,201907,1675,4044,771,2339,196,649,216,586,412,1235
431333,201907,234,646,113,334,22,61,37,103,59,164
431335,201907,40,113,23,77,6,14,3,4,9,18
431337,201907,2546,6986,1819,5707,411,1463,760,2256,1171,3719
431339,201907,407,1075,297,870,75,219,126,368,201,587
431340,201907,19509,48566,13290,37796,2595,8015,5174,13796,7769,21811
431342,201907,450,1008,325,824,18,51,283,710,301,761
431344,201907,389,1008,222,662,9,32,140,401,149,433
431346,201907,253,630,93,299,14,50,29,93,43,143
431349,201907,663,1746,357,1057,80,242,133,372,213,614
431350,201907,3940,10605,2872,8686,436,1454,1396,4140,1832,5594
431360,201907,573,1389,307,875,74,223,97,271,171,494
431365,201907,1755,4396,1439,3942,137,435,1043,2836,1180,3271
431370,201907,4093,10542,2966,8573,785,2394,1220,3621,2005,6015
431380,201907,753,2128,634,1919,40,144,419,1254,459,1398
431390,201907,2491,6221,1454,4288,202,692,598,1531,800,2223
431395,201907,1220,3204,861,2631,206,657,363,1114,569,1771
431400,201907,342,983,172,560,27,87,38,115,65,202
431402,201907,839,1956,593,1547,75,210,380,951,455,1161
431403,201907,179,499,142,429,22,76,76,189,98,265
431405,201907,4351,11734,3365,10119,631,2154,1607,4533,2238,6687
431406,201907,484,1438,365,1181,91,279,170,560,261,839
431407,201907,462,1278,300,924,61,209,137,411,198,620
431410,201907,15984,41627,10163,30709,1742,6002,4446,12435,6188,18437
431413,201907,230,605,57,182,5,15,6,17,11,32
431415,201907,683,1722,421,1280,74,261,174,471,248,732
431417,201907,554,1268,379,1002,55,158,207,535,262,693
431420,201907,1444,3437,1107,2953,182,511,556,1487,738,1998
431430,201907,530,1385,243,799,35,134,72,202,107,336
431440,201907,26999,65785,19200,53019,3763,11201,6995,18421,10758,29622
431442,201907,114,331,54,187,6,20,8,19,14,39
431445,201907,414,1184,135,470,15,41,13,46,28,87
431446,201907,295,827,201,633,45,157,83,251,128,408
431447,201907,630,1720,403,1228,83,274,147,446,230,720
431449,201907,721,1914,426,1259,76,216,177,508,253,724
431450,201907,2088,4498,1683,3915,97,247,1286,2889,1383,3136
431454,201907,39,116,35,107,6,19,13,40,19,59
431455,201907,588,1432,284,779,34,103,144,354,178,457
431460,201907,2845,7245,2052,5770,557,1635,596,1703,1153,3338
431470,201907,1428,4053,1006,3134,183,584,439,1377,622,1961
431475,201907,253,735,35,143,3,14,5,22,8,36
431477,201907,420,1096,255,755,39,115,104,273,143,388
431478,201907,281,738,60,190,16,45,6,16,22,61
431480,201907,3015,7741,2319,6629,507,1496,1186,3377,1693,4873
431490,201907,102972,251677,81200,217513,6891,21630,58719,151426,65610,173056
431500,201907,487,1276,356,1013,64,173,187,519,251,692
431505,201907,321,785,208,604,18,52,132,386,150,438
431507,201907,341,809,137,396,41,127,41,107,82,234
431510,201907,1527,4070,1047,3099,240,775,392,1144,632,1919
431513,201907,231,538,120,338,11,30,80,227,91,257
431514,201907,94,242,54,164,4,10,34,102,38,112
431515,201907,486,1260,337,977,68,207,167,458,235,665
431517,201907,73,207,57,168,10,28,22,64,32,92
431520,201907,431,1067,160,521,33,122,52,139,85,261
431530,201907,3895,8385,2306,6144,611,1667,452,1183,1063,2850
431531,201907,196,521,120,360,11,36,54,156,65,192
431532,201907,549,1306,331,915,75,224,130,350,205,574
431535,201907,251,671,99,318,21,71,16,41,37,112
431540,201907,1780,5741,1651,5546,62,251,1329,4460,1391,4711
431545,201907,352,930,60,189,9,25,14,41,23,66
431550,201907,1933,5136,1538,4370,263,808,776,2120,1039,2928
431555,201907,679,1581,421,1134,28,90,254,667,282,757
431560,201907,20960,53124,13799,41394,2883,9233,4193,13240,7076,22473
431570,201907,4695,11536,3647,10038,501,1570,2336,6152,2837,7722
431575,201907,236,636,176,518,38,98,39,103,77,201
431580,201907,564,1516,331,1019,45,165,164,471,209,636
431590,201907,654,1802,461,1396,95,289,184,569,279,858
431595,201907,335,940,213,667,43,141,88,254,131,395
431600,201907,1335,3218,967,2685,271,814,341,964,612,1778
431610,201907,1313,3473,884,2637,141,408,451,1372,592,1780
431620,201907,532,1413,222,675,39,127,92,257,131,384
431630,201907,1289,3267,568,1732,112,375,192,525,304,900
431640,201907,5849,14967,5129,13972,602,1714,3627,9924,4229,11638
431642,201907,497,1204,323,871,27,64,179,461,206,525
431643,201907,349,881,148,449,16,43,46,136,62,179
431645,201907,1745,4166,1378,3617,94,306,1040,2670,1134,2976
431647,201907,234,609,103,310,12,43,20,50,32,93
431650,201907,160,454,107,349,15,56,43,124,58,180
431660,201907,884,2429,466,1541,77,294,124,377,201,671
431670,201907,1132,2780,725,2033,110,322,376,1010,486,1332
431673,201907,236,616,84,291,13,40,14,46,27,86
431675,201907,577,1438,120,382,10,38,27,65,37,103
431680,201907,7199,19077,5234,15225,1316,3997,2082,5951,3398,9948
431690,201907,21108,53500,14164,40903,3227,9883,5087,14786,8314,24669
431695,201907,147,384,89,277,14,56,39,94,53,150
431697,201907,463,1118,342,916,57,142,184,510,241,652
431700,201907,1393,3680,1160,3240,159,440,672,1854,831,2294
431710,201907,11394,29132,8345,24583,1781,5541,3696,11257,5477,16798
431720,201907,5726,14974,3484,10376,912,2871,512,1374,1424,4245
431725,201907,24,65,18,52,5,14,5,12,10,26
431730,201907,3644,9183,2316,6927,559,1786,689,2170,1248,3956
431740,201907,4970,12280,3244,9214,953,3060,674,1604,1627,4664
431750,201907,7034,18670,5712,16547,1195,3742,2690,7702,3885,11444
431755,201907,317,871,67,242,9,36,11,41,20,77
431760,201907,5488,12627,3531,9470,355,1153,2085,5174,2440,6327
431770,201907,1776,4359,1406,3855,99,319,1025,2733,1124,3052
431775,201907,205,540,95,295,23,63,15,41,38,104
431780,201907,1911,4872,1231,3586,227,729,479,1339,706,2068
431790,201907,841,2305,603,1819,111,327,260,750,371,1077
431795,201907,229,593,104,316,22,71,31,86,53,157
431800,201907,7354,18924,4913,14771,1416,4757,597,1879,2013,6636
431805,201907,299,707,80,265,6,20,30,93,36,113
431810,201907,3244,7893,2041,5627,374,1107,846,2204,1220,3311
431820,201907,2129,6006,1701,5277,488,1591,585,1876,1073,3467
431830,201907,8660,19573,6371,16295,1602,4651,2125,5435,3727,10086
431840,201907,2426,6655,1990,5900,351,1048,1156,3451,1507,4499
431842,201907,666,1650,219,677,29,103,68,188,97,291
431843,201907,311,845,236,691,31,99,117,317,148,416
431844,201907,230,607,68,226,20,74,20,63,40,137
431845,201907,514,1356,356,1033,27,81,209,598,236,679
431846,201907,278,747,238,689,17,50,197,570,214,620
431848,201907,153,388,82,253,9,31,10,21,19,52
431849,201907,404,975,57,169,4,10,5,15,9,25
431850,201907,3954,10990,3068,9182,729,2342,950,2806,1679,5148
431860,201907,677,1719,391,1136,70,213,196,536,266,749
431861,201907,103,272,46,139,10,31,13,30,23,61
431862,201907,432,1370,349,1224,77,300,171,580,248,880
431870,201907,17068,45695,13817,40188,2046,6632,7764,21705,9810,28337
431880,201907,3959,10402,2789,8270,495,1671,1193,3373,1688,5044
431890,201907,4082,10695,2508,7487,778,2516,374,1195,1152,3711
431900,201907,1003,2603,623,1851,102,349,303,835,405,1184
431910,201907,777,1900,266,771,52,152,72,168,124,320
431912,201907,454,1306,357,1123,68,232,209,645,277,877
431915,201907,984,2566,788,2224,37,120,576,1585,613,1705
431920,201907,1105,2791,934,2535,39,124,784,2093,823,2217
431930,201907,672,1859,466,1478,123,354,222,732,345,1086
431935,201907,84,245,49,168,16,51,7,28,23,79
431936,201907,292,873,158,529,32,113,56,182,88,295
431937,201907,183,464,113,309,23,77,45,97,68,174
431940,201907,2813,6804,1605,4549,203,664,777,2085,980,2749
431950,201907,1753,4810,1447,4308,446,1347,575,1714,1021,3061
431960,201907,2764,7000,2021,5615,583,1671,533,1472,1116,3143
431970,201907,436,1131,155,485,36,109,36,100,72,209
431971,201907,58,149,32,102,4,16,5,10,9,26
431973,201907,459,1493,371,1317,42,153,266,948,308,1101
431975,201907,102,214,18,60,3,10,5,14,8,24
431980,201907,1062,2842,801,2382,182,577,350,991,532,1568
431990,201907,5733,14213,3753,11175,605,2052,1595,4523,2200,6575
432000,201907,10416,25995,7572,21412,1896,5476,3206,9142,5102,14618
432010,201907,1939,5094,1450,4160,215,677,807,2194,1022,2871
432020,201907,1748,4365,1174,3339,248,746,543,1447,791,2193
432023,201907,516,1262,264,753,48,154,122,310,170,464
432026,201907,1035,2914,733,2316,181,563,272,852,453,1415
432030,201907,334,877,185,568,28,84,93,288,121,372
432032,201907,388,1025,260,776,30,101,133,362,163,463
432035,201907,666,1904,585,1762,203,628,203,631,406,1259
432040,201907,1123,2601,382,1203,67,241,115,319,182,560
432045,201907,182,501,107,345,25,82,42,140,67,222
432050,201907,478,1272,359,1052,88,255,137,410,225,665
432055,201907,666,1782,414,1279,139,464,98,273,237,737
432057,201907,242,636,172,468,29,71,79,197,108,268
432060,201907,473,1136,144,456,30,107,45,119,75,226
432065,201907,220,622,150,464,29,82,54,161,83,243
432067,201907,728,2155,617,1891,61,198,414,1226,475,1424
432070,201907,1740,4654,1091,3349,238,828,304,823,542,1651
432080,201907,4057,10247,3109,8614,606,1932,1387,3657,1993,5589
432085,201907,379,975,255,779,81,245,91,293,172,538
432090,201907,1302,3438,919,2713,189,604,425,1184,614,1788
432100,201907,988,2643,437,1425,89,307,57,133,146,440
432110,201907,2107,5807,1403,4475,347,1264,106,323,453,1587
432120,201907,2676,7592,2151,6635,534,1796,671,1998,1205,3794
432130,201907,2434,6499,2058,5951,673,1998,818,2422,1491,4420
432132,201907,181,519,107,357,21,72,43,121,64,193
432135,201907,979,2412,629,1767,50,180,434,1183,484,1363
432140,201907,1547,4755,1152,3946,182,671,657,2249,839,2920
432143,201907,1346,3653,1063,3198,80,261,694,2071,774,2332
432145,201907,1356,3696,774,2413,126,426,217,570,343,996
432146,201907,111,320,68,238,20,77,17,50,37,127
432147,201907,491,1464,297,1015,93,341,62,182,155,523
432149,201907,427,1091,210,635,16,46,101,293,117,339
432150,201907,2858,7649,2106,6233,490,1641,693,1970,1183,3611
432160,201907,4898,13567,3681,11497,1009,3413,1199,3627,2208,7040
432162,201907,267,603,36,110,6,18,5,14,11,32
432163,201907,135,347,26,74,0,0,3,6,3,6
432166,201907,554,1599,416,1297,72,240,154,432,226,672
432170,201907,1308,3632,824,2691,167,601,258,787,425,1388
432180,201907,2579,6489,1354,4051,252,807,432,1143,684,1950
432183,201907,353,1022,221,709,54,202,72,215,126,417
432185,201907,790,2073,461,1410,33,108,246,714,279,822
432190,201907,1787,4492,1109,3286,241,801,467,1291,708,2092
432195,201907,951,2385,592,1731,162,449,216,654,378,1103
432200,201907,3090,8274,2164,6662,423,1314,1045,3290,1468,4604
432210,201907,356,970,215,684,40,151,96,271,136,422
432215,201907,635,1864,568,1760,47,138,409,1273,456,1411
432218,201907,255,642,114,323,19,58,50,127,69,185
432220,201907,3635,8807,2680,7255,451,1324,1472,3863,1923,5187
432225,201907,92,276,69,224,16,54,31,101,47,155
432230,201907,724,1786,391,1139,54,153,160,438,214,591
432232,201907,490,1223,301,886,73,241,108,300,181,541
432234,201907,287,754,122,368,25,63,15,42,40,105
432235,201907,82,232,28,90,7,21,7,26,14,47
432237,201907,357,916,306,826,17,45,230,596,247,641
432240,201907,13945,37135,10523,32161,850,2986,6584,20834,7434,23820
432250,201907,4389,13589,3640,12107,1079,3647,1331,4507,2410,8154
432252,201907,449,1118,269,770,40,124,125,340,165,464
432253,201907,1011,3136,584,2020,155,581,28,86,183,667
432254,201907,834,2063,166,547,33,111,16,41,49,152
432255,201907,122,307,60,184,7,24,26,67,33,91
432260,201907,4717,12353,3420,9867,947,2843,984,2802,1931,5645
432270,201907,1885,5445,1505,4664,459,1503,266,794,725,2297
432280,201907,1094,2857,604,1853,108,362,230,612,338,974
432285,201907,189,582,24,86,0,0,2,5,2,5
432290,201907,347,1010,178,595,61,206,30,67,91,273
432300,201907,25224,66488,19114,56219,2900,9496,10963,31128,13863,40624
432310,201907,746,2089,538,1696,60,193,347,1103,407,1296
432320,201907,207,486,65,190,9,33,24,60,33,93
432330,201907,218,551,73,232,8,20,17,49,25,69
432335,201907,188,534,58,208,6,23,12,37,18,60
432340,201907,318,770,129,411,19,67,36,101,55,168
432345,201907,596,1418,527,1332,19,49,413,1035,432,1084
432350,201907,335,895,167,548,27,93,59,188,86,281
432360,201907,224,657,43,141,4,15,16,46,20,61
432370,201907,313,794,203,598,17,50,131,377,148,427
432375,201907,498,1270,371,1023,65,161,190,528,255,689
432377,201907,201,641,35,133,5,20,3,6,8,26
432380,201907,1514,4214,966,3134,198,720,433,1343,631,2063
500020,201907,2343,6244,1629,4986,244,839,863,2560,1107,3399
500025,201907,1220,2910,748,2069,71,212,415,1095,486,1307
500060,201907,6570,18686,4781,15485,662,2210,2801,9454,3463,11664
500070,201907,4005,10598,2804,8539,541,1697,1237,3853,1778,5550
500080,201907,1344,3493,893,2683,173,583,373,1013,546,1596
500085,201907,2013,5037,1333,3919,313,987,637,1787,950,2774
500090,201907,1889,5157,1279,4062,243,810,492,1609,735,2419
500100,201907,3471,9032,2617,7593,464,1478,1212,3334,1676,4812
500110,201907,7461,19917,4710,15300,1089,3891,1334,4992,2423,8883
500124,201907,1976,6002,1598,5321,284,895,862,3023,1146,3918
500150,201907,1246,2895,752,2133,177,527,236,633,413,1160
500190,201907,4169,10341,2850,8272,713,2117,873,2536,1586,4653
500200,201907,2152,5174,1551,4156,204,566,901,2320,1105,2886
500210,201907,4450,11601,3290,9967,866,2680,1399,4318,2265,6998
500215,201907,1327,3819,931,3049,93,342,478,1568,571,1910
500220,201907,2539,7240,1707,5698,292,1049,536,1755,828,2804
500230,201907,2109,5073,1575,4275,209,547,995,2658,1204,3205
500240,201907,3489,10625,2409,8308,385,1455,888,3150,1273,4605
500260,201907,3067,6680,1863,4988,247,674,947,2437,1194,3111
500270,201907,133761,321198,76956,220911,14229,44379,26145,70640,40374,115019
500280,201907,1225,3152,831,2515,106,346,487,1437,593,1783
500290,201907,3594,8409,1957,5763,350,1154,654,1773,1004,2927
500295,201907,3099,7728,1805,5295,307,1003,670,1714,977,2717
500310,201907,894,1949,609,1582,106,230,314,851,420,1081
500315,201907,3353,9827,2704,8771,276,912,1842,6145,2118,7057
500320,201907,17584,49982,12342,40972,3268,11437,4074,14306,7342,25743
500325,201907,4181,9625,2835,7711,272,785,1765,4805,2037,5590
500330,201907,6681,15522,4247,11790,341,1070,2364,6656,2705,7726
500345,201907,2008,4968,1279,3787,329,1002,414,1193,743,2195
500348,201907,2467,6373,1860,5341,260,761,1048,3093,1308,3854
500350,201907,1262,3462,658,2108,73,241,267,845,340,1086
500370,201907,23439,62292,15973,49583,2454,8601,7713,23830,10167,32431
500375,201907,2405,6499,1613,4832,335,1086,533,1518,868,2604
500380,201907,3450,8779,2345,6877,671,2078,673,1993,1344,4071
500390,201907,501,1093,301,824,52,163,163,442,215,605
500400,201907,1243,3311,804,2433,153,517,275,763,428,1280
500410,201907,2325,5947,1664,4924,203,591,950,2882,1153,3473
500430,201907,2558,6572,1721,5256,261,910,673,2162,934,3072
500440,201907,1130,2786,685,2055,106,328,249,801,355,1129
500450,201907,1350,3467,737,2280,154,503,141,419,295,922
500460,201907,3560,9775,2148,6972,411,1495,657,2161,1068,3656
500470,201907,2394,6594,1459,4640,448,1552,273,734,721,2286
500480,201907,2151,6412,1836,5924,175,600,1241,4189,1416,4789
500490,201907,977,2323,549,1669,138,498,150,444,288,942
500500,201907,4195,11502,2694,9000,958,3692,507,1712,1465,5404
500510,201907,705,1811,444,1299,31,104,259,734,290,838
500515,201907,1831,4601,1409,3946,147,421,910,2505,1057,2926
500520,201907,2967,9861,2374,8660,669,2514,958,3600,1627,6114
500525,201907,854,2579,698,2331,70,264,425,1437,495,1701
500540,201907,4293,11364,2563,8268,730,2859,237,661,967,3520
500560,201907,5107,14794,4196,13532,320,1151,3179,10349,3499,11500
500568,201907,4305,9564,2538,6934,614,1842,810,2180,1424,4022
500570,201907,7390,17694,4225,12111,868,2715,1223,3267,2091,5982
500580,201907,3029,8222,2256,6875,475,1545,1089,3274,1564,4819
500600,201907,3063,7798,2142,6385,436,1311,913,2803,1349,4114
500620,201907,7345,19980,4886,15158,1117,3625,1662,5041,2779,8666
500625,201907,468,1286,257,812,47,164,94,259,141,423
500627,201907,724,1887,426,1321,62,197,138,427,200,624
500630,201907,6207,14890,3554,10324,757,2372,1067,3126,1824,5498
500635,201907,2802,9067,2172,8199,165,677,1532,6211,1697,6888
500640,201907,1647,3733,1093,2954,37,127,739,1922,776,2049
500660,201907,16236,44855,11326,37080,3874,14075,2656,8805,6530,22880
500690,201907,2116,5909,1454,4861,587,2237,93,211,680,2448
500710,201907,2863,7993,2182,6739,642,2084,644,1869,1286,3953
500720,201907,4918,12719,3078,9612,717,2410,814,2582,1531,4992
500730,201907,908,2367,557,1719,77,211,205,647,282,858
500740,201907,4561,11046,3137,8692,367,1081,1729,4806,2096,5887
500750,201907,959,2498,633,1906,97,305,230,610,327,915
500755,201907,880,2406,491,1637,100,352,74,221,174,573
500769,201907,4866,12285,2498,7566,485,1652,371,858,856,2510
500770,201907,1459,4032,912,3000,170,625,280,927,450,1552
500780,201907,1239,3095,793,2319,178,564,209,575,387,1139
500790,201907,7458,19818,5842,17162,1111,3549,3097,9113,4208,12662
500793,201907,1848,4806,1241,3732,395,1250,282,745,677,1995
500795,201907,2460,6459,2026,5885,102,293,1709,5088,1811,5381
500797,201907,696,1826,461,1384,120,368,162,477,282,845
500800,201907,2818,6714,1790,5181,597,1992,244,772,841,2764
500830,201907,17597,45017,11830,34299,2285,7179,4725,12892,7010,20071
500840,201907,1388,3488,789,2303,96,298,321,886,417,1184
510010,201907,1851,4317,1212,3434,131,379,793,2255,924,2634
510020,201907,3590,9306,1834,5657,411,1334,366,999,777,2333
510025,201907,6747,17271,4126,12651,686,2333,1501,4395,2187,6728
510030,201907,2241,5128,1470,4012,343,923,529,1481,872,2404
510035,201907,1187,3101,716,2334,91,323,418,1430,509,1753
510040,201907,2176,5043,1571,4216,163,428,978,2685,1141,3113
510050,201907,1962,4487,1297,3538,188,586,811,2104,999,2690
510060,201907,1366,3523,994,2921,188,600,319,892,507,1492
510080,201907,1190,3213,778,2480,237,801,227,632,464,1433
510100,201907,664,1604,443,1228,54,153,227,600,281,753
510120,201907,260,489,144,349,5,16,109,270,114,286
510125,201907,2119,5378,1650,4666,208,773,785,2037,993,2810
510130,201907,1429,3653,993,2943,210,698,303,905,513,1603
510140,201907,2885,7763,1999,6604,757,2918,652,1954,1409,4872
510160,201907,1684,4416,1214,3787,198,607,825,2601,1023,3208
510170,201907,4557,12379,3326,10339,802,2562,1319,4188,2121,6750
510180,201907,13452,31848,8076,23347,1924,6025,2318,7584,4242,13609
510185,201907,1659,4438,1079,3591,429,1432,299,1232,728,2664
510190,201907,1988,5759,1303,4528,380,1455,250,912,630,2367
510250,201907,14356,38237,11536,34232,2253,6919,6301,19393,8554,26312
510260,201907,2035,8385,1644,7655,276,1384,959,4894,1235,6278
510263,201907,2927,8399,1762,5939,314,1156,207,617,521,1773
510267,201907,4686,13666,2773,9378,613,2184,313,1007,926,3191
510268,201907,1286,3241,916,2620,113,320,548,1529,661,1849
510269,201907,1036,2880,636,2095,170,603,195,596,365,1199
510270,201907,2865,8454,1983,6802,372,1393,757,2546,1129,3939
510279,201907,1756,4707,1146,3620,226,796,484,1443,710,2239
510285,201907,1079,2959,748,2387,222,794,167,484,389,1278
510300,201907,3613,9297,2663,7981,417,1233,1528,4839,1945,6072
510305,201907,1470,4137,880,2953,183,643,223,811,406,1454
510310,201907,928,2378,640,1886,187,575,180,543,367,1118
510320,201907,3651,9468,2548,7519,571,1811,660,1986,1231,3797
510325,201907,4378,13185,3372,11425,960,3385,1208,4207,2168,7592
510330,201907,2824,8694,1892,6987,379,1418,672,2835,1051,4253
510335,201907,4554,13268,3394,11506,510,1854,1865,6533,2375,8387
510336,201907,470,1390,341,1178,69,224,152,568,221,792
510337,201907,1612,4873,1072,3858,431,1680,178,654,609,2334
510340,201907,87454,198907,52279,145752,13768,44944,13870,35609,27638,80553
510343,201907,1033,2884,704,2226,127,447,281,853,408,1300
510345,201907,1239,3613,903,2946,170,566,380,1197,550,1763
510350,201907,2804,7506,1784,5726,407,1354,670,2114,1077,3468
510360,201907,1846,3949,1161,3123,65,166,830,2343,895,2509
510370,201907,1691,5063,1207,4150,183,684,676,2354,859,3038
510380,201907,544,1381,286,901,66,239,84,248,150,487
510385,201907,1169,3983,834,3332,94,410,509,2124,603,2534
510390,201907,1111,3221,786,2755,210,720,343,1313,553,2033
510395,201907,720,1638,473,1268,31,95,269,773,300,868
510410,201907,4527,13029,3338,10793,663,2229,1766,5868,2429,8097
510420,201907,2187,4835,1493,3880,126,371,937,2404,1063,2775
510450,201907,500,1242,281,819,68,196,44,152,112,348
510452,201907,687,1953,459,1514,78,260,215,710,293,970
510454,201907,899,2552,677,2150,72,204,417,1413,489,1617
510455,201907,892,2559,626,1985,101,387,233,673,334,1060
510460,201907,1823,4595,1287,3783,115,403,811,2265,926,2668
510480,201907,4648,11611,3024,8409,613,1879,1118,2943,1731,4822
510490,201907,1652,4498,1225,3920,215,713,699,2258,914,2971
510500,201907,1559,4005,932,2923,181,609,318,985,499,1594
510510,201907,3307,10001,2462,8367,691,2606,692,2480,1383,5086
510515,201907,5306,14183,3394,10507,795,2735,841,2318,1636,5053
510517,201907,1077,3176,812,2697,246,915,142,398,388,1313
510520,201907,2058,4243,1186,3167,71,195,640,1818,711,2013
510523,201907,1005,2652,733,2176,153,440,391,1174,544,1614
510525,201907,6145,17401,4529,14141,771,2710,1998,5837,2769,8547
510530,201907,540,1403,392,1189,36,121,236,687,272,808
510550,201907,2542,7620,1832,6327,457,1644,727,2529,1184,4173
510558,201907,2077,5644,1492,4707,162,491,744,2511,906,3002
510560,201907,1605,4684,935,3335,210,819,237,889,447,1708
510562,201907,5129,13904,3629,11059,967,3205,1095,3386,2062,6591
510590,201907,3083,7809,2216,6687,220,700,1514,4618,1734,5318
510600,201907,1500,3488,938,2599,186,517,374,1031,560,1548
510610,201907,2772,6785,1867,5510,188,639,1126,3312,1314,3951
510615,201907,2451,6424,1609,4970,297,931,830,2629,1127,3560
510617,201907,944,2784,684,2344,116,446,386,1377,502,1823
510618,201907,1228,3355,839,2649,171,592,406,1243,577,1835
510619,201907,713,1847,424,1313,73,243,88,256,161,499
510620,201907,1404,3228,633,1997,161,589,38,87,199,676
510621,201907,1463,4008,890,2904,209,752,258,788,467,1540
510622,201907,4250,12246,2911,9238,1047,3564,422,1207,1469,4771
510623,201907,2648,6820,1822,5463,435,1548,460,1309,895,2857
510624,201907,1643,4267,701,2399,90,324,157,464,247,788
510625,201907,2682,6615,1438,4370,289,1006,308,908,597,1914
510626,201907,1494,3650,903,2706,267,915,205,608,472,1523
510627,201907,592,1566,335,1048,89,290,78,260,167,550
510628,201907,1532,3557,990,2821,195,585,423,1202,618,1787
510629,201907,1571,4638,1159,3834,268,960,394,1293,662,2253
510630,201907,3211,9189,1854,6483,431,1625,312,1170,743,2795
510631,201907,556,1360,399,1130,15,42,307,881,322,923
510637,201907,3320,8252,2362,6758,649,2066,624,1743,1273,3809
510642,201907,5186,15495,4074,13758,1093,3902,1606,5665,2699,9567
510645,201907,832,1799,484,1321,108,306,207,527,315,833
510650,201907,6857,18230,5508,16744,670,1892,3853,12660,4523,14552
510665,201907,1793,4099,1041,2871,155,454,428,1222,583,1676
510670,201907,411,873,229,601,25,74,128,336,153,410
510675,201907,5744,16356,3981,12977,1214,4250,659,2137,1873,6387
510677,201907,2109,5509,1431,4477,204,690,718,2220,922,2910
510680,201907,673,1813,390,1258,85,296,70,215,155,511
510682,201907,1592,4847,1161,4077,377,1460,239,820,616,2280
510685,201907,614,1817,450,1481,67,234,206,663,273,897
510700,201907,3790,9542,2671,7885,341,1133,1788,5224,2129,6357
510704,201907,10169,24639,6589,18309,1321,3965,1861,4912,3182,8877
510706,201907,1882,5708,1327,4808,244,908,701,2753,945,3661
510710,201907,2561,6701,1702,5031,374,1161,592,1660,966,2821
510715,201907,607,1395,450,1175,47,134,206,547,253,681
510718,201907,2425,5369,1345,4015,508,1528,321,1225,829,2753
510719,201907,421,897,251,674,33,86,143,368,176,454
510720,201907,950,2334,619,1815,124,395,243,678,367,1073
510724,201907,735,2026,485,1565,82,292,222,688,304,980
510726,201907,1146,2103,574,1379,66,171,285,676,351,847
510729,201907,618,1493,274,845,40,139,66,211,106,350
510730,201907,2917,7232,1949,5686,328,1054,841,2406,1169,3460
510735,201907,1028,3025,765,2635,81,328,542,1855,623,2183
510740,201907,879,2199,539,1542,82,242,254,717,336,959
510757,201907,550,1761,443,1581,149,572,143,485,292,1057
510760,201907,41257,92075,23688,64798,5281,16619,7103,17638,12384,34257
510770,201907,4211,9674,2920,8079,280,729,1933,5616,2213,6345
510774,201907,349,954,236,736,38,120,115,372,153,492
510775,201907,601,1664,418,1362,96,356,90,270,186,626
510776,201907,456,1177,311,878,89,263,92,274,181,537
510777,201907,1570,4251,1122,3645,150,592,710,2247,860,2839
510779,201907,587,1622,448,1396,51,148,264,875,315,1023
510780,201907,3637,9696,2661,8233,636,1970,1123,3875,1759,5845
510785,201907,2068,5524,1147,3778,296,1038,176,654,472,1692
510787,201907,2545,7386,1654,5465,631,2229,130,388,761,2617
510788,201907,659,1585,448,1256,71,188,179,587,250,775
510790,201907,16418,43546,9639,30346,2126,7468,1435,3897,3561,11365
510792,201907,8557,23313,5276,16987,1120,4022,1022,3030,2142,7052
510794,201907,1226,3353,797,2590,248,893,170,472,418,1365
510795,201907,7873,21367,5149,16346,1236,4282,1283,4108,2519,8390
510800,201907,1752,4615,1110,3471,385,1216,137,377,522,1593
510805,201907,1589,4418,1047,3374,235,825,320,910,555,1735
510810,201907,647,1371,409,1031,107,291,171,426,278,717
510820,201907,775,1505,418,1048,35,109,198,502,233,611
510830,201907,831,2078,586,1737,65,190,392,1212,457,1402
510835,201907,562,1418,369,1131,49,166,199,595,248,761
510840,201907,48546,108061,33907,89615,6281,15838,17675,50648,23956,66486
510850,201907,1880,4579,1034,3193,321,1101,111,281,432,1382
510860,201907,2452,6648,1550,5103,484,1853,148,484,632,2337
510880,201907,653,1927,493,1610,123,419,198,659,321,1078
510885,201907,561,1425,384,1152,68,240,122,349,190,589
510890,201907,640,1898,483,1628,114,410,214,720,328,1130
510895,201907,1228,3225,818,2534,198,715,315,875,513,1590
520005,201907,2246,5999,1769,5410,474,1417,799,2763,1273,4180
520010,201907,2177,6444,1563,5175,406,1473,403,1157,809,2630
520013,201907,2677,7115,1834,5528,425,1318,493,1602,918,2920
520015,201907,533,1352,396,1161,97,309,130,398,227,707
520017,201907,1091,2902,826,2490,113,362,510,1500,623,1862
520020,201907,385,898,295,776,35,121,197,486,232,607
520025,201907,32581,92294,28200,86082,2848,9383,20216,61392,23064,70775
520030,201907,5268,14024,4240,12535,402,1310,2815,8265,3217,9575
520050,201907,405,958,260,700,15,37,155,436,170,473
520055,201907,1425,3692,980,2815,64,189,552,1532,616,1721
520060,201907,1405,4040,1043,3351,280,972,251,811,531,1783
520080,201907,1851,4806,1379,4154,250,777,627,2066,877,2843
520082,201907,888,2289,713,1989,77,199,402,1165,479,1364
520085,201907,788,2199,609,1894,115,378,264,776,379,1154
520090,201907,852,1684,579,1379,68,126,432,1081,500,1207
520110,201907,38256,105589,26778,86361,8779,31803,1999,5841,10778,37644
520120,201907,201,495,114,347,14,49,39,117,53,166
520130,201907,3665,9250,2895,7994,557,1595,1259,3502,1816,5097
520140,201907,39061,108466,27933,89020,10373,35561,3349,11132,13722,46693
520145,201907,540,1282,363,1016,72,221,178,454,250,675
520150,201907,571,1339,413,1126,64,169,226,637,290,806
520160,201907,810,1875,573,1506,100,250,274,744,374,994
520170,201907,5021,10316,3418,8451,208,575,2612,6326,2820,6901
520180,201907,2025,5682,1665,5124,364,1219,812,2457,1176,3676
520215,201907,1861,4495,1318,3634,317,947,494,1315,811,2262
520235,201907,602,1439,367,1073,39,124,144,404,183,528
520250,201907,1523,4002,1103,3319,357,1191,210,639,567,1830
520260,201907,825,1944,498,1382,100,286,196,542,296,828
520280,201907,679,1754,514,1476,120,354,228,688,348,1042
520310,201907,1167,2626,747,1995,170,490,286,805,456,1295
520320,201907,1682,4642,1292,3990,150,517,675,2046,825,2563
520330,201907,3721,10421,2711,8707,458,1762,1284,3977,1742,5739
520340,201907,2297,5204,1450,4009,181,470,843,2421,1024,2891
520350,201907,2921,7177,2102,5875,624,1857,776,2134,1400,3991
520355,201907,1788,5000,1303,4034,356,1179,404,1166,760,2345
520357,201907,755,1912,579,1632,43,124,410,1171,453,1295
520360,201907,704,1876,524,1566,162,506,143,467,305,973
520380,201907,1281,3262,766,2290,77,255,380,1051,457,1306
520390,201907,993,2219,576,1688,174,554,166,517,340,1071
520393,201907,534,1291,357,1010,50,169,166,419,216,588
520396,201907,786,2133,660,1912,59,199,438,1216,497,1415
520400,201907,1613,4076,1251,3575,198,610,795,2277,993,2887
520410,201907,1862,4141,1091,2983,171,500,492,1292,663,1792
520420,201907,384,905,290,733,29,81,206,486,235,567
520425,201907,1451,3569,900,2593,232,692,276,774,508,1466
520430,201907,2213,5153,1199,3570,224,785,40,105,264,890
520440,201907,2994,7298,1832,5252,451,1393,474,1313,925,2706
520450,201907,11755,28883,7736,22482,2477,7813,1069,3185,3546,10998
520455,201907,656,1829,474,1543,131,455,129,421,260,876
520460,201907,905,2278,760,2079,100,236,569,1599,669,1835
520465,201907,796,2074,632,1831,98,312,409,1140,507,1452
520470,201907,1933,5362,1585,4906,391,1194,779,2587,1170,3781
520480,201907,906,2562,607,2042,192,655,128,465,320,1120
520485,201907,1538,4358,1291,4009,199,625,845,2604,1044,3229
520490,201907,3960,11082,2961,9506,901,2913,1198,4000,2099,6913
520495,201907,1515,3387,1147,2893,56,161,900,2253,956,2414
520500,201907,1350,3593,928,2789,213,699,339,1013,552,1712
520505,201907,721,1706,503,1411,75,211,282,776,357,987
520510,201907,7472,19236,4951,15222,1183,4062,1304,4293,2487,8355
520520,201907,1126,2930,840,2470,197,599,271,811,468,1410
520530,201907,2004,5994,1485,5078,490,1746,423,1610,913,3356
520540,201907,2855,7725,1735,5397,342,1120,373,1108,715,2228
520545,201907,908,2459,697,2113,141,410,261,805,402,1215
520547,201907,772,2160,614,1875,162,515,269,811,431,1326
520549,201907,12390,34502,10198,31051,1625,5254,6359,19219,7984,24473
520551,201907,4361,12132,3678,11127,418,1511,2539,7459,2957,8970
520552,201907,835,2182,694,2004,130,373,424,1291,554,1664
520570,201907,560,1307,374,1039,98,253,130,389,228,642
520580,201907,2247,5251,1701,4593,131,409,1193,3186,1324,3595
520590,201907,1209,3221,842,2566,236,735,172,526,408,1261
520620,201907,8125,22392,6419,19860,1658,5240,2824,9006,4482,14246
520630,201907,754,1967,472,1461,83,262,108,341,191,603
520640,201907,2446,6094,1856,5072,471,1283,728,2069,1199,3352
520650,201907,882,2137,624,1740,107,300,298,881,405,1181
520660,201907,522,1272,250,765,50,171,58,179,108,350
520670,201907,925,2585,781,2377,70,231,514,1507,584,1738
520680,201907,703,1760,514,1462,94,261,250,723,344,984
520690,201907,349,821,237,666,77,208,70,217,147,425
520710,201907,473,1126,304,836,9,25,204,540,213,565
520725,201907,1566,3762,1093,2987,131,390,674,1765,805,2155
520735,201907,713,1791,483,1412,109,301,175,550,284,851
520740,201907,2001,4668,1525,4066,275,702,837,2343,1112,3045
520750,201907,655,1638,465,1330,87,247,213,620,300,867
520753,201907,1342,3579,1037,3002,191,585,441,1206,632,1791
520760,201907,1135,2527,1020,2378,58,110,876,2106,934,2216
520780,201907,1503,3621,1091,3036,122,358,540,1453,662,1811
520790,201907,3346,7960,2314,6340,259,723,1326,3841,1585,4564
520800,201907,15125,40054,11964,35448,2140,6507,6848,20927,8988,27434
520810,201907,1306,2768,927,2330,163,449,549,1428,712,1877
520815,201907,601,1799,434,1458,87,300,109,381,196,681
520830,201907,1854,4034,1290,3384,53,142,1014,2601,1067,2743
520840,201907,2360,6490,1916,5914,815,2666,528,1754,1343,4420
520850,201907,683,1833,481,1512,173,615,102,323,275,938
520860,201907,6106,16908,4613,14468,1149,3890,1730,5387,2879,9277
520870,201907,95292,227018,64629,181134,16261,49331,20883,56979,37144,106310
520880,201907,6343,18391,4943,15934,1254,4209,1697,5510,2951,9719
520890,201907,3788,9468,2588,7570,546,1714,1085,3161,1631,4875
520910,201907,4478,11492,2834,8563,718,2351,562,1703,1280,4054
520915,201907,629,1750,396,1251,69,238,115,346,184,584
520920,201907,4505,10436,3038,8435,396,1145,1623,4569,2019,5714
520929,201907,725,1753,506,1386,80,195,246,723,326,918
520940,201907,991,2675,777,2366,48,174,571,1685,619,1859
520945,201907,485,1106,389,957,29,66,272,653,301,719
520960,201907,1027,2646,801,2261,111,324,505,1379,616,1703
520970,201907,2456,6984,1980,6188,529,1814,488,1612,1017,3426
520980,201907,789,1967,578,1660,118,365,225,606,343,971
520990,201907,2977,8233,2403,7448,332,1038,1532,4801,1864,5839
520993,201907,1073,2565,717,1982,84,269,424,1114,508,1383
520995,201907,2251,5802,1700,5038,285,857,678,2054,963,2911
521000,201907,8313,22181,5677,17492,1285,4122,1614,4935,2899,9057
521010,201907,3733,9751,2783,8101,306,904,1579,4542,1885,5446
521015,201907,720,1833,525,1486,54,168,323,870,377,1038
521020,201907,2991,7813,1783,5451,533,1716,160,518,693,2234
521030,201907,472,1030,324,826,44,91,151,425,195,516
521040,201907,7581,18550,5596,15441,1194,3424,2359,6641,3553,10065
521056,201907,887,2400,693,2114,212,653,205,683,417,1336
521060,201907,975,2576,727,2147,59,180,367,1086,426,1266
521080,201907,1116,2493,572,1609,78,235,223,549,301,784
521090,201907,3342,8915,2261,6869,626,2007,287,913,913,2920
521100,201907,1747,4131,1249,3420,207,562,703,1947,910,2509
521120,201907,4725,11124,3308,9328,254,660,1635,5273,1889,5933
521130,201907,923,2137,563,1536,28,99,301,846,329,945
521140,201907,1228,3231,888,2630,149,471,391,1136,540,1607
521150,201907,12223,27362,7676,20914,1440,4479,3437,9467,4877,13946
521160,201907,642,1393,449,1093,54,130,274,639,328,769
521170,201907,1052,2497,752,2021,72,199,501,1317,573,1516
521180,201907,6810,19538,5649,17453,1050,3522,2683,7985,3733,11507
521190,201907,10427,26865,5946,18905,1496,5026,1170,3906,2666,8932
521200,201907,725,1813,492,1407,51,147,272,770,323,917
521205,201907,605,1534,454,1287,16,40,328,899,344,939
521210,201907,709,1817,408,1213,101,328,66,153,167,481
521220,201907,3848,9615,2482,7349,548,1798,660,1822,1208,3620
521225,201907,336,748,255,654,36,94,163,409,199,503
521230,201907,1285,3479,1170,3324,419,1197,563,1691,982,2888
521250,201907,30216,83450,23774,74018,8984,29201,7059,23374,16043,52575
521260,201907,581,1367,420,1103,66,178,232,595,298,773
521270,201907,1814,4632,1562,4322,92,228,1189,3314,1281,3542
521280,201907,1866,5089,1389,4268,358,1181,521,1614,879,2795
521290,201907,469,1157,326,963,49,168,182,520,231,688
521295,201907,1073,2362,835,2099,76,176,635,1679,711,1855
521300,201907,1905,4783,1506,4239,296,786,903,2613,1199,3399
521305,201907,715,1770,487,1406,62,168,274,794,336,962
521308,201907,4713,12855,3363,10227,387,1191,1852,5521,2239,6712
521310,201907,8299,21618,5560,16808,1302,4240,1999,5796,3301,10036
521340,201907,416,962,291,776,20,58,206,533,226,591
521350,201907,2043,5280,1553,4521,161,542,1033,2889,1194,3431
521370,201907,1191,3130,727,2313,200,726,99,331,299,1057
521375,201907,1362,3443,949,2839,225,670,305,976,530,1646
521377,201907,1463,3168,1062,2668,79,157,860,2241,939,2398
521380,201907,5996,16204,3929,12274,426,1495,951,3140,1377,4635
521385,201907,635,1552,491,1370,71,192,271,816,342,1008
521390,201907,691,1735,490,1424,150,473,171,517,321,990
521400,201907,2534,5872,1961,5175,221,577,1385,3779,1606,4356
521405,201907,1290,3343,955,2783,192,561,424,1235,616,1796
521410,201907,761,2073,604,1812,118,342,300,966,418,1308
521440,201907,1300,3399,942,2825,288,939,250,737,538,1676
521450,201907,3887,11780,2869,9722,723,2479,765,2732,1488,5211
521460,201907,5751,15531,4150,12639,1483,4701,870,2672,2353,7373
521470,201907,658,1816,400,1261,59,182,122,369,181,551
521480,201907,347,880,197,584,36,110,50,129,86,239
521483,201907,2450,5974,1688,4753,408,1223,592,1614,1000,2837
521486,201907,1699,4058,1274,3457,78,227,947,2537,1025,2764
521487,201907,446,1109,317,917,59,174,141,421,200,595
521490,201907,864,2351,633,1963,42,163,450,1351,492,1514
521500,201907,2057,5235,1500,4298,89,318,1055,2944,1144,3262
521520,201907,749,1733,514,1384,89,248,209,567,298,815
521523,201907,11273,36122,9562,33241,2717,10204,2503,8936,5220,19140
521525,201907,1060,2464,778,2060,77,213,549,1441,626,1654
521530,201907,2299,6000,1315,3954,289,934,318,987,607,1921
521540,201907,854,2180,551,1653,78,279,238,742,316,1021
521550,201907,1272,3289,756,2253,147,484,213,667,360,1151
521560,201907,4295,11681,2976,9881,535,2074,1474,5076,2009,7150
521565,201907,621,1547,487,1351,82,220,295,802,377,1022
521570,201907,3683,9899,2424,7499,487,1714,280,914,767,2628
521580,201907,525,1299,298,887,41,135,77,190,118,325
521590,201907,623,1530,465,1290,102,306,236,629,338,935
521600,201907,389,1071,239,751,41,107,74,234,115,341
521630,201907,1669,3762,1002,2715,214,609,324,848,538,1457
521640,201907,1874,4459,1303,3627,289,872,430,1143,719,2015
521645,201907,550,1450,352,1082,85,243,112,346,197,589
521680,201907,1136,3495,883,2981,252,922,109,394,361,1316
521690,201907,515,1350,445,1236,68,204,260,697,328,901
521710,201907,2977,7726,1947,5945,369,1280,436,1267,805,2547
521720,201907,2183,5232,1468,4121,179,562,815,2231,994,2793
521730,201907,3619,10549,2800,9072,843,3065,599,1641,1442,4706
521740,201907,3906,10401,2950,8977,838,2738,1006,3187,1844,5925
521760,201907,14284,40701,11278,35945,3285,11514,3789,12432,7074,23946
521770,201907,2894,7177,1978,5657,610,1883,464,1331,1074,3214
521800,201907,6053,16828,4588,14368,1188,3859,1575,5371,2763,9230
521805,201907,524,1261,379,1044,130,338,146,418,276,756
521810,201907,703,1644,474,1317,75,210,236,669,311,879
521830,201907,5285,14911,4285,13395,364,1347,2973,9126,3337,10473
521839,201907,677,1722,486,1383,92,283,228,581,320,864
521850,201907,5164,12900,3280,9753,489,1600,264,703,753,2303
521860,201907,1695,4529,1163,3574,198,654,366,1101,564,1755
521870,201907,682,1920,468,1503,106,351,123,362,229,713
521878,201907,663,1741,472,1379,67,222,230,602,297,824
521880,201907,18277,44705,12228,35488,3180,9723,3941,11747,7121,21470
521890,201907,3114,8353,2056,6349,547,1792,323,913,870,2705
521900,201907,1587,3806,954,2852,293,840,162,513,455,1353
521910,201907,1162,2598,778,2128,79,212,441,1260,520,1472
521920,201907,451,1271,326,1031,61,208,130,412,191,620
521925,201907,766,2081,566,1753,100,312,254,760,354,1072
521930,201907,4902,12381,3393,10074,933,2644,1215,4001,2148,6645
521935,201907,895,2201,627,1727,61,181,377,972,438,1153
521940,201907,1278,2924,831,2305,188,564,326,879,514,1443
521945,201907,536,1503,423,1298,95,290,205,651,300,941
521950,201907,720,1760,517,1455,127,381,240,626,367,1007
521960,201907,735,1993,484,1482,68,233,229,641,297,874
521970,201907,2518,6366,2077,5835,151,418,1615,4602,1766,5020
521971,201907,760,1854,537,1526,149,425,131,368,280,793
521973,201907,1188,3180,928,2758,53,201,647,1874,700,2075
521975,201907,11850,31875,9868,29099,1583,4879,6118,17997,7701,22876
521980,201907,2551,6087,1947,5274,171,431,1423,3908,1594,4339
521990,201907,1134,3152,900,2753,158,487,404,1252,562,1739
522000,201907,2770,7401,2138,6610,248,761,1395,4460,1643,5221
522005,201907,332,809,247,688,50,130,121,342,171,472
522010,201907,3890,9727,2740,7855,714,2172,805,2253,1519,4425
522015,201907,943,2544,674,2104,158,507,253,803,411,1310
522020,201907,5230,12614,3436,9764,726,2183,1382,4016,2108,6199
522026,201907,651,1836,478,1507,85,289,161,488,246,777
522028,201907,471,1260,340,1002,61,181,138,382,199,563
522040,201907,3002,6888,2129,5721,267,786,1393,3652,1660,4438
522045,201907,17016,48581,12585,40362,3043,10431,3140,9699,6183,20130
522050,201907,1008,2652,693,2129,164,536,262,769,426,1305
522060,201907,2515,6954,1968,6083,216,671,1137,3637,1353,4308
522068,201907,1774,4719,1399,4249,154,419,1010,3154,1164,3573
522070,201907,621,1581,507,1408,28,92,398,1064,426,1156
522100,201907,647,1717,453,1389,53,168,241,737,294,905
522108,201907,909,2459,708,2147,51,226,554,1602,605,1828
522119,201907,1532,3972,1170,3474,186,578,604,1842,790,2420
522130,201907,362,915,255,773,47,143,139,451,186,594
522140,201907,16494,44828,11873,36572,3268,10778,2771,8211,6039,18989
522145,201907,822,2024,569,1640,146,406,234,701,380,1107
522150,201907,1042,2586,737,2079,204,572,209,612,413,1184
522155,201907,926,2391,717,2052,127,348,400,1148,527,1496
522157,201907,534,1360,455,1252,28,99,352,961,380,1060
522160,201907,5883,15591,3853,11794,1063,3517,284,935,1347,4452
522170,201907,2639,6864,1935,5791,353,1102,996,2995,1349,4097
522180,201907,459,1129,290,836,60,174,26,90,86,264
522185,201907,16549,42145,12138,36159,5203,16593,2738,8870,7941,25463
522190,201907,764,1846,524,1433,110,304,190,524,300,828
522200,201907,1650,4832,1038,3509,198,723,91,273,289,996
522205,201907,1609,3800,1227,3278,120,355,855,2261,975,2616
522220,201907,1287,3334,960,2819,157,460,484,1440,641,1900
522230,201907,1134,2997,933,2701,226,782,468,1268,694,2050
530010,201907,162262,455209,133983,410584,23798,80073,72822,218786,96620,298859
110001,201908,3801,10940,2575,8577,658,2335,966,3226,1624,5561
110002,201908,11652,31074,8117,24927,2360,7672,2322,7180,4682,14852
110003,201908,648,1943,459,1538,121,437,101,320,222,757
110004,201908,10285,27945,6832,21466,1641,5562,1812,5855,3453,11417
110005,201908,2553,6718,1594,4971,363,1235,441,1464,804,2699
110006,201908,1809,5118,1092,3591,232,853,183,538,415,1391
110007,201908,1330,3426,828,2596,285,944,208,766,493,1710
110008,201908,3227,9225,2355,7849,274,905,1568,5495,1842,6400
110009,201908,4185,12007,2685,9177,677,2399,968,3387,1645,5786
110010,201908,6697,22561,5128,19532,1166,4389,2402,10075,3568,14464
110011,201908,6581,18009,4589,14323,1656,5351,684,2240,2340,7591
110012,201908,14296,36899,8584,26587,2190,7121,880,2953,3070,10074
110013,201908,5319,15765,3950,12975,1681,5731,533,1940,2214,7671
110014,201908,3729,10157,2524,7846,692,2220,919,2816,1611,5036
110015,201908,5149,13824,2910,9274,757,2603,474,1401,1231,4004
110018,201908,3575,9277,2098,6623,431,1538,587,1792,1018,3330
110020,201908,75812,186443,52234,152884,11630,35051,20992,66185,32622,101236
110025,201908,4959,12304,3190,9185,688,2126,1393,3962,2081,6088
110026,201908,491,1337,358,1133,102,341,142,462,244,803
110028,201908,6389,16853,3992,12436,1083,3608,587,1795,1670,5403
110029,201908,1423,3526,812,2466,192,589,312,992,504,1581
110030,201908,12998,30563,8110,23418,1746,5825,1963,5928,3709,11753
110032,201908,2988,8772,1953,6538,630,2128,444,1528,1074,3656
110033,201908,3730,12049,2948,10544,1080,3965,699,2774,1779,6739
110034,201908,3415,8279,2243,6631,703,2234,830,2567,1533,4801
110037,201908,1643,5091,1285,4415,319,1103,567,1993,886,3096
110040,201908,3010,8599,2144,6963,646,2241,590,1851,1236,4092
110045,201908,5049,14798,3848,12605,1054,3739,1400,4593,2454,8332
110050,201908,1789,5067,1266,4088,519,1785,231,760,750,2545
110060,201908,787,2379,540,1827,218,781,67,221,285,1002
110070,201908,1695,5425,1284,4488,429,1601,256,814,685,2415
110080,201908,6130,14570,4433,12543,563,1474,3007,9029,3570,10503
110090,201908,592,1626,415,1306,97,335,174,529,271,864
110092,201908,1190,3578,873,2964,154,539,441,1584,595,2123
110094,201908,2810,8475,2131,7220,894,3175,399,1419,1293,4594
110100,201908,1732,5240,1398,4549,363,1235,631,2047,994,3282
110110,201908,1741,4971,1199,3985,406,1400,255,908,661,2308
110120,201908,1286,3878,958,3216,252,879,286,951,538,1830
110130,201908,2615,6793,1657,5036,364,1218,565,1703,929,2921
110140,201908,2070,6331,1442,5005,386,1366,361,1296,747,2662
110143,201908,1342,3665,910,2805,300,909,182,581,482,1490
110145,201908,862,2346,556,1775,138,445,182,605,320,1050
110146,201908,441,1192,308,982,64,197,143,485,207,682
110147,201908,771,2039,476,1419,72,224,186,476,258,700
110148,201908,822,2396,495,1701,127,488,53,178,180,666
110149,201908,3015,8516,2111,7052,791,2709,442,1619,1233,4328
110150,201908,2641,6654,1752,5399,576,1920,458,1599,1034,3519
110155,201908,678,2065,507,1660,123,418,166,519,289,937
110160,201908,1495,4714,1080,3771,338,1172,256,951,594,2123
110170,201908,2211,5810,1353,4100,269,845,665,1954,934,2799
110175,201908,1605,4630,1127,3781,205,726,493,1738,698,2464
110180,201908,1345,3789,900,2872,165,536,436,1377,601,1913
120001,201908,3129,9486,2618,8740,434,1468,1674,5754,2108,7222
120005,201908,1970,7525,1769,7218,166,763,1364,5661,1530,6424
120010,201908,5268,16160,4470,14894,501,1627,3158,10822,3659,12449
120013,201908,2204,8040,2014,7785,494,1837,1202,4947,1696,6784
120017,201908,2380,8701,2120,8298,349,1393,1350,5610,1699,7003
120020,201908,14860,59560,13743,57322,1215,5720,10545,44370,11760,50090
120025,201908,3035,8940,2479,8237,437,1476,1646,5607,2083,7083
120030,201908,6602,25982,6205,25244,419,2271,4863,19830,5282,22101
120032,201908,1658,7579,1582,7406,94,604,1303,6027,1397,6631
120033,201908,4110,15243,3832,14739,136,750,3290,12556,3426,13306
120034,201908,2625,9616,2230,8884,119,716,1810,7043,1929,7759
120035,201908,3520,14586,3335,14231,298,1420,2666,11504,2964,12924
120038,201908,2735,8931,2358,8302,560,2076,1232,4383,1792,6459
120039,201908,1992,8700,1857,8404,149,909,1460,6527,1609,7436
120040,201908,43527,140796,37902,131299,5965,21855,23220,81317,29185,103172
120042,201908,3395,12775,3083,12142,147,796,2500,9787,2647,10583
120043,201908,1410,5647,1273,5411,42,240,1139,4865,1181,5105
120045,201908,6092,16160,5322,15291,135,546,4846,13760,4981,14306
120050,201908,9300,33681,8495,32417,458,2319,6928,26524,7386,28843
120060,201908,9587,37187,8846,36037,413,2385,7624,30932,8037,33317
120070,201908,3131,10269,2726,9705,278,1021,1917,7085,2195,8106
120080,201908,4346,14384,3874,13624,573,2167,2643,9423,3216,11590
130002,201908,3101,12303,2773,11813,201,911,2331,10044,2532,10955
130006,201908,2387,9026,1961,8252,179,831,1462,6154,1641,6985
130008,201908,2581,9164,2299,8733,80,426,1939,7341,2019,7767
130010,201908,3970,11517,3323,10773,64,199,3084,10136,3148,10335
130014,201908,3030,9186,2367,8054,449,1548,1423,4949,1872,6497
130020,201908,2753,10825,2490,10407,152,892,1967,8174,2119,9066
130030,201908,9886,32396,9013,31366,266,951,8040,28419,8306,29370
130040,201908,3817,11590,3185,10711,180,634,2558,8650,2738,9284
130050,201908,7647,27996,6376,26342,183,951,5742,23929,5925,24880
130060,201908,7602,30300,6546,28890,511,2869,5243,23019,5754,25888
130063,201908,6272,20620,5590,19858,212,913,5063,18096,5275,19009
130068,201908,3666,13387,3130,12512,248,1383,2304,9016,2552,10399
130070,201908,7659,21763,6333,20276,328,1077,5281,17246,5609,18323
130080,201908,6903,25881,6078,24881,292,1670,5033,20897,5325,22567
130083,201908,2724,9042,2445,8696,191,782,2047,7277,2238,8059
130090,201908,3464,10823,3075,10311,67,300,2649,9049,2716,9349
130100,201908,7855,23779,6726,22584,69,174,6276,21672,6345,21846
130110,201908,8519,24520,7020,22644,973,2592,5165,17808,6138,20400
130115,201908,5489,17216,4769,16366,110,411,4182,14568,4292,14979
130120,201908,14672,52329,13134,50287,1228,5212,10559,40789,11787,46001
130130,201908,5221,17017,4102,15556,440,1825,3033,11549,3473,13374
130140,201908,7094,25244,6421,24478,212,1120,5640,21630,5852,22750
130150,201908,3717,13832,3484,13556,92,582,3159,12303,3251,12885
130160,201908,5182,18545,4468,17618,314,1414,3706,14846,4020,16260
130165,201908,3275,12466,3100,12226,129,592,2763,10962,2892,11554
130170,201908,12032,35694,9627,32838,802,3123,7607,26091,8409,29214
130180,201908,4494,14257,4242,13971,43,240,4086,13413,4129,13653
130185,201908,18570,45849,15156,42179,946,1731,12861,37618,13807,39349
130190,201908,19280,64012,15666,58600,1951,7550,10819,41685,12770,49235
130195,201908,2440,8948,1987,8363,74,386,1756,7416,1830,7802
130200,201908,2561,7361,2133,6781,120,485,1737,5463,1857,5948
130210,201908,1316,5007,1179,4845,100,591,937,3756,1037,4347
130220,201908,2287,8117,2023,7742,70,354,1751,6730,1821,7084
130230,201908,4490,18871,3923,18045,279,1680,3289,15119,3568,16799
130240,201908,11898,36021,9674,33005,205,1183,8590,29201,8795,30384
130250,201908,26135,78976,22568,74929,1841,5734,18007,62121,19848,67855
130255,201908,4354,14880,3824,13936,176,830,3070,11166,3246,11996
130260,201908,264083,756121,217076,685708,59880,201492,97825,314422,157705,515914
130270,201908,8855,32668,7536,30578,1165,4766,5049,21281,6214,26047
130280,201908,3537,14234,3247,13910,106,526,2994,13006,3100,13532
130290,201908,13229,44746,11572,42680,659,2651,9854,36982,10513,39633
130300,201908,4762,16797,4321,16166,165,911,3688,13730,3853,14641
130310,201908,6085,21057,5350,20044,336,1485,4398,16567,4734,18052
130320,201908,3511,11372,2974,10702,360,1268,2207,8187,2567,9455
130330,201908,4640,14868,3769,13775,204,926,3213,11723,3417,12649
130340,201908,23105,74363,19999,70747,1546,5072,16513,60348,18059,65420
130350,201908,3954,14518,3571,14014,155,893,3086,12012,3241,12905
130353,201908,7210,20162,5881,18444,943,2868,3972,12905,4915,15773
130356,201908,5110,16752,4322,15477,738,2612,2674,10025,3412,12637
130360,201908,3171,9672,2698,9121,76,251,2480,8464,2556,8715
130370,201908,5728,22448,5039,21488,311,1637,4148,17602,4459,19239
130380,201908,7356,30648,6845,29902,417,2390,5719,24738,6136,27128
130390,201908,6050,25436,5328,24172,592,3174,3792,17174,4384,20348
130395,201908,2353,7571,2016,6999,209,757,1499,5190,1708,5947
130400,201908,2760,8768,2383,8272,105,366,2108,7438,2213,7804
130406,201908,11207,39902,9584,37815,1791,7123,6416,26179,8207,33302
130410,201908,4154,14930,3550,13865,1106,4510,1574,6370,2680,10880
130420,201908,13727,48744,11591,46087,1032,5252,9003,35818,10035,41070
130423,201908,4274,13661,3754,13058,194,922,3273,11228,3467,12150
130426,201908,2867,11214,2692,10974,86,459,2464,10078,2550,10537
130430,201908,4276,12273,3730,11532,316,1152,2997,9090,3313,10242
130440,201908,4849,15256,4204,14493,158,626,3811,13233,3969,13859
140002,201908,2262,6735,1970,6353,105,399,1636,5257,1741,5656
140005,201908,3261,9130,2925,8744,148,407,2535,7692,2683,8099
140010,201908,57169,152310,44844,133649,11593,36252,17771,54363,29364,90615
140015,201908,3652,11174,3119,10521,215,714,2693,9223,2908,9937
140017,201908,4067,11877,3569,11227,315,981,2773,8980,3088,9961
140020,201908,5285,15683,4516,14635,280,1173,3571,11501,3851,12674
140023,201908,2418,7312,1969,6675,218,767,1413,4873,1631,5640
140028,201908,2117,5449,1783,5011,114,368,1387,3856,1501,4224
140030,201908,5232,13649,4632,12937,380,804,3910,11297,4290,12101
140040,201908,2394,9702,2195,9406,102,632,1943,8194,2045,8826
140045,201908,2675,9821,2267,9243,398,1512,1509,6539,1907,8051
140047,201908,5950,17330,5032,15950,728,2426,3396,10849,4124,13275
140050,201908,1411,4201,1193,3878,143,476,852,2818,995,3294
140060,201908,1660,4456,1400,4064,128,346,1085,3219,1213,3565
140070,201908,1878,9863,1814,9702,145,984,1460,7698,1605,8682
150010,201908,45893,114724,41583,109138,997,2620,36919,96421,37916,99041
150013,201908,1978,5136,1623,4744,151,323,1240,3844,1391,4167
150020,201908,14320,43407,13344,42128,1206,3055,11186,36358,12392,39413
150030,201908,8688,32832,7939,31904,426,1979,6891,27831,7317,29810
150034,201908,4401,11047,3641,10064,259,678,2990,8425,3249,9103
150040,201908,16495,42514,14420,40190,1382,2295,11721,35718,13103,38013
150050,201908,6960,24501,6381,23697,146,677,5808,21766,5954,22443
150060,201908,21823,60353,17795,54246,2971,9214,11036,34418,14007,43632
150070,201908,6655,25299,5886,24369,211,1091,5268,22054,5479,23145
150080,201908,96912,219327,81816,198861,19376,51055,25722,76221,45098,127276
150085,201908,7364,21895,6733,21117,156,511,6261,19737,6417,20248
150090,201908,10018,37362,9397,36160,690,2867,7521,29101,8211,31968
150095,201908,5615,16792,4951,15942,292,712,4091,13730,4383,14442
150100,201908,3005,10639,2656,10029,209,779,2048,7828,2257,8607
150110,201908,4317,18218,4074,17923,226,1068,3677,16280,3903,17348
150120,201908,7868,25167,7555,24771,322,833,6677,22642,6999,23475
150125,201908,750,2059,562,1800,111,409,318,997,429,1406
150130,201908,23099,67363,20118,62866,2948,8261,13925,45361,16873,53622
150140,201908,242882,572642,207727,523540,32950,81162,120575,317094,153525,398256
150145,201908,4492,13675,3813,12688,910,2729,2236,8099,3146,10828
150150,201908,15893,41463,14009,39042,699,2109,11542,32130,12241,34239
150157,201908,3412,9526,2813,8748,296,967,1992,6409,2288,7376
150160,201908,3012,9150,2811,8835,612,1860,1654,5379,2266,7239
150170,201908,24753,81712,21563,76277,4095,13699,12965,48782,17060,62481
150172,201908,4682,13071,3775,11778,264,758,2835,9108,3099,9866
150175,201908,1645,5208,1379,4694,238,856,804,2750,1042,3606
150178,201908,10587,29198,8807,27100,275,798,7678,23979,7953,24777
150180,201908,21808,78974,20082,76880,1048,3842,17527,68460,18575,72302
150190,201908,6836,23157,6390,22558,277,1215,5548,19501,5825,20716
150195,201908,5291,17186,5047,16818,88,477,4665,15370,4753,15847
150200,201908,5808,17111,5317,16568,63,165,5003,15734,5066,15899
150210,201908,25928,91789,24269,89455,1943,7163,19786,74728,21729,81891
150215,201908,7592,21922,6488,20293,1323,4077,3618,11848,4941,15925
150220,201908,12040,34889,10629,32831,1187,3598,7144,22485,8331,26083
150230,201908,12618,36096,10977,33917,1248,3530,7527,24269,8775,27799
150240,201908,32928,92669,27181,82601,8038,24865,8655,26852,16693,51717
150250,201908,4202,16575,3996,16302,610,2476,3016,12562,3626,15038
150260,201908,2696,9001,2459,8621,187,649,1894,6722,2081,7371
150270,201908,8874,25719,6255,21236,2087,7416,1824,6592,3911,14008
150275,201908,6869,22111,6318,21316,242,945,5442,18246,5684,19191
150276,201908,2319,6279,1984,5876,254,695,1355,4381,1609,5076
150277,201908,5290,13946,4293,12796,358,954,3281,10427,3639,11381
150280,201908,6715,27437,6504,27056,528,2208,5412,22751,5940,24959
150285,201908,3276,11587,2883,10967,273,1082,2055,7965,2328,9047
150290,201908,10740,29201,9774,28148,349,786,8772,25861,9121,26647
150293,201908,9693,24226,7204,20903,1210,3451,4089,12606,5299,16057
150295,201908,8070,21754,5824,18721,2021,7073,1871,6692,3892,13765
150300,201908,2364,7144,2109,6799,57,225,1881,6063,1938,6288
150304,201908,4106,12417,3384,11234,645,2040,2024,7007,2669,9047
150307,201908,6255,20235,5811,19520,398,1272,4717,16068,5115,17340
150309,201908,6315,19301,5057,17066,966,3197,2737,9646,3703,12843
150310,201908,7336,28850,6974,28404,253,1393,6124,25155,6377,26548
150320,201908,9601,26071,8727,24868,455,1407,6734,19119,7189,20526
150330,201908,14053,45816,12983,44035,1462,4704,9633,33600,11095,38304
150340,201908,2591,7566,2319,7163,340,962,1622,5167,1962,6129
150345,201908,7960,23672,7215,22673,425,1415,6113,19291,6538,20706
150350,201908,8978,23260,8249,22309,814,1557,6677,18741,7491,20298
150360,201908,24505,68875,19726,62659,2201,6140,13530,45447,15731,51587
150370,201908,10474,32892,8763,30526,999,3118,6366,23583,7365,26701
150375,201908,3432,14082,3103,13588,267,1287,2544,11252,2811,12539
150380,201908,11089,28797,9192,26259,183,661,8003,22871,8186,23532
150390,201908,8017,32486,7241,31200,1133,4344,4973,22716,6106,27060
150400,201908,6409,23337,6146,22831,286,1141,5309,19779,5595,20920
150405,201908,9300,24775,8213,23441,518,1191,6570,19437,7088,20628
150410,201908,1927,6210,1634,5689,205,667,1069,3803,1274,4470
150420,201908,41847,119207,32252,104436,9499,32303,10242,38320,19741,70623
150430,201908,8500,25084,7788,24137,870,2128,6043,19558,6913,21686
150440,201908,5586,18370,5186,17756,698,2179,3735,13211,4433,15390
150442,201908,25812,63599,21381,57770,2363,6282,14560,40185,16923,46467
150445,201908,6327,19660,5597,18529,227,794,4738,15731,4965,16525
150450,201908,5071,21950,4755,21510,370,1857,4039,18274,4409,20131
150460,201908,8484,27914,7795,27023,253,1024,6678,23960,6931,24984
150470,201908,21387,55715,19031,53026,503,1288,17628,49303,18131,50591
150475,201908,4761,15361,4175,14443,188,716,3433,12008,3621,12724
150480,201908,13891,45472,12443,43253,2281,7391,8157,30081,10438,37472
150490,201908,8216,28897,7658,28176,259,1159,6791,25096,7050,26255
150495,201908,5290,18356,5097,18067,128,642,4621,16268,4749,16910
150497,201908,2903,9389,2337,8370,554,2047,1186,4496,1740,6543
150500,201908,3338,8673,2966,8133,264,663,2295,6310,2559,6973
150503,201908,4737,12680,3331,10775,1028,3545,1050,3839,2078,7384
150506,201908,10359,31874,8844,29749,1889,5615,5530,20423,7419,26038
150510,201908,9941,36508,8648,34007,1186,4468,5758,23737,6944,28205
150520,201908,7263,27775,6935,27357,230,1331,6254,24577,6484,25908
150530,201908,12456,42618,10871,40311,1626,4889,7714,30531,9340,35420
150540,201908,4970,13779,4246,12679,174,505,3613,10779,3787,11284
150543,201908,7234,19647,5934,17970,600,1857,4358,13767,4958,15624
150548,201908,10099,31704,9112,30356,305,1118,7991,26734,8296,27852
150549,201908,2038,6129,1749,5732,50,216,1512,4937,1562,5153
150550,201908,20085,59957,16948,54726,4059,13355,7473,25729,11532,39084
150553,201908,25188,76540,19854,66821,6245,21560,6395,23331,12640,44891
150555,201908,1897,5139,1486,4488,130,312,1026,3208,1156,3520
150560,201908,1843,5665,1633,5251,288,883,932,3119,1220,4002
150563,201908,2498,7781,2127,7121,470,1662,1139,3803,1609,5465
150565,201908,4298,13937,3801,13119,112,521,3088,10730,3200,11251
150570,201908,6266,20503,5931,20003,274,1070,5115,17168,5389,18238
150580,201908,10372,41699,9229,40399,664,3340,7476,33713,8140,37053
150590,201908,7753,27471,6862,26364,212,1244,6164,23522,6376,24766
150600,201908,9488,31993,8829,31158,238,958,8092,28707,8330,29665
150610,201908,2859,8528,2568,8039,117,431,2116,6563,2233,6994
150611,201908,3155,9075,2814,8573,90,362,2473,7447,2563,7809
150613,201908,13632,37962,10263,32159,1923,6446,4979,15602,6902,22048
150616,201908,3365,9356,2454,7826,607,2006,955,3001,1562,5007
150618,201908,6995,20518,5655,18409,591,1853,3550,12156,4141,14009
150619,201908,6246,17968,5193,16405,188,740,4254,13437,4442,14177
150620,201908,6651,22149,5778,20705,765,2678,3995,14707,4760,17385
150630,201908,6185,16998,5665,16339,463,1242,4638,13587,5101,14829
150635,201908,4747,13335,4026,12142,568,1672,2565,7907,3133,9579
150640,201908,2218,6500,2031,6275,36,118,1886,5905,1922,6023
150650,201908,11679,32940,10276,30577,3147,8842,4461,14390,7608,23232
150655,201908,5916,16886,5340,16021,227,685,4571,13697,4798,14382
150658,201908,4506,12866,3561,11423,578,1945,2140,7199,2718,9144
150660,201908,5813,16778,5198,15890,506,1496,3585,11148,4091,12644
150670,201908,8400,19713,6584,17633,687,1567,5113,14344,5800,15911
150680,201908,68767,204154,52327,177890,13018,43856,23042,87539,36060,131395
150690,201908,2895,7890,2583,7499,118,282,2256,6704,2374,6986
150700,201908,6269,18774,5619,17927,391,1142,4445,14502,4836,15644
150710,201908,3798,12690,3470,12157,264,963,2646,9386,2910,10349
150715,201908,5152,15086,4278,13714,356,1088,3316,10807,3672,11895
150720,201908,6823,24736,6357,23943,444,1851,5210,19727,5654,21578
150730,201908,11690,36464,10234,34285,1150,4025,7694,26262,8844,30287
150740,201908,3982,11295,3514,10528,329,854,2616,7985,2945,8839
150745,201908,5210,14950,4195,13429,844,2867,2661,8545,3505,11412
150746,201908,1643,5091,1502,4873,83,266,1228,3989,1311,4255
150747,201908,4871,15753,4326,14846,767,2346,2812,10178,3579,12524
150750,201908,3714,11717,3120,10770,236,864,2368,8372,2604,9236
150760,201908,12124,35614,11019,34149,1483,4241,7853,25011,9336,29252
150770,201908,6347,23050,6046,22679,213,698,5506,21239,5719,21937
150775,201908,922,2695,730,2411,142,528,385,1271,527,1799
150780,201908,4629,13898,4164,13339,133,378,3779,12338,3912,12716
150790,201908,5663,16379,4932,15591,220,546,4061,13986,4281,14532
150795,201908,13696,43646,12273,41290,3238,10294,6714,24158,9952,34452
150796,201908,3732,9415,3241,8825,189,465,2733,7534,2922,7999
150797,201908,3993,12510,3439,11666,151,442,2866,9874,3017,10316
150800,201908,13561,42765,12403,41284,1559,4777,9391,32348,10950,37125
150803,201908,7005,22989,6595,22351,369,1271,5637,19213,6006,20484
150805,201908,3495,10938,2966,10125,257,894,2255,7807,2512,8701
150808,201908,6255,17980,4553,15115,1727,6245,611,2269,2338,8514
150810,201908,21054,56553,15995,50338,3363,10788,8171,27922,11534,38710
150812,201908,5523,15738,4870,14594,466,1474,3540,10391,4006,11865
150815,201908,9364,28294,7938,26502,678,2268,6352,21543,7030,23811
150820,201908,12057,33118,10158,30768,1034,2720,7764,24433,8798,27153
150830,201908,11515,43294,10887,42502,417,2043,9450,37551,9867,39594
150835,201908,2288,7741,1989,7189,387,1379,1030,3769,1417,5148
150840,201908,7473,21734,5912,19024,1054,3625,3079,9803,4133,13428
160005,201908,1176,3238,1055,3063,51,180,903,2614,954,2794
160010,201908,2456,6341,2313,6187,20,103,2245,5933,2265,6036
160015,201908,2606,7856,2350,7519,78,265,2149,6889,2227,7154
160020,201908,2051,6794,1817,6479,199,719,1392,5048,1591,5767
160021,201908,1110,4344,1028,4232,73,418,819,3292,892,3710
160023,201908,1268,4500,1115,4240,116,394,786,3157,902,3551
160025,201908,1932,5628,1862,5546,12,39,1825,5448,1837,5487
160027,201908,8930,24906,8015,23746,626,1732,6474,19548,7100,21280
160030,201908,68644,198337,55562,180610,12234,37729,29564,105570,41798,143299
160040,201908,5550,19311,5037,18625,94,466,4648,17263,4742,17729
160050,201908,4727,14856,3753,13451,1487,5089,1287,5645,2774,10734
160053,201908,3777,11980,3472,11596,267,824,2847,9772,3114,10596
160055,201908,915,2707,886,2673,30,94,825,2486,855,2580
160060,201908,24115,65903,19833,60930,1074,3407,15720,50355,16794,53762
160070,201908,2878,10875,2582,10383,214,842,1999,8302,2213,9144
160080,201908,3273,10581,2980,10238,49,238,2725,9432,2774,9670
170025,201908,622,1683,455,1433,86,265,237,759,323,1024
170030,201908,1185,3605,892,3048,151,511,428,1486,579,1997
170035,201908,1503,3918,1083,3224,104,343,634,1890,738,2233
170040,201908,1860,5405,1466,4849,108,421,864,2973,972,3394
170070,201908,1805,4280,1257,3576,85,291,741,2148,826,2439
170100,201908,2466,7122,2023,6369,192,580,1290,4138,1482,4718
170105,201908,738,2158,500,1636,124,371,178,590,302,961
170110,201908,926,2902,707,2476,122,460,296,1034,418,1494
170130,201908,1348,4088,957,3317,189,668,443,1591,632,2259
170190,201908,1404,4026,952,3263,327,1132,174,781,501,1913
170200,201908,1875,4653,1144,3408,231,732,357,1064,588,1796
170210,201908,25378,70013,19149,59315,6764,22671,2021,7345,8785,30016
170215,201908,1342,3644,1104,3324,54,228,853,2556,907,2784
170220,201908,5942,18564,4984,16774,1310,4214,2172,7889,3482,12103
170230,201908,1276,3827,951,3165,268,899,186,669,454,1568
170240,201908,2699,7637,2056,6583,167,652,1386,4306,1553,4958
170255,201908,4063,11918,2840,9562,524,1819,1239,4284,1763,6103
170270,201908,1005,2448,645,1934,31,96,392,1159,423,1255
170290,201908,2973,8726,2525,8168,125,397,1989,6666,2114,7063
170300,201908,1964,5437,1578,4846,191,608,1041,3239,1232,3847
170305,201908,712,1994,557,1718,65,229,263,789,328,1018
170307,201908,955,3297,765,2906,112,447,412,1588,524,2035
170310,201908,1641,4176,1123,3302,187,599,502,1479,689,2078
170320,201908,1052,2751,775,2310,72,237,485,1448,557,1685
170330,201908,929,2869,828,2705,46,216,675,2145,721,2361
170360,201908,488,1335,338,1072,27,91,216,647,243,738
170370,201908,1314,3548,924,2880,289,876,225,829,514,1705
170380,201908,1790,5231,1320,4482,122,465,719,2517,841,2982
170382,201908,559,1702,451,1501,46,197,312,987,358,1184
170384,201908,1597,5798,1299,5197,278,1158,619,2502,897,3660
170386,201908,877,2445,535,1757,76,298,181,544,257,842
170388,201908,631,1816,445,1483,65,251,194,641,259,892
170389,201908,1048,3375,885,3089,48,204,674,2392,722,2596
170390,201908,1677,3930,1233,3378,73,193,968,2722,1041,2915
170410,201908,556,1657,396,1343,21,95,251,836,272,931
170460,201908,386,1027,303,886,45,126,181,545,226,671
170510,201908,907,2700,647,2199,46,191,399,1310,445,1501
170550,201908,6644,18028,4759,14828,1265,4265,1080,3586,2345,7851
170555,201908,1347,3769,1047,3293,60,201,552,1791,612,1992
170560,201908,1056,3007,782,2606,76,289,463,1663,539,1952
170600,201908,1351,3675,1085,3281,226,537,616,2037,842,2574
170610,201908,1766,4786,1260,3975,78,281,774,2415,852,2696
170625,201908,435,1210,260,831,35,98,88,282,123,380
170650,201908,1298,3919,1006,3414,158,541,516,1828,674,2369
170700,201908,3483,10295,2574,8555,518,1770,1105,3742,1623,5512
170710,201908,1565,4165,1174,3494,168,559,696,2044,864,2603
170720,201908,1835,4652,1438,4058,82,184,1060,3112,1142,3296
170730,201908,1031,2880,753,2408,151,450,345,1182,496,1632
170740,201908,2083,7009,1766,6388,209,797,1199,4336,1408,5133
170755,201908,882,2508,606,1987,59,221,291,920,350,1141
170765,201908,1245,3238,849,2598,182,556,343,1097,525,1653
170770,201908,1818,5388,1494,4863,193,593,954,3195,1147,3788
170820,201908,3444,10586,2808,9389,494,1762,1380,4681,1874,6443
170825,201908,966,2313,773,2038,84,223,537,1426,621,1649
170830,201908,1395,3799,1147,3404,27,100,910,2693,937,2793
170900,201908,2688,8737,2277,8108,195,759,1752,6325,1947,7084
170930,201908,3752,10484,2859,8818,660,2160,1028,3115,1688,5275
170950,201908,11426,31958,7772,25283,2271,8341,949,3298,3220,11639
170980,201908,441,1217,353,1075,18,81,251,718,269,799
171050,201908,1598,5147,1380,4734,54,261,1121,3813,1175,4074
171070,201908,1349,3947,1144,3638,294,932,532,1905,826,2837
171090,201908,1046,2596,837,2290,80,220,567,1554,647,1774
171110,201908,575,1590,411,1281,64,218,187,518,251,736
171150,201908,1105,2793,643,1979,75,261,376,1135,451,1396
171180,201908,766,2139,497,1612,77,227,203,676,280,903
171190,201908,1689,5863,1481,5485,244,955,870,3306,1114,4261
171195,201908,837,2729,685,2434,98,399,402,1404,500,1803
171200,201908,540,1564,405,1317,77,263,177,576,254,839
171215,201908,382,1079,295,926,46,161,176,535,222,696
171240,201908,762,2577,621,2293,42,206,401,1463,443,1669
171245,201908,651,1983,495,1637,47,178,293,934,340,1112
171250,201908,1078,2837,771,2354,135,432,379,1163,514,1595
171270,201908,389,1523,326,1361,69,316,127,566,196,882
171280,201908,856,2608,669,2273,82,254,369,1322,451,1576
171320,201908,4069,11576,3147,9955,627,1974,1239,4083,1866,6057
171330,201908,2738,7513,2094,6416,415,1222,1000,3165,1415,4387
171360,201908,1433,4219,1146,3789,87,331,820,2757,907,3088
171370,201908,670,1753,520,1535,53,161,347,1039,400,1200
171380,201908,1509,4363,1241,3954,114,340,854,2814,968,3154
171395,201908,985,2819,657,2169,69,257,376,1208,445,1465
171420,201908,1930,5818,1393,4731,243,917,618,2078,861,2995
171430,201908,1049,3155,863,2783,71,269,571,1772,642,2041
171488,201908,2365,7054,1823,6133,319,1119,871,3020,1190,4139
171500,201908,981,2475,742,2098,39,116,552,1559,591,1675
171510,201908,781,2640,682,2440,48,216,466,1647,514,1863
171515,201908,465,1261,332,1034,37,147,195,567,232,714
171525,201908,671,1979,519,1698,37,155,312,958,349,1113
171550,201908,342,1009,243,834,31,128,136,447,167,575
171570,201908,1128,3433,930,3067,152,501,530,1797,682,2298
171575,201908,1818,4872,1136,3615,145,478,489,1543,634,2021
171610,201908,5865,16642,4352,14034,969,3443,1210,4116,2179,7559
171620,201908,2701,7665,2265,7020,126,487,1774,5495,1900,5982
171630,201908,980,2662,781,2380,121,373,505,1588,626,1961
171650,201908,2119,6144,1591,5175,407,1415,470,1627,877,3042
171660,201908,2361,6110,1612,4814,256,738,809,2451,1065,3189
171665,201908,1327,3747,992,3189,171,632,462,1501,633,2133
171670,201908,1886,5115,1440,4371,223,754,793,2370,1016,3124
171700,201908,1207,3487,880,2902,109,338,489,1623,598,1961
171720,201908,822,2145,632,1835,59,199,443,1261,502,1460
171750,201908,1277,3658,884,2927,211,712,123,502,334,1214
171780,201908,1239,3174,891,2664,71,247,617,1801,688,2048
171790,201908,1435,4821,1148,4201,240,893,506,1928,746,2821
171800,201908,751,2093,558,1792,69,274,310,984,379,1258
171820,201908,11269,32038,8298,26739,2024,6753,2662,9141,4686,15894
171830,201908,1502,4996,1259,4539,123,561,799,2831,922,3392
171840,201908,751,2016,590,1763,26,76,399,1189,425,1265
171845,201908,633,1616,457,1354,57,208,261,771,318,979
171850,201908,868,2975,736,2674,78,359,507,1773,585,2132
171855,201908,1065,3258,895,2943,80,261,546,1761,626,2022
171865,201908,394,1261,317,1122,51,197,153,510,204,707
171870,201908,793,2262,550,1797,65,228,288,954,353,1182
171875,201908,1271,3819,1019,3405,54,242,753,2476,807,2718
171880,201908,1142,3570,1007,3381,33,134,809,2742,842,2876
171884,201908,838,2336,609,1956,115,423,219,759,334,1182
171886,201908,1457,4117,1017,3340,292,1045,201,674,493,1719
171888,201908,727,2063,492,1616,31,113,314,1016,345,1129
171889,201908,418,1304,348,1174,81,291,139,468,220,759
171890,201908,1143,3188,844,2702,186,561,454,1512,640,2073
171900,201908,523,1822,362,1401,78,302,140,554,218,856
172000,201908,583,1801,485,1599,46,170,281,890,327,1060
172010,201908,1056,3684,890,3327,81,355,533,1930,614,2285
172015,201908,362,1293,267,1087,64,258,110,474,174,732
172020,201908,2526,7446,2240,7055,165,611,1666,5359,1831,5970
172025,201908,757,2090,548,1742,40,150,368,1170,408,1320
172030,201908,1238,3683,1057,3400,44,190,835,2666,879,2856
172049,201908,1305,3190,867,2556,190,534,467,1466,657,2000
172065,201908,1515,3741,1170,3319,113,236,942,2845,1055,3081
172080,201908,2346,7016,1887,6169,112,436,1244,4025,1356,4461
172085,201908,474,1324,300,939,56,166,104,308,160,474
172090,201908,4025,10302,3068,9018,141,480,2298,6765,2439,7245
172093,201908,490,1452,353,1199,33,132,187,614,220,746
172097,201908,610,1648,438,1354,61,190,213,675,274,865
172100,201908,50444,126473,33949,99300,6528,21065,11128,33218,17656,54283
172110,201908,1642,6049,1411,5674,161,657,1014,4283,1175,4940
172120,201908,4929,14827,3867,13064,545,1896,2102,7352,2647,9248
172125,201908,307,855,223,712,24,77,123,389,147,466
172130,201908,686,1711,556,1503,27,96,396,992,423,1088
172208,201908,2508,6297,2008,5629,191,474,1414,4062,1605,4536
172210,201908,2764,7250,2092,6375,402,1274,1105,3478,1507,4752
210005,201908,19816,57935,15361,50500,4540,15483,5696,19570,10236,35053
210010,201908,1953,6028,1765,5771,68,313,1509,4953,1577,5266
210015,201908,3387,10153,3005,9626,126,334,2572,8383,2698,8717
210020,201908,7546,17360,6513,16157,87,237,6016,14947,6103,15184
210030,201908,4854,16152,4535,15676,208,973,3908,13436,4116,14409
210040,201908,1873,4500,1689,4278,31,51,1568,4022,1599,4073
210043,201908,6436,18158,5352,16719,546,1646,3968,12763,4514,14409
210047,201908,6732,21327,5576,19699,176,868,4788,16851,4964,17719
210050,201908,2302,7830,1796,6884,187,822,1207,4604,1394,5426
210055,201908,1875,6087,1706,5813,69,286,1429,4847,1498,5133
210060,201908,7206,26798,6390,25270,798,3250,4357,17764,5155,21014
210070,201908,7257,20497,6818,19949,46,177,6478,19008,6524,19185
210080,201908,4104,14054,3910,13824,38,225,3680,13078,3718,13303
210083,201908,5631,16053,4631,14987,67,334,4357,14063,4424,14397
210087,201908,3055,8365,2665,7851,124,302,2264,6850,2388,7152
210090,201908,9499,29738,8865,28631,424,1311,7626,24669,8050,25980
210095,201908,6387,20806,5899,20211,237,1018,4963,17444,5200,18462
210100,201908,6897,21001,6194,19895,325,1139,5019,16166,5344,17305
210110,201908,3095,10624,2872,10339,62,412,2621,9337,2683,9749
210120,201908,23251,64430,19461,59382,2243,5791,12917,41772,15160,47563
210125,201908,4368,11960,3849,11318,833,1926,2656,8437,3489,10363
210130,201908,4363,11658,3618,10696,167,399,3061,9116,3228,9515
210135,201908,1477,4477,1278,4153,67,218,1024,3374,1091,3592
210140,201908,18239,49771,14153,44384,2786,8547,7796,25551,10582,34098
210150,201908,4507,10956,3981,10214,128,362,3455,8741,3583,9103
210160,201908,16776,49837,14666,47049,1373,4596,10365,34302,11738,38898
210170,201908,15063,47533,14042,46175,715,2265,12320,40707,13035,42972
210173,201908,2335,8826,2135,8469,70,448,1893,7492,1963,7940
210177,201908,3403,9440,3019,8971,111,196,2708,8336,2819,8532
210180,201908,1474,4027,1301,3803,38,115,1163,3377,1201,3492
210190,201908,5175,14604,4485,13586,86,434,3807,11288,3893,11722
210193,201908,1273,3797,1132,3575,38,147,892,2865,930,3012
210197,201908,2048,6605,1900,6389,157,542,1526,5220,1683,5762
210200,201908,7633,24880,6898,23665,542,1954,5460,18818,6002,20772
210203,201908,7004,20995,6086,19750,474,1586,4881,16088,5355,17674
210207,201908,3587,9537,3038,8893,151,355,2508,7555,2659,7910
210210,201908,8297,26867,7639,25970,130,777,6942,23472,7072,24249
210215,201908,2271,7499,2057,7183,60,306,1817,6324,1877,6630
210220,201908,6174,21439,5844,20918,216,1339,5056,17672,5272,19011
210230,201908,5232,15974,4727,15218,357,949,3968,13041,4325,13990
210232,201908,11537,36621,9517,33608,1560,5578,5982,22512,7542,28090
210235,201908,3475,10324,3023,9713,73,339,2654,8528,2727,8867
210237,201908,2616,8941,2357,8616,33,195,2180,7974,2213,8169
210240,201908,2679,8465,2450,8064,92,388,2102,6814,2194,7202
210250,201908,5629,17239,5128,16606,77,423,4569,14779,4646,15202
210255,201908,2528,7820,2142,7103,289,979,1342,4415,1631,5394
210260,201908,5515,16669,4864,15702,251,936,4118,13239,4369,14175
210270,201908,4864,13572,4329,12875,115,535,3832,11277,3947,11812
210275,201908,3649,9177,3228,8662,53,127,2948,7994,3001,8121
210280,201908,5586,16237,4485,14478,291,1248,3180,10036,3471,11284
210290,201908,7111,19641,6402,18747,142,464,5808,16983,5950,17447
210300,201908,34105,92877,27944,84289,1904,5971,20474,63936,22378,69907
210310,201908,3081,7965,2708,7417,124,291,2348,6478,2472,6769
210312,201908,2727,7066,2392,6687,46,196,2189,6030,2235,6226
210315,201908,3049,8495,2584,7957,74,199,2336,7358,2410,7557
210317,201908,4162,13191,3780,12735,120,616,3381,11305,3501,11921
210320,201908,19190,58809,17549,56631,458,2204,15418,49445,15876,51649
210325,201908,3554,10277,3089,9667,78,256,2767,8789,2845,9045
210330,201908,24503,71530,20739,66313,5832,17072,10192,37100,16024,54172
210340,201908,10135,30375,9080,28832,750,2420,6916,22436,7666,24856
210350,201908,9544,27571,8351,26098,173,624,7309,22949,7482,23573
210355,201908,4334,14719,3816,13897,112,589,3246,11877,3358,12466
210360,201908,13506,42549,12135,40523,581,2607,9530,31369,10111,33976
210370,201908,10843,24473,8411,21881,244,450,7649,20363,7893,20813
210375,201908,3341,8911,2509,7801,628,1988,1176,4011,1804,5999
210380,201908,5618,14637,4882,13734,250,629,4115,11664,4365,12293
210390,201908,2562,9265,2387,8931,141,659,1949,7250,2090,7909
210400,201908,4537,14008,4050,13398,155,504,3584,11984,3739,12488
210405,201908,7198,19646,5790,17618,1087,3123,3238,10437,4325,13560
210407,201908,2000,6668,1656,6014,86,387,1326,4746,1412,5133
210408,201908,2484,9427,2328,9179,146,732,1866,7379,2012,8111
210409,201908,3807,13236,3487,12790,112,624,2866,10517,2978,11141
210410,201908,3552,10974,3008,10047,208,768,2189,7290,2397,8058
210420,201908,3978,12694,3570,11984,216,642,2964,10080,3180,10722
210430,201908,2297,6717,2069,6429,92,271,1812,5663,1904,5934
210440,201908,4276,11838,3836,11250,69,272,3533,10292,3602,10564
210450,201908,2511,7517,2181,7007,103,370,1781,5712,1884,6082
210455,201908,4296,11417,3262,10099,966,2975,1540,4988,2506,7963
210460,201908,3622,10613,3134,9966,81,349,2726,8610,2807,8959
210462,201908,1610,5026,1390,4658,42,178,1118,3732,1160,3910
210465,201908,2634,7749,2303,7283,64,244,1988,6294,2052,6538
210467,201908,5806,19058,5210,18270,320,1307,4366,15405,4686,16712
210470,201908,2137,5566,1467,4607,85,196,1095,3572,1180,3768
210480,201908,16284,48450,13586,45075,1265,3832,9876,35026,11141,38858
210490,201908,3773,9529,3025,8468,75,234,2609,7288,2684,7522
210500,201908,6296,24579,5857,23795,383,1899,4741,19111,5124,21010
210510,201908,6072,20343,5396,19590,118,559,4808,17704,4926,18263
210515,201908,3808,11063,3310,10512,111,390,2889,9269,3000,9659
210520,201908,2550,7377,2304,7064,88,328,2012,6101,2100,6429
210530,201908,54825,134034,42866,116273,6925,23598,11547,39881,18472,63479
210535,201908,3095,10552,2879,10212,114,458,2414,8626,2528,9084
210540,201908,14666,42866,12266,39552,1466,4442,8598,28829,10064,33271
210542,201908,6530,15457,5309,14102,352,615,4440,12504,4792,13119
210545,201908,2255,7072,2118,6837,48,199,1852,5900,1900,6099
210547,201908,3576,12893,3146,12031,325,1205,2244,8866,2569,10071
210550,201908,6323,19063,5068,17115,345,1301,3768,13019,4113,14320
210560,201908,3536,10924,3186,10353,126,424,2664,8620,2790,9044
210565,201908,1482,4965,1234,4583,68,365,960,3594,1028,3959
210570,201908,10879,29827,9666,28356,325,950,8563,25482,8888,26432
210580,201908,2992,8178,2558,7658,191,371,2046,6447,2237,6818
210590,201908,4351,13058,3793,12322,87,446,3344,10818,3431,11264
210592,201908,2609,7723,2409,7381,30,148,2153,6523,2183,6671
210594,201908,2555,6922,1964,6011,92,259,1451,4584,1543,4843
210596,201908,2513,9007,2246,8456,145,595,1779,6757,1924,7352
210598,201908,1885,5465,1725,5226,36,158,1563,4697,1599,4855
210600,201908,3095,8322,2485,7442,86,216,2003,6112,2089,6328
210610,201908,2636,7621,2294,7201,68,333,1958,6076,2026,6409
210620,201908,2664,7289,2244,6775,51,141,2045,6297,2096,6438
210630,201908,3119,10521,2839,10068,138,685,2315,8076,2453,8761
210632,201908,4427,14475,3949,13766,260,1122,3077,10625,3337,11747
210635,201908,1789,6356,1683,6169,139,492,1362,5111,1501,5603
210637,201908,2365,8033,2104,7640,173,738,1557,5703,1730,6441
210640,201908,4726,16953,4479,16658,62,312,4227,15694,4289,16006
210650,201908,7444,21203,6762,20320,74,338,6271,18855,6345,19193
210660,201908,8317,24527,7342,22952,292,1123,6298,19463,6590,20586
210663,201908,2587,7697,2405,7483,119,297,2090,6667,2209,6964
210667,201908,1897,6229,1763,6032,49,197,1588,5471,1637,5668
210670,201908,4521,15522,4149,14924,139,701,3549,12666,3688,13367
210675,201908,5119,13910,4409,12967,232,566,3678,11071,3910,11637
210680,201908,4297,10900,3611,10035,126,227,3212,9134,3338,9361
210690,201908,7638,23976,6697,22894,269,1212,5848,20055,6117,21267
210700,201908,2741,7509,2224,6818,148,400,1704,5508,1852,5908
210710,201908,5048,15772,4429,14865,119,619,3856,12820,3975,13439
210720,201908,2893,9562,2649,9260,58,328,2379,8260,2437,8588
210725,201908,1364,4604,1174,4308,46,194,812,3090,858,3284
210730,201908,1210,3246,1008,2961,64,177,811,2396,875,2573
210735,201908,4662,13912,3986,12980,238,771,3350,11132,3588,11903
210740,201908,5344,14406,4664,13651,121,440,3842,11168,3963,11608
210745,201908,4503,12365,4166,11914,138,397,3761,10760,3899,11157
210750,201908,23132,58969,20077,55156,1623,4252,14059,40577,15682,44829
210760,201908,5875,15654,5103,14820,31,81,4850,14194,4881,14275
210770,201908,6206,15986,5344,15002,52,225,4991,13955,5043,14180
210780,201908,7232,23534,6436,22165,572,1799,5003,17594,5575,19393
210790,201908,4481,13987,4065,13434,234,657,3229,11316,3463,11973
210800,201908,5013,13348,4284,12374,74,293,3842,10947,3916,11240
210805,201908,3961,14526,3802,14286,117,637,3361,12535,3478,13172
210810,201908,4989,14636,4550,14069,229,523,3865,12299,4094,12822
210820,201908,7112,20413,5980,18574,750,2356,3621,11535,4371,13891
210825,201908,6834,21076,6221,20266,248,845,5369,17677,5617,18522
210830,201908,7717,22057,7159,21371,429,990,6140,18841,6569,19831
210840,201908,3286,8716,2920,8205,80,267,2556,7060,2636,7327
210845,201908,6544,17791,5924,17108,26,79,5746,16648,5772,16727
210850,201908,5947,20455,5059,19083,267,1314,3927,14841,4194,16155
210860,201908,20790,54282,17472,50069,785,2016,14150,42409,14935,44425
210870,201908,7040,19052,5848,17628,227,667,5080,15365,5307,16032
210880,201908,4436,13599,4001,13087,218,805,3271,10717,3489,11522
210890,201908,4072,12084,3663,11599,250,658,2972,9718,3222,10376
210900,201908,4626,13672,3523,11601,1408,4944,563,2075,1971,7019
210905,201908,1965,5506,1652,5085,49,90,1487,4689,1536,4779
210910,201908,7390,22503,6228,20624,896,3023,3997,13322,4893,16345
210920,201908,3306,10849,2868,10263,81,452,2540,9008,2621,9460
210923,201908,1453,4510,1276,4213,55,199,967,3188,1022,3387
210927,201908,5264,16578,4627,15846,199,742,3930,13683,4129,14425
210930,201908,2521,8701,2235,8151,163,723,1697,6116,1860,6839
210940,201908,4040,11539,3784,11223,119,480,3442,10067,3561,10547
210945,201908,6258,18379,5688,17698,251,759,4850,15328,5101,16087
210950,201908,5198,14884,4013,13168,613,1673,2640,9283,3253,10956
210955,201908,1586,5121,1390,4775,152,522,982,3437,1134,3959
210960,201908,9067,27246,7855,25434,1278,3820,4997,17023,6275,20843
210970,201908,1295,4059,1039,3623,58,247,783,2656,841,2903
210975,201908,1694,5434,1515,5140,96,335,1190,4042,1286,4377
210980,201908,10239,23438,8925,22084,108,235,8424,20969,8532,21204
210990,201908,15683,45276,12590,41182,805,2898,9513,31536,10318,34434
211000,201908,14617,43561,12390,40914,642,2425,10002,33924,10644,36349
211003,201908,5550,16916,4714,15886,143,562,4055,13964,4198,14526
211010,201908,6566,23613,5926,22802,96,513,5349,20823,5445,21336
211020,201908,7935,24074,7093,23064,254,1042,6103,19898,6357,20940
211023,201908,1999,6638,1906,6511,96,391,1602,5422,1698,5813
211027,201908,2954,9652,2847,9472,158,570,2483,8184,2641,8754
211030,201908,3907,10900,3495,10394,252,577,2835,8693,3087,9270
211040,201908,4574,16592,4259,16040,127,759,3753,14011,3880,14770
211050,201908,9347,24151,8485,23053,145,401,7784,21148,7929,21549
211060,201908,6942,21228,6409,20507,146,586,5874,18779,6020,19365
211065,201908,2171,6185,1805,5697,88,286,1475,4761,1563,5047
211070,201908,7388,24316,6412,22782,506,1846,5001,17916,5507,19762
211080,201908,1294,3637,1027,3212,33,176,774,2281,807,2457
211085,201908,2023,5875,1746,5488,91,236,1509,4858,1600,5094
211090,201908,3254,9019,2917,8588,41,203,2654,7741,2695,7944
211100,201908,6749,17197,6250,16570,46,139,5742,15287,5788,15426
211102,201908,3013,10570,2779,10218,145,698,2379,8653,2524,9351
211105,201908,2361,7579,1973,6835,192,696,1378,4735,1570,5431
211107,201908,4565,14608,3930,13654,154,653,3197,11340,3351,11993
211110,201908,6018,16681,4659,14601,435,1270,3313,10603,3748,11873
211120,201908,43155,109254,37532,102751,5035,12852,24134,70544,29169,83396
211125,201908,2064,6134,1738,5631,45,164,1456,4732,1501,4896
211130,201908,197133,473520,176133,446768,25660,65099,76508,222119,102168,287218
211140,201908,4971,14929,4377,14123,202,619,3724,12043,3926,12662
211150,201908,9460,26120,8069,24284,350,1056,6743,20414,7093,21470
211153,201908,2556,7453,2050,6824,299,1056,1323,4618,1622,5674
211157,201908,1088,3481,900,3144,34,184,651,2245,685,2429
211160,201908,4014,11740,3199,10500,165,694,2362,7596,2527,8290
211163,201908,1711,5369,1566,5162,26,130,1415,4716,1441,4846
211167,201908,1563,4998,1460,4831,32,160,1334,4371,1366,4531
211170,201908,6435,15853,6013,15366,42,143,5723,14561,5765,14704
211172,201908,2441,6751,2082,6202,99,329,1697,4890,1796,5219
211174,201908,2868,8430,2609,8124,57,291,2372,7335,2429,7626
211176,201908,4310,12449,3342,11022,176,742,2616,8561,2792,9303
211178,201908,4739,11019,4043,10245,38,161,3801,9532,3839,9693
211180,201908,4043,13455,3751,13017,207,804,3169,11013,3376,11817
211190,201908,3058,9122,2618,8450,38,204,2256,7214,2294,7418
211195,201908,1351,3912,1158,3619,48,119,974,3111,1022,3230
211200,201908,2160,6249,1742,5692,224,736,1186,3941,1410,4677
211210,201908,6538,19865,5925,19051,276,1068,5075,16224,5351,17292
211220,201908,36688,94268,30209,86266,2901,8087,22120,64584,25021,72671
211223,201908,5094,13746,4338,12706,423,1238,3199,9419,3622,10657
211227,201908,1763,5954,1599,5712,36,172,1406,5099,1442,5271
211230,201908,7260,21828,6438,20551,410,1229,5169,16691,5579,17920
211240,201908,8270,26368,7780,25723,157,846,7112,23255,7269,24101
211245,201908,6812,17452,6284,16906,81,225,6094,16409,6175,16634
211250,201908,13392,41210,12129,39627,544,2310,10107,32591,10651,34901
211260,201908,7918,25775,7169,24745,207,924,6426,22276,6633,23200
211270,201908,10572,33893,9124,31888,389,1782,7437,26081,7826,27863
211280,201908,12914,36278,11514,34509,954,2332,9191,28750,10145,31082
211285,201908,1791,6026,1567,5683,185,727,1007,3746,1192,4473
211290,201908,7397,22667,6776,21798,177,786,5820,18573,5997,19359
211300,201908,8083,22876,7238,21742,154,553,6490,19405,6644,19958
211400,201908,11448,33287,9411,30406,1194,3862,6188,21000,7382,24862
220005,201908,1830,4920,1658,4665,39,159,1378,3796,1417,3955
220010,201908,1495,4282,1237,3822,31,132,951,2894,982,3026
220020,201908,3474,10039,3041,9383,192,691,2403,7285,2595,7976
220025,201908,2239,5149,1901,4626,26,70,1581,3723,1607,3793
220027,201908,1261,3253,1090,3029,22,76,909,2474,931,2550
220030,201908,3319,8539,3119,8258,88,264,2728,7099,2816,7363
220040,201908,7063,21541,6266,20013,1389,4137,3517,11712,4906,15849
220045,201908,1481,4579,1236,4148,36,185,990,3262,1026,3447
220050,201908,4661,12936,3954,11942,89,432,3550,10535,3639,10967
220060,201908,2434,5138,2045,4687,25,59,1913,4363,1938,4422
220070,201908,2527,6429,2154,5880,80,173,1753,4782,1833,4955
220080,201908,702,1999,601,1849,29,121,513,1543,542,1664
220090,201908,1784,4358,1479,3937,20,74,1241,3393,1261,3467
220095,201908,657,1686,620,1643,22,34,559,1492,581,1526
220100,201908,1380,3832,1109,3379,51,184,877,2595,928,2779
220105,201908,2013,6302,1752,5768,157,535,1281,4234,1438,4769
220110,201908,3455,9536,3231,9117,44,218,2880,8005,2924,8223
220115,201908,2712,8077,2504,7768,73,290,2247,6853,2320,7143
220117,201908,1355,3299,1039,2848,12,53,863,2311,875,2364
220120,201908,12599,34392,11514,33009,103,397,10788,30835,10891,31232
220130,201908,1098,3017,916,2761,18,102,812,2394,830,2496
220140,201908,2024,4323,1734,3967,131,341,1481,3317,1612,3658
220150,201908,6454,19254,5987,18499,141,695,5012,15115,5153,15810
220155,201908,1116,3269,887,2841,26,103,635,1993,661,2096
220157,201908,1039,2571,880,2320,19,86,714,1807,733,1893
220160,201908,2781,7863,2390,7146,40,207,1970,5745,2010,5952
220170,201908,1537,4076,1294,3712,11,60,1148,3257,1159,3317
220173,201908,2098,5896,1612,4993,42,180,1318,3961,1360,4141
220177,201908,1971,5637,1877,5527,14,45,1835,5408,1849,5453
220180,201908,1133,2840,911,2450,2,12,692,1734,694,1746
220190,201908,6621,17238,5562,15745,376,1192,4156,11709,4532,12901
220191,201908,1428,4497,1309,4281,71,284,959,3043,1030,3327
220192,201908,1872,5056,1444,4289,32,117,1174,3412,1206,3529
220194,201908,1713,4939,1518,4615,69,283,1225,3630,1294,3913
220196,201908,1962,5238,1776,4942,33,145,1495,4049,1528,4194
220198,201908,1299,3565,1076,3274,10,38,990,3035,1000,3073
220200,201908,5072,14792,4435,13941,164,624,3693,11596,3857,12220
220202,201908,2205,6223,1881,5683,30,158,1597,4733,1627,4891
220205,201908,2555,7271,2269,6788,57,256,1902,5547,1959,5803
220207,201908,777,2343,635,2090,62,226,404,1330,466,1556
220208,201908,1685,5276,1363,4629,186,690,751,2495,937,3185
220209,201908,1596,4571,1381,4200,29,130,1109,3324,1138,3454
220210,201908,1631,4151,1394,3772,15,66,1168,3094,1183,3160
220211,201908,1587,4113,1463,3940,21,83,1274,3441,1295,3524
220213,201908,1756,4724,1516,4271,32,122,1220,3322,1252,3444
220217,201908,2079,6281,1961,6152,31,95,1834,5816,1865,5911
220220,201908,10362,27417,8564,24565,549,1423,5944,17606,6493,19029
220225,201908,1080,2812,873,2545,8,39,790,2272,798,2311
220230,201908,5847,14433,5015,13276,198,503,4267,11305,4465,11808
220240,201908,2902,8546,2655,8084,109,359,2130,6485,2239,6844
220245,201908,1651,4021,1296,3573,9,48,1182,3281,1191,3329
220250,201908,3034,8411,2651,7914,18,100,2445,7263,2463,7363
220253,201908,1627,4451,1400,4052,77,259,1149,3215,1226,3474
220255,201908,1856,4556,1561,4117,43,196,1285,3226,1328,3422
220260,201908,4276,13278,3731,12322,169,658,2960,9712,3129,10370
220265,201908,1239,4040,1119,3864,45,200,922,3116,967,3316
220270,201908,6410,20144,5999,19388,224,1042,4994,15577,5218,16619
220271,201908,1470,3784,1272,3508,28,104,1120,3075,1148,3179
220272,201908,1753,5022,1558,4661,76,230,1136,3299,1212,3529
220273,201908,1225,3512,1008,3111,44,171,762,2295,806,2466
220275,201908,2303,5524,1794,4812,33,103,1551,4168,1584,4271
220277,201908,2148,5481,1846,5017,34,109,1558,4138,1592,4247
220280,201908,1645,3928,1344,3506,28,98,1150,2935,1178,3033
220285,201908,1469,3760,1224,3455,15,72,1098,3058,1113,3130
220290,201908,6190,18099,4937,16311,371,1335,3568,11991,3939,13326
220300,201908,1974,5801,1604,5293,41,245,1315,4251,1356,4496
220310,201908,3046,8272,2374,7485,50,244,1959,6114,2009,6358
220320,201908,3040,9047,2347,7708,109,486,1778,5651,1887,6137
220323,201908,1627,4853,1299,4307,66,264,1062,3456,1128,3720
220325,201908,1288,3786,1088,3444,27,129,892,2761,919,2890
220327,201908,1469,4263,1299,3978,51,225,1050,3127,1101,3352
220330,201908,4356,10613,3608,9674,81,246,3175,8410,3256,8656
220335,201908,1755,5227,1562,4988,25,95,1404,4473,1429,4568
220340,201908,1855,4909,1433,4210,56,187,979,2757,1035,2944
220342,201908,1176,3466,1036,3249,49,231,802,2453,851,2684
220345,201908,3121,7079,2458,6126,17,53,2229,5525,2246,5578
220350,201908,3345,8633,2668,7589,138,422,1919,5417,2057,5839
220360,201908,1241,3190,974,2749,20,67,783,2184,803,2251
220370,201908,8827,25319,7972,23971,187,795,6935,20557,7122,21352
220375,201908,1589,4531,1410,4310,7,31,1337,4106,1344,4137
220380,201908,1530,3671,1237,3248,17,55,1071,2752,1088,2807
220385,201908,847,2035,672,1722,12,37,575,1448,587,1485
220390,201908,9529,25539,7401,22148,1902,5552,2905,9479,4807,15031
220400,201908,1499,3632,1132,3067,21,69,869,2280,890,2349
220410,201908,1151,3169,932,2803,50,156,744,2192,794,2348
220415,201908,818,2124,685,1905,18,52,537,1470,555,1522
220420,201908,1969,5471,1592,4758,46,141,1239,3643,1285,3784
220430,201908,2515,6840,2378,6637,89,292,2044,5611,2133,5903
220435,201908,1735,4551,1494,4182,48,163,1203,3282,1251,3445
220440,201908,2386,7594,2059,7064,117,483,1669,5629,1786,6112
220450,201908,2488,6508,2023,5920,98,336,1646,4816,1744,5152
220455,201908,1330,4067,1256,3969,21,96,1117,3519,1138,3615
220460,201908,953,2382,888,2304,30,90,768,1956,798,2046
220465,201908,2370,7386,2087,6935,167,573,1544,5208,1711,5781
220470,201908,3484,9774,3091,9140,84,249,2488,7253,2572,7502
220480,201908,2563,6776,2034,5897,160,415,1416,4071,1576,4486
220490,201908,2424,6220,2108,5799,33,157,1851,5007,1884,5164
220500,201908,2623,6948,2371,6548,46,179,1958,5216,2004,5395
220510,201908,2535,7196,2002,6236,85,258,1556,4854,1641,5112
220515,201908,1671,4045,1515,3825,39,72,1307,3295,1346,3367
220520,201908,4974,12929,4453,12176,106,315,3868,10508,3974,10823
220525,201908,1318,3354,1145,3125,16,73,1033,2772,1049,2845
220527,201908,1350,3759,1147,3449,16,59,971,2973,987,3032
220530,201908,1408,3525,1207,3267,33,117,1108,2945,1141,3062
220535,201908,804,2262,747,2187,40,148,597,1719,637,1867
220540,201908,3301,10509,3098,10129,117,438,2617,8497,2734,8935
220545,201908,1375,4290,1272,4114,71,283,1042,3312,1113,3595
220550,201908,8735,26870,7795,25274,543,1949,5811,18594,6354,20543
220551,201908,1433,4131,1251,3807,31,126,1003,2994,1034,3120
220552,201908,1607,4665,1309,4117,38,184,1030,3123,1068,3307
220553,201908,1612,4361,1405,4074,52,118,1120,3335,1172,3453
220554,201908,874,2313,633,1905,51,115,419,1266,470,1381
220555,201908,2160,6689,1983,6411,56,253,1602,5275,1658,5528
220556,201908,1228,3619,1056,3258,68,275,734,2144,802,2419
220557,201908,1620,4930,1356,4398,71,265,983,3080,1054,3345
220558,201908,1420,3677,1101,3218,25,111,934,2685,959,2796
220559,201908,1645,4242,1391,3839,5,29,1120,3126,1125,3155
220560,201908,1780,4017,1415,3542,35,73,1273,3201,1308,3274
220570,201908,7230,21757,6584,20827,457,1482,5179,16397,5636,17879
220580,201908,6969,19315,6399,18383,105,406,5734,16290,5839,16696
220585,201908,1985,6337,1704,5817,48,166,1383,4760,1431,4926
220590,201908,1325,3658,1080,3272,89,274,764,2312,853,2586
220595,201908,2516,6892,2275,6558,22,93,2037,5821,2059,5914
220600,201908,1407,3152,1170,2846,101,146,963,2415,1064,2561
220605,201908,1656,4810,1396,4344,19,111,1110,3362,1129,3473
220610,201908,2809,8450,2623,8191,31,132,2427,7571,2458,7703
220620,201908,7970,24723,7345,23882,218,1109,6587,21089,6805,22198
220630,201908,363,1084,276,921,27,91,173,586,200,677
220635,201908,1615,5127,1418,4689,55,258,1069,3439,1124,3697
220640,201908,2603,7126,2210,6550,90,362,1769,5167,1859,5529
220650,201908,2046,5677,1754,5201,33,124,1404,4137,1437,4261
220660,201908,2684,8377,2303,7714,98,478,1856,6051,1954,6529
220665,201908,1273,3886,1085,3576,34,178,877,2819,911,2997
220667,201908,1613,5066,1439,4734,68,269,1148,3746,1216,4015
220669,201908,1681,5147,1605,5020,71,312,1372,4188,1443,4500
220670,201908,2210,5816,1762,5181,26,92,1509,4425,1535,4517
220672,201908,3233,7925,2604,7165,120,362,2259,6160,2379,6522
220675,201908,1232,3372,1115,3161,40,121,900,2529,940,2650
220680,201908,2677,7390,2543,7192,110,265,2296,6527,2406,6792
220690,201908,1512,4027,1345,3778,85,232,1052,2962,1137,3194
220695,201908,884,2478,816,2342,20,67,695,1986,715,2053
220700,201908,9638,24055,7626,21218,356,1065,5811,15981,6167,17046
220710,201908,884,2465,658,2026,27,101,499,1495,526,1596
220720,201908,2165,5115,1933,4792,18,67,1654,4036,1672,4103
220730,201908,1296,3656,1098,3326,19,95,937,2768,956,2863
220735,201908,980,2309,743,1928,19,61,619,1548,638,1609
220740,201908,1400,3740,1107,3362,37,106,918,2819,955,2925
220750,201908,3825,9824,3364,9143,221,514,2894,7919,3115,8433
220755,201908,1247,3124,1027,2780,33,119,809,2103,842,2222
220760,201908,3073,8707,2686,8176,96,328,2335,7166,2431,7494
220770,201908,21805,66481,18433,60529,6011,20648,6409,21654,12420,42302
220775,201908,1124,2915,1039,2809,13,54,1001,2691,1014,2745
220777,201908,1650,4205,1247,3563,34,84,936,2661,970,2745
220779,201908,1347,3339,1175,3095,26,80,1017,2657,1043,2737
220780,201908,5535,14201,4842,13104,221,716,3954,10403,4175,11119
220785,201908,1482,3264,1301,3021,9,20,1254,2900,1263,2920
220790,201908,10086,28879,9080,27418,247,1141,7585,22519,7832,23660
220793,201908,901,2381,716,2056,16,40,582,1695,598,1735
220795,201908,1398,3642,1242,3440,16,50,1098,3035,1114,3085
220800,201908,17604,40492,14783,36538,719,1779,11139,27181,11858,28960
220810,201908,2982,8371,2516,7520,50,177,2067,6071,2117,6248
220820,201908,5164,13385,4409,12314,366,883,3264,9161,3630,10044
220830,201908,7274,19414,6525,18331,249,805,5449,15101,5698,15906
220840,201908,12259,37740,10253,33582,2427,7568,4787,16323,7214,23891
220850,201908,3185,9787,2822,9327,68,359,2464,8113,2532,8472
220855,201908,664,1729,572,1584,12,57,501,1356,513,1413
220860,201908,1025,2563,874,2314,25,95,761,1975,786,2070
220865,201908,2528,6681,1951,5681,86,296,1448,4109,1534,4405
220870,201908,2944,8309,2439,7633,39,187,2212,6880,2251,7067
220880,201908,5326,12657,4593,11753,89,318,4195,10590,4284,10908
220885,201908,1377,4272,1134,3862,57,242,902,3084,959,3326
220887,201908,1518,3328,1252,2971,8,28,1166,2731,1174,2759
220890,201908,1460,4557,1252,4204,55,198,1005,3393,1060,3591
220900,201908,2041,4920,1692,4455,34,76,1471,3844,1505,3920
220910,201908,1501,4183,1270,3841,55,181,1044,3135,1099,3316
220915,201908,959,2587,757,2195,7,27,582,1624,589,1651
220920,201908,1378,4546,1184,4278,78,343,940,3384,1018,3727
220930,201908,1637,4539,1420,4209,25,89,1303,3830,1328,3919
220935,201908,1058,3027,843,2579,26,101,573,1650,599,1751
220937,201908,1373,3691,1180,3377,25,96,957,2685,982,2781
220940,201908,1492,4244,1185,3675,41,153,886,2702,927,2855
220945,201908,438,1523,380,1395,19,103,278,990,297,1093
220950,201908,1423,3306,906,2473,15,51,716,1883,731,1934
220955,201908,1597,4138,1339,3686,40,120,1100,2985,1140,3105
220960,201908,831,2121,629,1786,12,48,474,1287,486,1335
220965,201908,1767,4869,1536,4531,24,150,1317,3779,1341,3929
220970,201908,1856,4607,1366,3850,38,101,1121,3123,1159,3224
220975,201908,697,2080,602,1960,23,135,524,1621,547,1756
220980,201908,1178,3313,1042,3122,35,142,867,2560,902,2702
220985,201908,1204,3243,1054,3017,45,153,838,2298,883,2451
220987,201908,1482,4404,1275,4038,63,261,1012,3139,1075,3400
220990,201908,1746,4796,1524,4461,23,125,1264,3614,1287,3739
220995,201908,1134,3412,897,2984,47,173,642,2126,689,2299
220997,201908,2445,7221,2238,6899,52,239,1996,6067,2048,6306
221000,201908,4229,11842,3856,11309,101,492,3287,9432,3388,9924
221005,201908,1494,3960,1355,3725,32,144,1161,3057,1193,3201
221010,201908,1210,2843,972,2541,29,77,837,2138,866,2215
221020,201908,1526,4653,1411,4429,26,113,1067,3308,1093,3421
221030,201908,1611,4122,1378,3826,28,101,1192,3315,1220,3416
221035,201908,1480,3865,1266,3573,25,44,1103,3204,1128,3248
221037,201908,634,1801,525,1603,8,40,363,1051,371,1091
221038,201908,517,1468,409,1259,17,62,282,857,299,919
221039,201908,877,2377,752,2163,17,71,615,1696,632,1767
221040,201908,4105,12307,3593,11381,167,583,2822,8910,2989,9493
221050,201908,3851,10237,3396,9642,58,228,3056,8604,3114,8832
221060,201908,8562,23661,7017,21246,252,755,5636,17134,5888,17889
221062,201908,1183,3850,996,3513,39,193,797,2762,836,2955
221063,201908,1077,3080,912,2839,72,250,654,1991,726,2241
221065,201908,2624,6792,2300,6219,23,104,2005,5306,2028,5410
221070,201908,3276,10306,2727,9173,316,1037,1688,5809,2004,6846
221080,201908,3546,8673,2850,7631,58,222,2338,6150,2396,6372
221090,201908,1412,3692,1140,3210,13,50,976,2674,989,2724
221093,201908,1352,3826,1242,3587,122,352,852,2415,974,2767
221095,201908,903,2344,749,2103,9,26,610,1680,619,1706
221097,201908,818,2152,622,1792,22,71,462,1268,484,1339
221100,201908,109486,295882,92626,267912,11302,34547,59420,167601,70722,202148
221110,201908,10033,29900,9202,28824,187,938,8152,25182,8339,26120
221120,201908,4659,13160,4173,12346,193,612,3536,10381,3729,10993
221130,201908,5146,13621,3816,10985,788,2160,1815,5283,2603,7443
221135,201908,1603,4344,1438,4114,39,141,1266,3598,1305,3739
221140,201908,1304,3152,1104,2883,11,45,974,2482,985,2527
221150,201908,1090,2708,855,2299,21,93,667,1674,688,1767
221160,201908,760,1899,663,1768,23,42,536,1436,559,1478
221170,201908,970,2827,893,2691,26,83,757,2274,783,2357
230010,201908,3192,8385,2549,7244,61,204,1966,5464,2027,5668
230015,201908,3011,9836,2666,9142,199,797,1838,6234,2037,7031
230020,201908,13124,41498,12339,40248,405,1712,10288,33169,10693,34881
230030,201908,12888,32643,10896,29967,206,649,9507,26051,9713,26700
230040,201908,4507,11693,3740,10426,70,309,3074,8416,3144,8725
230050,201908,2801,8805,2082,7054,331,1080,890,2923,1221,4003
230060,201908,2350,6434,1872,5541,39,175,1488,4310,1527,4485
230070,201908,3931,10657,3186,9177,169,536,2166,6153,2335,6689
230075,201908,9215,29816,8431,28430,421,1912,6754,22307,7175,24219
230080,201908,3059,6386,2322,5461,6,21,2105,4956,2111,4977
230090,201908,4236,10589,3595,9537,157,436,2829,7441,2986,7877
230100,201908,18038,47854,16018,44989,1346,3951,11129,31262,12475,35213
230110,201908,12688,37943,10822,34168,1776,5576,5824,18443,7600,24019
230120,201908,7501,20467,6578,18916,553,1452,4738,13820,5291,15272
230125,201908,3140,8377,2553,7414,74,267,1962,5621,2036,5888
230130,201908,5753,17878,4663,15443,332,1201,3086,10033,3418,11234
230140,201908,3458,10456,2942,9382,113,467,2203,6812,2316,7279
230150,201908,1630,4857,1349,4224,215,561,780,2549,995,3110
230160,201908,6574,17181,5622,15684,217,795,4510,12287,4727,13082
230170,201908,6126,17652,5097,15542,311,961,3662,10927,3973,11888
230180,201908,1671,4657,1412,4147,27,122,1120,3165,1147,3287
230185,201908,4269,12367,3614,11248,257,876,2645,8219,2902,9095
230190,201908,13261,39031,11233,35190,1655,5346,6080,18954,7735,24300
230195,201908,5165,15300,4685,14413,342,1057,3564,10913,3906,11970
230200,201908,5035,13911,4263,12420,152,506,3233,9203,3385,9709
230205,201908,4031,12341,3590,11624,161,655,2695,8566,2856,9221
230210,201908,10500,25492,8827,23171,383,1232,6806,17504,7189,18736
230220,201908,13716,34891,12152,32552,527,1492,10072,26646,10599,28138
230230,201908,6908,20908,6162,19337,391,1267,4500,14002,4891,15269
230240,201908,12665,34083,11137,31583,305,1162,9179,25551,9484,26713
230250,201908,9136,26141,8690,25417,296,1068,6793,19271,7089,20339
230260,201908,14690,44506,12814,41072,1615,5148,7402,24063,9017,29211
230270,201908,7450,20423,5737,17177,501,1489,3811,11439,4312,12928
230280,201908,20762,55482,16850,48814,551,2269,13179,36714,13730,38983
230290,201908,4842,13515,4050,11969,311,822,2999,8898,3310,9720
230300,201908,4745,12939,4340,12353,85,317,3773,10580,3858,10897
230310,201908,4711,13447,3973,12145,143,613,2834,8397,2977,9010
230320,201908,7775,22472,6618,20307,289,1141,4978,14941,5267,16082
230330,201908,4721,12969,3833,11251,180,591,2804,8051,2984,8642
230340,201908,3622,11346,3073,10211,290,1001,2021,6645,2311,7646
230350,201908,18186,50757,16022,47308,1003,3423,10300,30622,11303,34045
230360,201908,2828,7778,2266,6738,146,430,1493,4408,1639,4838
230365,201908,3072,7631,2536,6810,45,225,2131,5634,2176,5859
230370,201908,57550,163223,49067,150087,7995,24732,27599,86087,35594,110819
230380,201908,6473,18080,5074,15419,153,597,3683,10961,3836,11558
230390,201908,3347,9961,2914,9249,115,477,2221,6978,2336,7455
230393,201908,3107,9390,2503,8160,82,455,1919,5974,2001,6429
230395,201908,5827,15902,5064,14584,361,993,3488,10061,3849,11054
230400,201908,5730,15964,5065,14829,128,635,3966,11201,4094,11836
230410,201908,14547,43236,11907,38231,1005,3462,7876,25216,8881,28678
230420,201908,28461,79524,23226,69954,2987,9354,12724,38037,15711,47391
230423,201908,4787,14253,4157,12958,93,413,3306,10096,3399,10509
230425,201908,5608,17441,5086,16353,425,1444,3583,11441,4008,12885
230426,201908,2705,7229,1976,5775,31,121,1478,4211,1509,4332
230427,201908,1862,5287,1301,4044,68,231,877,2630,945,2861
230428,201908,9659,26421,8412,24468,1185,3486,4893,14054,6078,17540
230430,201908,4827,13755,3856,12067,158,585,2882,8840,3040,9425
230435,201908,5759,15406,4854,13841,572,1617,3025,8574,3597,10191
230440,201908,409951,1034197,340261,928099,39428,113767,208196,560434,247624,674201
230445,201908,4325,11515,3510,10085,208,574,2372,6700,2580,7274
230450,201908,3696,10776,3192,9968,263,1039,2276,6891,2539,7930
230460,201908,2157,6023,1865,5552,76,297,1522,4497,1598,4794
230465,201908,4029,11370,3436,10245,104,441,2514,7188,2618,7629
230470,201908,11259,37450,10073,35184,848,3551,7166,24558,8014,28109
230480,201908,1424,4146,1191,3722,96,383,834,2495,930,2878
230490,201908,2489,6971,2099,6236,168,550,1316,3694,1484,4244
230495,201908,5878,17579,5146,16208,393,1512,3326,10310,3719,11822
230500,201908,9279,30154,8435,28581,299,1260,6763,22779,7062,24039
230510,201908,1655,5131,1236,4165,199,709,568,1887,767,2596
230520,201908,4555,13013,3952,11901,318,942,2761,8273,3079,9215
230523,201908,15043,44866,12136,38489,2814,8891,3185,10684,5999,19575
230526,201908,3917,11153,3279,10004,163,547,2390,7231,2553,7778
230530,201908,5365,16744,4528,15096,330,1224,3213,10594,3543,11818
230533,201908,4261,10669,3613,9576,98,270,2950,7716,3048,7986
230535,201908,5324,14888,4504,13482,220,695,3182,9578,3402,10273
230540,201908,16227,44491,14057,41196,249,1044,11653,33694,11902,34738
230550,201908,20743,55961,16770,48984,1619,4896,10333,29907,11952,34803
230560,201908,8042,19903,6459,17305,63,274,5511,14591,5574,14865
230565,201908,3053,8541,2544,7587,85,374,1903,5558,1988,5932
230570,201908,3564,9028,3036,8328,70,219,2525,6884,2595,7103
230580,201908,10682,28162,9222,26063,344,1067,7674,21492,8018,22559
230590,201908,8986,25856,7437,22920,442,1597,5348,15916,5790,17513
230600,201908,3685,9686,2839,8125,93,296,1932,5557,2025,5853
230610,201908,6674,18457,5894,17171,476,1355,4556,13227,5032,14582
230620,201908,2096,5699,1576,4663,120,387,961,2760,1081,3147
230625,201908,7948,23021,6717,20692,2032,6470,1776,5838,3808,12308
230630,201908,10776,32355,9352,29368,1732,5158,4937,16041,6669,21199
230640,201908,28233,85600,25395,80922,1507,5876,19639,61596,21146,67472
230650,201908,5183,14221,4374,12760,157,649,3463,9814,3620,10463
230655,201908,9518,32510,8960,31471,694,2593,6919,24471,7613,27064
230660,201908,6165,18378,5001,16234,177,917,4003,12684,4180,13601
230670,201908,6148,14839,4509,12110,136,434,3592,9416,3728,9850
230680,201908,2619,7265,2233,6566,157,463,1556,4590,1713,5053
230690,201908,6962,20797,6072,18983,419,1474,3810,11655,4229,13129
230700,201908,9835,25441,8232,22505,341,992,6134,16346,6475,17338
230710,201908,6862,21659,5910,19638,625,2161,3932,12830,4557,14991
230720,201908,1970,5815,1585,5014,134,406,1034,3191,1168,3597
230725,201908,3929,11988,3486,11127,433,1515,1870,5860,2303,7375
230730,201908,56803,156517,45017,137688,10296,33976,14770,47277,25066,81253
230740,201908,6113,17188,5245,15745,134,550,4168,12378,4302,12928
230750,201908,8495,22885,7059,20448,171,643,5502,15433,5673,16076
230760,201908,11178,29960,9842,27855,610,2012,7240,19926,7850,21938
230763,201908,4669,13068,3954,11720,136,593,3108,8906,3244,9499
230765,201908,41579,115151,34676,103557,5874,18238,16025,47522,21899,65760
230770,201908,25688,64607,21569,58971,2389,6766,13845,37756,16234,44522
230780,201908,6170,21986,5714,20953,820,3058,3333,12507,4153,15565
230790,201908,2993,8718,2656,8141,119,518,1967,5846,2086,6364
230800,201908,8097,26069,7191,24195,832,3064,4233,13933,5065,16997
230810,201908,11922,35697,10579,33460,446,1669,7963,24657,8409,26326
230820,201908,3321,10906,2770,9628,280,1156,1648,5441,1928,6597
230830,201908,7737,21157,6526,19048,167,706,5274,14977,5441,15683
230835,201908,4213,10137,3184,8479,78,236,2611,6835,2689,7071
230837,201908,3154,9759,2716,8949,116,547,2138,6831,2254,7378
230840,201908,8977,26705,7776,24697,645,2079,5631,17981,6276,20060
230850,201908,9525,27926,8051,24953,406,1449,5688,17417,6094,18866
230860,201908,5174,13434,4339,12186,83,300,3728,10345,3811,10645
230870,201908,16700,41170,14336,37227,442,1230,11537,29620,11979,30850
230880,201908,2111,6464,1914,6113,54,287,1482,4589,1536,4876
230890,201908,4595,14836,4194,14032,355,1322,2965,9708,3320,11030
230900,201908,3032,8880,2599,8016,208,718,1697,5083,1905,5801
230910,201908,3018,8222,2449,7272,69,338,1952,5708,2021,6046
230920,201908,4574,13027,3863,11869,155,619,2951,8835,3106,9454
230930,201908,6551,18569,5499,16585,337,1039,3772,11333,4109,12372
230940,201908,7751,20235,6786,18748,208,562,5674,15554,5882,16116
230945,201908,6614,19082,5650,17153,363,1269,3897,11651,4260,12920
230950,201908,6322,15905,5637,15014,128,289,4940,13291,5068,13580
230960,201908,13109,38661,11642,35873,1768,5525,5905,18379,7673,23904
230970,201908,13646,36966,11451,33478,1949,5778,5964,17596,7913,23374
230980,201908,2760,8124,2403,7453,422,1256,1407,4493,1829,5749
230990,201908,1707,4840,1429,4282,73,300,967,2747,1040,3047
231000,201908,2488,6668,2054,5807,77,213,1474,4075,1551,4288
231010,201908,3384,8103,2715,6953,55,200,2302,5700,2357,5900
231020,201908,8081,25851,7218,24063,1321,4146,4061,14032,5382,18178
231025,201908,7496,21138,6548,19547,807,2376,4396,13220,5203,15596
231030,201908,7277,21850,5738,18545,933,2963,3005,9740,3938,12703
231040,201908,3029,8877,2629,8115,111,388,2014,6095,2125,6483
231050,201908,11901,31099,9543,26785,680,1916,6897,18899,7577,20815
231060,201908,2791,7999,2461,7444,75,280,1976,5924,2051,6204
231070,201908,8100,23793,6838,21517,834,2686,4125,12881,4959,15567
231080,201908,4017,11617,3474,10696,144,651,2583,7757,2727,8408
231085,201908,6553,16336,5281,14765,225,597,4040,11287,4265,11884
231090,201908,4349,11469,3210,9225,100,395,2236,6193,2336,6588
231095,201908,2208,6678,1754,5668,144,488,1175,3779,1319,4267
231100,201908,3048,8916,2509,7894,140,499,1873,5841,2013,6340
231110,201908,3539,10627,3259,10097,131,510,2429,7377,2560,7887
231120,201908,2214,6577,1869,5968,92,349,1290,4049,1382,4398
231123,201908,1941,5090,1603,4497,80,208,1150,3193,1230,3401
231126,201908,5614,15626,4458,13370,249,770,3202,9426,3451,10196
231130,201908,20930,54700,17472,50202,1160,4204,12531,35234,13691,39438
231135,201908,4196,11836,3470,10421,153,550,2471,7269,2624,7819
231140,201908,16781,47753,13513,41855,678,2844,9314,27946,9992,30790
231150,201908,5626,15835,4399,13371,722,2218,1976,6095,2698,8313
231160,201908,6125,18908,5430,17570,853,2612,3040,10103,3893,12715
231170,201908,4454,13178,3628,11510,206,746,2457,7529,2663,8275
231180,201908,14321,41233,11796,35737,3128,9250,4137,12811,7265,22061
231190,201908,3865,10957,3235,9776,92,401,2487,7291,2579,7692
231195,201908,4792,14773,4008,13117,221,858,2932,9401,3153,10259
231200,201908,7863,24849,6855,22730,262,1288,5216,16738,5478,18026
231210,201908,4846,14354,4117,13081,191,718,3054,9456,3245,10174
231220,201908,12118,32103,9449,26919,486,1532,6750,18433,7236,19965
231230,201908,9265,29612,8207,27743,473,1909,6040,20367,6513,22276
231240,201908,11708,34640,10299,31872,1637,5001,5929,18490,7566,23491
231250,201908,2062,5363,1324,3700,101,289,785,2135,886,2424
231260,201908,3276,9399,2842,8699,278,814,1880,5894,2158,6708
231270,201908,6535,17096,5350,15124,144,570,4028,11112,4172,11682
231280,201908,1691,5359,1573,5133,107,363,1151,3715,1258,4078
231290,201908,37985,114546,31871,101772,5495,17496,14490,45954,19985,63450
231300,201908,4057,11356,3189,9560,244,781,2030,5963,2274,6744
231310,201908,7283,19238,5836,16502,511,1471,3871,10731,4382,12202
231320,201908,7771,21500,6061,18393,91,430,4677,13980,4768,14410
231325,201908,2527,6787,2045,6015,199,517,1321,3960,1520,4477
231330,201908,9776,29688,8069,26204,1501,4691,4203,14131,5704,18822
231335,201908,5820,15283,4888,13756,83,372,4252,11767,4335,12139
231340,201908,17854,55745,15933,52291,1422,4750,11202,37140,12624,41890
231350,201908,15897,43276,14378,41125,343,1184,12771,36150,13114,37334
231355,201908,4460,13375,3964,12476,237,831,2999,9355,3236,10186
231360,201908,7509,22824,6495,21030,364,1311,4911,15828,5275,17139
231370,201908,2233,6076,1766,5227,36,120,1356,3970,1392,4090
231375,201908,4458,13940,4042,13227,150,679,3301,10659,3451,11338
231380,201908,6004,16256,5429,15463,194,526,4374,12627,4568,13153
231390,201908,3393,9980,3027,9370,154,576,2179,6551,2333,7127
231395,201908,4027,12006,3348,10903,515,1638,1841,6112,2356,7750
231400,201908,9366,27195,7964,24571,316,1287,6014,18129,6330,19416
231410,201908,14809,46333,13330,43857,723,2720,10465,33956,11188,36676
240010,201908,2523,6786,1942,5691,207,659,1159,3293,1366,3952
240020,201908,12142,34678,10309,31350,732,2690,6700,19939,7432,22629
240030,201908,2825,7137,2586,6778,110,344,2236,5762,2346,6106
240040,201908,828,2335,663,2029,30,111,471,1387,501,1498
240050,201908,3153,8498,2613,7500,49,146,2055,5799,2104,5945
240060,201908,1400,3763,1164,3329,35,112,926,2596,961,2708
240070,201908,2149,6318,1981,5980,204,652,1447,4273,1651,4925
240080,201908,2896,7894,2418,7001,59,227,1858,5250,1917,5477
240090,201908,2273,5619,1833,4871,20,65,1530,4005,1550,4070
240100,201908,9846,24742,7903,21118,263,829,6123,15750,6386,16579
240110,201908,4467,12913,3825,11726,204,761,2736,8216,2940,8977
240120,201908,3534,9552,2618,8485,206,771,1755,5819,1961,6590
240130,201908,3632,7628,3041,6846,41,123,2756,6093,2797,6216
240140,201908,1913,5750,1627,5207,182,638,1049,3285,1231,3923
240145,201908,6608,18614,5440,16520,806,2493,3076,9398,3882,11891
240150,201908,883,2606,801,2439,54,191,617,1815,671,2006
240160,201908,1450,4410,1222,3963,52,255,881,2841,933,3096
240165,201908,966,2653,809,2341,48,154,629,1787,677,1941
240170,201908,2403,6676,2024,5974,213,714,1333,3794,1546,4508
240180,201908,3075,9101,2434,7793,570,1742,1113,3752,1683,5494
240185,201908,1246,3986,1131,3798,65,256,914,3032,979,3288
240190,201908,1035,3062,907,2843,25,110,752,2346,777,2456
240200,201908,10855,28462,8803,24827,955,2905,4878,13473,5833,16378
240210,201908,2991,7585,2588,6972,32,153,2176,5655,2208,5808
240220,201908,7394,22279,6604,21018,392,1730,5038,15630,5430,17360
240230,201908,5881,15002,4731,13050,218,602,3728,10248,3946,10850
240240,201908,1905,5496,1181,3692,126,419,460,1253,586,1672
240250,201908,2875,7736,2564,7278,131,345,2089,5949,2220,6294
240260,201908,13918,41431,12059,38168,1713,5173,7388,24448,9101,29621
240270,201908,2230,6676,1952,6236,103,318,1454,4748,1557,5066
240280,201908,1678,4317,1427,3914,52,147,1136,3058,1188,3205
240290,201908,1216,3535,990,3029,30,123,688,1964,718,2087
240300,201908,2182,5667,1560,4462,75,232,1012,2814,1087,3046
240310,201908,8777,23417,6974,20163,903,2726,3658,10408,4561,13134
240320,201908,2058,5606,1482,4467,30,143,1113,3185,1143,3328
240325,201908,30592,83533,23813,71404,4758,14896,9330,28345,14088,43241
240330,201908,1694,4617,1297,3856,44,152,898,2549,942,2701
240340,201908,2016,4693,1650,4116,59,140,1341,3262,1400,3402
240350,201908,2099,5478,1932,5289,27,111,1733,4737,1760,4848
240360,201908,8503,23971,7591,22496,966,2855,5006,15134,5972,17989
240370,201908,1938,5198,1498,4267,82,238,1017,2826,1099,3064
240375,201908,896,2281,750,1997,25,93,602,1532,627,1625
240380,201908,2282,6482,1657,5085,142,419,983,2941,1125,3360
240390,201908,988,2486,671,1854,27,70,428,1109,455,1179
240400,201908,1383,3482,1079,2927,37,143,749,1916,786,2059
240410,201908,561,1741,472,1541,49,210,287,884,336,1094
240420,201908,4664,16547,4087,15223,501,2243,2296,8323,2797,10566
240430,201908,3385,9033,2850,7990,213,674,2025,5455,2238,6129
240440,201908,2625,5847,2194,5237,163,361,1684,3956,1847,4317
240450,201908,4489,12470,3554,10689,324,1099,2097,6044,2421,7143
240460,201908,2934,8444,2678,8028,284,897,2037,6091,2321,6988
240470,201908,3558,10773,2755,9119,433,1373,1469,4993,1902,6366
240480,201908,552,1540,381,1159,29,99,170,499,199,598
240485,201908,2109,6049,1724,5296,147,460,1151,3541,1298,4001
240490,201908,1680,4278,1302,3580,74,180,988,2721,1062,2901
240500,201908,2120,5739,1860,5322,84,266,1533,4349,1617,4615
240510,201908,1695,4484,1506,4213,81,289,1236,3348,1317,3637
240520,201908,1357,3449,1067,3038,48,161,818,2292,866,2453
240530,201908,2046,6106,1870,5808,112,356,1475,4550,1587,4906
240540,201908,2243,5641,1944,5173,63,150,1675,4426,1738,4576
240550,201908,696,1976,632,1854,24,97,494,1388,518,1485
240560,201908,3295,8676,2812,8008,283,731,2036,5897,2319,6628
240570,201908,2864,7541,1893,5372,276,818,770,2003,1046,2821
240580,201908,7973,23328,7135,21811,551,1682,5678,17368,6229,19050
240590,201908,705,1883,613,1724,13,45,466,1291,479,1336
240600,201908,1808,4878,1313,3840,53,184,871,2447,924,2631
240610,201908,4281,11693,3596,10413,143,494,2681,7588,2824,8082
240615,201908,1145,3109,906,2633,59,210,626,1713,685,1923
240620,201908,1842,5200,1565,4700,87,256,1248,3712,1335,3968
240630,201908,2066,5969,1858,5589,137,343,1298,4028,1435,4371
240640,201908,932,2526,737,2188,28,121,542,1566,570,1687
240650,201908,3985,11033,3480,10106,200,596,2671,7678,2871,8274
240660,201908,3037,7844,2687,7378,58,183,2427,6654,2485,6837
240670,201908,2447,6890,1990,5955,141,430,1283,3756,1424,4186
240680,201908,1631,4384,1296,3797,57,196,975,2761,1032,2957
240690,201908,954,2441,749,2094,15,64,604,1620,619,1684
240700,201908,2407,6970,1993,6209,64,247,1562,4767,1626,5014
240710,201908,16322,42591,13659,37915,2041,5496,8013,22349,10054,27845
240720,201908,5246,13273,4534,12186,469,1339,3166,8354,3635,9693
240725,201908,1104,3181,846,2645,36,128,566,1713,602,1841
240730,201908,2135,6062,1798,5404,73,245,1359,4006,1432,4251
240740,201908,1845,4991,1508,4355,50,204,1092,2967,1142,3171
240750,201908,2244,7450,1867,6637,268,1049,992,3542,1260,4591
240760,201908,1552,3758,1094,3056,53,105,845,2403,898,2508
240770,201908,3219,8888,2716,8155,135,534,2144,6290,2279,6824
240780,201908,5203,14239,4136,12428,514,1553,2482,7603,2996,9156
240790,201908,859,2453,704,2141,12,51,527,1560,539,1611
240800,201908,45703,113302,35942,98079,4991,14130,17790,48259,22781,62389
240810,201908,85546,226964,73279,206034,11284,32191,43415,120797,54699,152988
240820,201908,5801,17548,4993,16049,715,2310,3008,9795,3723,12105
240830,201908,8793,25418,7917,24048,272,1205,6421,19129,6693,20334
240840,201908,1141,2876,900,2463,39,102,629,1651,668,1753
240850,201908,1271,3530,918,2763,40,132,526,1538,566,1670
240860,201908,1235,3348,926,2781,17,77,687,1957,704,2034
240870,201908,1134,2882,866,2410,116,329,503,1388,619,1717
240880,201908,1294,4083,1150,3798,83,341,902,2913,985,3254
240890,201908,4596,12625,3446,10360,508,1663,1688,4853,2196,6516
240895,201908,2701,8538,2444,8148,162,589,2063,6855,2225,7444
240910,201908,3238,9004,2781,8118,60,211,2256,6478,2316,6689
240920,201908,831,2357,706,2139,65,186,397,1247,462,1433
240930,201908,3752,8587,3095,7779,195,291,2337,6118,2532,6409
240933,201908,1786,4320,1450,3809,47,183,1233,3178,1280,3361
240940,201908,6239,15460,4905,13180,403,1129,3236,8363,3639,9492
240950,201908,976,2938,857,2708,33,143,695,2141,728,2284
240960,201908,692,2114,612,1947,33,125,469,1451,502,1576
240970,201908,1871,4831,1515,4214,60,221,1243,3345,1303,3566
240980,201908,3188,9624,2874,9038,147,607,2270,6969,2417,7576
240990,201908,2616,7449,2351,6914,279,909,1632,4617,1911,5526
241000,201908,947,2499,756,2132,36,83,547,1542,583,1625
241010,201908,2825,9007,2586,8480,177,703,1890,6064,2067,6767
241020,201908,2062,5583,1510,4441,162,476,947,2728,1109,3204
241025,201908,1732,4975,1359,4242,48,206,957,2935,1005,3141
241030,201908,2522,7939,2039,6898,239,822,1313,4421,1552,5243
241040,201908,2279,7227,2026,6790,96,447,1621,5365,1717,5812
241050,201908,1309,3638,1062,3169,43,145,795,2316,838,2461
241060,201908,731,2084,648,1901,34,107,451,1267,485,1374
241070,201908,642,1757,565,1623,16,52,438,1211,454,1263
241080,201908,1128,3207,860,2665,9,37,630,1929,639,1966
241090,201908,2040,5918,1634,5220,57,281,1280,4014,1337,4295
241100,201908,1143,3232,895,2692,62,195,601,1746,663,1941
241105,201908,1042,3158,837,2758,264,855,261,897,525,1752
241110,201908,919,2639,691,2138,41,145,458,1349,499,1494
241120,201908,7597,21618,6466,19599,1020,3021,3647,11408,4667,14429
241140,201908,3296,8774,2636,7441,174,486,1890,5209,2064,5695
241142,201908,763,2054,552,1630,27,98,321,880,348,978
241150,201908,5963,15704,5279,14547,161,562,4269,11495,4430,12057
241160,201908,1278,3464,1067,3080,142,414,707,1984,849,2398
241170,201908,1326,3382,1151,3083,33,128,953,2421,986,2549
241180,201908,1031,2673,740,2110,75,197,417,1159,492,1356
241190,201908,1115,2929,911,2522,20,72,666,1764,686,1836
241200,201908,19416,51316,16717,47055,2723,7691,9496,26734,12219,34425
241210,201908,1387,3794,991,2987,124,414,564,1635,688,2049
241220,201908,8849,26529,7727,24569,1893,5972,3470,11522,5363,17494
241230,201908,2903,7760,2571,7223,103,352,2129,5843,2232,6195
241240,201908,1202,3403,711,2267,62,205,329,1051,391,1256
241250,201908,5251,15554,4283,13673,182,834,3146,9622,3328,10456
241255,201908,2114,6787,1844,6178,124,525,1325,4300,1449,4825
241260,201908,4887,12901,3800,11012,101,433,2954,8322,3055,8755
241270,201908,1771,5155,1455,4526,129,450,1003,3071,1132,3521
241280,201908,2167,5464,1867,4908,71,193,1550,4011,1621,4204
241290,201908,3447,8448,2573,6996,82,308,2017,5296,2099,5604
241300,201908,1446,3894,1144,3337,41,145,768,2168,809,2313
241310,201908,2060,5256,1756,4834,17,80,1465,4020,1482,4100
241320,201908,1004,3245,826,2880,95,391,513,1772,608,2163
241330,201908,1819,4653,1401,4119,21,84,1181,3461,1202,3545
241335,201908,3126,8847,2786,8206,99,351,2316,6734,2415,7085
241340,201908,1617,4646,1254,3876,267,843,512,1560,779,2403
241350,201908,2000,5830,1771,5407,102,349,1340,4024,1442,4373
241355,201908,1322,3577,1088,3128,22,76,836,2363,858,2439
241360,201908,2106,5468,1565,4343,48,143,1137,3045,1185,3188
241370,201908,1359,3762,1043,3115,58,194,714,2025,772,2219
241380,201908,633,1782,500,1509,79,227,264,816,343,1043
241390,201908,2749,8203,2447,7734,178,567,1885,5987,2063,6554
241400,201908,3523,9802,3160,9263,172,554,2557,7417,2729,7971
241410,201908,2366,7067,1907,6119,343,1136,971,3109,1314,4245
241415,201908,1640,4877,1339,4275,62,243,957,2969,1019,3212
241420,201908,2252,7383,1913,6752,460,1753,849,2987,1309,4740
241430,201908,580,1615,395,1176,29,103,248,702,277,805
241440,201908,7380,23379,6625,22006,388,1536,5188,16948,5576,18484
241445,201908,1098,2834,990,2698,23,58,890,2478,913,2536
241450,201908,2660,6743,2305,6164,382,873,1525,4178,1907,5051
241460,201908,3682,10082,3031,8695,184,568,2118,5914,2302,6482
241470,201908,1436,3731,1141,3296,26,93,932,2668,958,2761
241475,201908,1203,3420,937,2898,26,140,677,1989,703,2129
241480,201908,2849,9007,2383,8007,770,2577,715,2711,1485,5288
241490,201908,675,1622,539,1425,23,68,364,928,387,996
241500,201908,834,2358,730,2220,8,35,646,1975,654,2010
250010,201908,2626,7845,2161,6860,59,238,1555,4792,1614,5030
250020,201908,1585,4308,1113,3370,38,103,813,2418,851,2521
250030,201908,6888,18988,6118,17774,504,1546,4580,13097,5084,14643
250040,201908,4089,12609,3526,11559,228,892,2502,8035,2730,8927
250050,201908,3536,9623,3221,9158,116,428,2637,7403,2753,7831
250053,201908,1172,3367,1060,3187,75,242,767,2304,842,2546
250057,201908,658,2311,618,2247,6,28,555,2057,561,2085
250060,201908,5412,14394,4924,13772,352,925,3930,11102,4282,12027
250070,201908,3996,11283,3471,10345,54,233,2748,7973,2802,8206
250073,201908,754,2029,614,1812,5,24,500,1416,505,1440
250077,201908,2233,6057,1677,5130,72,251,1226,3719,1298,3970
250080,201908,4733,12063,4125,11252,83,342,3544,9519,3627,9861
250090,201908,3167,7888,2779,7363,56,170,2388,6202,2444,6372
250100,201908,3698,11397,3375,10777,176,665,2656,8244,2832,8909
250110,201908,4894,13734,4408,13024,305,1126,3401,9788,3706,10914
250115,201908,646,1752,487,1502,11,56,345,1039,356,1095
250120,201908,1896,5517,1563,4946,37,171,1214,3807,1251,3978
250130,201908,5507,15283,4664,14041,78,416,3839,11351,3917,11767
250135,201908,1181,3241,1055,3036,15,65,939,2674,954,2739
250140,201908,2208,6584,2063,6386,132,600,1727,5196,1859,5796
250150,201908,4845,15246,4361,14372,170,744,3461,11151,3631,11895
250153,201908,1456,3774,1205,3395,28,88,978,2710,1006,2798
250157,201908,1740,5231,1551,4854,83,319,1203,3692,1286,4011
250160,201908,3905,9800,3143,8755,35,157,2800,7743,2835,7900
250170,201908,1831,4699,1633,4407,34,127,1390,3682,1424,3809
250180,201908,19431,48323,16793,44858,862,2702,12877,33553,13739,36255
250190,201908,4083,11098,3447,10101,391,1127,2254,6510,2645,7637
250200,201908,1928,5212,1638,4775,53,175,1381,4005,1434,4180
250205,201908,825,2615,717,2433,25,128,589,1973,614,2101
250210,201908,1586,4819,1428,4560,52,255,1125,3513,1177,3768
250215,201908,1594,4493,1307,4010,76,262,780,2355,856,2617
250220,201908,660,1872,533,1673,38,142,342,1023,380,1165
250230,201908,1599,3673,1152,2988,26,89,915,2280,941,2369
250240,201908,2281,6896,2023,6438,42,182,1704,5349,1746,5531
250250,201908,4598,12792,3974,11862,94,297,3331,9943,3425,10240
250260,201908,1716,4775,1428,4290,42,135,1126,3341,1168,3476
250270,201908,1206,3640,1080,3480,68,232,806,2678,874,2910
250280,201908,3276,9267,2871,8626,103,327,2263,6763,2366,7090
250290,201908,1622,4268,1365,3901,27,81,1075,3093,1102,3174
250300,201908,5505,14764,5021,14196,204,897,4132,11223,4336,12120
250310,201908,1151,3209,969,2899,36,120,741,2176,777,2296
250320,201908,11072,25816,9646,24111,315,901,8409,20689,8724,21590
250330,201908,2337,6646,1963,6153,116,412,1551,4807,1667,5219
250340,201908,1120,2847,980,2657,8,23,869,2330,877,2353
250350,201908,4053,11313,3624,10638,148,379,2909,8780,3057,9159
250355,201908,1989,6039,1774,5740,33,186,1589,5089,1622,5275
250360,201908,1787,4996,1607,4730,35,117,1307,3838,1342,3955
250370,201908,12928,33945,10721,30600,322,1228,8742,24483,9064,25711
250375,201908,1189,3077,963,2799,6,18,895,2633,901,2651
250380,201908,1622,4225,1484,4039,32,131,1265,3312,1297,3443
250390,201908,1787,4634,1515,4190,108,283,1154,3186,1262,3469
250400,201908,71268,175825,51115,144318,13857,41208,15637,45936,29494,87144
250403,201908,1701,4827,1532,4608,76,382,1183,3377,1259,3759
250407,201908,1223,3103,993,2767,59,133,717,2027,776,2160
250410,201908,605,1657,531,1534,6,21,439,1250,445,1271
250415,201908,1837,5226,1626,4877,37,163,1375,4086,1412,4249
250420,201908,1229,3468,1106,3304,14,64,1031,3077,1045,3141
250430,201908,6297,15616,5383,14363,149,489,4425,11561,4574,12050
250435,201908,1561,4344,1264,3829,21,92,947,2809,968,2901
250440,201908,4570,12121,3915,11305,75,252,3415,9830,3490,10082
250450,201908,1823,4923,1530,4518,33,139,1255,3679,1288,3818
250460,201908,7411,20041,6585,18831,352,1055,5300,15069,5652,16124
250470,201908,1575,4044,1297,3627,58,183,990,2699,1048,2882
250480,201908,4170,11208,3591,10521,16,71,3246,9614,3262,9685
250485,201908,732,1669,533,1388,35,73,384,966,419,1039
250490,201908,5013,12223,4491,11605,190,601,3897,9860,4087,10461
250500,201908,2000,5498,1770,5109,74,244,1431,4122,1505,4366
250510,201908,5491,13773,4727,12765,87,268,4146,11224,4233,11492
250520,201908,1833,4989,1577,4623,133,424,1100,3201,1233,3625
250523,201908,2238,5475,1991,5161,77,322,1648,4119,1725,4441
250527,201908,1671,4335,1517,4152,30,86,1317,3632,1347,3718
250530,201908,615,1649,530,1534,9,26,463,1335,472,1361
250535,201908,1349,3979,1233,3754,29,138,997,2933,1026,3071
250540,201908,3013,6911,2477,6308,71,125,2156,5576,2227,5701
250550,201908,771,2498,675,2313,22,98,512,1715,534,1813
250560,201908,1684,4680,1490,4397,49,188,1229,3519,1278,3707
250570,201908,2647,7933,2265,7236,81,326,1775,5548,1856,5874
250580,201908,1073,2786,960,2625,51,176,785,2102,836,2278
250590,201908,833,2345,736,2202,21,95,609,1810,630,1905
250600,201908,8204,21024,6850,19240,320,964,5604,15633,5924,16597
250610,201908,3053,8494,2737,8025,116,441,2261,6515,2377,6956
250620,201908,742,2003,623,1780,14,59,472,1315,486,1374
250625,201908,2560,7390,2295,6961,46,237,1904,5600,1950,5837
250630,201908,9791,27687,8087,24508,896,2795,5201,15387,6097,18182
250640,201908,3349,9428,3050,9016,74,363,2585,7441,2659,7804
250650,201908,935,2291,778,2077,18,57,666,1730,684,1787
250660,201908,1586,3979,1348,3656,42,125,1126,2972,1168,3097
250670,201908,2348,7331,2155,6999,52,235,1845,5852,1897,6087
250680,201908,5991,13689,5294,12888,91,336,4786,11406,4877,11742
250690,201908,6797,15543,5872,14356,106,285,5210,12576,5316,12861
250700,201908,4379,12334,3817,11467,373,1116,2757,8204,3130,9320
250710,201908,4458,12807,3826,11927,296,1029,2745,8525,3041,9554
250720,201908,2774,7350,2495,6946,39,189,2187,5983,2226,6172
250730,201908,4136,11005,3625,10317,112,419,2987,8237,3099,8656
250740,201908,1989,5013,1617,4513,110,304,1227,3402,1337,3706
250750,201908,100585,253965,86280,233622,7637,22473,61165,161900,68802,184373
250760,201908,2375,6129,2069,5634,100,295,1608,4241,1708,4536
250770,201908,3942,12072,3560,11544,356,1202,2561,8292,2917,9494
250780,201908,1726,4701,1442,4174,73,256,1057,2973,1130,3229
250790,201908,2461,7378,2141,6900,192,734,1399,4397,1591,5131
250800,201908,2473,6594,2130,6034,89,189,1734,4941,1823,5130
250810,201908,1279,3447,1031,3077,23,60,873,2622,896,2682
250820,201908,1937,5496,1807,5348,41,182,1637,4802,1678,4984
250830,201908,5774,17293,4821,15386,303,1147,3276,10151,3579,11298
250840,201908,792,2494,666,2233,18,74,481,1621,499,1695
250850,201908,1815,5480,1638,5174,35,181,1350,4138,1385,4319
250855,201908,959,2801,826,2573,65,224,613,1893,678,2117
250860,201908,3140,9460,2623,8538,469,1593,1431,4654,1900,6247
250870,201908,1046,2858,880,2574,35,127,708,2037,743,2164
250880,201908,1610,4172,1318,3741,125,354,937,2661,1062,3015
250890,201908,9957,26709,8971,25344,457,1938,7104,19015,7561,20953
250900,201908,2833,8052,2425,7284,79,287,2022,5930,2101,6217
250905,201908,2369,6779,2164,6471,51,215,1936,5763,1987,5978
250910,201908,6009,14938,4925,13665,103,365,4160,11608,4263,11973
250915,201908,2026,4861,1498,4290,17,42,1330,3879,1347,3921
250920,201908,3520,9008,3078,8325,332,821,2214,5926,2546,6747
250930,201908,2194,5946,1996,5680,59,240,1711,4748,1770,4988
250933,201908,1172,3482,1035,3224,20,105,778,2349,798,2454
250937,201908,716,1946,593,1736,23,83,436,1288,459,1371
250939,201908,1747,4715,1522,4393,59,195,1200,3420,1259,3615
250940,201908,3887,10545,3442,9938,44,167,2975,8538,3019,8705
250950,201908,1682,4315,1354,3898,21,82,1138,3235,1159,3317
250960,201908,1120,3288,979,3057,26,136,787,2359,813,2495
250970,201908,8391,21888,7298,20120,289,935,5847,15735,6136,16670
250980,201908,2498,6691,2239,6285,43,171,1871,5111,1914,5282
250990,201908,2024,6220,1698,5614,67,306,1247,4064,1314,4370
251000,201908,2087,5865,1703,5228,35,149,1393,4238,1428,4387
251010,201908,2649,7465,2403,7075,24,104,2171,6365,2195,6469
251020,201908,1672,4501,1514,4266,34,147,1323,3650,1357,3797
251030,201908,1001,2683,827,2347,35,100,575,1598,610,1698
251040,201908,1860,5365,1570,4855,49,234,1224,3733,1273,3967
251050,201908,1102,2992,917,2634,47,157,660,1822,707,1979
251060,201908,1070,2299,796,1957,7,30,645,1538,652,1568
251065,201908,455,1253,364,1094,15,47,257,741,272,788
251070,201908,738,1986,633,1838,10,37,526,1510,536,1547
251080,201908,18845,48701,15466,43599,1870,5588,9988,28095,11858,33683
251090,201908,2645,7705,2250,6974,52,183,1828,5636,1880,5819
251100,201908,798,2516,712,2364,26,99,542,1738,568,1837
251110,201908,1702,4628,1455,4176,52,152,1116,3159,1168,3311
251120,201908,7080,20405,6021,19041,264,1086,4732,14776,4996,15862
251130,201908,3966,8976,3511,8459,151,383,3080,7363,3231,7746
251140,201908,4267,11973,3844,11357,86,354,3179,9257,3265,9611
251150,201908,2705,7858,2432,7420,118,501,1942,5733,2060,6234
251160,201908,2076,6147,1824,5781,84,328,1505,4699,1589,5027
251170,201908,1539,4256,1371,4042,42,163,1175,3435,1217,3598
251180,201908,2618,7114,2165,6481,176,517,1436,4274,1612,4791
251190,201908,4370,11452,4028,11056,48,236,3644,9797,3692,10033
251200,201908,4267,12568,3810,11968,89,377,3285,10339,3374,10716
251203,201908,941,3082,872,2931,31,133,652,2129,683,2262
251207,201908,1087,3015,847,2602,19,96,587,1746,606,1842
251210,201908,7506,19441,6067,17519,279,714,4605,13464,4884,14178
251220,201908,1196,2935,922,2556,51,119,715,2010,766,2129
251230,201908,4690,12974,4048,11899,141,552,3182,9073,3323,9625
251240,201908,3649,10077,3032,9075,154,487,2264,6616,2418,7103
251250,201908,10062,27343,8897,25397,874,2617,6406,17700,7280,20317
251260,201908,481,1410,441,1336,12,62,341,992,353,1054
251270,201908,4227,13192,3788,12602,108,446,3128,10573,3236,11019
251272,201908,1353,3707,1222,3523,45,190,1020,2835,1065,3025
251274,201908,901,2529,737,2247,55,198,494,1425,549,1623
251275,201908,1242,3469,1059,3186,45,211,789,2264,834,2475
251276,201908,1352,3615,1182,3396,35,170,948,2627,983,2797
251278,201908,563,1598,498,1496,38,108,361,1093,399,1201
251280,201908,2253,6241,2010,5850,51,204,1652,4705,1703,4909
251290,201908,5870,14121,5387,13509,160,588,4668,11225,4828,11813
251300,201908,831,2461,759,2357,8,30,644,1997,652,2027
251310,201908,2804,8065,2442,7482,60,312,1915,5699,1975,6011
251315,201908,1702,5362,1562,5114,74,258,1167,3763,1241,4021
251320,201908,1646,4361,1157,3513,33,120,835,2504,868,2624
251330,201908,2061,4820,1698,4388,25,89,1537,3991,1562,4080
251335,201908,1026,3134,932,2987,27,110,795,2493,822,2603
251340,201908,3700,9096,2943,8052,118,366,2194,5877,2312,6243
251350,201908,1071,3140,952,2944,33,145,780,2348,813,2493
251360,201908,1817,5124,1482,4656,23,102,1268,3982,1291,4084
251365,201908,710,2003,558,1682,10,34,428,1280,438,1314
251370,201908,23241,62995,20293,58780,2404,7242,13176,38371,15580,45613
251380,201908,1197,3446,1063,3212,18,105,881,2562,899,2667
251385,201908,733,1910,572,1625,16,55,421,1142,437,1197
251390,201908,6475,19200,5657,17836,558,1881,3585,11233,4143,13114
251392,201908,990,2697,812,2421,26,117,630,1835,656,1952
251394,201908,603,1795,490,1590,22,89,363,1153,385,1242
251396,201908,708,1913,604,1736,20,62,410,1151,430,1213
251398,201908,935,2416,669,1937,17,70,499,1402,516,1472
251400,201908,1208,3036,981,2716,29,99,760,2023,789,2122
251410,201908,1493,3521,1222,3129,21,92,1042,2576,1063,2668
251420,201908,1928,5175,1588,4777,46,176,1221,3629,1267,3805
251430,201908,1541,4726,1372,4443,35,173,1173,3766,1208,3939
251440,201908,1120,3156,908,2747,31,92,719,2188,750,2280
251445,201908,1521,4357,1408,4185,41,175,1170,3370,1211,3545
251450,201908,4437,13157,3982,12465,97,434,3302,10200,3399,10634
251455,201908,906,2730,816,2567,29,113,613,1898,642,2011
251460,201908,907,2614,801,2442,23,84,654,1990,677,2074
251465,201908,441,1303,377,1170,5,19,279,849,284,868
251470,201908,1179,3282,874,2641,72,241,533,1527,605,1768
251480,201908,1002,2660,830,2358,20,88,634,1724,654,1812
251490,201908,1915,5119,1519,4569,53,175,1111,3324,1164,3499
251500,201908,1933,5504,1770,5266,44,179,1557,4588,1601,4767
251510,201908,2697,8167,2232,7207,136,504,1452,4559,1588,5063
251520,201908,959,2549,728,2108,66,177,475,1346,541,1523
251530,201908,14349,34769,11722,31465,123,684,10335,27182,10458,27866
251540,201908,2857,8422,2590,7917,102,390,2083,6236,2185,6626
251550,201908,3744,8982,2978,8002,83,211,2472,6634,2555,6845
251560,201908,581,1744,507,1626,68,222,338,1044,406,1266
251570,201908,923,2656,750,2290,20,90,575,1698,595,1788
251580,201908,1952,4651,1736,4333,61,212,1485,3566,1546,3778
251590,201908,1604,4091,1360,3798,64,204,1086,2926,1150,3130
251593,201908,886,2653,820,2541,85,284,530,1587,615,1871
251597,201908,2095,5883,1905,5632,25,109,1669,4858,1694,4967
251600,201908,6409,17466,5665,16311,177,584,4698,13307,4875,13891
251610,201908,3317,9407,2818,8467,278,781,1913,5820,2191,6601
251615,201908,1241,3114,993,2717,21,62,783,2084,804,2146
251620,201908,18522,43241,14440,38292,176,570,12098,32516,12274,33086
251630,201908,4686,11119,3775,9857,206,588,2896,7436,3102,8024
251640,201908,2092,5910,1874,5522,42,217,1598,4556,1640,4773
251650,201908,4093,10860,3552,10162,129,412,3018,8605,3147,9017
251660,201908,3480,10411,3061,9659,87,421,2519,7764,2606,8185
251670,201908,4153,11688,3647,10980,51,264,3217,9578,3268,9842
251675,201908,660,1908,592,1818,86,271,383,1180,469,1451
251680,201908,2571,6931,2135,6335,41,159,1708,5057,1749,5216
251690,201908,3198,9058,2699,8157,86,276,2009,5964,2095,6240
251700,201908,1980,5816,1723,5490,45,214,1452,4527,1497,4741
251710,201908,792,2071,539,1543,43,144,302,850,345,994
251720,201908,1324,3769,1082,3332,25,109,819,2442,844,2551
251740,201908,622,1754,498,1515,39,152,346,1002,385,1154
260005,201908,29933,63404,24490,56407,1773,4084,18584,41875,20357,45959
260010,201908,10116,26721,8313,23811,489,1487,4967,14288,5456,15775
260020,201908,6834,16156,5825,14679,128,554,4804,11874,4932,12428
260030,201908,6596,17141,5556,15567,178,572,4455,12382,4633,12954
260040,201908,7831,20824,6468,18704,565,1586,4314,12738,4879,14324
260050,201908,13735,35915,11577,33524,229,838,10399,30305,10628,31143
260060,201908,3984,10165,3408,9221,187,495,2688,7214,2875,7709
260070,201908,10505,26795,8989,24548,425,1464,7024,18648,7449,20112
260080,201908,6605,15146,5774,13993,125,405,4785,11307,4910,11712
260090,201908,4844,12563,4309,11845,565,1548,2940,8138,3505,9686
260100,201908,3036,8249,2563,7532,72,315,2056,5924,2128,6239
260105,201908,5108,13838,4532,13035,144,514,3709,10516,3853,11030
260110,201908,22535,61874,20059,58285,1096,3658,16285,46568,17381,50226
260120,201908,14571,39473,12202,35831,1626,4726,7424,22195,9050,26921
260130,201908,3033,7973,2708,7481,210,625,2000,5405,2210,6030
260140,201908,13167,30150,11289,27828,628,1750,9287,22480,9915,24230
260150,201908,3603,8483,3085,7841,103,343,2641,6592,2744,6935
260160,201908,6674,17467,5599,16095,106,430,4923,14232,5029,14662
260170,201908,19053,46621,16198,42623,1238,3205,12429,32409,13667,35614
260180,201908,3429,9299,2975,8675,91,347,2525,7220,2616,7567
260190,201908,18612,37619,15577,34034,195,565,13634,29077,13829,29642
260200,201908,11158,26883,9610,24912,461,1094,8051,21011,8512,22105
260210,201908,11956,34006,10092,30920,351,1373,7976,24232,8327,25605
260220,201908,10404,25271,9590,24221,186,638,8372,20725,8558,21363
260230,201908,10750,26706,9337,24773,223,726,7763,20204,7986,20930
260240,201908,2748,8193,2392,7517,144,505,1821,5661,1965,6166
260250,201908,2216,5876,1932,5444,119,293,1445,4048,1564,4341
260260,201908,12988,34212,11469,31795,451,1543,8986,24323,9437,25866
260270,201908,4129,10278,3614,9623,139,538,2923,7583,3062,8121
260280,201908,12946,39132,11613,37256,537,2229,9727,30781,10264,33010
260290,201908,39533,102837,34148,94684,3908,11081,22507,61811,26415,72892
260300,201908,9868,26446,8521,24565,244,1027,7019,20111,7263,21138
260310,201908,4874,12787,4336,12083,311,820,3337,9403,3648,10223
260320,201908,7652,22118,6542,20226,269,812,5287,16383,5556,17195
260330,201908,2562,7883,2255,7254,68,267,1812,5672,1880,5939
260340,201908,2063,5547,1769,5088,35,162,1482,4151,1517,4313
260345,201908,24994,66665,21053,60723,3353,10338,10653,29986,14006,40324
260350,201908,5192,12598,4569,11839,103,311,4012,10318,4115,10629
260360,201908,2536,6658,2301,6217,39,181,1585,4191,1624,4372
260370,201908,5574,16042,4814,14729,240,850,3655,11074,3895,11924
260380,201908,4955,14819,4242,13631,176,643,3121,9856,3297,10499
260390,201908,4412,13352,3709,11900,206,691,2520,7891,2726,8582
260392,201908,3472,11044,3065,10522,129,750,2407,8237,2536,8987
260400,201908,17173,40821,14921,37824,583,1738,11589,28220,12172,29958
260410,201908,72683,177994,55624,153785,10148,29578,24797,69979,34945,99557
260415,201908,4515,12438,3878,11323,79,335,3100,8854,3179,9189
260420,201908,12907,26955,10897,24687,141,404,9918,22182,10059,22586
260430,201908,2826,8733,2402,7899,116,460,1677,5453,1793,5913
260440,201908,3731,9865,3257,9077,93,333,2650,7205,2743,7538
260450,201908,5694,14532,5125,13818,301,683,4183,11462,4484,12145
260460,201908,5263,15908,4487,14470,501,1826,2621,8245,3122,10071
260470,201908,5008,13084,4216,12154,116,295,3788,11102,3904,11397
260480,201908,4074,10790,3385,9790,232,826,2300,6670,2532,7496
260490,201908,5333,12379,4705,11417,49,177,4201,9981,4250,10158
260500,201908,6164,15662,5274,14369,456,1223,3658,10008,4114,11231
260510,201908,9669,23966,8113,21779,146,564,7061,18699,7207,19263
260515,201908,4283,11907,3322,10029,147,460,2168,6356,2315,6816
260520,201908,17410,40624,15231,37743,926,2289,12136,29684,13062,31973
260530,201908,9805,28185,8409,25999,187,866,7077,21550,7264,22416
260540,201908,7052,15477,6248,14430,261,611,5459,12516,5720,13127
260545,201908,44,141,17,77,4,15,3,12,7,27
260550,201908,3083,8660,2528,7693,133,541,1647,4882,1780,5423
260560,201908,6062,15491,5107,14114,138,553,4220,11378,4358,11931
260570,201908,7736,21276,6796,19977,451,1450,5243,15387,5694,16837
260580,201908,4469,10647,3978,9982,27,109,3631,9059,3658,9168
260590,201908,6736,15711,5655,14480,242,620,4644,11978,4886,12598
260600,201908,30576,80382,24960,71511,1257,4012,18501,52062,19758,56074
260610,201908,7186,18968,6511,18047,408,1249,4827,13207,5235,14456
260620,201908,16003,42612,14072,39732,1458,4593,9800,27033,11258,31626
260630,201908,2331,6376,1915,5699,38,161,1524,4432,1562,4593
260640,201908,21069,48749,17823,44920,921,2389,14109,35198,15030,37587
260650,201908,5868,15915,4804,14514,177,734,4032,12042,4209,12776
260660,201908,7259,19234,6214,17817,173,742,5210,14583,5383,15325
260670,201908,2185,5729,1799,5142,80,208,1339,3773,1419,3981
260680,201908,27156,65930,22783,59447,1780,4984,15417,39291,17197,44275
260690,201908,3645,9377,2962,8331,106,390,2324,6439,2430,6829
260700,201908,6024,17441,5684,17045,24,75,5498,16624,5522,16699
260710,201908,1347,3597,1186,3377,43,160,898,2552,941,2712
260720,201908,22635,58972,19854,54955,2375,6816,13267,36166,15642,42982
260730,201908,7448,21880,6578,20623,304,1142,5386,16587,5690,17729
260740,201908,1354,3782,1116,3392,12,68,878,2707,890,2775
260750,201908,6973,19480,5948,18133,126,416,5291,16347,5417,16763
260760,201908,5668,13539,4877,12560,209,599,3928,10131,4137,10730
260765,201908,7866,23138,6864,21720,486,2027,4735,14570,5221,16597
260770,201908,3878,10003,3270,8968,91,308,2594,7003,2685,7311
260775,201908,5280,14165,4669,13210,224,825,3542,9666,3766,10491
260780,201908,3672,10948,3267,10282,294,1143,2078,6300,2372,7443
260790,201908,118478,269667,98500,242837,15536,37509,59679,146621,75215,184130
260795,201908,3037,7959,2606,7354,108,366,1970,5544,2078,5910
260800,201908,5438,12760,4850,11917,159,519,4216,9981,4375,10500
260805,201908,3639,10431,3048,9360,183,672,2202,6619,2385,7291
260810,201908,6677,18132,5865,16556,547,1520,4138,11434,4685,12954
260820,201908,4432,10587,3904,9911,131,467,3185,7881,3316,8348
260825,201908,2964,8843,2554,8110,124,470,1880,5863,2004,6333
260830,201908,4324,12591,3589,11242,485,1373,2245,7222,2730,8595
260840,201908,4225,11059,3741,10355,210,551,3085,8539,3295,9090
260845,201908,4236,11360,3793,10553,263,729,2799,7693,3062,8422
260850,201908,4908,13845,4154,12355,368,1177,2650,7630,3018,8807
260860,201908,3544,10028,2982,9044,94,351,2371,6995,2465,7346
260870,201908,4520,10844,3875,10039,90,349,3416,8666,3506,9015
260875,201908,6869,17366,5659,15535,637,1770,3762,10274,4399,12044
260880,201908,9849,27675,8547,25356,504,1473,6643,19748,7147,21221
260890,201908,13343,34641,11619,31990,715,2194,8267,22124,8982,24318
260900,201908,5309,15249,4428,13885,304,1109,2939,9069,3243,10178
260910,201908,3181,8753,2751,8083,106,359,2147,6240,2253,6599
260915,201908,5214,15265,4585,14515,58,288,4143,13126,4201,13414
260920,201908,3336,8408,2837,7838,95,288,2391,6627,2486,6915
260930,201908,3634,11598,3136,10677,178,734,2314,7683,2492,8417
260940,201908,14687,35549,12764,32750,802,2219,9624,24121,10426,26340
260950,201908,6785,18565,5490,16195,417,1430,3344,9366,3761,10796
260960,201908,68005,156450,54736,138707,6603,17502,33618,83535,40221,101037
260970,201908,5349,14333,4755,13520,180,484,3637,10327,3817,10811
260980,201908,4512,13205,4034,12587,66,245,3627,11406,3693,11651
260990,201908,18147,50534,15327,46661,929,3205,11668,35152,12597,38357
261000,201908,16315,38988,13740,35542,466,1673,10770,27119,11236,28792
261010,201908,2442,6348,2122,5911,78,203,1837,5124,1915,5327
261020,201908,6178,16933,5275,15323,249,881,4176,11630,4425,12511
261030,201908,4114,11764,3548,10811,159,586,2771,8225,2930,8811
261040,201908,5221,15491,4222,13482,201,794,3058,9544,3259,10338
261050,201908,7783,20584,7049,19365,460,1032,5165,14200,5625,15232
261060,201908,13941,35347,12244,33205,354,1160,10067,26941,10421,28101
261070,201908,62235,137299,51467,122860,3125,7360,38409,89781,41534,97141
261080,201908,6335,15700,5803,15003,154,397,5296,13657,5450,14054
261090,201908,18571,44870,16489,42155,352,1217,14173,35590,14525,36807
261100,201908,8322,23286,7171,21560,561,1824,5137,15435,5698,17259
261110,201908,63070,178161,52813,160057,8724,27626,28811,86994,37535,114620
261120,201908,3847,9517,3281,8746,91,241,2810,7478,2901,7719
261130,201908,7414,18039,6499,16812,134,386,5689,14611,5823,14997
261140,201908,3612,8390,3217,7863,170,456,2566,6132,2736,6588
261150,201908,5365,14178,4728,13197,97,376,4058,11147,4155,11523
261153,201908,1889,5644,1640,5178,61,240,1123,3541,1184,3781
261160,201908,210131,496674,171311,441966,42551,112895,69097,180562,111648,293457
261170,201908,6033,15170,5374,14169,369,937,4223,11024,4592,11961
261180,201908,9805,24830,8586,23204,489,1390,6127,16472,6616,17862
261190,201908,4716,14023,4210,13138,241,1012,3146,9458,3387,10470
261200,201908,3388,7838,3015,7335,149,391,2498,5951,2647,6342
261210,201908,1956,4711,1644,4275,70,209,1363,3484,1433,3693
261220,201908,13887,39678,11455,35007,1481,4866,6376,19164,7857,24030
261230,201908,4210,12045,3512,11057,67,284,2882,9136,2949,9420
261240,201908,5225,13331,4589,12333,252,709,3755,9930,4007,10639
261245,201908,3594,10221,3038,9227,89,411,2378,6968,2467,7379
261247,201908,2941,8843,2451,7922,149,539,1660,5306,1809,5845
261250,201908,21807,50284,18767,46670,1725,3982,14128,35906,15853,39888
261255,201908,4052,12031,3336,10634,146,641,2442,7504,2588,8145
261260,201908,13060,34967,11212,32591,402,1640,9436,27002,9838,28642
261270,201908,4178,10764,3695,10100,164,549,3077,8232,3241,8781
261280,201908,2598,7321,2283,6769,83,326,1784,5158,1867,5484
261290,201908,2976,7782,2522,7240,86,342,2031,5844,2117,6186
261300,201908,12056,34279,10193,31046,608,2244,7235,21521,7843,23765
261310,201908,8708,22523,7406,20667,734,2277,5216,14141,5950,16418
261320,201908,6027,17102,5241,15735,96,429,4334,12768,4430,13197
261330,201908,6017,14843,5418,14037,146,502,4687,11919,4833,12421
261340,201908,4232,12180,3678,11429,175,694,2910,8888,3085,9582
261350,201908,8799,25727,7808,24047,131,621,6320,19061,6451,19682
261360,201908,8299,20292,7038,18488,258,815,5521,14007,5779,14822
261370,201908,22522,57381,19000,52451,2319,6416,11937,33064,14256,39480
261380,201908,4041,12364,3591,11546,492,1711,2312,7300,2804,9011
261390,201908,16517,47387,13888,43043,1261,4209,8950,27538,10211,31747
261400,201908,4705,14952,4059,13579,173,808,2987,9686,3160,10494
261410,201908,9525,24159,7881,21528,562,1549,6023,16156,6585,17705
261420,201908,7415,22626,6739,21776,804,3020,4637,14820,5441,17840
261430,201908,3465,9769,2901,8891,79,318,2370,7145,2449,7463
261440,201908,1480,4418,1239,3935,40,198,873,2637,913,2835
261450,201908,15169,40867,13469,38201,237,947,11139,31389,11376,32336
261460,201908,7530,20708,6673,19429,182,698,5539,15923,5721,16621
261470,201908,4258,10582,3728,9872,39,188,3152,8322,3191,8510
261480,201908,5069,15671,4373,14474,214,890,3323,10755,3537,11645
261485,201908,5073,14482,4328,13267,393,1326,2954,8873,3347,10199
261500,201908,5772,15028,5042,14026,423,1048,3492,10034,3915,11082
261510,201908,1879,5660,1616,5199,67,250,1190,3873,1257,4123
261520,201908,2421,7429,2191,6946,96,349,1515,4800,1611,5149
261530,201908,11547,34384,9366,30179,1050,3961,4585,14278,5635,18239
261540,201908,8112,23438,7273,22178,1110,3379,4075,12981,5185,16360
261550,201908,3651,9785,3174,9029,225,736,2254,6248,2479,6984
261560,201908,7830,23357,6794,21806,355,1364,5033,16150,5388,17514
261570,201908,3505,9481,2799,8326,208,755,1902,5490,2110,6245
261580,201908,6637,17551,5829,16470,126,586,5167,14375,5293,14961
261590,201908,2715,7013,2162,6200,72,234,1597,4544,1669,4778
261600,201908,5155,13269,4313,11985,398,1001,2867,8245,3265,9246
261610,201908,2350,6486,1925,5772,95,351,1344,3978,1439,4329
261618,201908,2582,6499,2243,6004,83,259,1775,4676,1858,4935
261620,201908,4095,11711,3787,11253,886,2353,2279,7145,3165,9498
261630,201908,6525,18352,5533,16471,395,1428,3616,10256,4011,11684
261640,201908,37354,84360,31983,77598,1781,3648,24261,60288,26042,63936
261650,201908,4233,10540,3661,9785,160,552,2713,7139,2873,7691
270010,201908,4315,14666,3752,13668,174,975,2913,10326,3087,11301
270020,201908,3916,9914,3452,9312,166,538,2876,7590,3042,8128
270030,201908,33490,92552,28502,84527,4022,11737,18450,54918,22472,66655
270040,201908,11213,30116,9630,28219,424,1678,7795,22527,8219,24205
270050,201908,5613,12888,4750,11922,196,489,4163,10479,4359,10968
270060,201908,2086,5408,1751,5017,130,348,1373,3976,1503,4324
270070,201908,4646,13139,4039,12274,150,578,3352,9983,3502,10561
270080,201908,1445,3985,1192,3548,44,143,899,2562,943,2705
270090,201908,1900,5761,1675,5333,76,326,1330,4095,1406,4421
270100,201908,5599,14987,4857,13878,196,754,3917,10894,4113,11648
270110,201908,3325,7971,2662,7176,153,384,2069,5795,2222,6179
270120,201908,2933,7926,2533,7407,79,331,2145,6186,2224,6517
270130,201908,5194,13478,4482,12634,149,486,3790,10711,3939,11197
270135,201908,2065,4937,1746,4577,58,178,1552,4039,1610,4217
270140,201908,9983,23247,8006,20494,358,1301,6267,15157,6625,16458
270150,201908,2759,8198,2553,7903,4,21,2430,7515,2434,7536
270160,201908,5992,16648,5223,15730,65,396,4798,14295,4863,14691
270170,201908,3491,10216,2949,9455,206,944,2166,6656,2372,7600
270180,201908,2270,7019,2064,6744,43,210,1817,5862,1860,6072
270190,201908,1665,4964,1487,4738,45,227,1278,4014,1323,4241
270200,201908,2457,7469,2126,7005,129,492,1536,4981,1665,5473
270210,201908,5800,13781,4986,12854,111,435,4524,11471,4635,11906
270220,201908,1456,3886,1163,3462,220,674,641,1883,861,2557
270230,201908,9498,26850,7863,24262,723,2512,5350,16188,6073,18700
270235,201908,5937,18293,5127,16956,162,726,4089,13307,4251,14033
270240,201908,10800,29375,8728,26632,899,3029,6220,18889,7119,21918
270250,201908,2835,7252,2485,6760,214,556,1903,5213,2117,5769
270255,201908,4630,13267,3557,11267,137,563,2612,8105,2749,8668
270260,201908,5653,16780,5144,15936,115,589,4406,13239,4521,13828
270270,201908,1045,2745,880,2534,111,326,619,1754,730,2080
270280,201908,3977,9552,3153,8505,482,791,2168,6316,2650,7107
270290,201908,7764,24675,6975,23354,234,1057,5915,19526,6149,20583
270300,201908,4182,11074,3281,10084,168,512,2476,7737,2644,8249
270310,201908,7166,20006,6153,18497,142,705,5146,15030,5288,15735
270320,201908,5634,16493,4899,15074,525,1677,3375,10132,3900,11809
270330,201908,3881,12784,3457,12132,264,1112,2617,9094,2881,10206
270340,201908,1651,4535,1417,4216,62,190,1156,3403,1218,3593
270350,201908,1839,4462,1521,4077,173,507,1029,2776,1202,3283
270360,201908,2529,6505,2253,6181,72,188,2046,5636,2118,5824
270370,201908,1417,4427,1278,4152,48,218,1021,3255,1069,3473
270375,201908,3127,7329,2627,6758,19,55,2448,6304,2467,6359
270380,201908,5641,16076,4734,14854,642,2020,2968,9619,3610,11639
270390,201908,1212,3072,987,2801,25,112,796,2235,821,2347
270400,201908,6297,16858,5304,15282,237,741,4093,11563,4330,12304
270410,201908,4643,13563,4031,12575,190,688,3265,10087,3455,10775
270420,201908,5599,16704,5089,15953,159,757,4302,13176,4461,13933
270430,201908,140425,342119,111336,304320,22628,64548,51201,141374,73829,205922
270440,201908,4830,13103,4150,12264,99,435,3534,10293,3633,10728
270450,201908,6878,18843,6121,17926,265,976,5098,14840,5363,15816
270460,201908,3824,8450,3324,7869,111,274,3013,7049,3124,7323
270470,201908,11264,31649,9770,29448,821,2699,7185,21602,8006,24301
270480,201908,2890,7796,2477,7186,120,474,1973,5552,2093,6026
270490,201908,978,2752,854,2598,49,181,671,1999,720,2180
270500,201908,4989,15229,4426,14345,264,1039,3435,10941,3699,11980
270510,201908,5639,15345,4806,14224,404,1592,3487,9788,3891,11380
270520,201908,3927,11356,3091,9862,668,2197,1213,4013,1881,6210
270530,201908,1211,3538,1049,3285,52,155,761,2394,813,2549
270540,201908,2155,6405,1889,6055,66,311,1622,5085,1688,5396
270550,201908,6803,17805,5519,16374,581,1449,4094,12619,4675,14068
270560,201908,3082,8157,2692,7615,171,540,2069,5754,2240,6294
270570,201908,4130,11695,3505,10733,118,464,2847,8580,2965,9044
270580,201908,2340,6624,2124,6306,107,328,1808,5326,1915,5654
270590,201908,1618,4813,1490,4642,17,85,1404,4355,1421,4440
270600,201908,2781,8590,2503,8152,58,305,2192,7024,2250,7329
270610,201908,3728,9750,3185,9023,97,365,2801,7825,2898,8190
270620,201908,1230,3798,1123,3597,46,188,942,2925,988,3113
270630,201908,17282,42797,14990,39575,690,2216,12414,32004,13104,34220
270640,201908,5462,15789,4755,14668,179,719,3832,11519,4011,12238
270642,201908,2495,8067,2209,7593,161,735,1666,5543,1827,6278
270644,201908,3613,9059,2939,8174,250,654,2194,6212,2444,6866
270650,201908,3173,9472,2797,8919,425,1435,1845,5791,2270,7226
270660,201908,2101,5290,1711,4731,91,331,1270,3437,1361,3768
270670,201908,15975,37647,13367,34454,488,1534,11159,28115,11647,29649
270680,201908,5411,13223,4826,12564,135,213,4497,11870,4632,12083
270690,201908,9142,22898,7575,20923,777,2068,5555,15392,6332,17460
270700,201908,544,1635,475,1515,24,100,353,1117,377,1217
270710,201908,5571,16849,5031,16032,251,1100,4080,12667,4331,13767
270720,201908,3467,10366,3065,9676,68,384,2683,8287,2751,8671
270730,201908,8172,18368,7221,17318,268,599,5694,14960,5962,15559
270740,201908,2376,6296,2101,5962,107,382,1718,4745,1825,5127
270750,201908,5651,15135,4961,14227,134,572,4259,12092,4393,12664
270760,201908,3329,9436,2885,8821,59,311,2413,7263,2472,7574
270770,201908,21525,52543,16959,46913,2816,7186,10140,29562,12956,36748
270780,201908,1757,5110,1620,4916,101,372,1304,3879,1405,4251
270790,201908,1554,4488,1308,4123,106,356,864,2692,970,3048
270800,201908,10872,30003,9713,28373,383,1467,8224,23482,8607,24949
270810,201908,3304,9480,2583,8243,192,758,1781,5541,1973,6299
270820,201908,1693,5069,1421,4611,62,267,1093,3456,1155,3723
270830,201908,5348,12855,4325,11587,196,675,3422,8989,3618,9664
270840,201908,8259,24562,7371,23317,202,1100,6392,19652,6594,20752
270850,201908,9093,21916,8114,20704,663,1967,6631,16511,7294,18478
270860,201908,12616,29949,10483,27423,413,1349,8665,22151,9078,23500
270870,201908,2143,6124,1792,5527,225,735,1190,3691,1415,4426
270880,201908,8202,24517,7323,23202,236,1046,5993,18589,6229,19635
270890,201908,2744,7568,2345,7000,189,636,1628,4777,1817,5413
270895,201908,3001,9564,2757,9234,86,471,2406,7862,2492,8333
270900,201908,1781,4608,1338,3891,42,124,1054,3043,1096,3167
270910,201908,3917,11464,3354,10516,110,446,2638,8134,2748,8580
270915,201908,9324,27215,7601,24258,711,2679,5055,15674,5766,18353
270920,201908,5265,16450,4764,15602,210,1001,3829,12074,4039,13075
270930,201908,17429,41159,13611,36660,1896,4601,9144,25558,11040,30159
270940,201908,6422,17402,5549,16324,221,1064,4399,12488,4620,13552
280010,201908,681,1870,548,1585,14,57,383,987,397,1044
280020,201908,4806,12422,4093,11291,517,1359,2686,7453,3203,8812
280030,201908,75051,178687,58522,155085,13373,35711,24661,67898,38034,103609
280040,201908,3028,8520,2630,7913,265,855,1742,5142,2007,5997
280050,201908,3965,11350,3404,10429,570,1828,1974,6046,2544,7874
280060,201908,5584,15015,4466,13276,820,2516,2190,6750,3010,9266
280067,201908,6968,17525,5907,15886,345,979,4236,11100,4581,12079
280070,201908,1926,5835,1801,5622,95,344,1489,4557,1584,4901
280100,201908,3930,10683,3316,9669,328,994,2292,6641,2620,7635
280110,201908,1373,3743,1191,3462,23,108,1030,2920,1053,3028
280120,201908,7557,22133,6754,20801,777,2203,4911,15419,5688,17622
280130,201908,9155,21651,8025,20025,481,1292,6378,15740,6859,17032
280140,201908,5550,13457,4881,12543,246,700,4054,10289,4300,10989
280150,201908,4065,10270,3521,9560,219,589,2852,7702,3071,8291
280160,201908,1261,3621,1034,3219,112,368,672,2037,784,2405
280170,201908,5191,13753,4617,12978,245,724,3662,10229,3907,10953
280190,201908,1225,2763,1041,2505,62,165,814,1905,876,2070
280200,201908,1330,3503,1076,3093,100,356,737,2052,837,2408
280210,201908,16265,41480,14080,38298,1699,4873,8753,23694,10452,28567
280220,201908,1776,4769,1505,4387,41,211,1223,3537,1264,3748
280230,201908,4045,10345,3501,9542,272,680,2516,6828,2788,7508
280240,201908,3406,9099,3048,8561,61,308,2565,6986,2626,7294
280250,201908,857,2189,692,1924,69,212,417,1118,486,1330
280260,201908,2133,5232,1900,4946,42,112,1741,4541,1783,4653
280270,201908,2314,6501,2048,6075,125,453,1691,4880,1816,5333
280280,201908,4169,12627,3714,11969,459,1381,2604,8661,3063,10042
280290,201908,17650,47495,15177,43947,1444,4556,10079,29269,11523,33825
280300,201908,11506,28556,9980,26884,256,841,7674,22076,7930,22917
280310,201908,1369,3540,1121,3108,39,131,829,2223,868,2354
280320,201908,8789,23970,7578,22111,865,2576,4974,14251,5839,16827
280330,201908,4776,11955,3991,10784,281,767,2884,7725,3165,8492
280340,201908,5567,11569,4702,10627,237,429,4046,9283,4283,9712
280350,201908,25379,60656,22072,56099,1309,3602,16954,42229,18263,45831
280360,201908,5965,16716,5183,15350,826,2478,2928,8716,3754,11194
280370,201908,2236,5508,1816,4774,65,175,1421,3638,1486,3813
280380,201908,990,2733,845,2531,82,260,549,1634,631,1894
280390,201908,3623,9147,2985,8089,138,375,2334,6254,2472,6629
280400,201908,4002,10343,3420,9489,486,1222,2097,6062,2583,7284
280410,201908,2231,6287,1771,5487,195,640,1039,3126,1234,3766
280420,201908,4357,11685,3948,11127,94,343,3555,9960,3649,10303
280430,201908,2080,5123,1812,4757,73,293,1443,3647,1516,3940
280440,201908,4402,11908,3833,11039,206,698,3128,8766,3334,9464
280445,201908,2320,5903,2047,5413,52,179,1532,3858,1584,4037
280450,201908,10438,23897,9070,22073,665,1311,6964,17270,7629,18581
280460,201908,6898,16547,6231,15593,442,1058,5130,12737,5572,13795
280470,201908,1745,4971,1494,4509,60,232,1086,3190,1146,3422
280480,201908,41365,101661,35801,93817,3018,8679,25279,64678,28297,73357
280490,201908,3799,10848,3270,9948,91,401,2486,7296,2577,7697
280500,201908,1005,2411,844,2188,34,130,702,1775,736,1905
280510,201908,2576,6709,2211,6167,84,313,1676,4559,1760,4872
280520,201908,1625,4166,1425,3898,76,216,1125,3027,1201,3243
280530,201908,2637,6497,2241,5974,316,724,1552,4227,1868,4951
280540,201908,9045,24334,8208,23098,242,901,7107,19610,7349,20511
280550,201908,6815,15966,5485,14037,246,814,4337,10668,4583,11482
280560,201908,7156,20259,6696,19571,155,596,5818,16755,5973,17351
280570,201908,6518,15995,5252,14355,227,785,3839,10321,4066,11106
280580,201908,5610,15270,4803,14006,530,1481,3312,9697,3842,11178
280590,201908,3035,6919,2542,6323,127,478,1914,4501,2041,4979
280600,201908,3561,9655,3130,9026,167,545,2221,6361,2388,6906
280610,201908,2544,6306,2283,5919,151,391,1841,4711,1992,5102
280620,201908,5420,13481,4593,12363,423,990,3225,8969,3648,9959
280630,201908,3823,10923,3468,10401,174,619,2769,8216,2943,8835
280640,201908,2440,6540,2161,6218,68,205,1908,5492,1976,5697
280650,201908,1261,3290,987,2868,102,333,681,1893,783,2226
280660,201908,3285,7598,2878,7105,124,306,2496,6111,2620,6417
280670,201908,19807,44957,17105,41460,969,2547,13509,32348,14478,34895
280680,201908,2794,6811,2380,6194,205,398,1701,4453,1906,4851
280690,201908,949,2419,791,2197,30,94,592,1606,622,1700
280700,201908,1150,2919,977,2647,24,100,764,2018,788,2118
280710,201908,15229,34230,12844,31501,509,984,10955,27384,11464,28368
280720,201908,2730,6127,2200,5501,83,247,1477,3870,1560,4117
280730,201908,1072,2764,947,2553,52,165,707,1840,759,2005
280740,201908,14382,35195,12194,31835,898,2449,8503,21695,9401,24144
280750,201908,3594,10128,3140,9325,180,617,2245,6528,2425,7145
280760,201908,6309,17200,5522,15967,554,1518,3694,10899,4248,12417
290010,201908,3157,6678,2080,4987,10,35,1682,3820,1692,3855
290020,201908,5506,14565,4980,13870,374,720,4136,11920,4510,12640
290030,201908,4391,10436,3625,9570,176,435,3033,8061,3209,8496
290035,201908,5296,11611,4295,10304,391,629,3325,8340,3716,8969
290040,201908,4329,10535,3651,9698,120,313,2854,7877,2974,8190
290050,201908,2111,6718,1745,5932,124,511,1164,3852,1288,4363
290060,201908,1334,3261,978,2663,77,259,648,1705,725,1964
290070,201908,36682,81857,31443,75178,1985,5022,23650,55777,25635,60799
290080,201908,5477,16140,4648,14885,497,1724,3161,10200,3658,11924
290090,201908,2217,4282,1584,3603,31,82,1422,3202,1453,3284
290100,201908,9989,26455,8136,23621,1260,3441,4501,13512,5761,16953
290110,201908,5194,13941,4632,12975,392,1163,3254,8996,3646,10159
290115,201908,4127,11916,3482,10780,236,801,2572,7874,2808,8675
290120,201908,6678,16460,5535,14956,131,461,4746,12608,4877,13069
290130,201908,4642,11306,3663,10063,160,509,2854,7747,3014,8256
290135,201908,4340,10248,3492,8836,237,607,2604,6394,2841,7001
290140,201908,4625,12305,3633,10966,111,429,3036,9079,3147,9508
290150,201908,2482,6542,2148,6117,158,479,1615,4557,1773,5036
290160,201908,3210,7628,2861,7161,311,684,2164,5459,2475,6143
290170,201908,3308,8558,2929,8124,116,337,2584,7206,2700,7543
290180,201908,3021,8196,2470,7315,83,302,1976,5779,2059,6081
290190,201908,4190,12052,3683,11354,168,697,2977,9023,3145,9720
290195,201908,2392,5986,1884,5260,30,151,1553,4301,1583,4452
290200,201908,4108,11486,3362,10251,236,799,2516,7588,2752,8387
290205,201908,3439,8862,3021,8242,145,526,2352,6196,2497,6722
290210,201908,13437,37424,11793,34913,950,2575,8942,27002,9892,29577
290220,201908,2841,7182,2491,6725,140,397,1998,5344,2138,5741
290225,201908,3361,7155,2621,6364,183,344,2181,5382,2364,5726
290230,201908,2544,6712,2307,6432,37,133,2049,5671,2086,5804
290240,201908,3680,9325,2978,8413,94,318,2467,6918,2561,7236
290250,201908,4093,11854,3467,10944,129,444,2778,8927,2907,9371
290260,201908,5485,13649,4473,12192,201,687,3591,9546,3792,10233
290265,201908,3548,10436,2845,9040,155,590,2080,6504,2235,7094
290270,201908,11404,38770,10727,37584,567,2513,8520,29425,9087,31938
290280,201908,6074,18287,5252,16668,335,1220,3706,11583,4041,12803
290290,201908,10104,29595,8213,26049,861,2997,5332,16595,6193,19592
290300,201908,4272,11688,3169,9576,180,613,2213,6672,2393,7285
290310,201908,1571,3973,1281,3601,77,309,960,2594,1037,2903
290320,201908,24891,65951,19863,58113,4460,12967,9337,28578,13797,41545
290323,201908,3804,10336,3299,9569,103,324,2615,7521,2718,7845
290327,201908,4287,12383,3598,11033,284,829,2479,7557,2763,8386
290330,201908,2178,4595,1710,4086,51,102,1511,3632,1562,3734
290340,201908,5720,14810,4487,13253,503,1542,3178,9499,3681,11041
290350,201908,4767,13265,3921,11818,301,949,2762,8343,3063,9292
290360,201908,5099,13458,4454,12591,129,382,3827,10818,3956,11200
290370,201908,5345,12967,3934,11124,181,426,2897,8343,3078,8769
290380,201908,5677,15061,4796,13842,125,334,4142,12089,4267,12423
290390,201908,14644,41367,12253,37737,1283,3872,8172,25576,9455,29448
290395,201908,2819,8309,2311,7408,74,359,1764,5538,1838,5897
290400,201908,3711,10050,2989,8869,86,373,2269,6533,2355,6906
290405,201908,4641,13628,3917,12346,300,994,2711,8684,3011,9678
290410,201908,5788,15984,4440,13731,129,606,3314,9869,3443,10475
290420,201908,3031,8519,2471,7613,79,291,1890,5780,1969,6071
290430,201908,3152,8764,2572,7837,269,862,1674,5060,1943,5922
290440,201908,2799,7121,1998,5844,40,131,1431,4245,1471,4376
290450,201908,3369,8864,2709,7876,151,470,2004,5800,2155,6270
290460,201908,11983,33800,10128,30241,2085,6308,4626,13688,6711,19996
290470,201908,4504,11319,3337,9672,363,1155,1902,5545,2265,6700
290475,201908,6565,19077,5511,17161,121,610,4380,13295,4501,13905
290480,201908,1786,4557,1491,4126,97,307,1012,2667,1109,2974
290485,201908,4569,13438,4014,12608,124,625,3374,10362,3498,10987
290490,201908,9228,21861,8202,20457,517,1247,6425,16101,6942,17348
290500,201908,4011,12177,3099,10150,544,1875,1380,4388,1924,6263
290510,201908,3430,8684,2867,7948,86,302,2439,6662,2525,6964
290515,201908,3777,10248,3213,9498,60,180,2824,8512,2884,8692
290520,201908,11391,32793,8818,27726,504,1794,5533,17073,6037,18867
290530,201908,5039,14380,4283,13137,150,542,3543,10836,3693,11378
290540,201908,3510,9371,3144,8925,76,256,2843,8029,2919,8285
290550,201908,4361,11339,3776,10654,18,71,3465,9906,3483,9977
290560,201908,6669,17352,5070,14915,464,1661,3301,9333,3765,10994
290570,201908,44087,110020,39496,104110,2646,7204,31376,82021,34022,89225
290580,201908,7879,23378,6839,21840,648,2087,4915,16026,5563,18113
290590,201908,7112,21969,6036,20027,150,615,4861,16129,5011,16744
290600,201908,18803,52585,16713,49224,724,2304,13251,38866,13975,41170
290610,201908,2546,8037,1990,6886,98,423,1373,4677,1471,5100
290620,201908,6623,18505,5695,16956,211,622,4709,13951,4920,14573
290630,201908,9212,22561,7326,20072,609,1642,5598,15429,6207,17071
290640,201908,2777,7223,2102,6211,77,245,1533,4515,1610,4760
290650,201908,12865,32978,11500,31332,2858,7375,6531,18807,9389,26182
290660,201908,3740,9578,3119,8677,55,130,2305,6669,2360,6799
290670,201908,6755,18996,5753,17323,429,1241,4330,13161,4759,14402
290680,201908,10770,30141,9106,27664,209,1105,7420,21982,7629,23087
290682,201908,4713,12409,4122,11578,136,329,3457,9766,3593,10095
290685,201908,3470,7889,2459,6440,193,487,1533,4265,1726,4752
290687,201908,6824,18553,5511,16365,748,2137,3428,10446,4176,12583
290689,201908,2819,7997,2251,6972,125,385,1656,5141,1781,5526
290690,201908,5781,14939,4652,13334,367,1086,3297,9343,3664,10429
290700,201908,2631,7235,2324,6829,85,284,1882,5557,1967,5841
290710,201908,8578,24076,7263,22224,181,750,6105,18584,6286,19334
290720,201908,19126,52219,17321,49452,989,3213,13569,38176,14558,41389
290730,201908,7310,17542,6203,16228,309,667,4757,12549,5066,13216
290740,201908,1078,2936,817,2488,36,143,625,1897,661,2040
290750,201908,11201,28481,9683,25911,781,2255,6896,17818,7677,20073
290755,201908,2109,5947,1698,5185,106,347,1173,3562,1279,3909
290760,201908,3843,11267,3046,9723,230,681,1957,6436,2187,7117
290770,201908,2656,8560,2398,8232,55,281,1992,6885,2047,7166
290780,201908,8465,20927,7244,19269,317,705,5647,15243,5964,15948
290790,201908,4725,12959,4102,12094,153,435,3418,10213,3571,10648
290800,201908,7280,15053,5185,12584,348,791,3799,9319,4147,10110
290810,201908,5654,14975,4493,13220,120,412,3293,9782,3413,10194
290820,201908,5039,13618,4495,12786,205,612,3305,9505,3510,10117
290830,201908,4650,10560,4174,9940,50,144,3613,8457,3663,8601
290840,201908,16973,45773,14746,42253,1886,4544,9456,28505,11342,33049
290850,201908,6530,16098,5871,15369,293,718,4929,13059,5222,13777
290860,201908,6041,17712,5273,16787,228,771,4399,14228,4627,14999
290870,201908,4851,13416,3705,11301,126,444,2593,7791,2719,8235
290880,201908,1417,3566,1124,3176,71,189,775,2250,846,2439
290890,201908,9091,18648,8127,17539,159,372,7576,16236,7735,16608
290900,201908,2383,6315,1801,5323,103,298,1140,3307,1243,3605
290910,201908,5166,12474,3940,10602,46,167,3258,8644,3304,8811
290920,201908,5186,12877,4718,12316,58,131,4412,11583,4470,11714
290930,201908,7969,22278,6381,19477,198,904,4918,14515,5116,15419
290940,201908,3793,10616,3123,9654,177,672,2429,7506,2606,8178
290950,201908,1511,3829,1236,3422,66,184,868,2408,934,2592
290960,201908,5520,14614,4936,13878,159,447,4125,11569,4284,12016
290970,201908,3540,10276,2872,9093,130,470,2151,6788,2281,7258
290980,201908,12071,29494,10152,26458,883,2470,6169,15592,7052,18062
290990,201908,9533,25666,8304,23631,301,1191,6819,18698,7120,19889
291000,201908,3453,9078,2723,8158,150,424,2175,6614,2325,7038
291005,201908,15368,37836,13489,35374,984,2576,10717,27958,11701,30534
291010,201908,3079,9321,2456,8001,130,469,1602,5083,1732,5552
291020,201908,1304,3254,1032,2733,25,88,739,1842,764,1930
291030,201908,2451,6065,1697,4731,98,261,1083,2930,1181,3191
291040,201908,5408,15114,4572,13897,188,779,3561,10700,3749,11479
291050,201908,7598,20410,6546,18881,771,2414,4523,12805,5294,15219
291060,201908,5961,18832,5140,17642,397,1675,3789,12888,4186,14563
291070,201908,16031,43458,13387,39254,520,1797,10684,31042,11204,32839
291072,201908,24719,64554,17813,52121,3458,10469,7348,21608,10806,32077
291075,201908,5360,13606,4745,12607,125,357,3859,10013,3984,10370
291077,201908,1600,4207,1249,3577,46,120,884,2518,930,2638
291080,201908,92753,242888,74117,215445,24377,72610,17777,54984,42154,127594
291085,201908,5720,14478,4766,13018,207,656,3944,10658,4151,11314
291090,201908,2000,3764,1462,3167,33,78,1220,2608,1253,2686
291100,201908,3177,7037,2205,5857,118,352,1676,4369,1794,4721
291110,201908,6041,17996,5109,16377,337,1377,3776,11589,4113,12966
291120,201908,7766,19217,6595,17682,352,1030,4956,13223,5308,14253
291125,201908,2194,3881,1608,3226,136,200,1195,2499,1331,2699
291130,201908,3193,9219,2364,7574,91,410,1682,5186,1773,5596
291140,201908,4830,13239,3530,10790,436,1176,2192,6736,2628,7912
291150,201908,2344,5253,1911,4758,11,33,1788,4442,1799,4475
291160,201908,5193,14409,4291,13061,415,1349,2762,8297,3177,9646
291165,201908,2209,6058,1690,5072,43,191,1208,3452,1251,3643
291170,201908,21124,53731,17662,47884,1024,2997,11410,30439,12434,33436
291180,201908,6039,14355,4547,12237,355,899,3398,9188,3753,10087
291185,201908,3188,8667,2765,7948,85,264,2099,5986,2184,6250
291190,201908,7689,19015,6332,17197,342,1061,4916,13285,5258,14346
291200,201908,2832,7868,2090,6444,95,328,1247,3708,1342,4036
291210,201908,6984,15313,5319,13352,165,545,3939,9887,4104,10432
291220,201908,4107,11805,3700,11164,221,805,2834,8431,3055,9236
291230,201908,4466,9683,3450,8556,52,115,3065,7690,3117,7805
291240,201908,4277,11046,3682,10047,66,231,3144,8433,3210,8664
291250,201908,3472,10216,2708,8823,180,579,1725,5655,1905,6234
291260,201908,1430,3364,1206,3075,34,105,976,2499,1010,2604
291270,201908,5238,13993,4154,12337,638,1884,2625,7926,3263,9810
291280,201908,2569,6522,1947,5551,141,481,1205,3286,1346,3767
291290,201908,5915,15822,4645,13789,391,1265,3108,9149,3499,10414
291300,201908,4023,10758,2993,9046,125,435,2219,6594,2344,7029
291310,201908,5155,13824,4382,12375,117,393,3641,10076,3758,10469
291320,201908,6229,17571,4805,14852,1109,3183,2300,7522,3409,10705
291330,201908,1822,4636,1498,4093,77,212,1089,2895,1166,3107
291340,201908,4242,10989,3485,9716,88,299,2627,7145,2715,7444
291345,201908,3019,9143,2750,8717,126,441,2247,7118,2373,7559
291350,201908,6877,17298,5345,15346,70,226,4531,13236,4601,13462
291360,201908,36786,86275,29243,76885,3266,8754,18281,48893,21547,57647
291370,201908,7991,22046,7136,20780,537,1709,5258,15102,5795,16811
291380,201908,3439,9641,3049,9068,91,433,2504,7301,2595,7734
291390,201908,13196,28876,10357,25711,397,1040,8555,21142,8952,22182
291400,201908,13799,35952,11437,32365,1597,4039,6708,20318,8305,24357
291410,201908,2906,7670,2209,6477,51,220,1613,4600,1664,4820
291420,201908,1964,4862,1543,4336,38,151,1320,3688,1358,3839
291430,201908,2895,8178,2491,7520,108,481,1939,5659,2047,6140
291440,201908,6371,18471,5464,16924,316,1091,4281,13239,4597,14330
291450,201908,8930,22714,7424,20946,111,207,6481,18874,6592,19081
291460,201908,15474,41475,13594,38638,702,2268,10153,28581,10855,30849
291465,201908,9148,23123,7275,20941,191,859,6133,17474,6324,18333
291470,201908,16049,37112,13528,34267,658,1574,10031,26103,10689,27677
291480,201908,41717,93731,30542,78203,3934,10551,15708,40046,19642,50597
291490,201908,5627,14185,4921,13330,162,521,4399,11852,4561,12373
291500,201908,5030,12383,4168,11224,71,303,3733,9988,3804,10291
291510,201908,4117,10518,3146,9232,68,333,2554,7435,2622,7768
291520,201908,4550,10424,3466,8991,179,503,2620,6757,2799,7260
291530,201908,2274,5326,1621,4445,301,744,927,2762,1228,3506
291535,201908,3304,9814,2996,9282,181,538,2286,7201,2467,7739
291540,201908,2290,5206,1597,4354,58,223,1313,3489,1371,3712
291550,201908,5640,13114,4429,11518,418,954,2975,7872,3393,8826
291560,201908,19561,45112,13692,37707,1232,3326,8604,24584,9836,27910
291570,201908,2434,5773,1924,5130,59,153,1581,4337,1640,4490
291580,201908,6317,16625,4962,14768,249,878,3639,10637,3888,11515
291590,201908,1980,5141,1757,4845,110,385,1485,3992,1595,4377
291600,201908,5134,12702,3843,10645,441,1368,2426,6478,2867,7846
291610,201908,5794,15420,5307,14869,100,358,4841,13534,4941,13892
291620,201908,3176,7097,2327,6146,119,316,1794,4813,1913,5129
291630,201908,3266,7438,2418,6343,227,676,1775,4572,2002,5248
291640,201908,15761,39729,11961,34071,1902,5256,5108,15281,7010,20537
291650,201908,9420,23980,8307,22609,552,1120,6921,19280,7473,20400
291660,201908,2092,5151,1523,4242,143,483,966,2519,1109,3002
291670,201908,2112,5517,1782,5056,110,265,1358,3908,1468,4173
291680,201908,4154,10365,3357,9154,320,890,2340,6326,2660,7216
291685,201908,4701,11258,3729,10004,227,469,2810,7817,3037,8286
291690,201908,4259,9444,2892,7469,216,475,2207,5698,2423,6173
291700,201908,8679,25231,7654,23418,381,1354,6168,18553,6549,19907
291710,201908,5375,12979,3992,10995,256,788,2839,7649,3095,8437
291720,201908,4440,13707,3705,12197,409,1466,2421,7751,2830,9217
291730,201908,6374,16564,5491,15395,295,904,4432,12368,4727,13272
291733,201908,2965,7544,2482,6889,69,204,1797,5204,1866,5408
291735,201908,2959,7708,2368,6699,95,274,1794,5031,1889,5305
291740,201908,3900,10123,2919,8384,101,309,2071,5787,2172,6096
291750,201908,19991,48106,16110,42290,1555,4100,10720,28156,12275,32256
291760,201908,10493,30732,8232,26917,2513,9290,2159,7051,4672,16341
291770,201908,7149,19495,5927,17316,440,1354,4256,12095,4696,13449
291780,201908,5111,13714,4608,12967,93,361,3984,11060,4077,11421
291790,201908,2683,7597,2450,7287,263,673,1809,5523,2072,6196
291800,201908,29547,75579,22345,64594,3494,9798,11373,33937,14867,43735
291810,201908,10793,25909,8917,23567,252,735,7612,19994,7864,20729
291820,201908,3855,10245,3342,9537,104,334,2623,7524,2727,7858
291830,201908,4341,10530,3665,9586,211,538,2880,7554,3091,8092
291835,201908,6431,19275,4988,16442,667,2312,2981,9977,3648,12289
291840,201908,48304,132682,41576,122454,4750,14896,28341,83085,33091,97981
291845,201908,2421,6457,1953,5878,105,346,1566,4742,1671,5088
291850,201908,3968,11355,3283,10196,264,755,2330,7441,2594,8196
291855,201908,2224,4437,1743,3881,43,110,1553,3439,1596,3549
291860,201908,2251,5904,1545,4518,44,141,1035,2901,1079,3042
291870,201908,1338,3383,885,2577,57,173,575,1629,632,1802
291875,201908,2762,8315,2416,7618,76,299,1794,5493,1870,5792
291880,201908,5650,16195,4861,14830,258,785,3598,10958,3856,11743
291890,201908,1604,3379,1045,2713,128,304,698,1809,826,2113
291900,201908,1176,2964,913,2534,23,85,713,1924,736,2009
291905,201908,2652,6669,2069,5710,88,296,1538,4100,1626,4396
291910,201908,2963,7497,2478,6913,67,234,2136,5962,2203,6196
291915,201908,7429,21210,6063,18858,250,906,4496,13980,4746,14886
291920,201908,26240,70146,22488,64793,2492,7750,15053,42464,17545,50214
291930,201908,2550,6969,2156,6388,260,800,1395,4112,1655,4912
291940,201908,3919,10116,2585,7826,205,622,1502,4469,1707,5091
291950,201908,9261,28050,7893,25367,394,1452,5343,16991,5737,18443
291955,201908,15277,38634,13665,36510,1255,3480,10490,28117,11745,31597
291960,201908,3166,8444,2578,7599,134,447,1961,5854,2095,6301
291970,201908,4432,11450,3750,10539,157,531,2791,7845,2948,8376
291980,201908,10123,28661,7971,25070,794,2353,5053,16166,5847,18519
291990,201908,2176,5703,1871,5354,27,120,1761,5030,1788,5150
291992,201908,4079,9961,3149,8707,261,625,2445,6867,2706,7492
291995,201908,2156,5813,1724,5163,48,223,1328,3855,1376,4078
292000,201908,2698,6435,2183,5785,110,431,1689,4389,1799,4820
292010,201908,6029,13935,4865,12283,217,629,3943,9737,4160,10366
292020,201908,4574,13310,3803,11924,210,775,2744,8340,2954,9115
292030,201908,1806,5627,1682,5409,83,317,1051,3285,1134,3602
292040,201908,4332,11304,3432,9971,254,688,2607,7751,2861,8439
292045,201908,4042,10629,3002,9085,50,131,2621,8094,2671,8225
292050,201908,6557,18577,5251,16162,279,992,3267,9878,3546,10870
292060,201908,11864,27561,10963,26443,582,1319,9391,22400,9973,23719
292070,201908,5979,15444,5234,14535,293,862,4481,12338,4774,13200
292080,201908,3245,8074,2647,7314,87,287,2320,6377,2407,6664
292090,201908,4579,9931,3281,8382,264,702,2461,6345,2725,7047
292100,201908,10643,26417,9014,24308,1121,3204,5840,15586,6961,18790
292105,201908,3461,8846,3017,8210,89,232,2438,6632,2527,6864
292110,201908,6127,15193,4306,12178,1009,2883,1928,5446,2937,8329
292120,201908,7021,18137,5698,15862,392,1180,4237,11537,4629,12717
292130,201908,3448,8296,2810,7495,120,361,2172,5707,2292,6068
292140,201908,5234,12259,4308,10909,301,753,3406,8560,3707,9313
292145,201908,2358,6873,1970,6180,61,189,1486,4696,1547,4885
292150,201908,13787,38142,12138,35479,315,1300,9968,28654,10283,29954
292160,201908,2998,7351,2270,6415,57,162,1845,5374,1902,5536
292170,201908,8416,22543,6966,20093,430,1402,5040,14282,5470,15684
292180,201908,2869,7848,2099,6457,204,608,1278,3855,1482,4463
292190,201908,2962,7876,2524,7206,133,409,1870,5310,2003,5719
292200,201908,8194,21028,6128,18010,1065,3231,3196,9586,4261,12817
292205,201908,3916,10769,3352,9917,68,317,2930,8572,2998,8889
292210,201908,6392,15118,5176,13548,100,451,4591,11807,4691,12258
292220,201908,2135,5199,1873,4796,64,188,1461,3606,1525,3794
292225,201908,3242,9507,2849,8912,78,364,2389,7334,2467,7698
292230,201908,8656,20666,7703,19416,193,672,6501,16037,6694,16709
292240,201908,4811,14028,4147,12792,323,970,2825,8721,3148,9691
292250,201908,5359,14549,4803,13666,511,1425,3291,9437,3802,10862
292260,201908,3398,8975,3039,8514,129,355,2598,7287,2727,7642
292265,201908,3376,9291,2811,8403,77,353,2178,6359,2255,6712
292270,201908,4390,10064,3508,9007,169,416,2825,7278,2994,7694
292273,201908,2692,5835,2135,5147,68,120,1588,4042,1656,4162
292275,201908,1684,4417,1330,3907,58,145,1002,2991,1060,3136
292280,201908,2647,6283,2135,5690,101,209,1776,4885,1877,5094
292285,201908,2613,6349,2047,5564,85,228,1622,4420,1707,4648
292290,201908,7377,19737,5887,17606,177,677,4780,14245,4957,14922
292300,201908,10297,26429,8062,23457,812,2526,5402,15662,6214,18188
292303,201908,2940,8418,2570,7835,77,204,2146,6576,2223,6780
292305,201908,2485,6621,2282,6335,49,220,2009,5461,2058,5681
292310,201908,6792,17290,5826,16087,169,573,4955,13519,5124,14092
292320,201908,6212,16935,4935,14560,252,792,3623,10414,3875,11206
292330,201908,2824,6164,2217,5477,115,253,1694,4323,1809,4576
292335,201908,4830,12481,4289,11707,266,650,3568,9819,3834,10469
292340,201908,5813,16187,4811,14251,230,705,3527,10311,3757,11016
292350,201908,2589,6916,2111,6265,78,297,1709,5050,1787,5347
292360,201908,4925,13228,4096,11796,266,878,2859,7973,3125,8851
292370,201908,10983,25156,9412,23052,138,487,8653,20796,8791,21283
292380,201908,6960,19504,6194,18133,446,1303,4602,13378,5048,14681
292390,201908,4462,8656,3237,7228,101,206,2836,6333,2937,6539
292400,201908,22392,64541,19441,59692,1848,5954,13280,40614,15128,46568
292405,201908,4248,10570,3548,9487,125,325,2866,7591,2991,7916
292410,201908,2190,5199,1867,4800,62,161,1635,4209,1697,4370
292420,201908,3650,10967,3304,10393,129,615,2755,8448,2884,9063
292430,201908,4883,14661,3735,12581,318,1165,2429,8119,2747,9284
292440,201908,8571,27221,7896,26179,133,691,7039,23251,7172,23942
292450,201908,3918,11363,3116,9771,107,413,2398,7477,2505,7890
292460,201908,4940,13676,4043,12128,389,1118,2831,8518,3220,9636
292465,201908,2642,6912,2195,6291,95,228,1505,4621,1600,4849
292467,201908,1864,5272,1662,4995,241,630,1123,3530,1364,4160
292470,201908,3055,7706,2354,6588,67,137,1816,5082,1883,5219
292480,201908,6500,15348,5155,13723,74,292,4602,12087,4676,12379
292490,201908,2119,5589,1758,5052,108,282,1309,3820,1417,4102
292500,201908,6529,18048,5287,15766,561,1730,3402,10015,3963,11745
292510,201908,12771,34448,10082,30341,514,1888,7263,21728,7777,23616
292520,201908,7031,17601,6187,16359,543,1499,4656,12211,5199,13710
292525,201908,5855,13960,4838,12794,110,313,4187,11134,4297,11447
292530,201908,27583,73933,21334,63398,5571,16729,7819,23960,13390,40689
292540,201908,4302,8127,3395,7142,121,206,3001,6335,3122,6541
292550,201908,8216,21904,6280,19498,456,1489,4545,14639,5001,16128
292560,201908,4318,10929,3719,10124,91,296,3041,8257,3132,8553
292570,201908,3792,9892,3183,8864,81,292,2690,7315,2771,7607
292575,201908,7042,20188,6464,19393,348,1047,5189,15649,5537,16696
292580,201908,7584,19166,6331,17301,137,454,5312,14330,5449,14784
292590,201908,7449,19730,6397,17980,265,844,5340,14692,5605,15536
292593,201908,2897,7135,2387,6280,77,187,1968,5152,2045,5339
292595,201908,5520,14674,4733,13701,174,584,3913,11195,4087,11779
292600,201908,11224,30370,9601,27909,378,1051,7486,21833,7864,22884
292610,201908,4214,11044,3540,9842,205,496,2584,7274,2789,7770
292620,201908,6530,17844,5436,16552,113,285,5013,15492,5126,15777
292630,201908,8645,21191,6999,18543,638,1709,4604,12168,5242,13877
292640,201908,8256,24518,7184,22725,209,896,5060,15988,5269,16884
292650,201908,4636,11325,4123,10647,121,342,3719,9457,3840,9799
292660,201908,11451,31088,9747,28536,488,1562,7476,21791,7964,23353
292665,201908,2202,6545,1937,6207,77,236,1618,5269,1695,5505
292670,201908,3599,9707,2760,8132,132,429,1856,5369,1988,5798
292680,201908,4040,10799,3199,9265,206,569,2279,6456,2485,7025
292690,201908,2669,6964,1853,5607,194,559,1096,3484,1290,4043
292700,201908,9961,27166,8640,25105,801,2193,5828,17415,6629,19608
292710,201908,2472,7740,2281,7479,51,196,2034,6716,2085,6912
292720,201908,9159,21944,7722,20306,268,748,6072,16167,6340,16915
292730,201908,4487,10503,4209,10161,205,331,3679,9020,3884,9351
292740,201908,328376,811300,287910,751091,43280,114140,175330,453154,218610,567294
292750,201908,6344,16880,5503,15627,258,762,4133,11843,4391,12605
292760,201908,3903,11299,3399,10391,247,833,2457,7434,2704,8267
292770,201908,6216,16568,4965,14770,812,2522,2982,9147,3794,11669
292780,201908,2046,4212,1516,3534,41,133,1206,2666,1247,2799
292790,201908,4176,8828,3193,7762,164,431,2669,6492,2833,6923
292800,201908,11197,28233,9639,25838,349,968,7921,20956,8270,21924
292805,201908,3438,8365,2696,7361,118,343,2094,5681,2212,6024
292810,201908,10830,28752,8534,25164,245,1018,6262,17874,6507,18892
292820,201908,7614,20838,5445,17272,495,1648,3655,11424,4150,13072
292830,201908,2927,6882,2478,6322,89,290,2107,5341,2196,5631
292840,201908,8889,23294,7591,21517,171,667,6512,18023,6683,18690
292850,201908,2582,6895,2159,6250,145,467,1479,4205,1624,4672
292860,201908,17196,38284,15296,35932,627,1501,12761,29594,13388,31095
292870,201908,17867,45175,15412,41668,1034,3067,10208,27156,11242,30223
292880,201908,11285,30762,9668,28315,332,1399,7477,21119,7809,22518
292890,201908,6937,19466,6099,18198,242,938,5157,15202,5399,16140
292895,201908,2995,6517,2184,5283,98,245,1726,4104,1824,4349
292900,201908,2635,7236,2415,6885,59,243,1938,5337,1997,5580
292905,201908,4466,11713,3484,10244,174,608,2500,7229,2674,7837
292910,201908,4998,13690,4529,12986,247,764,3380,9582,3627,10346
292920,201908,9891,27206,9194,26193,282,1055,7898,22052,8180,23107
292925,201908,5473,15454,4632,13969,229,709,3357,9950,3586,10659
292930,201908,6671,19865,5674,17909,514,1889,3486,10599,4000,12488
292935,201908,2385,6070,1857,5473,31,136,1645,4860,1676,4996
292937,201908,3036,7376,2634,6875,65,206,2315,6015,2380,6221
292940,201908,3016,7651,2391,6703,193,455,1691,4897,1884,5352
292950,201908,9839,25201,8592,23272,522,1312,6405,17208,6927,18520
292960,201908,5340,12927,4481,11706,128,366,3548,9115,3676,9481
292970,201908,3887,11287,3393,10535,101,478,2812,8703,2913,9181
292975,201908,4529,9828,4003,9223,166,316,3579,8338,3745,8654
292980,201908,3354,8107,2692,7110,90,284,2150,5555,2240,5839
292990,201908,11536,31517,9635,28122,691,2181,7045,20253,7736,22434
293000,201908,2613,6277,2259,5763,43,163,1772,4513,1815,4676
293010,201908,18371,47359,14753,41492,1997,5790,8899,24867,10896,30657
293015,201908,8192,25361,6427,21846,439,1681,4297,14639,4736,16320
293020,201908,9998,29041,8988,27587,146,683,7948,24567,8094,25250
293030,201908,5426,14511,4114,12477,113,396,2796,8638,2909,9034
293040,201908,4029,11081,3437,10247,79,305,2962,8806,3041,9111
293050,201908,22153,55142,19652,51482,1089,3026,14658,37877,15747,40903
293060,201908,3518,9294,2865,8133,252,754,1955,5431,2207,6185
293070,201908,25648,62632,21717,57395,2466,6792,14585,38591,17051,45383
293075,201908,3418,10875,2993,10163,190,797,2346,7932,2536,8729
293076,201908,3661,9012,3271,8521,82,220,2823,7403,2905,7623
293077,201908,6148,17078,4913,15135,471,1525,3110,9829,3581,11354
293080,201908,4806,14161,4136,13029,110,485,3281,10124,3391,10609
293090,201908,3286,9556,2498,8256,229,792,1609,5327,1838,6119
293100,201908,5748,15519,4680,13586,245,768,3604,10313,3849,11081
293105,201908,3716,11782,3260,10841,218,800,2332,7636,2550,8436
293110,201908,2438,6091,2040,5518,70,265,1659,4349,1729,4614
293120,201908,4390,12008,3904,11227,132,359,3226,9274,3358,9633
293130,201908,3806,10445,3342,9829,82,333,2846,8281,2928,8614
293135,201908,30322,72401,22344,61328,3603,10721,10200,28130,13803,38851
293140,201908,2384,5356,2045,4923,74,173,1693,4049,1767,4222
293150,201908,5419,16233,4479,14429,379,1292,3040,9789,3419,11081
293160,201908,3918,9486,3326,8811,273,468,2709,7561,2982,8029
293170,201908,4726,10162,4093,9341,140,305,3499,7923,3639,8228
293180,201908,4488,12515,3650,11032,110,465,2866,8424,2976,8889
293190,201908,14313,39040,12439,36317,189,813,10847,31438,11036,32251
293200,201908,8235,20611,6643,18098,219,840,5261,13979,5480,14819
293210,201908,5330,14042,4485,12694,326,911,3383,9584,3709,10495
293220,201908,5131,13485,3808,11179,889,2632,1478,4450,2367,7082
293230,201908,3990,10269,2972,8786,231,751,2018,6019,2249,6770
293240,201908,4503,11863,3598,10370,80,230,2733,8096,2813,8326
293245,201908,3892,10490,3489,9913,161,501,2914,8175,3075,8676
293250,201908,5773,13687,4822,12442,187,481,3975,10225,4162,10706
293260,201908,4495,12255,3671,10973,130,403,2563,7604,2693,8007
293270,201908,7103,15968,5682,14425,426,685,4408,11931,4834,12616
293280,201908,4754,12497,4131,11624,269,641,3154,8946,3423,9587
293290,201908,14015,42082,12435,39548,2089,6698,7471,24245,9560,30943
293300,201908,5874,14305,5046,13070,301,745,3673,9548,3974,10293
293305,201908,4066,9974,3556,9311,42,122,3161,8238,3203,8360
293310,201908,2205,5599,1808,4935,54,160,1393,3737,1447,3897
293315,201908,4213,10128,3410,8885,185,437,2751,7153,2936,7590
293317,201908,2565,6272,2255,5825,160,341,1744,4549,1904,4890
293320,201908,11481,28667,10426,27445,327,887,9193,24099,9520,24986
293325,201908,1733,4387,1361,3864,189,544,867,2473,1056,3017
293330,201908,48427,145486,40194,130477,8665,28600,17571,58259,26236,86859
293340,201908,2325,6529,1922,5823,113,389,1306,3892,1419,4281
293345,201908,3416,9427,2724,8390,332,795,1841,6085,2173,6880
293350,201908,6746,19122,5878,18121,69,284,5352,16751,5421,17035
293360,201908,15633,39158,13262,36066,365,1433,11539,30784,11904,32217
310010,201908,850,2021,580,1635,52,177,268,707,320,884
310020,201908,2363,6677,1702,5453,366,1289,304,920,670,2209
310030,201908,2003,5817,1566,5014,244,866,926,2849,1170,3715
310040,201908,944,2473,756,2153,40,151,503,1349,543,1500
310050,201908,1556,4753,1344,4407,167,675,818,2577,985,3252
310060,201908,3226,9196,2796,8632,116,480,2265,6900,2381,7380
310070,201908,353,807,245,644,6,14,181,469,187,483
310080,201908,807,2177,541,1637,80,275,215,603,295,878
310090,201908,4614,12488,3753,11057,307,980,2674,7741,2981,8721
310100,201908,3350,9486,2816,8575,92,421,2232,6577,2324,6998
310110,201908,4780,12782,3728,10897,808,2563,1562,4354,2370,6917
310120,201908,659,1651,420,1250,52,186,235,630,287,816
310130,201908,378,1026,321,938,39,142,211,576,250,718
310140,201908,267,785,190,645,42,162,70,207,112,369
310150,201908,5151,13874,3821,11381,594,2006,1700,4784,2294,6790
310160,201908,7562,19591,5445,16050,1163,3722,1783,5214,2946,8936
310163,201908,1059,3143,836,2722,216,792,261,778,477,1570
310170,201908,9089,23574,7280,20723,675,1989,5082,14407,5757,16396
310180,201908,1752,4448,1296,3698,151,499,800,2187,951,2686
310190,201908,2867,8654,2270,7509,526,1919,291,871,817,2790
310200,201908,1807,5468,1307,4431,229,878,537,1773,766,2651
310205,201908,1120,3087,826,2608,162,570,335,1049,497,1619
310210,201908,2689,7165,2180,6280,112,345,1602,4501,1714,4846
310220,201908,1144,3134,888,2670,96,321,585,1698,681,2019
310230,201908,2291,6504,1842,5613,265,922,1070,3023,1335,3945
310240,201908,907,2879,761,2614,51,218,527,1763,578,1981
310250,201908,1037,2794,835,2470,27,115,585,1692,612,1807
310260,201908,2921,7775,1802,5767,530,1962,416,984,946,2946
310270,201908,2745,6876,2141,6040,109,404,1729,4819,1838,5223
310280,201908,2362,5597,1808,4783,291,824,975,2441,1266,3265
310285,201908,1889,6131,1604,5611,179,724,936,3230,1115,3954
310290,201908,1157,3090,957,2732,220,731,500,1264,720,1995
310300,201908,1494,4478,1282,4103,173,680,693,2035,866,2715
310310,201908,306,782,196,579,36,107,99,290,135,397
310320,201908,523,1360,343,1049,28,108,181,533,209,641
310330,201908,478,1131,280,768,40,134,116,278,156,412
310340,201908,7760,21384,6199,18691,948,2774,3034,9409,3982,12183
310350,201908,12703,31200,8589,24378,1806,5424,3344,9148,5150,14572
310360,201908,484,1145,362,984,12,39,265,704,277,743
310370,201908,1286,4062,1069,3632,225,837,320,1106,545,1943
310375,201908,856,2194,579,1771,93,292,264,801,357,1093
310380,201908,403,942,214,614,33,98,94,245,127,343
310390,201908,455,1396,362,1218,96,352,93,250,189,602
310400,201908,9800,24162,6835,19573,861,2853,3821,10568,4682,13421
310410,201908,870,2534,564,1957,98,364,183,587,281,951
310420,201908,4253,11034,2786,8139,406,1339,1036,2712,1442,4051
310430,201908,1517,4199,978,3159,202,736,330,949,532,1685
310440,201908,594,1532,412,1209,33,130,239,672,272,802
310445,201908,1342,3913,997,3229,47,171,707,2233,754,2404
310450,201908,4786,12114,3566,10160,175,653,2635,7253,2810,7906
310460,201908,1636,4397,1127,3435,212,691,332,966,544,1657
310470,201908,3894,8489,3011,7329,299,758,2180,5311,2479,6069
310480,201908,967,2558,725,2115,103,327,446,1257,549,1584
310490,201908,2891,8039,2253,6911,285,1049,1173,3334,1458,4383
310500,201908,1409,4020,1024,3318,184,676,503,1577,687,2253
310510,201908,2011,5367,1265,3925,252,868,439,1366,691,2234
310520,201908,1262,3240,898,2604,135,365,491,1427,626,1792
310530,201908,757,1968,428,1314,64,233,118,283,182,516
310540,201908,3247,9401,2671,8349,615,2017,1125,3360,1740,5377
310550,201908,1256,3253,856,2555,74,267,491,1381,565,1648
310560,201908,14496,38612,10363,31326,1851,6320,3910,10572,5761,16892
310570,201908,1107,2959,869,2612,72,266,586,1714,658,1980
310590,201908,4158,11178,3294,9586,254,861,1863,5102,2117,5963
310600,201908,1409,4180,1133,3611,171,608,569,1694,740,2302
310610,201908,495,1322,308,1000,54,192,152,456,206,648
310620,201908,172077,448504,124810,361545,21002,69696,55458,143379,76460,213075
310630,201908,4474,12418,3588,10714,294,1004,2282,6568,2576,7572
310640,201908,1025,3117,851,2760,190,695,329,986,519,1681
310650,201908,2454,7112,1775,5810,200,695,973,3071,1173,3766
310660,201908,1262,3479,1055,3211,35,124,887,2661,922,2785
310665,201908,1383,3606,1086,3170,36,138,892,2582,928,2720
310670,201908,54031,142338,45228,126776,4857,15747,29648,78458,34505,94205
310680,201908,706,1727,589,1557,21,71,476,1218,497,1289
310690,201908,1794,4832,1303,3986,128,452,716,2074,844,2526
310700,201908,492,1110,382,980,36,122,275,666,311,788
310710,201908,5492,15972,3931,13671,924,3699,543,1744,1467,5443
310720,201908,944,2311,739,2041,46,152,533,1420,579,1572
310730,201908,9695,26666,8273,24310,430,1631,5968,17089,6398,18720
310740,201908,5823,16364,3868,12141,669,2276,1235,3580,1904,5856
310750,201908,1237,3018,880,2480,130,420,401,1025,531,1445
310760,201908,574,1522,413,1268,28,92,211,662,239,754
310770,201908,1090,3055,748,2508,96,381,368,1144,464,1525
310780,201908,4246,10430,3525,9334,101,310,2712,7099,2813,7409
310790,201908,1816,5773,1573,5250,399,1416,333,1039,732,2455
310800,201908,2265,6851,1630,5525,387,1528,104,308,491,1836
310810,201908,1164,3021,932,2575,47,155,643,1712,690,1867
310820,201908,1195,3117,709,2253,148,506,162,509,310,1015
310825,201908,2467,7774,1990,6949,88,512,1549,5174,1637,5686
310830,201908,1596,4656,1082,3573,215,798,440,1359,655,2157
310840,201908,1931,5333,1365,4341,372,1306,325,915,697,2221
310850,201908,1500,4132,1264,3805,59,292,960,2736,1019,3028
310855,201908,3202,8576,2468,7383,198,670,1674,4873,1872,5543
310860,201908,7005,20391,5552,17481,564,1901,3350,10556,3914,12457
310870,201908,1039,2495,794,2131,68,188,573,1544,641,1732
310880,201908,1009,3020,778,2549,104,349,446,1419,550,1768
310890,201908,2311,6588,1465,4919,290,1052,205,600,495,1652
310900,201908,4124,11647,2837,8845,419,1373,1202,3437,1621,4810
310910,201908,1906,4812,1267,3724,120,432,234,611,354,1043
310920,201908,1886,4995,1430,4268,227,727,775,2277,1002,3004
310925,201908,966,2713,781,2390,84,295,513,1490,597,1785
310930,201908,5764,15491,4107,12748,813,2621,1928,6133,2741,8754
310940,201908,6466,15974,5132,13940,257,921,3746,9785,4003,10706
310945,201908,1296,3421,1024,2982,116,388,574,1618,690,2006
310950,201908,1882,5641,1222,4134,237,883,420,1275,657,2158
310960,201908,719,1886,424,1324,81,271,114,346,195,617
310970,201908,1181,3549,814,2746,205,740,154,465,359,1205
310980,201908,314,757,206,582,23,67,127,349,150,416
310990,201908,1265,3614,949,3021,188,624,431,1334,619,1958
311000,201908,4077,11620,3006,9760,769,2669,1162,3622,1931,6291
311010,201908,840,2547,664,2166,237,843,224,696,461,1539
311020,201908,1017,2683,660,2014,54,177,323,960,377,1137
311030,201908,1600,4086,1073,3158,216,730,473,1259,689,1989
311040,201908,324,1039,254,869,70,253,70,219,140,472
311050,201908,2672,6851,2014,5847,398,1297,951,2625,1349,3922
311060,201908,2999,7941,2099,6145,323,1109,815,2158,1138,3267
311070,201908,2227,5791,1583,4712,191,713,780,2173,971,2886
311080,201908,1069,2526,874,2204,42,151,658,1556,700,1707
311090,201908,2048,6621,1598,5762,356,1442,486,1710,842,3152
311100,201908,2134,6200,1286,4455,270,1056,196,612,466,1668
311110,201908,3692,7721,2036,5357,402,1117,752,2015,1154,3132
311115,201908,1328,3136,1083,2790,68,182,850,2147,918,2329
311120,201908,6576,17528,4882,14355,767,2547,1730,4509,2497,7056
311130,201908,1901,5069,1429,4398,134,529,762,2247,896,2776
311140,201908,1410,3506,1052,2996,79,257,663,1870,742,2127
311150,201908,1580,5019,1232,4330,202,795,648,2191,850,2986
311160,201908,3740,10943,2597,8791,687,2618,734,2398,1421,5016
311170,201908,874,2281,694,2023,43,123,439,1341,482,1464
311180,201908,1339,3070,839,2317,167,493,372,1020,539,1513
311190,201908,998,2765,723,2211,114,391,278,758,392,1149
311200,201908,1905,5265,1317,4087,295,994,392,1097,687,2091
311205,201908,883,2712,726,2387,44,203,428,1339,472,1542
311210,201908,1017,3000,884,2827,119,356,641,2097,760,2453
311220,201908,748,2120,613,1875,59,206,357,1021,416,1227
311230,201908,7770,23566,5741,19382,992,3494,2103,7235,3095,10729
311240,201908,986,2661,754,2334,167,563,338,1025,505,1588
311250,201908,920,2656,713,2282,171,551,299,926,470,1477
311260,201908,2526,6351,1567,4655,273,872,613,1690,886,2562
311265,201908,1293,3416,956,2836,44,171,661,1877,705,2048
311270,201908,3027,9070,2616,8381,173,763,1910,5812,2083,6575
311280,201908,1185,3135,528,1742,101,356,68,205,169,561
311290,201908,1890,5824,1733,5485,172,562,1152,3624,1324,4186
311300,201908,4714,13458,3849,11953,226,961,2968,8955,3194,9916
311310,201908,577,1637,485,1465,55,183,261,748,316,931
311320,201908,3125,9689,2636,8577,423,1575,1181,3512,1604,5087
311330,201908,4907,13269,3966,11697,440,1435,2195,6535,2635,7970
311340,201908,10300,29515,8058,25402,2300,7824,1982,5937,4282,13761
311350,201908,2287,5800,1578,4478,155,520,841,2120,996,2640
311360,201908,1121,2803,700,2113,220,756,198,545,418,1301
311370,201908,4535,11277,3325,9270,172,682,2104,5515,2276,6197
311380,201908,386,1193,294,1003,75,265,105,368,180,633
311390,201908,1694,5312,1328,4787,555,2290,327,1012,882,3302
311400,201908,1417,4017,1029,3265,146,498,408,1149,554,1647
311410,201908,1616,4794,1329,4391,219,824,715,2380,934,3204
311420,201908,1544,4586,1038,3488,190,695,196,526,386,1221
311430,201908,3620,9838,2335,7229,472,1499,678,2102,1150,3601
311440,201908,2521,7318,1777,5986,395,1541,566,1824,961,3365
311450,201908,1745,5344,1261,4406,314,1218,310,933,624,2151
311455,201908,976,2259,657,1778,181,496,232,639,413,1135
311460,201908,488,1540,328,1211,71,336,86,272,157,608
311470,201908,461,1467,308,1093,77,327,45,141,122,468
311480,201908,1138,3090,963,2830,54,146,760,2276,814,2422
311490,201908,243,724,183,597,38,148,81,224,119,372
311500,201908,423,1066,315,896,30,102,194,530,224,632
311510,201908,3066,8216,2017,6293,330,1172,780,2228,1110,3400
311520,201908,570,1677,514,1563,92,322,281,817,373,1139
311530,201908,8842,21053,5527,15591,1358,4262,1379,3730,2737,7992
311535,201908,756,2089,503,1578,75,251,162,473,237,724
311540,201908,513,1628,449,1514,83,303,274,904,357,1207
311545,201908,2048,5882,1769,5480,100,381,1335,4055,1435,4436
311547,201908,1477,3844,1288,3547,45,145,902,2521,947,2666
311550,201908,2751,7855,2160,6714,332,1174,883,2622,1215,3796
311560,201908,292,644,189,499,27,81,102,238,129,319
311570,201908,1792,4184,1270,3450,45,136,991,2728,1036,2864
311580,201908,2223,4151,1434,3225,157,321,943,2155,1100,2476
311590,201908,492,1344,399,1207,68,232,209,611,277,843
311600,201908,1741,3931,1468,3598,56,139,1254,3025,1310,3164
311610,201908,2318,7751,1915,6831,258,986,974,3435,1232,4421
311615,201908,3050,8992,2501,8059,150,563,1893,5979,2043,6542
311620,201908,438,1187,376,1108,20,80,303,878,323,958
311630,201908,1355,3761,1080,3214,91,293,707,2006,798,2299
311640,201908,546,1574,424,1342,74,278,197,579,271,857
311650,201908,1883,4947,1552,4415,140,456,1024,2807,1164,3263
311660,201908,2809,8144,2019,6603,379,1366,485,1331,864,2697
311670,201908,1539,4069,1102,3297,170,578,463,1382,633,1960
311680,201908,2168,6329,1612,5281,212,704,995,3245,1207,3949
311690,201908,579,1250,441,1076,44,100,312,800,356,900
311700,201908,2272,5483,1763,4759,31,139,1460,3806,1491,3945
311710,201908,1501,4380,1036,3485,250,910,386,1272,636,2182
311720,201908,406,1233,318,1062,26,113,178,573,204,686
311730,201908,4170,10694,2606,7748,776,2479,453,1363,1229,3842
311740,201908,853,2359,719,2184,37,101,620,1928,657,2029
311750,201908,3908,11972,3188,10682,466,1713,1753,5614,2219,7327
311760,201908,608,1786,508,1604,80,329,231,608,311,937
311770,201908,2032,5968,1559,5072,269,975,676,2086,945,3061
311780,201908,1297,3822,866,2924,170,653,241,708,411,1361
311783,201908,2212,6173,1800,5439,56,248,1410,4097,1466,4345
311787,201908,709,2090,514,1631,82,298,191,517,273,815
311790,201908,1474,3941,952,2992,249,858,256,762,505,1620
311800,201908,4891,14882,3931,12757,783,2732,638,1828,1421,4560
311810,201908,967,2997,759,2603,57,223,464,1574,521,1797
311820,201908,797,2006,585,1659,86,281,330,869,416,1150
311830,201908,8553,25089,5811,18999,1603,5617,676,2116,2279,7733
311840,201908,3345,8833,2809,8050,279,848,2030,5767,2309,6615
311850,201908,325,883,263,770,17,49,169,476,186,525
311860,201908,57376,147879,43605,124125,6794,20651,23506,64023,30300,84674
311870,201908,1967,5275,1282,4006,214,740,457,1279,671,2019
311880,201908,6281,16456,5224,14942,312,830,3943,11399,4255,12229
311890,201908,1558,3914,1202,3390,97,325,816,2188,913,2513
311900,201908,732,1917,547,1650,66,234,355,1040,421,1274
311910,201908,4207,10898,3136,9486,598,1804,1532,4730,2130,6534
311920,201908,2046,5671,1620,5014,130,387,976,3066,1106,3453
311930,201908,3369,8309,2500,7049,872,2637,731,1918,1603,4555
311940,201908,14468,38971,10600,31533,1559,5109,4763,13242,6322,18351
311950,201908,2160,6059,1573,5016,93,413,1005,3116,1098,3529
311960,201908,529,1332,425,1171,29,125,267,640,296,765
311970,201908,438,1430,291,1054,56,223,57,175,113,398
311980,201908,456,1262,229,785,31,115,66,223,97,338
311990,201908,554,1341,359,1057,80,281,148,386,228,667
311995,201908,995,2795,504,1626,19,63,62,137,81,200
312000,201908,608,1625,504,1474,47,152,325,943,372,1095
312010,201908,905,2573,691,2194,65,228,402,1213,467,1441
312015,201908,1350,4060,1191,3784,68,311,914,2806,982,3117
312020,201908,1258,3913,974,3342,233,841,275,901,508,1742
312030,201908,2036,5031,1769,4725,24,103,1625,4310,1649,4413
312040,201908,791,2520,596,2073,60,228,257,868,317,1096
312050,201908,1238,3969,974,3423,218,883,273,844,491,1727
312060,201908,855,2149,558,1761,147,472,241,764,388,1236
312070,201908,898,2669,636,2132,65,249,308,979,373,1228
312080,201908,2750,6891,2051,5840,135,451,1288,3482,1423,3933
312083,201908,865,2312,649,1973,59,216,411,1193,470,1409
312087,201908,2387,6372,1952,5680,60,197,1515,4410,1575,4607
312090,201908,9700,26141,7399,22327,1235,4149,3456,10119,4691,14268
312100,201908,1576,4712,1156,3920,117,523,581,1879,698,2402
312110,201908,1025,3241,856,2884,218,854,268,805,486,1659
312120,201908,774,2147,533,1718,155,576,167,446,322,1022
312125,201908,1705,4524,1429,4104,133,430,1022,2830,1155,3260
312130,201908,940,2343,692,1933,63,186,276,726,339,912
312140,201908,744,2196,612,1925,129,444,253,722,382,1166
312150,201908,455,1296,384,1138,16,71,270,737,286,808
312160,201908,8153,23231,6123,19493,847,3102,2791,8301,3638,11403
312170,201908,919,2493,681,2036,38,144,450,1293,488,1437
312180,201908,1363,3755,1067,3154,167,527,518,1460,685,1987
312190,201908,586,1719,408,1356,83,297,102,327,185,624
312200,201908,4755,12820,3730,11180,1113,3339,1371,4213,2484,7552
312210,201908,1361,3184,972,2603,44,140,686,1777,730,1917
312220,201908,1789,5551,1526,5050,122,437,941,3109,1063,3546
312230,201908,12535,33483,8202,25413,2111,7252,1500,4024,3611,11276
312235,201908,1875,4982,1499,4387,87,320,1054,2999,1141,3319
312240,201908,686,2286,511,1899,113,456,146,530,259,986
312245,201908,2578,6856,2110,6133,75,259,1683,4850,1758,5109
312247,201908,914,2310,643,1896,124,391,315,931,439,1322
312250,201908,995,2673,633,1941,83,262,260,794,343,1056
312260,201908,871,2495,700,2214,41,174,495,1496,536,1670
312270,201908,707,1963,534,1623,33,141,288,786,321,927
312280,201908,432,1286,336,1109,105,353,45,134,150,487
312290,201908,736,2233,590,1951,129,493,198,616,327,1109
312300,201908,936,2842,635,2115,161,581,117,317,278,898
312310,201908,801,2605,653,2296,103,406,292,991,395,1397
312320,201908,1870,4954,1342,3996,344,1069,269,779,613,1848
312330,201908,875,2618,691,2240,71,246,431,1359,502,1605
312340,201908,262,682,183,549,46,161,62,160,108,321
312350,201908,267,560,197,482,19,56,135,316,154,372
312352,201908,1624,4870,1418,4506,107,354,864,2901,971,3255
312360,201908,2589,7687,1874,6208,383,1372,505,1615,888,2987
312370,201908,1784,4858,1453,4275,223,737,772,2149,995,2886
312380,201908,2187,4949,1800,4462,14,48,1590,3901,1604,3949
312385,201908,1273,3574,977,3021,154,530,460,1360,614,1890
312390,201908,1889,5560,1399,4613,212,792,484,1437,696,2229
312400,201908,2827,8431,2292,7411,739,2493,682,2223,1421,4716
312410,201908,11753,33329,9583,29504,1783,5716,4931,14890,6714,20606
312420,201908,3653,10243,3050,9188,593,1913,1566,4601,2159,6514
312430,201908,8055,21386,6381,18393,489,1618,4275,12020,4764,13638
312440,201908,910,2951,696,2443,358,1324,70,209,428,1533
312450,201908,1186,3562,897,3025,264,955,286,985,550,1940
312460,201908,440,1171,300,948,35,123,156,507,191,630
312470,201908,489,1209,313,897,43,146,121,294,164,440
312480,201908,1133,2887,783,2374,110,354,376,1095,486,1449
312490,201908,2062,5101,1539,4300,227,652,797,2151,1024,2803
312500,201908,918,2302,722,2012,47,175,489,1339,536,1514
312510,201908,3731,10151,2742,8262,730,2116,754,2313,1484,4429
312520,201908,168,510,142,460,39,131,61,190,100,321
312530,201908,572,1443,492,1343,17,58,432,1179,449,1237
312540,201908,1519,4388,997,3261,160,571,505,1598,665,2169
312550,201908,768,2069,569,1654,37,120,360,956,397,1076
312560,201908,1978,5098,1599,4523,73,233,1219,3451,1292,3684
312570,201908,2153,5536,1653,4882,487,1511,615,1847,1102,3358
312580,201908,607,1730,443,1370,57,203,202,577,259,780
312590,201908,1635,4868,1317,4222,102,434,777,2318,879,2752
312595,201908,1736,5322,1503,4908,296,923,869,2973,1165,3896
312600,201908,1063,2617,538,1708,83,309,160,505,243,814
312610,201908,6337,16564,4030,12123,591,1930,1324,3721,1915,5651
312620,201908,2511,6537,1823,5582,52,229,1447,4487,1499,4716
312630,201908,269,830,200,700,36,156,79,258,115,414
312640,201908,559,1565,376,1244,49,162,129,449,178,611
312650,201908,2084,5472,1408,4147,72,235,961,2684,1033,2919
312660,201908,1358,3365,1020,2782,86,298,672,1718,758,2016
312670,201908,4976,13402,4084,11954,207,893,2865,7951,3072,8844
312675,201908,1225,3332,996,2966,56,209,788,2282,844,2491
312680,201908,1384,3969,1154,3610,63,283,911,2763,974,3046
312690,201908,2649,5916,2080,5202,76,217,1735,4266,1811,4483
312695,201908,955,2693,789,2401,42,111,591,1804,633,1915
312700,201908,2074,5544,1482,4444,155,536,830,2345,985,2881
312705,201908,1337,3389,1118,3038,19,68,962,2584,981,2652
312707,201908,1376,4114,1064,3530,72,363,644,2003,716,2366
312710,201908,6678,15370,3834,10845,1050,3222,1006,2929,2056,6151
312720,201908,1048,2935,784,2488,107,372,452,1379,559,1751
312730,201908,1651,3983,1190,3339,92,293,692,1865,784,2158
312733,201908,1449,3833,1085,3164,39,148,711,1962,750,2110
312735,201908,646,1784,544,1587,72,245,341,885,413,1130
312737,201908,824,1925,555,1518,80,249,303,752,383,1001
312738,201908,609,1612,422,1272,49,173,214,607,263,780
312740,201908,435,1103,246,776,55,190,60,152,115,342
312750,201908,1395,4335,1107,3767,207,773,432,1376,639,2149
312760,201908,1860,5606,1324,4482,246,885,443,1437,689,2322
312770,201908,44553,108211,27256,78501,5971,18287,8609,24157,14580,42444
312780,201908,2453,7484,2063,6817,243,921,1297,4230,1540,5151
312790,201908,261,649,155,491,8,39,52,136,60,175
312800,201908,4974,14421,3804,12098,925,3141,1293,3978,2218,7119
312810,201908,1665,4515,1081,3518,266,976,351,1001,617,1977
312820,201908,1784,4891,1436,4236,54,212,1038,2957,1092,3169
312825,201908,1340,3204,1143,2930,26,87,957,2401,983,2488
312830,201908,2833,8083,1607,5459,336,1268,379,1227,715,2495
312840,201908,1246,3557,953,3020,119,473,442,1293,561,1766
312850,201908,896,2234,619,1800,32,124,349,930,381,1054
312860,201908,1298,3327,854,2625,224,732,182,522,406,1254
312870,201908,6359,17549,3751,12249,653,2318,835,2566,1488,4884
312880,201908,1393,3541,1074,3007,43,158,594,1664,637,1822
312890,201908,2142,5612,1477,4414,122,375,723,2166,845,2541
312900,201908,1193,3147,956,2835,88,287,550,1727,638,2014
312910,201908,1623,3022,832,1978,144,298,320,731,464,1029
312920,201908,1014,2813,680,2206,141,530,260,773,401,1303
312930,201908,2155,5547,1699,4851,368,1077,732,2074,1100,3151
312940,201908,920,2604,712,2273,88,341,337,1013,425,1354
312950,201908,3172,7992,2043,6113,531,1749,651,1833,1182,3582
312960,201908,1881,4970,1549,4473,103,262,1149,3445,1252,3707
312965,201908,1690,4856,1400,4362,132,453,916,2787,1048,3240
312970,201908,1228,3533,950,3060,171,662,474,1395,645,2057
312980,201908,22768,64414,18363,56270,3307,11145,9081,26112,12388,37257
312990,201908,453,1181,273,865,55,204,117,353,172,557
313000,201908,456,1346,340,1130,36,151,183,573,219,724
313005,201908,2552,7438,2142,6741,147,496,1532,4732,1679,5228
313010,201908,4775,13591,3850,12010,716,2477,2199,6624,2915,9101
313020,201908,939,2890,624,2145,116,430,105,305,221,735
313030,201908,1176,2857,791,2248,80,290,489,1312,569,1602
313040,201908,802,2526,633,2141,48,200,361,1150,409,1350
313050,201908,1779,5106,1244,4283,209,868,353,1068,562,1936
313055,201908,1856,5127,1660,4822,64,203,1379,3976,1443,4179
313060,201908,986,2466,660,1923,210,693,139,321,349,1014
313065,201908,1650,5076,1449,4728,71,304,1064,3343,1135,3647
313070,201908,978,2590,728,2141,78,246,406,1160,484,1406
313080,201908,389,1067,275,839,55,189,92,229,147,418
313090,201908,4800,13294,4116,12114,472,1566,2554,7371,3026,8937
313100,201908,1370,3580,1034,3075,40,166,754,2191,794,2357
313110,201908,1477,3979,1041,3173,101,386,578,1613,679,1999
313115,201908,2482,7467,2042,6596,297,1065,1006,3026,1303,4091
313120,201908,3666,8777,2693,7473,284,873,1635,4502,1919,5375
313130,201908,29336,78335,22491,65296,2716,8986,12203,33228,14919,42214
313140,201908,577,1306,350,963,23,77,227,617,250,694
313150,201908,1377,3953,1003,3209,278,942,265,774,543,1716
313160,201908,1031,2684,793,2280,36,130,576,1604,612,1734
313170,201908,11554,33907,8048,26928,1469,5275,2930,9209,4399,14484
313180,201908,2242,6062,1564,4694,199,640,826,2403,1025,3043
313190,201908,4369,12748,3123,10134,566,1971,1040,3120,1606,5091
313200,201908,1078,3066,926,2799,22,95,765,2215,787,2310
313210,201908,3832,11342,3125,10051,389,1422,1822,5623,2211,7045
313220,201908,1765,4747,1155,3544,177,616,425,1137,602,1753
313230,201908,2980,8355,2455,7725,74,263,1999,6386,2073,6649
313240,201908,9343,23415,5699,17423,1045,3650,2277,6325,3322,9975
313250,201908,6180,18382,4751,15420,760,2549,2202,7017,2962,9566
313260,201908,611,1625,422,1269,53,199,196,542,249,741
313270,201908,5616,14921,4482,13162,659,2009,2774,8202,3433,10211
313280,201908,440,1248,286,929,43,146,109,342,152,488
313290,201908,912,2908,694,2542,230,924,219,756,449,1680
313300,201908,1644,4574,1182,3715,322,1076,218,596,540,1672
313310,201908,1073,3265,839,2740,137,523,217,609,354,1132
313320,201908,2144,5706,1484,4629,287,1012,626,1940,913,2952
313330,201908,4036,10946,3078,9465,178,748,1972,5946,2150,6694
313340,201908,1345,3074,948,2507,101,277,661,1733,762,2010
313350,201908,2242,6427,1475,4705,204,730,554,1579,758,2309
313360,201908,1333,3378,886,2629,154,545,447,1228,601,1773
313370,201908,1335,3878,1149,3510,147,535,647,1822,794,2357
313375,201908,1713,4484,1025,3203,203,709,229,669,432,1378
313380,201908,5971,15422,4177,12037,807,2567,1809,4663,2616,7230
313390,201908,863,2801,756,2624,53,245,481,1589,534,1834
313400,201908,3707,9258,2846,8075,179,564,2161,5987,2340,6551
313410,201908,1290,3408,971,2840,58,198,706,2018,764,2216
313420,201908,15321,34807,7560,21441,1707,5342,982,2758,2689,8100
313430,201908,868,2573,657,2151,118,460,260,758,378,1218
313440,201908,6133,13407,3971,10544,304,855,2557,6749,2861,7604
313450,201908,645,1817,454,1417,92,311,143,385,235,696
313460,201908,2154,6315,1724,5635,353,1333,787,2422,1140,3755
313470,201908,2947,7574,2314,6655,258,725,1463,4286,1721,5011
313480,201908,920,2674,520,1771,82,305,138,420,220,725
313490,201908,1989,4709,932,2939,320,1143,115,372,435,1515
313500,201908,435,1283,333,1042,42,138,117,341,159,479
313505,201908,9768,26143,8294,24153,342,1240,6704,19391,7046,20631
313507,201908,1471,3900,1206,3489,28,120,950,2687,978,2807
313510,201908,12912,36047,10382,31311,1294,4201,5130,14939,6424,19140
313520,201908,13745,39590,11052,34843,707,2608,7931,24462,8638,27070
313530,201908,534,1566,405,1301,35,120,171,508,206,628
313535,201908,2370,6492,2023,5848,188,480,1361,3888,1549,4368
313540,201908,801,2455,613,1973,113,373,240,714,353,1087
313545,201908,1201,4030,1007,3626,170,636,532,1844,702,2480
313550,201908,1743,5368,1440,4648,345,1246,668,2032,1013,3278
313560,201908,2619,5234,1915,4373,68,127,1613,3674,1681,3801
313570,201908,953,2870,769,2520,177,613,308,948,485,1561
313580,201908,5529,14736,4182,12462,531,1703,2343,7032,2874,8735
313590,201908,964,2815,757,2505,221,784,318,1089,539,1873
313600,201908,3802,10460,3166,9441,107,440,2597,7596,2704,8036
313610,201908,1006,2591,806,2233,104,295,487,1285,591,1580
313620,201908,5488,14849,4328,12734,652,2121,2322,6540,2974,8661
313630,201908,8545,21168,5860,17015,677,2272,3228,9120,3905,11392
313640,201908,1029,2464,630,1921,198,621,180,570,378,1191
313650,201908,1762,5365,1435,4808,98,386,923,3107,1021,3493
313652,201908,783,2533,706,2358,129,475,420,1361,549,1836
313655,201908,1132,2930,902,2618,49,160,704,2029,753,2189
313657,201908,1251,3357,974,2906,47,186,699,1964,746,2150
313660,201908,879,2496,714,2178,96,359,407,1151,503,1510
313665,201908,4631,12673,3526,10650,487,1645,2022,5836,2509,7481
313670,201908,47381,118820,29754,88205,4868,15867,12322,34365,17190,50232
313680,201908,1011,2745,831,2462,68,231,535,1523,603,1754
313690,201908,842,2697,645,2299,151,581,180,602,331,1183
313695,201908,1725,4800,1327,4144,85,295,904,2807,989,3102
313700,201908,3032,9853,2634,9341,269,1018,1952,6911,2221,7929
313710,201908,1382,3275,975,2693,80,234,654,1803,734,2037
313720,201908,5454,15382,3867,12049,603,2142,1603,4534,2206,6676
313730,201908,1292,3012,969,2567,84,200,641,1675,725,1875
313740,201908,1659,5953,1337,5099,336,1446,217,715,553,2161
313750,201908,1936,5358,1493,4486,303,1012,637,1784,940,2796
313753,201908,2126,5149,1410,3994,151,452,784,2132,935,2584
313760,201908,5079,14236,3715,11530,860,2841,1430,4180,2290,7021
313770,201908,3874,11066,3065,9736,217,742,2179,6958,2396,7700
313780,201908,4092,11143,2943,9140,274,1006,755,2371,1029,3377
313790,201908,480,1517,424,1406,49,188,232,735,281,923
313800,201908,1335,3163,988,2642,132,406,524,1314,656,1720
313810,201908,1604,4164,1261,3666,68,249,914,2590,982,2839
313820,201908,15125,36519,9766,26794,1607,4760,3348,8820,4955,13580
313830,201908,360,1043,270,842,54,171,108,311,162,482
313835,201908,921,2755,742,2412,69,268,389,1190,458,1458
313840,201908,6697,17862,4811,14574,1264,4033,992,3061,2256,7094
313850,201908,942,2346,745,2062,125,422,391,965,516,1387
313860,201908,2624,7240,1933,5866,305,1024,743,2097,1048,3121
313862,201908,1483,3252,703,2043,52,168,337,932,389,1100
313865,201908,2327,6347,1971,5776,117,349,1495,4307,1612,4656
313867,201908,1143,3559,957,3202,143,492,619,2077,762,2569
313868,201908,1720,5319,1403,4676,54,254,1069,3443,1123,3697
313870,201908,799,2219,587,1830,107,358,210,589,317,947
313880,201908,1503,4041,1104,3359,188,640,491,1339,679,1979
313890,201908,1996,4490,1470,3802,63,191,1036,2615,1099,2806
313900,201908,3956,11825,2860,9584,752,2815,675,2057,1427,4872
313910,201908,609,1844,446,1525,94,350,97,312,191,662
313920,201908,2957,9309,2466,8271,516,1714,1202,4046,1718,5760
313925,201908,1595,4145,1277,3565,200,535,783,2173,983,2708
313930,201908,4811,14562,3867,12856,302,1170,2515,8193,2817,9363
313940,201908,8523,25258,6068,20847,1013,4140,1460,5440,2473,9580
313950,201908,5119,11629,3594,9666,465,1570,2049,5382,2514,6952
313960,201908,5513,13836,3664,10651,828,2673,1129,2994,1957,5667
313970,201908,1422,3973,1208,3582,24,82,764,2235,788,2317
313980,201908,1365,3613,883,2817,132,492,319,973,451,1465
313990,201908,1841,6061,1317,4807,350,1420,384,1228,734,2648
314000,201908,9591,25405,7977,22592,590,2109,5281,14603,5871,16712
314010,201908,1363,3411,1086,3026,52,180,806,2173,858,2353
314015,201908,2003,5635,1510,4802,220,856,774,2350,994,3206
314020,201908,492,1376,298,992,60,245,51,185,111,430
314030,201908,774,2279,620,1978,67,227,312,976,379,1203
314040,201908,647,1767,517,1511,91,301,258,715,349,1016
314050,201908,1751,4761,1250,3826,169,604,637,1799,806,2403
314053,201908,1828,5497,1453,4731,267,855,723,2462,990,3317
314055,201908,2304,6269,1959,5750,54,211,1582,4643,1636,4854
314060,201908,1240,3321,918,2803,41,164,625,1870,666,2034
314070,201908,4573,12835,3566,10964,754,2330,1462,4383,2216,6713
314080,201908,2164,5802,1395,4376,198,733,528,1470,726,2203
314085,201908,2099,6152,1716,5540,284,965,896,2900,1180,3865
314090,201908,4230,11965,3592,10943,241,956,2299,6952,2540,7908
314100,201908,3178,7525,2435,6491,71,195,1862,4958,1933,5153
314110,201908,4436,12873,3629,11283,447,1606,1995,5777,2442,7383
314120,201908,857,1999,325,989,79,281,53,154,132,435
314130,201908,671,1787,394,1235,31,118,208,638,239,756
314140,201908,4657,13425,3566,11234,525,1745,1689,5188,2214,6933
314150,201908,1512,3823,1101,3091,96,278,717,1947,813,2225
314160,201908,2238,6032,1593,4846,243,795,643,1960,886,2755
314170,201908,971,2763,773,2362,62,215,462,1314,524,1529
314180,201908,5430,15395,4402,13692,411,1409,2530,7830,2941,9239
314190,201908,609,1554,418,1258,78,265,184,494,262,759
314200,201908,2894,8210,2349,7245,131,490,1671,4997,1802,5487
314210,201908,1975,5266,1551,4486,176,546,796,2227,972,2773
314220,201908,1318,3691,926,2999,216,819,328,970,544,1789
314225,201908,1106,3178,923,2893,80,239,653,2079,733,2318
314230,201908,776,2039,632,1851,77,251,400,1201,477,1452
314240,201908,1026,2801,790,2453,189,598,307,975,496,1573
314250,201908,515,1453,314,1023,45,159,118,345,163,504
314260,201908,956,2743,762,2447,169,591,389,1192,558,1783
314270,201908,3265,9272,2630,8266,95,382,1924,5954,2019,6336
314280,201908,3391,7941,2158,5992,280,872,1060,2753,1340,3625
314290,201908,4548,11915,3734,10458,347,987,2501,6871,2848,7858
314300,201908,1772,5229,1201,3950,260,938,370,1151,630,2089
314310,201908,4403,11859,3028,9444,955,3181,508,1439,1463,4620
314315,201908,911,3200,779,2914,60,294,521,1872,581,2166
314320,201908,2823,7759,1816,5863,349,1233,642,1984,991,3217
314330,201908,48545,136935,36209,115123,10279,33988,7658,25310,17937,59298
314340,201908,2297,5790,1279,3890,267,961,314,779,581,1740
314345,201908,1386,4209,1138,3755,159,540,651,2110,810,2650
314350,201908,906,2542,598,1972,120,443,137,398,257,841
314360,201908,581,1672,355,1178,58,204,106,322,164,526
314370,201908,698,1914,548,1680,29,119,394,1158,423,1277
314380,201908,1119,3177,758,2479,187,702,165,517,352,1219
314390,201908,12468,32684,7886,23969,1660,5396,2248,6086,3908,11482
314400,201908,4012,12032,3077,10231,827,2857,1086,3715,1913,6572
314410,201908,2758,7768,1858,6008,273,984,638,2139,911,3123
314420,201908,804,1983,601,1701,22,104,430,1143,452,1247
314430,201908,7129,18139,4997,14420,802,2466,2173,5952,2975,8418
314435,201908,1620,4437,1286,3857,57,214,941,2777,998,2991
314437,201908,943,2445,653,1955,62,217,308,900,370,1117
314440,201908,595,1720,422,1375,113,400,89,246,202,646
314450,201908,1350,3685,1122,3316,107,360,678,1939,785,2299
314460,201908,3336,10324,2369,8183,600,2191,458,1529,1058,3720
314465,201908,2195,6439,1880,5811,56,219,1411,4196,1467,4415
314467,201908,844,2322,726,2115,27,84,578,1646,605,1730
314470,201908,2201,6453,1751,5489,317,1092,754,2195,1071,3287
314480,201908,6352,18611,4506,14594,771,2786,1465,4192,2236,6978
314490,201908,975,2709,717,2149,73,245,431,1239,504,1484
314500,201908,1703,4292,1218,3537,240,704,485,1410,725,2114
314505,201908,1964,4894,1606,4388,102,292,1142,3056,1244,3348
314510,201908,1852,4895,1269,3982,260,911,555,1686,815,2597
314520,201908,4689,14685,3309,11575,658,2515,416,1266,1074,3781
314530,201908,5532,18029,4945,16858,396,1640,3479,11589,3875,13229
314535,201908,2599,6837,2082,6056,111,401,1553,4454,1664,4855
314537,201908,1127,3263,865,2811,60,240,589,1862,649,2102
314540,201908,404,1050,268,796,23,79,125,350,148,429
314545,201908,1797,4486,1574,4206,43,110,1322,3657,1365,3767
314550,201908,652,1635,488,1393,41,159,254,649,295,808
314560,201908,4074,12608,3015,10145,498,1832,979,3021,1477,4853
314570,201908,296,818,220,677,28,104,98,303,126,407
314580,201908,440,1341,329,1112,93,324,86,300,179,624
314585,201908,654,2087,491,1706,62,274,228,745,290,1019
314587,201908,2028,5597,1536,4810,215,621,831,2673,1046,3294
314590,201908,3695,10305,2534,8024,368,1293,1004,2967,1372,4260
314600,201908,1820,5113,1048,3570,205,757,129,404,334,1161
314610,201908,8821,22965,6055,18801,1138,4073,2427,7379,3565,11452
314620,201908,2174,5189,1689,4555,52,188,1381,3646,1433,3834
314625,201908,1518,4297,1285,3960,45,249,1051,3160,1096,3409
314630,201908,5216,13603,4261,12295,124,495,3492,10063,3616,10558
314640,201908,649,1607,459,1296,69,230,238,607,307,837
314650,201908,898,2147,544,1586,53,175,260,658,313,833
314655,201908,1582,4380,1109,3505,185,563,527,1644,712,2207
314660,201908,339,807,220,582,9,16,130,323,139,339
314670,201908,1694,3905,1144,3102,29,99,724,1927,753,2026
314675,201908,1721,4649,1483,4248,99,358,1126,3105,1225,3463
314690,201908,2078,5971,1588,5181,469,1656,463,1505,932,3161
314700,201908,10103,29015,6426,21531,1298,4782,1697,5459,2995,10241
314710,201908,7823,22294,5528,17362,1104,3738,1500,4166,2604,7904
314720,201908,2145,6450,1444,4948,309,1176,354,1143,663,2319
314730,201908,2094,5818,1484,4609,327,1053,446,1321,773,2374
314740,201908,2850,8173,2230,7039,306,1058,1128,3483,1434,4541
314750,201908,326,903,248,742,24,84,133,355,157,439
314760,201908,1835,5621,1160,3998,183,715,278,781,461,1496
314770,201908,1085,3215,548,1790,48,164,157,463,205,627
314780,201908,344,825,226,649,43,148,116,291,159,439
314790,201908,9883,27166,6654,21056,1633,5866,1878,5426,3511,11292
314795,201908,1446,3895,1221,3505,35,162,951,2600,986,2762
314800,201908,10967,28266,6348,19458,1221,4108,1331,3625,2552,7733
314810,201908,8623,23552,6173,19137,1621,5329,1856,5674,3477,11003
314820,201908,1083,2743,841,2367,58,226,536,1431,594,1657
314830,201908,1441,4487,1206,4009,253,906,542,1784,795,2690
314840,201908,896,2881,695,2546,64,322,466,1620,530,1942
314850,201908,1986,4822,1591,4290,47,159,1357,3659,1404,3818
314860,201908,3163,9613,2600,8489,301,1178,1647,5179,1948,6357
314870,201908,6251,16302,4709,14136,331,1091,3380,10141,3711,11232
314875,201908,1731,5249,1531,4985,110,308,1234,4077,1344,4385
314880,201908,868,2128,664,1816,27,74,430,1194,457,1268
314890,201908,422,1253,304,981,50,182,114,338,164,520
314900,201908,660,1792,503,1525,98,319,187,555,285,874
314910,201908,1634,4754,1208,4044,256,993,550,1697,806,2690
314915,201908,2218,6627,1853,5984,126,436,1217,3849,1343,4285
314920,201908,478,1246,305,976,10,37,201,636,211,673
314930,201908,5346,15630,4010,13056,759,2674,1466,4457,2225,7131
314940,201908,405,1051,334,925,34,91,207,539,241,630
314950,201908,468,1220,299,933,28,120,143,393,171,513
314960,201908,807,2013,620,1674,34,108,445,1130,479,1238
314970,201908,852,2470,662,2094,127,427,313,936,440,1363
314980,201908,1369,3654,977,3040,229,809,364,1108,593,1917
314990,201908,2382,6959,1585,5101,342,1217,326,893,668,2110
314995,201908,1642,4669,1298,4046,67,283,828,2445,895,2728
315000,201908,1113,2926,798,2423,67,232,513,1502,580,1734
315010,201908,386,1091,282,895,49,186,130,377,179,563
315015,201908,2205,6358,1919,5876,192,656,1221,3696,1413,4352
315020,201908,787,2360,550,1808,73,299,223,639,296,938
315030,201908,576,1589,373,1196,94,312,79,235,173,547
315040,201908,794,2345,674,2058,86,288,421,1282,507,1570
315050,201908,1126,2943,847,2526,62,238,469,1366,531,1604
315053,201908,1151,3039,863,2517,55,174,497,1388,552,1562
315057,201908,1629,5161,1382,4686,154,534,891,3040,1045,3574
315060,201908,566,1747,401,1400,78,286,99,326,177,612
315070,201908,556,1495,388,1190,97,329,97,266,194,595
315080,201908,2746,8161,2105,6835,343,1148,1097,3459,1440,4607
315090,201908,787,2453,568,2005,94,361,205,687,299,1048
315100,201908,1195,3672,734,2576,143,556,289,910,432,1466
315110,201908,1673,4260,1233,3535,138,386,595,1732,733,2118
315120,201908,11717,28063,8379,22893,1201,3121,4200,11922,5401,15043
315130,201908,1348,3908,1088,3417,139,509,431,1274,570,1783
315140,201908,2876,8111,2172,6800,399,1380,1056,3071,1455,4451
315150,201908,4331,10725,2973,8460,464,1490,1327,3617,1791,5107
315160,201908,1666,4200,1075,3219,242,747,440,1291,682,2038
315170,201908,1406,4523,961,3433,227,847,189,657,416,1504
315180,201908,16956,42212,8666,26278,1252,4227,2439,6446,3691,10673
315190,201908,2114,4813,1653,4192,234,569,1166,2969,1400,3538
315200,201908,3712,10874,2670,8951,817,2962,606,1939,1423,4901
315210,201908,8072,21490,5585,16110,693,2178,2620,6825,3313,9003
315213,201908,1131,3000,966,2763,22,69,777,2197,799,2266
315217,201908,2611,7916,2030,6906,101,490,1358,4442,1459,4932
315220,201908,8050,22298,6416,19394,1385,4436,2572,7741,3957,12177
315230,201908,3093,7271,2576,6624,175,313,2000,5413,2175,5726
315240,201908,2367,7193,2004,6522,482,1666,1019,3266,1501,4932
315250,201908,11449,31842,8145,25549,1383,4709,3378,10087,4761,14796
315260,201908,992,2834,518,1744,84,271,36,112,120,383
315270,201908,813,2393,548,1869,74,282,165,470,239,752
315280,201908,2943,7461,1681,5090,400,1313,253,750,653,2063
315290,201908,1188,3020,710,2248,205,713,178,561,383,1274
315300,201908,678,1629,435,1284,116,389,170,498,286,887
315310,201908,1291,3677,935,2976,80,267,495,1496,575,1763
315320,201908,697,2067,485,1642,73,298,200,623,273,921
315330,201908,747,2606,400,1626,68,306,115,415,183,721
315340,201908,3085,7635,2229,6380,162,535,1358,3835,1520,4370
315350,201908,1540,4285,1177,3679,171,613,641,1967,812,2580
315360,201908,1683,5120,1215,4060,178,633,485,1513,663,2146
315370,201908,444,1294,350,1100,64,189,146,449,210,638
315380,201908,176,531,129,413,32,100,26,59,58,159
315390,201908,1156,3398,882,2851,170,614,344,1019,514,1633
315400,201908,4041,11376,3153,9703,464,1480,1591,4708,2055,6188
315410,201908,2297,5377,1738,4549,468,1318,293,796,761,2114
315415,201908,1263,3489,1000,3080,224,809,404,1248,628,2057
315420,201908,1231,3562,782,2654,157,577,133,404,290,981
315430,201908,3590,8853,2488,7135,452,1528,1037,2764,1489,4292
315440,201908,1001,2717,802,2368,79,284,455,1239,534,1523
315445,201908,2020,4931,1437,4070,118,372,990,2761,1108,3133
315450,201908,2201,6289,1807,5662,246,749,1096,3460,1342,4209
315460,201908,34655,99884,28621,88718,5477,18778,13744,39920,19221,58698
315470,201908,490,1400,378,1171,30,109,227,670,257,779
315480,201908,1239,3653,862,2821,170,585,266,839,436,1424
315490,201908,2992,7506,2000,5946,299,922,691,1996,990,2918
315500,201908,504,1373,299,914,33,124,128,331,161,455
315510,201908,1246,3359,1063,3087,28,115,902,2565,930,2680
315520,201908,1062,2947,831,2549,56,213,598,1774,654,1987
315530,201908,598,1766,458,1484,145,509,188,574,333,1083
315540,201908,1360,3746,920,2896,108,400,384,1173,492,1573
315550,201908,1865,4946,1183,3696,265,916,290,891,555,1807
315560,201908,6297,19574,5356,17806,331,1105,3486,11688,3817,12793
315570,201908,1926,5376,1568,4762,94,382,937,2723,1031,3105
315580,201908,2491,6125,1859,5097,307,993,714,1828,1021,2821
315590,201908,898,2396,701,2071,86,306,354,975,440,1281
315600,201908,2413,7755,1730,6374,254,910,911,3472,1165,4382
315610,201908,889,2309,661,1877,119,403,290,702,409,1105
315620,201908,401,1163,324,1036,46,161,197,642,243,803
315630,201908,918,2527,722,2194,143,466,278,778,421,1244
315640,201908,350,927,284,840,30,113,173,479,203,592
315645,201908,965,2546,641,1995,162,541,153,450,315,991
315650,201908,1756,4375,1391,3843,34,134,1128,2994,1162,3128
315660,201908,2425,5953,1792,4857,105,307,1268,3305,1373,3612
315670,201908,13769,38851,10561,32894,2186,7074,4507,13513,6693,20587
315680,201908,3047,9134,2213,7476,354,1351,1023,3278,1377,4629
315690,201908,2839,7394,1734,5302,381,1172,520,1736,901,2908
315700,201908,7647,21718,5748,17877,958,3203,2569,7649,3527,10852
315710,201908,1861,4745,1329,3916,52,239,921,2580,973,2819
315720,201908,4291,12191,3608,10946,178,764,2526,7336,2704,8100
315725,201908,1927,5359,1461,4479,154,466,969,3020,1123,3486
315727,201908,562,1476,415,1227,61,208,167,463,228,671
315730,201908,612,1904,535,1752,84,308,210,653,294,961
315733,201908,1361,3523,928,2727,142,499,337,922,479,1421
315737,201908,1132,3298,875,2782,43,174,598,1845,641,2019
315740,201908,905,2575,704,2154,90,332,412,1165,502,1497
315750,201908,1249,3386,985,2927,79,251,629,1882,708,2133
315760,201908,1161,2780,1040,2625,54,152,873,2163,927,2315
315765,201908,1874,5014,1522,4550,29,109,1326,3945,1355,4054
315770,201908,995,2919,792,2631,307,1130,173,481,480,1611
315780,201908,27966,78722,23477,70534,1757,6496,15145,43165,16902,49661
315790,201908,3567,11163,3020,10107,313,1116,1801,6111,2114,7227
315800,201908,1217,4437,846,3388,147,642,210,775,357,1417
315810,201908,1308,3301,1082,2915,52,185,844,2165,896,2350
315820,201908,2571,7206,2089,6460,197,709,1400,4258,1597,4967
315830,201908,1067,3132,781,2583,66,247,339,1070,405,1317
315840,201908,827,2048,530,1493,47,160,251,643,298,803
315850,201908,1129,3420,900,3001,180,650,443,1388,623,2038
315860,201908,500,1494,346,1204,81,304,86,282,167,586
315870,201908,464,1209,363,1060,27,93,245,669,272,762
315880,201908,1093,2851,710,2180,92,355,163,437,255,792
315890,201908,1601,4733,1273,4247,324,1167,603,1947,927,3114
315895,201908,6019,16561,4508,13533,483,1665,2284,6385,2767,8050
315900,201908,813,2135,700,1971,61,191,510,1384,571,1575
315910,201908,525,1508,438,1361,64,241,290,848,354,1089
315920,201908,1577,4148,846,2631,141,496,251,712,392,1208
315930,201908,1089,2529,711,1946,126,345,308,844,434,1189
315935,201908,798,2444,642,2140,118,403,209,701,327,1104
315940,201908,594,1706,471,1498,55,186,242,738,297,924
315950,201908,1196,3329,992,2998,97,272,737,2246,834,2518
315960,201908,4155,11800,2410,8258,800,3123,165,332,965,3455
315970,201908,637,1696,492,1503,61,210,327,992,388,1202
315980,201908,4270,9496,2277,6164,401,1142,773,1918,1174,3060
315990,201908,3583,9212,2765,7821,292,894,1586,4366,1878,5260
316000,201908,526,1397,394,1207,59,226,173,486,232,712
316010,201908,836,2238,615,1864,38,137,370,1034,408,1171
316020,201908,950,2909,762,2531,84,351,450,1381,534,1732
316030,201908,2844,7944,2078,6584,232,768,1294,4163,1526,4931
316040,201908,2505,7440,1808,6073,326,1195,404,1219,730,2414
316045,201908,2057,5415,1854,5147,82,180,1555,4434,1637,4614
316050,201908,377,1087,277,904,40,148,147,457,187,605
316060,201908,692,1807,512,1520,26,124,346,964,372,1088
316070,201908,5433,15515,4430,13553,814,2618,1992,5885,2806,8503
316080,201908,708,2238,539,1872,129,478,75,248,204,726
316090,201908,427,1300,301,1022,39,161,138,404,177,565
316095,201908,1268,3990,1012,3361,269,939,321,1035,590,1974
316100,201908,2504,7588,1750,5863,328,1184,572,1729,900,2913
316105,201908,853,2270,651,1962,45,159,449,1362,494,1521
316110,201908,13029,38535,10839,34771,935,3402,7207,22828,8142,26230
316120,201908,1101,3249,676,2187,123,421,177,450,300,871
316130,201908,1233,2785,753,2011,63,193,423,1089,486,1282
316140,201908,1134,3081,734,2334,113,395,367,1133,480,1528
316150,201908,1806,4086,1481,3670,199,617,592,1353,791,1970
316160,201908,1032,2877,832,2522,55,194,537,1566,592,1760
316165,201908,890,2224,662,1854,102,342,334,869,436,1211
316170,201908,1110,2838,822,2380,63,234,542,1498,605,1732
316180,201908,1272,3693,839,2763,163,625,165,467,328,1092
316190,201908,2623,7579,1515,4896,233,768,534,1527,767,2295
316200,201908,3213,9497,2318,7751,533,1951,465,1480,998,3431
316210,201908,4416,13164,3157,10262,1114,3893,234,636,1348,4529
316220,201908,615,1894,402,1387,99,381,40,159,139,540
316225,201908,1527,3494,1124,2817,42,166,849,1973,891,2139
316230,201908,423,1167,323,999,33,104,182,573,215,677
316240,201908,5649,16559,4960,15372,423,1436,3676,11173,4099,12609
316245,201908,2930,9845,2613,9300,148,866,1942,6538,2090,7404
316250,201908,9945,24701,6915,19756,1595,4957,2231,6146,3826,11103
316255,201908,2922,8241,2535,7622,168,574,1830,5519,1998,6093
316257,201908,1252,3069,878,2463,130,380,455,1244,585,1624
316260,201908,1913,5070,1429,4275,127,406,761,2359,888,2765
316265,201908,1148,3150,898,2715,37,135,624,1833,661,1968
316270,201908,3592,11385,3046,10130,544,1907,1390,4415,1934,6322
316280,201908,2930,8682,2492,7836,360,1242,1334,4033,1694,5275
316290,201908,3487,9752,2740,8313,337,1190,1131,3325,1468,4515
316292,201908,4902,13303,3938,11656,499,1630,2584,7365,3083,8995
316294,201908,821,2456,600,2068,111,437,139,455,250,892
316295,201908,2846,8118,2332,7196,139,544,1603,4660,1742,5204
316300,201908,956,2895,801,2629,52,207,543,1760,595,1967
316310,201908,873,2288,527,1674,97,376,88,233,185,609
316320,201908,587,1694,453,1460,57,217,208,640,265,857
316330,201908,1059,2907,782,2382,53,205,548,1587,601,1792
316340,201908,1023,2888,751,2366,76,324,405,1180,481,1504
316350,201908,1221,3595,1038,3293,97,322,707,2229,804,2551
316360,201908,640,1679,505,1461,52,167,358,1003,410,1170
316370,201908,4923,13619,3649,11166,739,2582,1194,3222,1933,5804
316380,201908,1677,4047,1299,3516,50,108,936,2549,986,2657
316390,201908,845,2306,601,1855,228,795,116,329,344,1124
316400,201908,1182,3421,765,2567,133,493,250,757,383,1250
316410,201908,1089,3217,913,2937,62,217,701,2224,763,2441
316420,201908,1867,5267,1626,4958,64,236,1331,3981,1395,4217
316430,201908,874,2391,546,1762,110,393,150,457,260,850
316440,201908,727,2299,566,2021,130,524,103,343,233,867
316443,201908,541,1555,407,1298,104,364,80,240,184,604
316447,201908,1864,5125,1616,4716,48,189,1322,3780,1370,3969
316450,201908,2206,6769,1651,5604,222,808,967,3218,1189,4026
316460,201908,1009,2643,804,2298,154,483,457,1228,611,1711
316470,201908,6505,19037,4631,15031,828,3048,1670,4971,2498,8019
316480,201908,215,597,176,533,41,123,85,247,126,370
316490,201908,297,802,213,657,27,92,86,226,113,318
316500,201908,1194,3879,772,2793,161,630,152,523,313,1153
316510,201908,707,2369,562,2086,122,472,239,903,361,1375
316520,201908,1106,2888,865,2471,134,448,402,1042,536,1490
316530,201908,1052,2818,767,2298,95,386,378,987,473,1373
316540,201908,802,2174,637,1912,114,396,292,801,406,1197
316550,201908,1367,4093,1174,3708,71,268,872,2709,943,2977
316553,201908,3701,11238,2539,8417,481,1755,763,2256,1244,4011
316555,201908,2533,8241,2300,7906,140,525,1766,6151,1906,6676
316556,201908,567,1388,396,1103,24,73,225,574,249,647
316557,201908,990,3181,847,2920,320,1149,241,824,561,1973
316560,201908,292,869,213,755,59,249,59,176,118,425
316570,201908,1176,3526,994,3182,249,810,358,1135,607,1945
316580,201908,400,873,243,604,43,122,112,255,155,377
316590,201908,1305,3468,933,2727,159,437,488,1365,647,1802
316600,201908,963,3015,817,2694,141,502,414,1337,555,1839
316610,201908,578,1871,488,1730,56,253,292,985,348,1238
316620,201908,2009,5566,1724,5166,91,288,1270,3842,1361,4130
316630,201908,1562,4705,1244,4097,338,1114,482,1717,820,2831
316640,201908,141,382,109,334,20,67,49,129,69,196
316650,201908,1024,3333,818,3000,70,283,499,1868,569,2151
316660,201908,201,517,88,275,7,23,11,37,18,60
316670,201908,1838,4737,1339,3909,333,1049,462,1300,795,2349
316680,201908,2179,5640,1645,4694,117,357,1219,3408,1336,3765
316690,201908,1238,3656,960,3103,186,667,414,1294,600,1961
316695,201908,1004,2952,824,2629,34,141,566,1782,600,1923
316700,201908,386,933,325,862,15,53,240,590,255,643
316710,201908,2932,9799,2203,8230,483,1898,829,3096,1312,4994
316720,201908,20457,57657,14876,46531,2885,9619,5775,17148,8660,26767
316730,201908,411,1171,324,993,54,191,148,397,202,588
316740,201908,698,2101,607,1950,66,275,371,1166,437,1441
316750,201908,399,1222,305,1032,62,249,127,380,189,629
316760,201908,3656,11744,2951,10264,1182,4434,701,2324,1883,6758
316770,201908,1557,3686,1225,3233,28,96,1029,2744,1057,2840
316780,201908,564,1727,436,1472,152,569,64,186,216,755
316790,201908,706,1929,486,1488,111,348,127,358,238,706
316800,201908,6043,17377,4791,15044,459,1670,2571,7765,3030,9435
316805,201908,1016,2252,817,2031,61,166,643,1614,704,1780
316810,201908,681,1923,449,1417,92,340,199,572,291,912
316820,201908,328,816,161,497,16,61,61,181,77,242
316830,201908,684,1960,557,1750,84,316,333,991,417,1307
316840,201908,2733,7370,2211,6444,247,870,1401,3875,1648,4745
316850,201908,2013,5340,1422,4265,220,713,598,1746,818,2459
316860,201908,18214,48572,13587,41470,2376,8335,6158,18229,8534,26564
316870,201908,7318,20597,5447,16934,889,3101,2322,6658,3211,9759
316880,201908,796,2182,637,1960,132,453,286,839,418,1292
316890,201908,1120,2545,652,1897,117,415,350,896,467,1311
316900,201908,2263,6299,1735,5228,352,1167,553,1515,905,2682
316905,201908,510,1537,395,1302,94,340,161,534,255,874
316910,201908,889,2415,570,1847,147,540,50,148,197,688
316920,201908,1620,4177,1061,3252,222,734,391,1180,613,1914
316930,201908,8133,24439,5866,20031,1159,4189,1303,4276,2462,8465
316935,201908,3954,10937,2803,8741,523,1729,1077,3225,1600,4954
316940,201908,6558,19743,4946,16232,836,3014,1769,5359,2605,8373
316950,201908,1836,4352,1409,3757,59,180,1128,2950,1187,3130
316960,201908,5125,11874,3697,9810,424,1243,2358,6075,2782,7318
316970,201908,3496,10263,3023,9322,613,1963,1114,3288,1727,5251
316980,201908,729,2226,521,1801,163,631,73,261,236,892
316990,201908,10719,30033,7441,23018,2024,6660,939,2559,2963,9219
317000,201908,2547,7757,2260,7324,171,526,1649,5357,1820,5883
317005,201908,2582,7551,2036,6390,341,1104,1026,3144,1367,4248
317010,201908,23704,56752,14417,42384,3292,10516,4795,14541,8087,25057
317020,201908,63690,153790,35870,104418,6734,21279,10298,27477,17032,48756
317030,201908,653,1806,523,1625,22,93,400,1225,422,1318
317040,201908,10766,27973,7587,22427,1768,5529,2738,8234,4506,13763
317043,201908,828,1944,602,1619,73,202,402,1085,475,1287
317047,201908,1160,2829,778,2192,100,297,459,1262,559,1559
317050,201908,1214,3788,836,2883,115,406,328,991,443,1397
317052,201908,2377,6850,1903,6047,293,963,1126,3560,1419,4523
317057,201908,1649,4174,1159,3315,50,196,702,1963,752,2159
317060,201908,455,1229,272,831,41,140,110,303,151,443
317065,201908,1233,3636,995,3168,52,202,628,1858,680,2060
317070,201908,7736,21658,5271,16776,1092,3943,1289,3807,2381,7750
317075,201908,924,2530,638,1989,112,387,207,572,319,959
317080,201908,6012,14486,4379,11779,1281,3684,1302,3273,2583,6957
317090,201908,4382,13516,3942,12778,336,1054,2827,9153,3163,10207
317100,201908,2479,5943,1622,4604,403,1225,587,1590,990,2815
317103,201908,1906,5743,1633,5252,123,615,1136,3406,1259,4021
317107,201908,1346,3717,1047,3118,51,218,650,1698,701,1916
317110,201908,716,1621,346,1055,48,184,111,336,159,520
317115,201908,1089,3129,911,2798,52,144,633,1951,685,2095
317120,201908,12383,35275,9673,30620,1296,4702,5173,15743,6469,20445
317130,201908,10360,24669,6341,18061,1145,3578,2074,5792,3219,9370
317140,201908,705,1918,545,1660,47,147,342,1070,389,1217
317150,201908,1023,2493,774,2170,36,124,592,1612,628,1736
317160,201908,3590,8831,2369,6919,201,633,1306,3812,1507,4445
317170,201908,1920,4926,1336,3877,218,738,495,1219,713,1957
317180,201908,1811,5841,1337,4646,280,1040,339,1110,619,2150
317190,201908,1225,3362,913,2857,115,365,515,1596,630,1961
317200,201908,4950,13279,3675,10964,1016,3296,694,1870,1710,5166
317210,201908,1169,2907,900,2529,40,149,643,1820,683,1969
317220,201908,278,889,237,800,64,221,76,268,140,489
320010,201908,4509,13346,3622,11570,393,1382,2277,7134,2670,8516
320013,201908,1611,4741,1068,3539,178,584,498,1681,676,2265
320016,201908,3056,7937,2387,6938,125,338,1861,5382,1986,5720
320020,201908,3924,10609,2891,8792,726,2352,968,3017,1694,5369
320030,201908,1537,4530,1056,3515,209,759,352,1092,561,1851
320035,201908,1751,4958,1444,4422,380,1281,623,1849,1003,3130
320040,201908,3821,11186,3124,9843,467,1606,1659,5067,2126,6673
320050,201908,1798,4116,1537,3724,230,655,881,2057,1111,2712
320060,201908,11531,32682,8494,26521,1420,4893,3727,10946,5147,15839
320070,201908,1469,4228,998,3230,185,669,328,1005,513,1674
320080,201908,5496,14407,3860,11172,838,2531,1353,3757,2191,6288
320090,201908,7835,21297,5211,15823,1156,3815,2003,5657,3159,9472
320100,201908,2745,7920,2169,6849,411,1413,1069,3311,1480,4724
320110,201908,1513,3863,1124,3197,198,589,530,1469,728,2058
320115,201908,1778,5859,1519,5397,648,2436,434,1587,1082,4023
320120,201908,19263,50617,13174,39456,2088,6800,5600,16024,7688,22824
320130,201908,41541,119451,34302,106019,5118,17295,19139,57346,24257,74641
320140,201908,3008,8783,2221,7133,384,1400,898,2832,1282,4232
320150,201908,13353,35483,9211,27195,2458,7770,1570,4229,4028,11999
320160,201908,5504,15939,4084,13158,692,2355,1870,5919,2562,8274
320170,201908,1471,4389,1088,3606,300,1005,421,1435,721,2440
320180,201908,713,2320,577,2031,193,728,148,489,341,1217
320190,201908,2801,9104,2135,7546,501,1867,535,1811,1036,3678
320200,201908,1108,3110,807,2541,207,736,265,827,472,1563
320210,201908,4458,11613,3423,9770,584,1820,1783,4859,2367,6679
320220,201908,2611,7241,1968,6093,377,1275,905,2690,1282,3965
320225,201908,1334,4238,905,3169,339,1260,152,527,491,1787
320230,201908,4656,13239,3505,11276,839,2933,1333,4183,2172,7116
320240,201908,14525,38341,10834,32228,2562,8160,3997,11608,6559,19768
320245,201908,2977,9150,2400,7949,954,3283,515,1641,1469,4924
320250,201908,2025,5800,1321,4094,319,1095,331,926,650,2021
320255,201908,1722,5580,1509,5194,491,1722,684,2448,1175,4170
320260,201908,1020,3082,715,2320,179,662,195,530,374,1192
320265,201908,2349,7443,1965,6665,939,3352,366,1211,1305,4563
320270,201908,2227,6528,1666,5367,369,1279,689,2215,1058,3494
320280,201908,6351,17613,5077,15311,1226,3875,1968,5860,3194,9735
320290,201908,1340,4050,859,2845,239,872,195,588,434,1460
320300,201908,3498,11032,2830,9557,870,3162,552,1734,1422,4896
320305,201908,5030,14600,3925,12361,800,2704,1846,5625,2646,8329
320310,201908,1913,5461,1321,4156,248,823,561,1706,809,2529
320313,201908,2353,6106,1455,4301,311,1008,313,871,624,1879
320316,201908,1442,4236,1208,3785,194,616,683,2139,877,2755
320320,201908,21280,57056,14921,45914,3606,11591,5445,16703,9051,28294
320330,201908,2967,8225,2313,7023,488,1451,1131,3522,1619,4973
320332,201908,5763,16582,4639,14558,1183,3982,2135,6627,3318,10609
320334,201908,1861,5501,1292,4263,293,1136,269,707,562,1843
320335,201908,1534,4571,979,3278,242,869,209,642,451,1511
320340,201908,4807,12432,3987,11145,536,1602,2234,6305,2770,7907
320350,201908,5155,13075,3540,10074,480,1424,1798,4906,2278,6330
320360,201908,1481,3804,1075,3015,142,378,509,1380,651,1758
320370,201908,2403,7699,1884,6527,573,2042,626,2126,1199,4168
320380,201908,2360,6545,1958,5864,259,836,1183,3461,1442,4297
320390,201908,7429,20625,5458,16560,1185,3785,2042,5882,3227,9667
320400,201908,3244,9416,2533,7911,701,2331,945,2819,1646,5150
320405,201908,4463,12021,3329,10050,571,1824,1518,4491,2089,6315
320410,201908,4859,12833,3650,10855,668,1975,1765,5467,2433,7442
320420,201908,2894,7865,2236,6756,698,2314,491,1427,1189,3741
320425,201908,2030,4898,1556,4125,95,278,1043,2671,1138,2949
320430,201908,2893,7399,2244,6146,315,953,1406,3671,1721,4624
320435,201908,2306,7329,1796,6287,633,2301,522,1869,1155,4170
320440,201908,1360,3832,974,3069,152,531,419,1255,571,1786
320450,201908,1620,4798,1267,4107,298,1084,540,1622,838,2706
320455,201908,3981,12231,2625,8951,695,2514,736,2359,1431,4873
320460,201908,2144,6568,1501,5115,352,1258,373,1187,725,2445
320465,201908,1218,3523,910,2906,142,491,481,1521,623,2012
320470,201908,3803,10612,2578,8003,616,2087,582,1656,1198,3743
320480,201908,1657,4756,1372,4230,228,803,724,2142,952,2945
320490,201908,20337,54382,14700,44145,2681,8889,5808,17086,8489,25975
320495,201908,1394,3848,941,2971,198,704,324,955,522,1659
320500,201908,50802,138917,40990,121358,6378,20343,22844,64781,29222,85124
320501,201908,4475,13096,3205,10742,873,3232,1026,3348,1899,6580
320503,201908,2077,6371,1475,5051,442,1635,470,1468,912,3103
320506,201908,2734,8281,1881,6327,541,1950,189,631,730,2581
320510,201908,9915,27624,7961,24051,1041,3554,4624,13447,5665,17001
320515,201908,1753,4861,1327,3978,387,1256,414,1189,801,2445
320517,201908,2101,6520,1643,5527,545,1988,413,1363,958,3351
320520,201908,35016,93661,25960,78024,4838,15892,10703,31021,15541,46913
320530,201908,30581,83478,23863,71189,2641,9344,14204,39679,16845,49023
330010,201908,21101,57937,17153,51097,2717,8545,10232,29804,12949,38349
330015,201908,1493,3763,1150,3193,204,640,609,1589,813,2229
330020,201908,20331,51464,17489,47376,2299,7151,12500,32833,14799,39984
330022,201908,1947,5277,1466,4430,246,764,828,2466,1074,3230
330023,201908,4830,11746,3339,9553,636,1966,1631,4521,2267,6487
330025,201908,5107,12606,3398,9731,1013,3107,1026,2868,2039,5975
330030,201908,10389,28512,7772,23957,917,3326,4562,13274,5479,16600
330040,201908,14483,38745,11470,33420,1251,4098,7360,20521,8611,24619
330045,201908,83682,201677,69039,182469,6007,15845,53265,139322,59272,155167
330050,201908,2461,6630,1813,5517,389,1278,810,2324,1199,3602
330060,201908,4934,13411,4071,11904,852,2743,1764,4775,2616,7518
330070,201908,22232,58580,18157,52329,3260,10000,9962,28361,13222,38361
330080,201908,8795,22795,7575,21002,1022,2950,5044,13776,6066,16726
330090,201908,3491,7401,2262,5723,165,452,1496,3739,1661,4191
330093,201908,2484,6260,1827,5245,144,441,1311,3744,1455,4185
330095,201908,1217,3534,932,2977,86,327,538,1573,624,1900
330100,201908,69044,186893,58434,170634,3962,13841,43271,123798,47233,137639
330110,201908,2062,6006,1752,5457,291,998,893,2674,1184,3672
330115,201908,2114,5389,1594,4605,248,793,920,2565,1168,3358
330120,201908,3510,8015,2558,6724,263,774,1708,4325,1971,5099
330130,201908,3896,10937,3238,9925,482,1567,1971,5981,2453,7548
330140,201908,3550,9460,2816,8358,417,1384,1694,4854,2111,6238
330150,201908,2148,5887,1651,5050,347,1113,713,2119,1060,3232
330160,201908,1356,3756,1051,3236,192,654,544,1591,736,2245
330170,201908,100746,261780,82623,236339,11947,34024,53515,154284,65462,188308
330180,201908,2122,5271,1615,4497,118,376,1074,2886,1192,3262
330185,201908,9517,24844,7911,22377,670,2260,5924,16171,6594,18431
330187,201908,4050,10529,3205,9223,461,1478,1913,5449,2374,6927
330190,201908,31457,78743,27063,72501,2203,6355,20953,55220,23156,61575
330200,201908,15335,40517,12664,37021,2584,7216,7793,23363,10377,30579
330205,201908,2079,5262,1581,4422,102,345,1068,2880,1170,3225
330210,201908,3357,8568,2396,6812,375,1185,1080,2838,1455,4023
330220,201908,11381,29303,8053,23464,1794,5715,2629,7031,4423,12746
330225,201908,3754,9874,2876,8495,251,895,1967,5623,2218,6518
330227,201908,17189,42743,14689,39550,746,2327,12333,32609,13079,34936
330230,201908,1691,3932,1198,3291,101,291,793,2148,894,2439
330240,201908,23057,61276,18624,53980,2802,8835,11319,31808,14121,40643
330245,201908,1676,4230,960,2973,208,668,309,966,517,1634
330250,201908,36257,95944,30392,86948,6061,17627,16968,48781,23029,66408
330260,201908,4138,10843,3178,9455,425,1405,1940,5512,2365,6917
330270,201908,25499,54000,15537,39490,2802,7695,6603,16401,9405,24096
330280,201908,2397,6416,1772,5303,200,660,1021,2927,1221,3587
330285,201908,21891,54291,17421,47723,1674,5251,12237,32355,13911,37606
330290,201908,3664,9289,2940,8252,383,1198,1901,5138,2284,6336
330300,201908,5651,13684,3999,11185,367,1160,2611,7117,2978,8277
330310,201908,2393,6113,1772,5059,110,283,1182,3369,1292,3652
330320,201908,15813,39000,12447,34635,1611,4520,8747,24397,10358,28917
330330,201908,34388,79069,26888,68533,2832,7954,18786,46623,21618,54577
330340,201908,14545,36987,10526,30427,1862,5955,5087,13970,6949,19925
330350,201908,117639,285578,97646,260393,7351,20600,77193,204552,84544,225152
330360,201908,7582,18612,6483,17240,285,787,5414,14267,5699,15054
330370,201908,4776,13918,3512,11667,808,2762,1407,4827,2215,7589
330380,201908,5283,14703,3974,12336,808,2820,1799,5337,2607,8157
330385,201908,3977,11791,3261,10713,800,2854,1466,4808,2266,7662
330390,201908,25612,72241,19733,61357,3135,10903,10383,30568,13518,41471
330395,201908,3197,8158,2634,7384,189,595,1820,4974,2009,5569
330400,201908,3131,8580,2710,7859,173,631,1976,5396,2149,6027
330410,201908,2918,8108,2179,6768,429,1478,975,2842,1404,4320
330411,201908,2837,7785,2213,6559,161,556,1526,4308,1687,4864
330412,201908,1501,4436,1225,3943,155,559,697,2093,852,2652
330414,201908,23393,60484,18913,54188,1967,5748,13200,37463,15167,43211
330415,201908,3851,10674,2987,9179,352,1106,1712,5276,2064,6382
330420,201908,10434,26242,6991,20502,932,3052,3235,8889,4167,11941
330430,201908,9329,23118,7947,21098,481,1550,5938,15124,6419,16674
330440,201908,2286,6348,1705,5366,344,1257,871,2587,1215,3844
330450,201908,1334,3939,1065,3439,148,518,529,1671,677,2189
330452,201908,15956,41574,12567,36245,1837,5849,7524,20998,9361,26847
330455,201908,554324,1347530,420171,1146697,66141,191672,251941,673496,318082,865168
330460,201908,1195,3349,892,2872,172,592,445,1403,617,1995
330470,201908,4804,12343,3525,10334,1069,3210,1177,3485,2246,6695
330475,201908,8998,23976,7236,21582,1260,4239,4414,12839,5674,17078
330480,201908,5971,15799,5040,14381,465,1462,3349,9261,3814,10723
330490,201908,115300,272320,94647,243493,10859,29512,66233,167596,77092,197108
330500,201908,6734,17355,5664,15848,664,2082,3997,10973,4661,13055
330510,201908,39507,102201,30306,88894,6338,19477,16705,48352,23043,67829
330513,201908,1266,3332,990,2922,209,667,495,1460,704,2127
330515,201908,2561,6986,2074,6225,492,1558,993,2882,1485,4440
330520,201908,11136,30438,9100,27076,1314,4368,5258,15052,6572,19420
330530,201908,1669,4192,1203,3423,270,822,512,1413,782,2235
330540,201908,2924,7918,2238,6694,582,1784,871,2547,1453,4331
330550,201908,8525,23843,6787,21282,2151,7234,2352,7243,4503,14477
330555,201908,15704,35206,13044,31905,1068,2968,10000,24365,11068,27333
330560,201908,4316,11675,3462,10187,547,1649,2000,5710,2547,7359
330570,201908,2884,8001,2344,7093,381,1246,1429,4261,1810,5507
330575,201908,5470,14469,4726,13158,344,1116,3643,9758,3987,10874
330580,201908,15387,42372,11653,35357,2414,7931,5218,15078,7632,23009
330590,201908,1474,4098,1260,3811,213,657,807,2451,1020,3108
330600,201908,11708,31542,9223,27375,1191,3901,5346,15462,6537,19363
330610,201908,9305,25342,7570,22524,706,2464,5048,14546,5754,17010
330615,201908,2076,5753,1573,5038,310,1048,946,3062,1256,4110
330620,201908,3970,11712,3156,10228,782,2764,1254,3762,2036,6526
330630,201908,24796,63856,19316,54850,1746,5888,13104,35561,14850,41449
350010,201908,2147,5657,1029,3177,227,735,140,313,367,1048
350020,201908,704,1864,370,1168,48,148,135,378,183,526
350030,201908,3848,11051,2789,9036,696,2404,994,3072,1690,5476
350040,201908,690,2012,399,1367,58,222,130,365,188,587
350050,201908,1089,2853,740,2200,177,603,235,554,412,1157
350055,201908,930,2434,687,2042,77,252,384,1061,461,1313
350060,201908,111,293,74,232,13,43,37,113,50,156
350070,201908,3740,9967,2252,7124,446,1539,633,1778,1079,3317
350075,201908,605,1834,437,1485,181,651,39,122,220,773
350080,201908,683,1805,402,1264,55,190,157,453,212,643
350090,201908,644,1563,363,1050,74,229,132,345,206,574
350100,201908,2130,5831,1415,4494,138,531,780,2332,918,2863
350110,201908,473,1240,322,963,23,83,176,517,199,600
350115,201908,1342,3957,1070,3339,187,662,549,1548,736,2210
350120,201908,658,1556,330,912,44,135,152,372,196,507
350130,201908,3151,8602,2477,7306,439,1357,1186,3308,1625,4665
350140,201908,757,2207,484,1627,53,233,236,714,289,947
350150,201908,515,1596,414,1394,96,304,97,307,193,611
350160,201908,11104,27906,7222,20872,914,3058,4260,11544,5174,14602
350170,201908,1928,5744,1491,4726,289,962,592,1763,881,2725
350180,201908,1081,2713,524,1582,115,345,120,338,235,683
350190,201908,2945,8472,2047,6574,409,1507,808,2152,1217,3659
350200,201908,435,1229,342,1051,21,73,227,660,248,733
350210,201908,5438,12816,3622,10026,575,1683,2056,5488,2631,7171
350220,201908,2832,7767,1864,5854,431,1425,625,1756,1056,3181
350230,201908,990,2677,819,2408,166,523,422,1197,588,1720
350240,201908,710,2104,448,1480,85,272,131,407,216,679
350250,201908,2421,7310,1789,6165,636,2379,300,1092,936,3471
350260,201908,783,1942,495,1412,54,162,297,816,351,978
350270,201908,4642,12794,3639,10805,605,1927,1802,4960,2407,6887
350275,201908,2405,6657,1901,5762,331,1130,1030,2907,1361,4037
350280,201908,19304,43871,11081,30259,2029,5876,3907,10285,5936,16161
350290,201908,3171,8816,2105,6606,408,1420,827,2400,1235,3820
350300,201908,681,1898,482,1478,85,290,224,623,309,913
350310,201908,839,2482,609,1973,104,412,230,646,334,1058
350315,201908,568,1501,369,1128,29,108,165,458,194,566
350320,201908,13524,35920,10185,29938,2400,7690,3387,9334,5787,17024
350330,201908,14136,35440,9908,27059,1231,3670,5909,15133,7140,18803
350335,201908,356,1010,262,826,22,83,148,442,170,525
350340,201908,1112,2914,642,2031,119,407,223,678,342,1085
350350,201908,759,1987,584,1788,82,297,314,928,396,1225
350360,201908,1114,3372,852,2801,224,735,242,792,466,1527
350370,201908,633,1637,429,1254,146,411,105,304,251,715
350380,201908,4574,12526,3008,9391,838,2634,699,2240,1537,4874
350390,201908,9680,26648,7550,22845,1870,5836,3033,8969,4903,14805
350395,201908,427,1097,202,654,21,63,62,179,83,242
350400,201908,8098,20581,5527,16160,1363,4275,1547,4305,2910,8580
350410,201908,9525,27291,6817,21836,1553,5529,2264,6665,3817,12194
350420,201908,696,1915,496,1538,94,324,115,324,209,648
350430,201908,664,1837,535,1616,70,258,327,877,397,1135
350440,201908,1845,4787,1463,4189,113,390,953,2640,1066,3030
350450,201908,6803,19147,5274,16405,1181,3990,2082,6045,3263,10035
350460,201908,1717,4472,838,2619,126,415,178,471,304,886
350470,201908,275,707,204,581,9,35,135,362,144,397
350480,201908,886,2370,557,1733,119,424,83,218,202,642
350490,201908,1884,5070,1310,4069,310,983,381,1092,691,2075
350500,201908,666,1812,499,1484,77,247,238,661,315,908
350510,201908,1131,3007,808,2396,109,368,421,1177,530,1545
350520,201908,2086,6534,1599,5501,262,1034,703,2185,965,3219
350530,201908,2743,6992,1963,5470,247,763,1104,2873,1351,3636
350535,201908,1440,4034,1239,3731,188,635,756,2182,944,2817
350540,201908,1777,4562,1270,3753,197,613,702,2021,899,2634
350550,201908,8621,21676,5903,17027,668,2259,3279,8787,3947,11046
350560,201908,3891,11138,3059,9555,308,1007,1850,5581,2158,6588
350570,201908,23754,68034,18958,58356,3898,13086,8953,26099,12851,39185
350580,201908,1949,5459,1036,3378,264,917,148,393,412,1310
350590,201908,4762,13353,3426,10256,521,1779,1910,5216,2431,6995
350600,201908,38054,90317,23171,63383,3437,10359,10729,26746,14166,37105
350610,201908,6648,18628,4756,14770,934,3118,2058,6107,2992,9225
350620,201908,412,1040,244,775,26,98,130,386,156,484
350630,201908,1482,3926,1070,3160,75,290,654,1791,729,2081
350635,201908,7907,20355,5932,17173,1057,3419,3253,8886,4310,12305
350640,201908,949,2605,506,1582,67,206,162,426,229,632
350650,201908,8008,21967,5297,16333,1079,3597,1759,4975,2838,8572
350660,201908,4596,12264,3490,10370,624,1867,1743,5180,2367,7047
350670,201908,1895,5157,1551,4644,163,534,1007,2983,1170,3517
350680,201908,1137,3107,739,2336,156,509,287,866,443,1375
350690,201908,1251,3384,896,2750,151,509,468,1355,619,1864
350700,201908,5029,12776,3262,9994,555,1938,1433,4079,1988,6017
350710,201908,2790,7817,2318,6975,338,1193,1266,3572,1604,4765
350715,201908,860,2487,687,2146,72,289,332,925,404,1214
350720,201908,171,434,118,335,20,57,37,90,57,147
350730,201908,572,1619,458,1400,33,135,322,922,355,1057
350740,201908,1643,4542,1072,3316,198,639,308,869,506,1508
350745,201908,580,1572,330,1033,32,112,149,420,181,532
350750,201908,10003,26848,7507,22343,1382,4651,3132,8246,4514,12897
350760,201908,13698,35306,9573,28012,2335,7441,3053,7991,5388,15432
350770,201908,931,2357,569,1715,50,158,335,994,385,1152
350775,201908,684,1689,465,1334,47,141,210,587,257,728
350780,201908,2003,5152,1399,4216,261,881,472,1589,733,2470
350790,201908,1736,4753,1056,3443,205,725,232,613,437,1338
350800,201908,3278,9760,2791,8864,351,1218,1693,5229,2044,6447
350810,201908,2543,6438,1997,5648,269,800,1107,3141,1376,3941
350820,201908,922,2186,495,1402,48,148,219,566,267,714
350830,201908,866,2445,463,1527,82,270,133,366,215,636
350840,201908,2999,9117,2186,7467,557,2082,803,2463,1360,4545
350850,201908,6719,19401,5097,16259,1197,4101,1922,5891,3119,9992
350860,201908,3462,9593,3020,8938,152,589,2232,6461,2384,7050
350870,201908,2695,7753,1954,6514,304,1150,994,3184,1298,4334
350880,201908,1260,3731,982,3132,232,752,307,947,539,1699
350890,201908,579,1524,358,1059,52,163,120,312,172,475
350900,201908,6844,19200,4268,13436,1130,3850,1034,2924,2164,6774
350910,201908,888,2307,747,2067,107,338,498,1330,605,1668
350920,201908,11971,30545,10092,27340,533,1783,7905,20464,8438,22247
350925,201908,4439,12396,3144,9922,619,2072,1382,3980,2001,6052
350930,201908,1457,3799,963,2846,118,362,528,1514,646,1876
350940,201908,2187,6054,1716,5211,211,696,1042,3073,1253,3769
350945,201908,887,2522,656,2054,109,410,316,885,425,1295
350950,201908,84583,224507,64464,184606,9075,28494,37520,101805,46595,130299
350960,201908,6088,16995,4684,14289,632,2190,2707,7782,3339,9972
350970,201908,3660,10841,2681,8781,830,2983,434,1224,1264,4207
350980,201908,618,1727,483,1472,146,471,193,576,339,1047
350990,201908,1771,5153,1301,4343,313,1180,450,1396,763,2576
350995,201908,780,2466,693,2283,55,217,471,1476,526,1693
351000,201908,2837,7518,1981,5954,383,1235,677,1920,1060,3155
351010,201908,321,805,201,586,21,68,104,291,125,359
351015,201908,775,2342,617,2020,94,355,281,807,375,1162
351020,201908,9061,25129,6758,21115,1410,4563,3221,9784,4631,14347
351030,201908,2608,7921,2090,6839,319,1178,1101,3478,1420,4656
351040,201908,4813,12241,4020,10984,231,801,3195,8400,3426,9201
351050,201908,17762,43927,11966,34571,2536,7780,4797,13504,7333,21284
351060,201908,47512,121821,36104,101785,4258,13104,23146,62915,27404,76019
351070,201908,1493,3832,829,2619,221,764,122,365,343,1129
351080,201908,2712,6874,1951,5912,286,1027,1169,3330,1455,4357
351090,201908,329,989,227,788,48,166,54,190,102,356
351100,201908,2355,6471,1503,4747,353,1150,403,1347,756,2497
351110,201908,6014,15593,3822,11442,714,2313,1522,4235,2236,6548
351120,201908,757,1999,507,1549,73,224,198,583,271,807
351130,201908,1091,2842,466,1493,97,318,87,251,184,569
351140,201908,1912,5549,1349,4415,318,1158,463,1347,781,2505
351150,201908,2056,6082,1306,4389,274,989,461,1385,735,2374
351160,201908,1150,3724,889,3095,198,728,261,802,459,1530
351170,201908,1402,3984,1207,3600,120,386,789,2249,909,2635
351190,201908,1038,2908,631,2026,113,373,201,573,314,946
351200,201908,1636,4011,1219,3366,99,313,808,2101,907,2414
351210,201908,1552,3879,901,2565,89,286,516,1358,605,1644
351220,201908,3228,9329,2750,8501,357,1152,1727,5268,2084,6420
351230,201908,1848,5175,1352,4269,269,982,577,1604,846,2586
351240,201908,2168,5678,1387,4022,263,791,596,1577,859,2368
351250,201908,1113,2994,629,1981,77,254,232,728,309,982
351260,201908,931,2435,665,1936,150,420,221,645,371,1065
351270,201908,406,1163,332,1039,42,154,189,519,231,673
351280,201908,4032,10990,3052,9094,554,1764,1376,3904,1930,5668
351290,201908,1122,2907,757,2244,138,413,373,1064,511,1477
351300,201908,15949,44701,10800,34492,2125,7322,4261,13176,6386,20498
351310,201908,3239,8343,2424,6976,221,760,1616,4350,1837,5110
351320,201908,919,2744,654,2140,128,461,235,688,363,1149
351330,201908,541,1290,453,1128,38,114,334,757,372,871
351340,201908,6453,18919,5115,16504,1262,4212,2087,6708,3349,10920
351350,201908,11756,30549,9778,27191,1132,3372,6978,18728,8110,22100
351360,201908,3863,10560,3179,9449,805,2575,1092,2986,1897,5561
351370,201908,2176,6234,1430,4620,374,1265,447,1285,821,2550
351380,201908,47608,119040,33756,93774,4942,14641,18108,47981,23050,62622
351385,201908,290,750,152,459,27,76,43,118,70,194
351390,201908,1402,3526,845,2662,140,513,458,1326,598,1839
351400,201908,955,2707,762,2291,151,458,425,1235,576,1693
351410,201908,2616,7400,1836,5854,320,1035,700,2160,1020,3195
351420,201908,370,909,196,587,39,101,91,270,130,371
351430,201908,924,2596,721,2245,72,226,472,1438,544,1664
351440,201908,3409,9199,2168,6538,401,1296,558,1410,959,2706
351450,201908,1762,4718,1132,3496,237,804,199,500,436,1304
351460,201908,821,2207,627,1862,157,445,321,946,478,1391
351470,201908,1202,3140,903,2607,97,331,550,1485,647,1816
351480,201908,2618,7810,2060,6805,368,1334,854,2625,1222,3959
351490,201908,1958,5728,1672,5172,90,356,1261,3706,1351,4062
351492,201908,349,971,279,815,11,40,185,524,196,564
351495,201908,202,558,145,439,18,54,73,205,91,259
351500,201908,36579,93145,26867,75796,4578,13813,14699,39305,19277,53118
351510,201908,12712,32407,9116,25833,1217,3910,5485,14763,6702,18673
351512,201908,494,1367,322,967,58,170,100,266,158,436
351515,201908,3304,7546,1918,5273,358,1081,532,1495,890,2576
351518,201908,2429,6271,1537,4638,223,776,814,2205,1037,2981
351519,201908,754,2100,421,1382,78,259,64,193,142,452
351520,201908,1181,2993,448,1414,57,196,174,485,231,681
351530,201908,352,980,198,626,31,99,70,173,101,272
351535,201908,2053,5004,1433,3950,209,630,735,1895,944,2525
351540,201908,2279,5819,1450,4333,358,1225,398,1010,756,2235
351550,201908,6459,16574,4272,12311,457,1566,2341,6183,2798,7749
351560,201908,444,1300,355,1122,89,314,95,274,184,588
351565,201908,195,585,154,506,32,119,41,125,73,244
351570,201908,19530,53912,14444,42995,1741,5660,8716,24724,10457,30384
351580,201908,270,697,154,468,15,48,61,188,76,236
351590,201908,500,1142,254,696,28,99,131,306,159,405
351600,201908,1447,3819,1092,3152,112,366,649,1724,761,2090
351610,201908,774,1852,477,1317,32,106,249,616,281,722
351620,201908,21955,60621,16073,49658,2801,9789,6825,18833,9626,28622
351630,201908,26476,72444,21156,62857,3574,11118,12477,35882,16051,47000
351640,201908,16417,44700,12525,37147,1394,4676,8133,23061,9527,27737
351650,201908,408,1094,180,591,22,79,40,105,62,184
351660,201908,767,2215,466,1487,87,290,69,183,156,473
351670,201908,5406,14951,3752,11285,758,2314,1696,4741,2454,7055
351680,201908,419,1243,255,824,50,146,61,174,111,320
351685,201908,447,1322,356,1159,97,308,111,330,208,638
351690,201908,1071,2782,619,1826,100,319,246,650,346,969
351700,201908,1293,3294,925,2629,124,355,524,1407,648,1762
351710,201908,773,2096,518,1617,48,174,260,721,308,895
351720,201908,1492,3994,952,2985,168,568,336,991,504,1559
351730,201908,941,2536,771,2236,78,280,481,1311,559,1591
351740,201908,3667,9371,2811,7668,503,1450,1341,3374,1844,4824
351750,201908,1348,3696,827,2724,164,567,281,909,445,1476
351760,201908,3328,9487,2346,7412,499,1771,816,2325,1315,4096
351770,201908,1849,5571,1498,4852,331,1109,707,2233,1038,3342
351780,201908,1414,3660,747,2275,123,436,231,651,354,1087
351790,201908,1303,3152,1017,2756,165,432,603,1653,768,2085
351800,201908,514,1192,248,699,32,93,83,199,115,292
351810,201908,1003,2681,806,2353,46,142,571,1584,617,1726
351820,201908,2541,7284,1737,5646,448,1582,353,1080,801,2662
351830,201908,4393,12049,3340,10152,346,1250,1993,5735,2339,6985
351840,201908,8221,23654,6202,19764,989,3505,2958,8825,3947,12330
351850,201908,1775,4758,1092,3419,208,747,325,872,533,1619
351860,201908,2852,8426,2214,7179,402,1362,1172,3825,1574,5187
351870,201908,23560,62014,17864,52306,5278,15845,6548,19699,11826,35544
351880,201908,118285,319922,87492,263624,23157,75364,32115,91670,55272,167034
351885,201908,890,2483,695,2112,92,314,404,1161,496,1475
351890,201908,676,1894,484,1555,115,365,72,200,187,565
351900,201908,1086,2990,839,2597,139,437,425,1306,564,1743
351905,201908,406,1131,266,838,23,82,101,267,124,349
351907,201908,22011,58589,16779,48949,1942,6167,10647,29895,12589,36062
351910,201908,1286,3427,887,2580,85,269,472,1246,557,1515
351920,201908,857,2299,622,1835,84,295,292,785,376,1080
351925,201908,904,2521,685,2085,107,356,318,887,425,1243
351930,201908,3177,9101,2875,8525,489,1497,2002,5826,2491,7323
351940,201908,1116,2938,795,2377,121,398,390,1123,511,1521
351950,201908,1597,3767,1141,3075,71,206,745,1948,816,2154
351960,201908,5308,13756,3848,11130,847,2619,1629,4372,2476,6991
351970,201908,6543,20236,5349,18054,894,3374,2886,9407,3780,12781
351980,201908,1060,2522,655,1839,79,263,373,969,452,1232
351990,201908,1456,3510,1003,2793,72,258,447,1113,519,1371
352000,201908,2564,7476,2172,6648,279,987,1370,3899,1649,4886
352010,201908,2186,6084,1759,5328,450,1475,322,1014,772,2489
352020,201908,1472,4106,1139,3521,199,651,531,1559,730,2210
352030,201908,5500,14853,4333,12945,873,2843,2181,6308,3054,9151
352040,201908,2711,7468,1715,5368,290,954,527,1429,817,2383
352042,201908,3199,8001,1939,5812,405,1314,771,2260,1176,3574
352044,201908,2136,5829,1162,3893,207,768,228,693,435,1461
352050,201908,12554,34245,7819,24535,1927,6755,1253,3350,3180,10105
352060,201908,742,2048,524,1609,78,263,225,632,303,895
352070,201908,881,1797,554,1355,63,169,248,519,311,688
352080,201908,480,1246,287,847,35,110,107,278,142,388
352090,201908,1476,4440,1181,3797,157,582,498,1427,655,2009
352100,201908,3098,8849,2548,7798,603,1983,1140,3276,1743,5259
352110,201908,592,1819,452,1513,104,362,164,505,268,867
352115,201908,527,1499,435,1351,56,190,246,761,302,951
352120,201908,861,2645,677,2248,75,278,388,1193,463,1471
352130,201908,1921,5478,1223,3727,226,706,470,1328,696,2034
352140,201908,1300,3504,850,2599,142,467,385,1139,527,1606
352150,201908,833,2294,620,1902,117,381,350,1033,467,1414
352160,201908,999,2503,717,2065,91,313,375,1016,466,1329
352170,201908,3015,8263,2343,6879,395,1305,1254,3331,1649,4636
352180,201908,2671,7374,2078,6236,528,1760,599,1549,1127,3309
352190,201908,1219,3352,922,2877,157,480,427,1367,584,1847
352200,201908,382,1169,266,920,37,144,93,308,130,452
352210,201908,18886,45904,14678,40074,1279,3822,10839,29086,12118,32908
352215,201908,541,1446,466,1344,50,169,323,894,373,1063
352220,201908,17898,46305,11742,34826,2937,9077,3918,11083,6855,20160
352230,201908,13117,39420,9897,33040,2423,8926,3383,10437,5806,19363
352240,201908,10980,28988,8235,24232,1867,6196,3302,8788,5169,14984
352250,201908,23507,67279,18795,58676,3634,12008,10368,31642,14002,43650
352260,201908,4944,12814,3357,9609,505,1695,1875,4823,2380,6518
352265,201908,924,2627,813,2448,58,223,590,1712,648,1935
352270,201908,1509,4652,1119,3785,250,923,360,1132,610,2055
352280,201908,2389,6218,1810,5334,188,691,1026,2776,1214,3467
352290,201908,1136,3411,917,2946,149,541,446,1270,595,1811
352300,201908,944,2594,637,1947,96,340,311,849,407,1189
352310,201908,46415,125194,33703,102041,8643,26661,13974,42359,22617,69020
352320,201908,6338,17228,4801,14068,753,2448,2430,6434,3183,8882
352330,201908,2184,5939,1652,5169,343,1257,782,2262,1125,3519
352340,201908,5453,14780,3902,11935,693,2402,1793,5002,2486,7404
352350,201908,2152,6304,1670,5182,207,786,873,2385,1080,3171
352360,201908,1252,3384,1054,3027,105,368,775,2121,880,2489
352370,201908,1064,3083,910,2797,27,118,697,2087,724,2205
352380,201908,824,2340,627,1960,139,459,207,613,346,1072
352390,201908,16070,40167,10777,30877,1754,5454,5776,15550,7530,21004
352400,201908,3582,10044,2976,8882,515,1839,1741,4810,2256,6649
352410,201908,3160,8374,2373,7003,248,860,1414,3962,1662,4822
352420,201908,877,2171,607,1741,108,333,208,559,316,892
352430,201908,7642,19662,5373,15564,1354,4348,2194,5935,3548,10283
352440,201908,17802,49526,13300,40595,3212,10203,5069,14851,8281,25054
352450,201908,834,2154,411,1337,54,183,124,367,178,550
352460,201908,2992,8424,1998,6507,423,1515,699,2115,1122,3630
352470,201908,3455,8760,2475,7122,294,971,1358,3613,1652,4584
352480,201908,3515,8610,2296,6389,380,1212,1077,2730,1457,3942
352490,201908,725,2195,569,1881,111,398,243,758,354,1156
352500,201908,10602,27914,7108,21227,3172,10282,803,1444,3975,11726
352510,201908,3517,9726,2603,8104,599,2047,1052,3059,1651,5106
352520,201908,2589,7162,2001,6092,431,1472,1012,2773,1443,4245
352530,201908,9635,26094,6030,18647,1256,4348,1232,3034,2488,7382
352540,201908,538,1635,381,1258,76,266,102,310,178,576
352550,201908,981,2838,677,2212,137,504,203,587,340,1091
352560,201908,605,1707,448,1379,73,240,193,536,266,776
352570,201908,2058,6065,1312,4485,337,1211,163,488,500,1699
352580,201908,736,1971,593,1707,84,293,325,874,409,1167
352585,201908,253,739,186,596,17,68,99,284,116,352
352590,201908,13348,35638,9189,27550,2618,8449,3741,10385,6359,18834
352600,201908,1970,5428,1499,4499,217,717,824,2281,1041,2998
352610,201908,3090,8765,2286,7297,497,1767,881,2628,1378,4395
352620,201908,5774,15190,4429,13101,1350,4059,1609,4794,2959,8853
352630,201908,854,2164,640,1832,112,368,284,735,396,1103
352640,201908,3019,7948,2128,6355,235,748,1211,3460,1446,4208
352650,201908,578,1669,400,1250,65,231,140,407,205,638
352660,201908,1046,3161,837,2716,179,604,366,1146,545,1750
352670,201908,9051,25201,5672,18170,1530,5191,890,2765,2420,7956
352680,201908,3299,9993,2295,7582,368,1415,1102,3327,1470,4742
352690,201908,27890,71596,20770,58627,1815,5923,13490,36123,15305,42046
352700,201908,567,1454,410,1221,149,492,91,240,240,732
352710,201908,5077,13446,3576,10629,876,2881,1452,3974,2328,6855
352720,201908,7974,22612,6116,18902,2879,9016,821,2237,3700,11253
352725,201908,539,1385,279,841,18,56,127,363,145,419
352730,201908,2862,8245,2392,7149,357,1212,1375,3724,1732,4936
352740,201908,2263,5442,1663,4539,203,637,945,2430,1148,3067
352750,201908,419,1062,227,703,38,126,85,227,123,353
352760,201908,1647,4652,1218,3730,162,520,585,1765,747,2285
352770,201908,934,2535,609,1882,122,392,232,672,354,1064
352780,201908,660,1929,453,1506,87,299,134,437,221,736
352790,201908,448,1233,293,898,30,98,110,295,140,393
352800,201908,1301,4093,914,3151,246,881,137,423,383,1304
352810,201908,1109,2674,675,1869,90,264,382,995,472,1259
352820,201908,517,1375,334,1058,75,243,72,244,147,487
352830,201908,600,1544,263,812,31,98,51,128,82,226
352840,201908,3967,11654,3237,10282,1125,3873,994,2998,2119,6871
352850,201908,10595,26664,6975,20633,1972,6271,2067,5599,4039,11870
352860,201908,1039,2876,728,2277,154,518,231,679,385,1197
352870,201908,900,2291,611,1670,42,138,394,1018,436,1156
352880,201908,1864,4541,1286,3478,179,518,736,1836,915,2354
352885,201908,294,847,218,705,30,102,117,352,147,454
352890,201908,720,1732,443,1158,53,150,238,544,291,694
352900,201908,18193,48343,11958,35850,2043,6581,5178,14404,7221,20985
352910,201908,458,1226,214,678,25,78,54,154,79,232
352920,201908,2688,7066,1930,5671,176,575,1234,3455,1410,4030
352930,201908,5795,16063,4209,12873,780,2570,1836,5190,2616,7760
352940,201908,22842,65116,16708,51639,3992,13499,5727,16575,9719,30074
352950,201908,485,1289,265,855,68,223,33,92,101,315
352960,201908,741,2053,378,1243,61,216,79,239,140,455
352965,201908,272,733,151,495,42,142,30,84,72,226
352970,201908,3104,7445,2304,6143,276,771,1446,3815,1722,4586
352980,201908,1425,3888,1101,3366,273,872,524,1555,797,2427
352990,201908,4101,11655,3237,10206,647,2256,1590,4801,2237,7057
353000,201908,451,1255,227,706,34,114,55,140,89,254
353010,201908,2535,6411,1633,4762,392,1254,587,1551,979,2805
353020,201908,3714,9697,2059,6177,296,1008,709,1962,1005,2970
353030,201908,4294,11296,2875,8659,722,2328,682,1990,1404,4318
353040,201908,621,1505,446,1231,62,191,253,647,315,838
353050,201908,5151,15205,3715,12176,784,2776,1592,4956,2376,7732
353060,201908,48189,125319,39234,110647,3058,10414,28493,76915,31551,87329
353070,201908,9515,27584,6634,21377,1407,4857,2346,6994,3753,11851
353080,201908,4287,12277,2917,9492,577,2103,1042,2954,1619,5057
353090,201908,582,1799,432,1467,41,153,242,790,283,943
353100,201908,312,861,129,430,28,96,29,83,57,179
353110,201908,7604,21123,6127,18891,1156,3655,3410,10736,4566,14391
353120,201908,476,1212,307,890,47,147,120,313,167,460
353130,201908,2434,6019,1590,4618,437,1395,507,1354,944,2749
353140,201908,2647,6693,1891,5291,153,500,1219,3174,1372,3674
353150,201908,1502,3804,1056,3063,209,633,441,1192,650,1825
353160,201908,591,1566,412,1261,77,259,165,459,242,718
353170,201908,522,1476,403,1296,81,300,170,505,251,805
353180,201908,9918,24855,7627,21037,834,2572,5385,14401,6219,16973
353190,201908,3347,9139,2617,7679,292,947,1579,4293,1871,5240
353200,201908,2057,5552,945,3106,153,528,214,645,367,1173
353205,201908,343,1063,285,919,59,203,130,411,189,614
353210,201908,989,2367,614,1725,31,103,383,1039,414,1142
353215,201908,407,1159,311,961,50,161,139,377,189,538
353220,201908,787,2166,451,1423,101,298,53,153,154,451
353230,201908,788,2241,634,1998,172,594,254,717,426,1311
353240,201908,2277,6328,1822,5494,259,891,1060,3051,1319,3942
353250,201908,1302,2962,763,2035,107,301,403,1025,510,1326
353260,201908,1121,2671,618,1814,105,349,260,717,365,1066
353270,201908,701,1846,576,1615,47,151,385,1016,432,1167
353280,201908,728,2003,502,1563,101,321,151,433,252,754
353282,201908,1817,5233,1530,4668,184,650,885,2516,1069,3166
353284,201908,361,863,176,491,22,82,71,165,93,247
353286,201908,166,428,98,312,24,77,37,119,61,196
353290,201908,1573,4188,941,2871,118,396,380,1062,498,1458
353300,201908,1806,4934,1306,3918,214,744,573,1500,787,2244
353310,201908,405,1010,277,773,23,82,176,464,199,546
353320,201908,668,1703,565,1533,14,44,472,1272,486,1316
353325,201908,650,1935,433,1444,95,317,149,475,244,792
353330,201908,563,1474,346,1018,44,136,174,480,218,616
353340,201908,2901,7999,1987,6199,482,1644,796,2321,1278,3965
353350,201908,3351,9068,2247,6729,499,1658,529,1343,1028,3001
353360,201908,596,1716,466,1474,55,177,236,734,291,911
353370,201908,575,1714,472,1537,35,119,321,1000,356,1119
353380,201908,273,840,217,724,36,135,98,300,134,435
353390,201908,5764,14677,4174,11846,566,1790,2193,5833,2759,7623
353400,201908,421,1202,314,981,49,179,91,226,140,405
353410,201908,536,1468,409,1234,77,255,223,664,300,919
353420,201908,468,1276,277,850,59,165,21,49,80,214
353430,201908,2249,6409,1633,5242,380,1347,640,1875,1020,3222
353440,201908,64568,179595,45373,140705,8186,27217,22460,65699,30646,92916
353450,201908,389,1022,258,786,43,156,110,299,153,455
353460,201908,3315,9096,2351,7130,168,615,1084,3150,1252,3765
353470,201908,7753,20812,5405,16331,991,3382,2105,5760,3096,9142
353475,201908,1438,3815,983,2838,139,442,465,1225,604,1667
353480,201908,1672,4543,1296,3837,74,267,852,2411,926,2678
353490,201908,1063,2856,667,2049,110,351,276,807,386,1158
353500,201908,1025,2446,781,2074,183,496,425,1136,608,1632
353510,201908,848,2578,604,1955,128,440,145,410,273,850
353520,201908,1125,3008,703,2201,95,333,302,884,397,1217
353530,201908,2491,6734,1898,5608,244,817,949,2586,1193,3403
353540,201908,2031,5650,1647,5007,305,957,887,2610,1192,3567
353550,201908,5906,15623,4619,13419,847,2572,2383,6649,3230,9221
353560,201908,2060,5879,1515,4967,495,1755,349,1061,844,2816
353570,201908,587,1537,430,1261,61,177,255,704,316,881
353580,201908,2100,5587,1621,4696,380,1071,717,2029,1097,3100
353590,201908,729,2004,460,1435,118,412,141,424,259,836
353600,201908,1806,4557,1344,3710,165,453,702,1892,867,2345
353610,201908,581,1792,413,1431,94,369,110,354,204,723
353620,201908,2654,7240,1830,5709,373,1298,576,1602,949,2900
353625,201908,520,1295,330,957,25,85,209,594,234,679
353630,201908,1252,4016,1002,3417,235,906,305,930,540,1836
353640,201908,1408,3718,1108,3237,143,446,629,1803,772,2249
353650,201908,8904,24475,6362,19226,747,2521,3522,9865,4269,12386
353657,201908,392,1039,269,819,32,98,110,307,142,405
353660,201908,1203,2634,813,2086,322,824,237,585,559,1409
353670,201908,4064,11555,3111,9627,639,2208,1497,4236,2136,6444
353680,201908,706,1949,525,1674,95,321,279,850,374,1171
353690,201908,446,1154,163,523,9,25,17,42,26,67
353700,201908,1973,5392,1634,4768,147,481,1134,3177,1281,3658
353710,201908,4432,9915,2460,6438,242,667,1495,3566,1737,4233
353715,201908,477,1256,265,835,14,53,66,190,80,243
353720,201908,1902,5226,1474,4585,183,645,915,2763,1098,3408
353730,201908,4386,11998,3226,9740,533,1777,1458,4047,1991,5824
353740,201908,1997,5386,1358,4193,334,1137,424,1195,758,2332
353750,201908,844,2607,592,2100,147,552,98,374,245,926
353760,201908,12450,29952,9558,25847,1759,5003,5422,14200,7181,19203
353770,201908,702,2135,355,1218,64,231,51,147,115,378
353780,201908,5173,15000,3942,12409,856,3000,1653,4717,2509,7717
353790,201908,2523,7870,1833,6378,501,1944,392,1200,893,3144
353800,201908,17454,47279,13298,40171,2167,6999,6860,20546,9027,27545
353810,201908,1132,3103,746,2299,117,401,297,855,414,1256
353820,201908,1753,4960,1201,3781,266,888,383,1160,649,2048
353830,201908,632,1583,440,1258,74,209,188,518,262,727
353850,201908,1656,4743,1250,3923,312,995,408,1287,720,2282
353860,201908,2596,7467,2018,6345,506,1775,853,2431,1359,4206
353870,201908,29312,78503,20040,60048,2875,9641,9740,26516,12615,36157
353880,201908,2970,8504,2319,7187,214,790,1354,3990,1568,4780
353890,201908,2427,5449,1575,4218,153,433,1033,2638,1186,3071
353900,201908,753,2132,529,1664,97,336,206,604,303,940
353910,201908,1945,5638,1601,5051,215,819,1027,3131,1242,3950
353920,201908,1894,5308,1283,4071,286,1051,318,838,604,1889
353930,201908,4309,11625,2828,8906,580,2061,972,2699,1552,4760
353940,201908,1130,3329,756,2527,148,498,239,739,387,1237
353950,201908,3041,8514,2383,7302,449,1507,1276,3586,1725,5093
353960,201908,755,2036,490,1508,95,305,177,519,272,824
353970,201908,716,1754,521,1459,45,138,324,870,369,1008
353980,201908,14950,38970,11384,32370,1052,3364,7640,20850,8692,24214
353990,201908,899,2219,520,1498,81,253,237,643,318,896
354000,201908,2567,6373,1381,4053,299,904,209,603,508,1507
354010,201908,357,950,259,788,35,116,149,434,184,550
354020,201908,3524,10115,2735,8365,701,2299,999,2748,1700,5047
354025,201908,745,2062,465,1501,82,298,89,254,171,552
354030,201908,494,1101,244,673,42,114,101,265,143,379
354040,201908,814,1946,502,1402,29,98,343,914,372,1012
354050,201908,957,2798,655,2220,166,583,168,573,334,1156
354060,201908,3613,10574,2434,7982,580,1993,738,2234,1318,4227
354070,201908,3499,9708,2396,7485,488,1710,825,2168,1313,3878
354075,201908,2475,7419,1866,6228,257,1018,1008,3260,1265,4278
354080,201908,1427,3986,926,2971,184,647,217,636,401,1283
354085,201908,416,894,324,778,1,3,226,505,227,508
354090,201908,1524,4358,1326,3946,99,323,982,2864,1081,3187
354100,201908,18354,52200,12727,41825,2906,10225,4852,15779,7758,26004
354105,201908,1532,3869,989,2847,132,381,437,1181,569,1562
354110,201908,515,1428,343,1103,66,231,102,317,168,548
354120,201908,1542,4203,1005,3043,192,613,339,894,531,1507
354130,201908,5821,15524,3703,11339,1005,3299,224,418,1229,3717
354140,201908,19582,48568,12623,35794,2387,7333,4943,12873,7330,20206
354150,201908,3162,7715,2318,6301,524,1454,902,2417,1426,3871
354160,201908,3088,9132,2237,7344,661,2326,612,1854,1273,4180
354165,201908,616,1855,455,1520,80,310,225,697,305,1007
354170,201908,1603,4574,1310,3972,92,328,795,2288,887,2616
354180,201908,443,1247,308,950,58,185,120,332,178,517
354190,201908,1481,4278,1039,3365,91,339,396,1248,487,1587
354200,201908,894,2294,693,1968,90,267,395,1052,485,1319
354210,201908,735,2014,583,1740,45,161,397,1092,442,1253
354220,201908,3116,8604,2231,6764,438,1418,988,2831,1426,4249
354230,201908,718,1840,558,1634,43,164,384,1056,427,1220
354240,201908,1595,4503,1030,3287,194,689,304,837,498,1526
354250,201908,530,1359,332,1046,92,292,89,294,181,586
354260,201908,8374,22613,6229,18792,1401,4401,2351,6888,3752,11289
354270,201908,1059,3244,828,2776,190,616,290,951,480,1567
354280,201908,767,1992,640,1803,65,238,396,1023,461,1261
354290,201908,899,2891,744,2549,132,456,350,1222,482,1678
354300,201908,3588,10775,3032,9703,939,3019,994,3147,1933,6166
354310,201908,635,1956,506,1664,123,442,160,469,283,911
354320,201908,912,2305,571,1693,74,261,224,582,298,843
354323,201908,484,1207,312,879,39,93,126,341,165,434
354325,201908,1232,3725,860,2900,158,540,323,1066,481,1606
354330,201908,8910,23121,5675,16321,769,2642,3195,8448,3964,11090
354340,201908,29451,77056,19906,59674,3861,12788,9031,25650,12892,38438
354350,201908,1188,3118,934,2648,103,313,611,1643,714,1956
354360,201908,616,1617,323,1086,59,199,54,180,113,379
354370,201908,992,2987,808,2667,140,494,423,1361,563,1855
354380,201908,755,2031,526,1640,95,355,121,305,216,660
354390,201908,13770,34282,8513,24794,1625,4986,2946,8117,4571,13103
354400,201908,1617,5262,1233,4336,211,784,430,1488,641,2272
354410,201908,5529,15472,4074,12453,972,3179,1663,4843,2635,8022
354420,201908,1464,3923,1058,3126,140,441,623,1759,763,2200
354425,201908,2661,6661,1865,5220,452,1290,729,2064,1181,3354
354430,201908,1565,4282,1203,3642,153,542,660,1825,813,2367
354440,201908,586,1597,358,1099,45,161,163,449,208,610
354450,201908,411,1092,216,716,36,126,53,152,89,278
354460,201908,922,2378,587,1764,82,261,295,845,377,1106
354470,201908,508,1304,308,885,17,59,149,376,166,435
354480,201908,1099,2522,729,1937,61,171,497,1259,558,1430
354490,201908,814,2455,587,1938,119,400,230,710,349,1110
354500,201908,2021,5836,1658,5263,525,1794,380,1214,905,3008
354510,201908,761,2135,600,1782,64,198,315,850,379,1048
354515,201908,318,968,231,775,41,160,86,266,127,426
354520,201908,6768,19165,4454,13889,683,2402,2345,6765,3028,9167
354530,201908,4219,12427,3199,10309,746,2509,1214,3831,1960,6340
354540,201908,1313,3567,946,2890,235,761,316,970,551,1731
354550,201908,532,1428,405,1178,58,179,230,626,288,805
354560,201908,2050,5121,1081,3151,155,474,530,1450,685,1924
354570,201908,1164,3000,462,1372,87,275,59,169,146,444
354580,201908,9217,24536,5896,18119,980,3298,2729,7936,3709,11234
354600,201908,1788,5013,1355,4150,159,566,830,2402,989,2968
354610,201908,417,1109,221,685,30,103,86,249,116,352
354620,201908,447,1318,282,977,48,181,101,305,149,486
354625,201908,337,954,183,619,30,117,42,114,72,231
354630,201908,1914,5832,1524,5022,544,1854,238,748,782,2602
354640,201908,3173,9310,2263,7362,399,1460,711,2125,1110,3585
354650,201908,909,2417,711,2059,61,176,430,1231,491,1407
354660,201908,3676,8739,1902,5683,178,631,926,2579,1104,3210
354670,201908,1069,3046,740,2343,168,585,267,768,435,1353
354680,201908,4833,13281,3800,11506,943,2947,1856,5715,2799,8662
354690,201908,567,1805,380,1357,88,334,105,367,193,701
354700,201908,904,2437,633,1889,99,321,300,825,399,1146
354710,201908,502,1383,345,1053,46,159,146,390,192,549
354720,201908,328,802,137,410,46,141,24,73,70,214
354730,201908,9898,28356,7296,23209,1061,3701,3937,12006,4998,15707
354740,201908,327,900,123,433,19,78,18,60,37,138
354750,201908,2470,6629,1541,4792,300,1005,600,1639,900,2644
354760,201908,1955,5474,1337,4253,347,1173,379,1124,726,2297
354765,201908,362,977,136,452,18,63,26,73,44,136
354770,201908,2355,5910,1681,4749,338,1017,741,1942,1079,2959
354780,201908,54908,142646,40898,113930,5188,16131,23854,61912,29042,78043
354790,201908,986,2798,774,2428,104,357,443,1327,547,1684
354800,201908,2647,7085,2028,6010,520,1558,798,2243,1318,3801
354805,201908,1365,3238,899,2482,107,303,468,1152,575,1455
354810,201908,667,1941,359,1270,52,206,77,244,129,450
354820,201908,951,2800,676,2227,133,489,163,457,296,946
354830,201908,485,1210,303,872,65,187,93,249,158,436
354840,201908,931,2369,496,1469,47,144,259,733,306,877
354850,201908,21017,56163,14397,43710,1905,6688,8168,23151,10073,29839
354860,201908,1646,4685,1037,3388,199,715,316,899,515,1614
354870,201908,55976,144134,42897,119129,5305,16140,25116,65576,30421,81716
354880,201908,5802,14745,2649,7761,339,1135,897,2100,1236,3235
354890,201908,17055,43488,12995,36403,1875,5907,7394,19772,9269,25679
354900,201908,417,1094,265,814,43,137,61,169,104,306
354910,201908,5298,14349,3056,10035,695,2433,394,1204,1089,3637
354920,201908,460,1236,192,663,27,103,37,121,64,224
354925,201908,291,852,162,555,24,82,34,110,58,192
354930,201908,407,980,218,650,17,62,91,235,108,297
354940,201908,2158,6670,1494,5133,493,1822,232,727,725,2549
354950,201908,1487,4014,1169,3512,71,308,800,2233,871,2541
354960,201908,886,2377,674,2063,64,242,385,1096,449,1338
354970,201908,4157,11979,3208,10218,438,1494,1868,5760,2306,7254
354980,201908,31379,76213,20262,56481,2438,7992,11322,29115,13760,37107
354990,201908,62104,161292,45328,129875,4525,14691,27520,74223,32045,88914
354995,201908,2728,6447,2046,5509,218,704,1409,3559,1627,4263
355000,201908,1537,4022,1175,3468,181,610,505,1361,686,1971
355010,201908,3750,10421,2161,6974,712,2355,193,658,905,3013
355020,201908,3488,10037,2492,8198,713,2554,719,2192,1432,4746
355030,201908,1367941,3425352,962132,2606523,159321,470638,458622,1140469,617943,1611107
355040,201908,2834,7502,2250,6672,369,1126,1439,4276,1808,5402
355050,201908,983,2402,698,1944,191,553,240,618,431,1171
355060,201908,5865,16432,4262,13264,753,2682,2007,5610,2760,8292
355070,201908,8413,22507,6640,19525,808,2788,4052,11122,4860,13910
355080,201908,908,2649,551,1924,110,423,68,175,178,598
355090,201908,1146,3369,846,2816,225,725,221,775,446,1500
355100,201908,22226,59559,17148,51790,3007,9634,10055,29897,13062,39531
355110,201908,944,2701,701,2291,216,760,120,385,336,1145
355120,201908,691,1856,471,1493,45,158,160,472,205,630
355130,201908,885,1995,388,1056,26,75,207,528,233,603
355140,201908,1719,4117,1467,3750,116,367,1170,2873,1286,3240
355150,201908,4350,11772,3407,10040,404,1290,2038,5744,2442,7034
355160,201908,1919,5431,1368,4435,337,1229,308,947,645,2176
355170,201908,9817,25777,7490,21739,1652,5115,3635,10189,5287,15304
355180,201908,2767,7584,1922,6099,419,1502,660,1867,1079,3369
355190,201908,1916,5106,1500,4441,346,1072,766,2353,1112,3425
355200,201908,853,2682,716,2451,198,763,271,839,469,1602
355210,201908,2904,8234,2323,6972,378,1295,1223,3417,1601,4712
355220,201908,44727,122064,34755,102190,8735,27034,13334,35994,22069,63028
355230,201908,1166,2954,609,1821,116,349,195,536,311,885
355240,201908,23216,62061,15812,47114,2344,7610,8048,22753,10392,30363
355250,201908,36955,101130,26610,80640,6819,21840,9406,26917,16225,48757
355255,201908,811,2104,421,1307,77,243,136,398,213,641
355260,201908,1411,3631,1000,2903,135,475,579,1558,714,2033
355270,201908,1248,3720,924,2998,224,755,284,863,508,1618
355280,201908,28741,76056,19752,58156,3213,10103,8957,24841,12170,34944
355290,201908,883,2503,643,2034,140,416,248,754,388,1170
355300,201908,1253,3719,961,3113,165,549,293,908,458,1457
355310,201908,1041,2880,768,2405,94,288,427,1345,521,1633
355320,201908,547,1481,404,1203,71,245,161,402,232,647
355330,201908,2431,6524,1840,5450,149,547,1291,3632,1440,4179
355340,201908,3889,8667,3003,7457,401,923,1849,4664,2250,5587
355350,201908,1358,4024,989,3253,220,752,327,1060,547,1812
355360,201908,1254,3329,958,2851,125,390,571,1677,696,2067
355365,201908,377,1029,187,658,45,146,28,99,73,245
355370,201908,5668,14449,4245,12254,999,2761,1860,5818,2859,8579
355380,201908,2953,8065,2160,6483,396,1281,722,1855,1118,3136
355385,201908,1437,3905,1167,3491,124,460,695,1888,819,2348
355390,201908,814,2289,569,1732,125,402,223,631,348,1033
355395,201908,1986,5609,1328,4212,216,715,451,1273,667,1988
355400,201908,9273,27738,7320,23609,1923,6890,2384,6848,4307,13738
355410,201908,22085,61383,14136,45831,3298,11755,3297,10507,6595,22262
355420,201908,665,2206,538,1938,142,593,130,432,272,1025
355430,201908,3784,9672,2805,7930,721,1983,1197,3398,1918,5381
355440,201908,836,2308,483,1521,82,271,142,414,224,685
355450,201908,3511,9260,2141,6507,398,1264,787,2165,1185,3429
355460,201908,533,1325,324,962,43,147,150,404,193,551
355465,201908,400,1117,302,931,47,146,127,385,174,531
355470,201908,1171,3077,632,1950,176,582,184,509,360,1091
355475,201908,365,880,284,756,19,48,198,513,217,561
355480,201908,3605,10312,2954,9296,466,1658,1852,5621,2318,7279
355490,201908,980,2697,529,1673,44,145,254,750,298,895
355495,201908,797,2316,573,1891,81,304,196,601,277,905
355500,201908,6830,18084,3881,11993,600,2015,1185,3329,1785,5344
355510,201908,1356,3473,830,2497,120,408,314,834,434,1242
355520,201908,383,854,172,493,30,82,44,106,74,188
355530,201908,412,937,136,397,22,80,53,130,75,210
355535,201908,518,1457,389,1242,88,336,155,438,243,774
355540,201908,10139,26681,8243,23783,1467,4585,4859,13534,6326,18119
355550,201908,656,2000,540,1776,74,265,259,806,333,1071
355560,201908,1141,3015,612,1964,129,462,43,130,172,592
355570,201908,250,721,131,438,24,83,28,80,52,163
355580,201908,1235,3074,803,2338,130,431,366,977,496,1408
355590,201908,182,449,136,375,17,49,82,211,99,260
355600,201908,1504,3750,989,2845,207,630,410,1139,617,1769
355610,201908,1779,4548,1183,3451,152,466,555,1543,707,2009
355620,201908,4554,12704,3314,10147,437,1617,1707,4718,2144,6335
355630,201908,2328,6528,1576,5039,276,927,750,2340,1026,3267
355635,201908,925,2759,685,2275,128,468,221,684,349,1152
355640,201908,2758,8027,1856,6160,388,1378,438,1384,826,2762
355645,201908,4337,12488,3202,10408,429,1515,1762,5603,2191,7118
355650,201908,6703,18603,5329,16022,1555,4856,2034,5574,3589,10430
355660,201908,1328,3554,897,2715,130,461,304,907,434,1368
355670,201908,3513,9907,2288,7023,312,1167,1107,2950,1419,4117
355680,201908,3139,8888,1238,4147,331,1140,131,453,462,1593
355690,201908,778,2392,498,1810,122,450,11,21,133,471
355695,201908,239,700,138,467,11,49,21,46,32,95
355700,201908,7150,21002,5744,17770,1070,3435,2865,8326,3935,11761
355710,201908,8432,20266,5143,14104,861,2540,2169,5357,3030,7897
355715,201908,471,1235,242,751,53,182,43,103,96,285
355720,201908,1499,4379,1161,3723,198,679,579,1689,777,2368
355730,201908,970,2776,763,2350,177,588,298,823,475,1411
410010,201908,1280,3550,949,2849,211,707,189,533,400,1240
410020,201908,995,3128,771,2593,278,880,190,656,468,1536
410030,201908,1513,4299,1266,3885,189,650,645,1974,834,2624
410040,201908,11747,33672,8600,27434,1890,6468,2678,7933,4568,14401
410045,201908,891,2394,599,1847,88,303,196,563,284,866
410050,201908,2514,6392,1585,4681,333,1079,434,1169,767,2248
410060,201908,2102,6163,1586,5047,380,1242,448,1381,828,2623
410070,201908,1827,4770,1287,3726,225,726,449,1200,674,1926
410080,201908,1405,3780,984,2965,161,503,392,1191,553,1694
410090,201908,1038,2822,914,2612,86,240,551,1644,637,1884
410100,201908,1963,5804,1317,4195,187,687,208,620,395,1307
410105,201908,489,1283,252,778,40,143,64,182,104,325
410110,201908,3117,8173,2135,6169,299,938,868,2337,1167,3275
410115,201908,561,1442,387,1130,67,216,125,345,192,561
410120,201908,2352,7095,2041,6559,571,1994,799,2477,1370,4471
410130,201908,1132,3106,977,2802,235,755,436,1143,671,1898
410140,201908,14715,36367,8689,25167,1697,5289,1926,5021,3623,10310
410150,201908,16624,40115,7740,22088,1365,4189,1641,4361,3006,8550
410160,201908,2968,8402,2380,7332,501,1710,839,2572,1340,4282
410165,201908,721,2003,598,1732,58,203,346,932,404,1135
410170,201908,2611,6947,1681,4882,392,1223,149,441,541,1664
410180,201908,14829,42314,11322,34703,1673,5586,5832,16607,7505,22193
410185,201908,446,1244,315,961,51,167,103,281,154,448
410190,201908,2252,5780,1621,4604,343,992,439,1213,782,2205
410200,201908,4981,11941,2647,7727,443,1515,517,1465,960,2980
410210,201908,2971,7715,1835,5557,310,1062,601,1569,911,2631
410220,201908,537,1419,329,998,48,163,47,137,95,300
410230,201908,1661,4609,1267,3761,171,606,685,1890,856,2496
410240,201908,4655,12730,3212,9857,854,2900,224,626,1078,3526
410250,201908,2590,6319,1850,5043,151,518,869,2304,1020,2822
410260,201908,1856,4751,1165,3438,226,701,466,1333,692,2034
410270,201908,469,1246,326,975,51,175,116,321,167,496
410275,201908,673,1956,424,1381,60,208,191,566,251,774
410280,201908,2301,6276,1490,4581,230,780,569,1622,799,2402
410290,201908,3053,8771,2052,6557,495,1599,570,1814,1065,3413
410300,201908,649,1664,512,1419,52,158,232,602,284,760
410302,201908,367,964,186,587,31,97,91,271,122,368
410304,201908,1198,3241,1013,2876,136,374,561,1569,697,1943
410305,201908,1731,4273,1173,3439,162,515,663,1879,825,2394
410310,201908,2591,7552,2004,6309,390,1326,797,2477,1187,3803
410315,201908,738,1806,378,1187,128,404,77,239,205,643
410320,201908,1106,3106,714,2249,114,416,101,299,215,715
410322,201908,561,1526,281,866,28,101,120,333,148,434
410330,201908,1503,3784,1028,2835,166,516,295,791,461,1307
410335,201908,852,2389,666,2018,100,321,292,819,392,1140
410337,201908,826,2032,557,1493,54,150,241,600,295,750
410340,201908,488,1361,320,949,33,110,153,379,186,489
410345,201908,2429,6387,1260,3787,258,799,350,932,608,1731
410347,201908,707,1820,494,1416,54,198,140,391,194,589
410350,201908,1299,3382,917,2711,101,325,389,1081,490,1406
410360,201908,4280,10461,3270,8725,313,964,1989,5043,2302,6007
410370,201908,12382,33887,8017,23639,1044,3419,3135,8137,4179,11556
410380,201908,1445,3835,1049,3035,137,436,413,1102,550,1538
410390,201908,2609,6917,1636,5014,419,1411,409,1145,828,2556
410395,201908,874,2579,710,2217,138,472,307,930,445,1402
410400,201908,5505,15029,4086,12259,691,2188,1756,5019,2447,7207
410405,201908,809,1993,611,1695,127,402,250,633,377,1035
410410,201908,1196,3289,1135,3201,176,607,693,2009,869,2616
410420,201908,8490,24598,6472,20420,1193,4170,2125,6008,3318,10178
410425,201908,2965,8603,2086,6761,374,1313,721,2101,1095,3414
410430,201908,12995,33263,8678,25061,1452,4569,2897,7897,4349,12466
410440,201908,2399,7304,2024,6565,331,1211,1024,3243,1355,4454
410442,201908,2216,6948,1834,6060,537,1774,534,1747,1071,3521
410445,201908,2305,6842,1746,5733,351,1295,443,1516,794,2811
410450,201908,1484,3871,1059,3090,200,664,327,868,527,1532
410460,201908,1903,4827,1480,4174,169,504,704,1908,873,2412
410465,201908,2624,7903,2002,6560,389,1297,630,1936,1019,3233
410470,201908,1986,5684,1385,4466,365,1327,242,800,607,2127
410480,201908,36731,88767,19157,56818,3114,10318,3967,9997,7081,20315
410490,201908,11054,31348,7636,23913,1470,4959,2714,7955,4184,12914
410500,201908,1735,4774,1176,3615,254,913,323,843,577,1756
410510,201908,2002,5068,1289,3655,242,669,372,1069,614,1738
410520,201908,3073,9833,2748,9157,872,2962,1024,3471,1896,6433
410530,201908,1649,4207,762,2251,111,328,160,376,271,704
410540,201908,2615,7170,1832,5589,312,1056,870,2586,1182,3642
410550,201908,7094,19297,4455,13313,785,2558,1142,2973,1927,5531
410560,201908,1475,3920,1091,3136,229,701,390,990,619,1691
410570,201908,2524,7167,1864,5949,536,2002,157,547,693,2549
410580,201908,24532,65436,17895,52836,3725,11678,7364,20171,11089,31849
410590,201908,1496,4357,955,2962,156,501,266,732,422,1233
410600,201908,1820,4961,1358,4036,292,821,484,1490,776,2311
410610,201908,739,1987,518,1551,58,210,224,641,282,851
410620,201908,2124,6395,1343,4474,297,1059,225,699,522,1758
410630,201908,2405,6566,1514,4634,302,1017,261,653,563,1670
410640,201908,4712,11333,2952,8224,697,2223,390,1077,1087,3300
410645,201908,1037,3073,851,2807,276,946,347,1154,623,2100
410650,201908,2057,5857,1361,4330,306,1055,413,1187,719,2242
410655,201908,914,2260,631,1733,32,110,308,798,340,908
410657,201908,639,1722,402,1224,65,234,153,397,218,631
410660,201908,3260,8622,1755,5220,306,944,397,1124,703,2068
410670,201908,1065,2691,607,1756,124,364,246,656,370,1020
410680,201908,2695,8252,1891,6218,480,1560,395,1325,875,2885
410685,201908,570,1482,427,1223,97,313,172,438,269,751
410690,201908,124227,314941,79969,229707,13729,44499,27367,68450,41096,112949
410700,201908,2423,6257,2033,5642,283,816,1071,2874,1354,3690
410710,201908,818,2111,524,1565,67,211,249,704,316,915
410712,201908,654,1980,545,1728,130,452,191,563,321,1015
410715,201908,881,2643,526,1783,90,311,160,521,250,832
410720,201908,3187,8395,2362,6702,340,1123,491,1270,831,2393
410725,201908,1108,2810,630,1877,122,390,95,223,217,613
410730,201908,624,1692,461,1382,94,329,99,283,193,612
410740,201908,932,2632,669,2138,97,329,266,845,363,1174
410750,201908,1772,4607,1399,3923,224,704,570,1507,794,2211
410752,201908,353,895,158,476,17,57,69,195,86,252
410753,201908,245,756,171,587,24,98,38,118,62,216
410754,201908,1134,2961,925,2635,58,156,615,1857,673,2013
410755,201908,582,1529,407,1171,60,197,175,439,235,636
410760,201908,3311,8715,2322,6903,627,2096,494,1347,1121,3443
410765,201908,12966,37539,9935,31317,1654,5733,1758,5027,3412,10760
410770,201908,1012,2460,680,1877,73,218,349,942,422,1160
410773,201908,1280,3425,1095,3122,127,411,668,1827,795,2238
410775,201908,1454,3781,1260,3489,79,251,757,2056,836,2307
410780,201908,622,1563,385,1074,56,161,98,273,154,434
410785,201908,760,2122,581,1773,100,341,207,603,307,944
410790,201908,693,2008,553,1717,152,524,66,144,218,668
410800,201908,3316,7482,2605,6382,62,212,1639,3882,1701,4094
410810,201908,376,1038,288,863,34,115,130,355,164,470
410820,201908,806,2350,420,1320,93,299,77,214,170,513
410830,201908,31896,80001,21213,61426,4757,15593,6930,18784,11687,34377
410832,201908,987,2619,788,2257,103,345,435,1151,538,1496
410840,201908,7642,20041,4434,13645,898,3037,1023,2801,1921,5838
410845,201908,1155,3042,891,2597,175,534,351,993,526,1527
410850,201908,2289,6713,1965,6094,339,1141,918,2756,1257,3897
410855,201908,754,1914,487,1397,43,132,226,596,269,728
410860,201908,4154,10643,3264,9054,442,1385,1603,4175,2045,5560
410865,201908,1375,4182,1205,3825,162,579,697,2243,859,2822
410870,201908,1295,3527,1090,3184,69,220,745,2144,814,2364
410880,201908,4296,12049,3013,9516,527,1862,444,1537,971,3399
410890,201908,981,2793,695,2200,159,552,188,582,347,1134
410895,201908,990,3266,816,2858,285,1086,137,456,422,1542
410900,201908,906,2446,587,1801,107,322,107,274,214,596
410910,201908,379,916,216,591,10,37,136,337,146,374
410920,201908,872,2106,584,1631,87,285,255,701,342,986
410930,201908,1553,4212,1120,3398,281,980,239,711,520,1691
410940,201908,22203,62586,15816,50402,3393,11861,4454,14012,7847,25873
410950,201908,1952,5751,1726,5383,61,226,1399,4285,1460,4511
410960,201908,7212,18768,4580,14002,1062,3597,1594,4728,2656,8325
410965,201908,1004,2674,718,2111,102,325,386,1102,488,1427
410970,201908,3925,10807,2716,8404,625,2307,358,938,983,3245
410975,201908,1307,3388,968,2799,127,398,383,1087,510,1485
410980,201908,6821,17599,4247,12759,554,1850,1744,4865,2298,6715
410990,201908,1313,3362,849,2574,245,854,213,575,458,1429
411000,201908,555,1532,370,1153,52,183,107,288,159,471
411005,201908,425,1153,259,782,49,158,53,143,102,301
411007,201908,2212,6376,1798,5603,406,1327,589,1842,995,3169
411010,201908,4331,13168,3368,11071,858,3021,360,1069,1218,4090
411020,201908,2311,6754,1875,5958,547,1823,504,1541,1051,3364
411030,201908,730,1822,483,1300,41,151,257,612,298,763
411040,201908,942,2416,430,1255,49,152,136,333,185,485
411050,201908,1859,5979,1518,5151,413,1495,224,643,637,2138
411060,201908,1780,4763,1122,3441,269,959,176,495,445,1454
411065,201908,351,961,239,742,41,135,98,288,139,423
411070,201908,6660,17557,5235,15007,791,2558,2423,6666,3214,9224
411080,201908,2159,5843,1692,4967,465,1513,330,902,795,2415
411090,201908,855,2250,526,1596,42,155,132,381,174,536
411095,201908,1577,3771,1044,2893,115,359,368,956,483,1315
411100,201908,1110,2907,738,2231,79,276,226,694,305,970
411110,201908,648,1697,263,826,37,103,21,46,58,149
411120,201908,1247,3604,993,3066,332,1148,218,563,550,1711
411125,201908,5143,15332,4515,14063,966,3054,2123,6818,3089,9872
411130,201908,691,1889,478,1456,85,249,183,580,268,829
411140,201908,2276,7098,1867,6143,544,1907,502,1624,1046,3531
411150,201908,3826,10109,2575,7454,540,1792,235,506,775,2298
411155,201908,988,2555,569,1732,68,203,234,656,302,859
411160,201908,347,815,220,621,32,102,44,129,76,231
411170,201908,715,2168,523,1706,112,347,171,551,283,898
411180,201908,5373,14671,4071,12235,675,2241,1772,4955,2447,7196
411190,201908,1582,4207,1168,3438,194,600,421,1161,615,1761
411200,201908,5050,13921,3361,10568,892,3014,594,1651,1486,4665
411210,201908,2840,6405,1826,4797,336,1030,542,1288,878,2318
411220,201908,873,2344,627,1835,142,443,180,515,322,958
411230,201908,851,2309,575,1756,116,371,212,631,328,1002
411240,201908,1593,3893,941,2607,98,320,460,1164,558,1484
411250,201908,2168,5846,1575,4739,333,1173,468,1342,801,2515
411260,201908,331,903,213,654,27,80,81,222,108,302
411270,201908,1966,5431,1497,4460,240,739,678,1884,918,2623
411275,201908,1378,3298,935,2531,157,500,396,979,553,1479
411280,201908,1368,3785,885,2816,229,755,110,327,339,1082
411290,201908,772,2086,501,1535,51,148,241,750,292,898
411295,201908,1204,3019,878,2383,95,271,408,1052,503,1323
411300,201908,1042,2634,629,1802,62,191,252,637,314,828
411310,201908,866,2066,644,1729,45,120,280,742,325,862
411320,201908,5376,14372,3848,11482,739,2306,1497,4070,2236,6376
411325,201908,1486,4226,1241,3785,215,637,681,2132,896,2769
411330,201908,3344,9222,2423,7471,574,1922,710,2200,1284,4122
411340,201908,868,2413,503,1565,75,258,171,502,246,760
411342,201908,994,2424,577,1592,94,260,246,662,340,922
411345,201908,1091,2890,806,2400,77,246,545,1624,622,1870
411350,201908,2598,7311,1678,5360,439,1521,191,575,630,2096
411360,201908,666,1649,468,1332,55,158,158,444,213,602
411370,201908,51281,128889,36283,102675,2978,10227,20900,55120,23878,65347
411373,201908,1376,3559,1107,3127,96,329,589,1665,685,1994
411375,201908,1090,2792,770,2173,129,382,278,721,407,1103
411380,201908,1145,2716,731,1894,48,148,407,949,455,1097
411390,201908,1617,4528,1225,3634,190,618,475,1225,665,1843
411400,201908,2225,5675,1688,4646,216,722,817,2097,1033,2819
411410,201908,2274,6478,1664,5090,382,1287,359,1058,741,2345
411420,201908,4052,10223,2154,6456,328,1124,378,873,706,1997
411430,201908,3394,9390,2580,7799,568,1875,924,2551,1492,4426
411435,201908,442,1268,273,888,49,151,92,253,141,404
411440,201908,2581,7495,2070,6430,435,1482,690,2097,1125,3579
411450,201908,2576,6939,1950,5864,266,770,1021,3106,1287,3876
411460,201908,3880,10390,2213,6938,408,1448,384,1120,792,2568
411470,201908,746,2003,536,1570,93,294,180,472,273,766
411480,201908,4503,12480,3168,9860,682,2459,942,2634,1624,5093
411490,201908,1614,4272,1222,3577,159,546,467,1214,626,1760
411500,201908,1393,3796,906,2736,145,492,186,486,331,978
411510,201908,2250,5937,1776,5064,384,1260,378,1086,762,2346
411520,201908,30127,74467,16499,47425,2180,7038,5847,14925,8027,21963
411530,201908,914,2431,548,1701,118,416,91,241,209,657
411535,201908,470,1400,235,803,24,91,44,113,68,204
411540,201908,2896,7261,1887,5266,252,801,822,2194,1074,2995
411545,201908,948,2787,780,2480,76,237,498,1594,574,1831
411550,201908,695,1826,485,1400,79,255,86,255,165,510
411560,201908,1972,5333,1108,3446,169,597,82,201,251,798
411570,201908,7046,16986,4564,12970,984,3062,894,2490,1878,5552
411573,201908,767,2126,642,1910,85,268,343,991,428,1259
411575,201908,1848,5179,1359,4148,276,904,314,929,590,1833
411580,201908,4471,10510,2487,7334,356,1250,400,1038,756,2288
411585,201908,675,2008,283,960,70,244,44,131,114,375
411590,201908,398,1134,272,847,21,77,150,410,171,487
411600,201908,295,768,174,556,42,133,53,163,95,296
411605,201908,1602,3785,947,2639,134,460,477,1292,611,1752
411610,201908,2429,6097,1678,4612,97,331,1041,2655,1138,2986
411620,201908,2876,7780,2422,7045,424,1336,1318,3747,1742,5083
411630,201908,748,1976,493,1476,76,266,156,415,232,681
411640,201908,541,1495,359,1063,48,153,130,339,178,492
411650,201908,226,660,145,479,35,119,23,63,58,182
411660,201908,912,2320,636,1806,45,138,304,826,349,964
411670,201908,1298,3297,874,2417,97,287,394,992,491,1279
411680,201908,1525,4135,1145,3381,143,484,538,1548,681,2032
411690,201908,3630,9554,2708,7927,558,1691,797,2412,1355,4103
411695,201908,679,2103,428,1414,50,181,163,516,213,697
411700,201908,1611,4280,1025,3115,236,788,130,358,366,1146
411705,201908,1893,5953,1585,5413,332,1127,845,3083,1177,4210
411710,201908,1863,4849,1263,3673,314,943,181,517,495,1460
411720,201908,1092,2620,758,2003,129,360,316,772,445,1132
411721,201908,921,2407,677,1934,127,359,151,438,278,797
411722,201908,773,2115,412,1222,67,228,143,340,210,568
411725,201908,1200,3500,805,2666,191,665,163,540,354,1205
411727,201908,1498,4227,950,3032,228,752,137,404,365,1156
411729,201908,713,1756,445,1234,55,197,158,383,213,580
411730,201908,5323,14469,3928,11617,903,2807,1525,4379,2428,7186
411740,201908,543,1425,272,829,51,152,62,163,113,315
411745,201908,778,2263,496,1586,66,212,89,208,155,420
411750,201908,5059,13590,3548,10519,465,1486,1661,4578,2126,6064
411760,201908,7057,19151,5368,16083,1816,5615,1032,3390,2848,9005
411770,201908,3106,9191,2207,7135,546,1884,297,878,843,2762
411780,201908,2889,8354,2415,7359,664,2148,794,2403,1458,4551
411790,201908,2938,7256,1537,4608,339,1118,190,460,529,1578
411800,201908,1003,2841,678,2076,107,339,138,404,245,743
411810,201908,1606,4256,1159,3344,178,527,545,1490,723,2017
411820,201908,11096,33004,9004,28969,2483,8486,3444,10729,5927,19215
411830,201908,596,1484,397,1129,69,202,91,284,160,486
411840,201908,11774,31883,7612,22957,1338,4361,1999,5501,3337,9862
411845,201908,494,1430,258,838,36,139,46,134,82,273
411850,201908,7618,20074,5160,15499,1365,4532,765,2047,2130,6579
411860,201908,721,2099,520,1662,89,312,138,388,227,700
411870,201908,643,1953,437,1453,94,339,93,266,187,605
411880,201908,2115,5530,1515,4488,262,867,415,1179,677,2046
411885,201908,1072,2816,748,2206,100,338,258,719,358,1057
411890,201908,1184,3228,785,2434,146,497,67,176,213,673
411900,201908,822,2358,484,1574,110,376,59,187,169,563
411910,201908,976,2991,697,2352,176,631,205,636,381,1267
411915,201908,15910,39774,9953,28661,1624,5201,3423,8731,5047,13932
411920,201908,1056,3213,869,2803,205,747,277,832,482,1579
411925,201908,489,1297,328,986,73,242,118,341,191,583
411930,201908,5144,16231,4313,14538,1871,6878,231,900,2102,7778
411940,201908,3301,10050,2505,8164,634,2172,722,2099,1356,4271
411950,201908,13426,37176,10855,32723,1819,6034,5733,16584,7552,22618
411960,201908,5742,15864,4612,13503,932,3002,1612,4404,2544,7406
411965,201908,431,1204,301,934,38,126,114,314,152,440
411970,201908,1056,2551,811,2205,174,448,327,1017,501,1465
411980,201908,1489,3858,1071,3112,278,833,353,971,631,1804
411990,201908,38078,102518,24034,75467,4772,16439,7941,23560,12713,39999
411995,201908,2980,7726,2217,6483,649,2116,603,1625,1252,3741
412000,201908,2021,4676,1412,3621,42,128,976,2342,1018,2470
412010,201908,617,1950,431,1516,59,217,103,303,162,520
412015,201908,564,1604,460,1415,56,190,266,817,322,1007
412020,201908,456,1290,267,866,37,146,109,323,146,469
412030,201908,635,1806,425,1384,73,243,114,369,187,612
412033,201908,857,2300,583,1698,64,185,208,532,272,717
412035,201908,797,2160,497,1610,64,246,254,769,318,1015
412040,201908,602,1658,372,1160,69,220,65,192,134,412
412050,201908,1734,4427,1165,3356,227,737,277,789,504,1526
412060,201908,7185,21824,5944,19264,1743,6314,1471,4476,3214,10790
412065,201908,633,1795,438,1351,90,293,123,386,213,679
412070,201908,1152,3003,861,2399,129,373,337,880,466,1253
412080,201908,2031,5886,1239,4080,190,656,164,459,354,1115
412085,201908,301,765,95,305,10,25,15,36,25,61
412090,201908,5840,15410,4416,12720,1254,3740,1527,4476,2781,8216
412100,201908,1713,4786,1250,3897,356,1208,239,803,595,2011
412110,201908,871,2339,604,1763,85,260,209,586,294,846
412120,201908,1923,5756,1480,4825,295,1090,421,1180,716,2270
412125,201908,674,1940,474,1499,98,313,134,397,232,710
412130,201908,714,1866,488,1422,74,228,115,345,189,573
412135,201908,602,1613,259,781,38,115,91,252,129,367
412140,201908,1640,4151,1061,3071,213,728,199,513,412,1241
412150,201908,2875,7721,2370,6794,348,1122,1382,3758,1730,4880
412160,201908,1024,3182,596,2039,118,432,90,272,208,704
412170,201908,4288,12195,3570,10945,757,2478,1408,3989,2165,6467
412175,201908,1305,3923,1071,3490,240,783,440,1452,680,2235
412180,201908,1695,4799,1225,3885,170,646,515,1466,685,2112
412190,201908,3429,8674,2522,7027,321,980,1132,3144,1453,4124
412200,201908,1788,5465,1269,4186,339,1192,205,620,544,1812
412210,201908,629,1579,353,1045,59,198,101,265,160,463
412215,201908,3511,9586,2790,8185,747,2122,1130,3757,1877,5879
412217,201908,968,2589,802,2300,69,212,520,1442,589,1654
412220,201908,5932,16790,4732,14445,1189,3607,1490,4775,2679,8382
412230,201908,2685,8145,2132,6990,390,1432,567,1578,957,3010
412240,201908,6917,18003,4331,12862,759,2476,1288,3525,2047,6001
412250,201908,2015,5234,1506,4286,351,1029,353,953,704,1982
412260,201908,1254,3405,860,2545,146,427,242,674,388,1101
412265,201908,839,2404,694,2135,141,469,287,839,428,1308
412270,201908,880,2503,560,1760,69,233,221,606,290,839
412280,201908,459,1333,360,1156,76,254,94,269,170,523
412290,201908,998,2590,659,1945,103,322,201,571,304,893
412300,201908,1473,4065,1147,3417,254,789,270,810,524,1599
412310,201908,765,2102,630,1853,48,199,342,949,390,1148
412320,201908,839,2172,549,1582,73,272,188,542,261,814
412330,201908,1509,4139,1012,3138,193,645,334,1064,527,1709
412340,201908,1132,3243,688,2204,117,412,124,371,241,783
412350,201908,2877,7668,1784,5447,375,1168,343,1005,718,2173
412360,201908,258,715,160,492,6,25,88,257,94,282
412370,201908,819,2368,533,1750,111,413,32,108,143,521
412380,201908,1576,4358,1062,3256,292,949,154,513,446,1462
412382,201908,525,1323,338,982,47,158,121,294,168,452
412385,201908,2201,6137,1781,5306,564,1605,527,1718,1091,3323
412390,201908,2419,6077,1942,5315,346,942,771,2131,1117,3073
412395,201908,727,2102,486,1540,61,189,201,619,262,808
412400,201908,894,2418,632,1888,133,414,153,472,286,886
412402,201908,1912,4844,1295,3770,293,893,153,444,446,1337
412405,201908,3167,8555,2017,6205,499,1812,56,148,555,1960
412410,201908,5626,15112,4003,12214,790,2771,1177,3343,1967,6114
412420,201908,516,1353,318,933,27,91,135,346,162,437
412430,201908,553,1443,352,1043,31,100,155,435,186,535
412440,201908,2755,7753,1805,5816,485,1659,285,925,770,2584
412450,201908,389,1173,253,811,50,155,21,49,71,204
412460,201908,1025,2787,803,2398,143,473,346,1019,489,1492
412470,201908,1536,5030,1238,4323,325,1184,285,1014,610,2198
412480,201908,969,2690,610,1861,114,368,162,456,276,824
412490,201908,1214,3121,939,2589,109,306,526,1382,635,1688
412500,201908,1928,4983,1418,3969,318,880,385,1005,703,1885
412510,201908,1996,6166,1352,4452,311,1100,120,338,431,1438
412520,201908,1328,3503,685,2043,161,481,48,123,209,604
412530,201908,669,1816,477,1403,72,236,113,324,185,560
412535,201908,829,2209,558,1663,99,313,111,293,210,606
412540,201908,1214,3227,830,2438,93,341,263,792,356,1133
412545,201908,709,1847,473,1338,72,215,140,359,212,574
412550,201908,30821,84938,20919,64082,3750,12390,7481,20987,11231,33377
412555,201908,260,697,164,479,17,49,50,115,67,164
412560,201908,4849,14371,3515,11157,586,2011,1044,3311,1630,5322
412570,201908,4267,11089,2337,7197,543,1838,295,982,838,2820
412575,201908,993,2583,781,2177,89,269,438,1149,527,1418
412580,201908,1413,3788,960,2869,112,391,471,1336,583,1727
412590,201908,416,1115,212,678,30,108,17,44,47,152
412600,201908,1416,3998,1037,3202,183,645,397,1155,580,1800
412610,201908,811,2205,540,1574,53,167,267,685,320,852
412620,201908,1276,3477,941,2894,190,668,288,813,478,1481
412625,201908,8889,24122,5429,16967,792,2764,329,917,1121,3681
412627,201908,1136,3242,698,2280,142,490,180,581,322,1071
412630,201908,2898,8531,2030,6578,420,1361,621,1826,1041,3187
412635,201908,361,961,241,699,36,123,75,176,111,299
412640,201908,1064,2907,569,1769,76,254,143,399,219,653
412650,201908,1607,4520,1259,3769,233,765,446,1157,679,1922
412660,201908,2519,6729,1732,5126,289,916,494,1322,783,2238
412665,201908,421,1130,307,892,59,180,115,306,174,486
412667,201908,1706,4567,1245,3628,173,548,503,1387,676,1935
412670,201908,786,1953,518,1471,96,319,154,388,250,707
412680,201908,1693,4687,1125,3526,152,529,419,1175,571,1704
412690,201908,934,2555,683,2026,103,323,252,699,355,1022
412700,201908,2088,5606,1674,4928,229,798,846,2360,1075,3158
412710,201908,5981,17941,4514,14699,950,3414,1221,3620,2171,7034
412720,201908,1230,3694,914,2953,144,505,177,473,321,978
412730,201908,2213,6073,1316,4120,245,843,365,1068,610,1911
412740,201908,1804,5097,1184,3753,225,791,165,529,390,1320
412750,201908,3875,10432,3227,9440,349,1200,2070,5721,2419,6921
412760,201908,2920,8080,2399,7152,433,1424,1229,3437,1662,4861
412770,201908,10465,26939,5429,16723,809,2610,1137,3024,1946,5634
412780,201908,1219,3316,916,2759,199,643,342,998,541,1641
412785,201908,1980,5031,1360,3891,183,546,778,2177,961,2723
412788,201908,1328,3819,1068,3314,280,852,446,1365,726,2217
412790,201908,1256,3356,648,2040,103,384,201,551,304,935
412795,201908,1353,3587,697,2145,120,411,133,379,253,790
412796,201908,2342,6977,1916,6059,396,1326,606,1777,1002,3103
412800,201908,3442,8598,2297,6371,289,902,968,2361,1257,3263
412810,201908,11130,28667,6684,19407,888,2975,2329,5923,3217,8898
412820,201908,6508,18175,4575,14214,1077,3501,1326,4074,2403,7575
412830,201908,342,983,225,717,30,90,45,135,75,225
412840,201908,1838,4740,1296,3655,166,513,471,1241,637,1754
412850,201908,2907,7815,2085,6325,350,1133,783,2292,1133,3425
412853,201908,1656,4312,1361,3708,186,548,675,1651,861,2199
412855,201908,1233,3326,773,2301,154,509,221,613,375,1122
412860,201908,828,2131,568,1690,81,266,279,781,360,1047
412862,201908,715,1730,460,1289,74,213,197,538,271,751
412863,201908,1225,3786,1132,3630,158,522,762,2427,920,2949
412865,201908,738,2051,529,1634,113,364,165,510,278,874
412870,201908,895,2366,647,1943,183,610,134,413,317,1023
412880,201908,850,2387,539,1711,99,333,79,217,178,550
420005,201908,456,1370,241,856,35,131,103,369,138,500
420010,201908,3431,8481,2214,6342,165,493,1576,4536,1741,5029
420020,201908,489,1534,306,1074,50,203,57,166,107,369
420030,201908,93,310,64,248,21,90,17,61,38,151
420040,201908,569,1777,332,1233,50,203,24,72,74,275
420050,201908,674,1626,417,1157,44,151,260,659,304,810
420055,201908,174,514,92,314,18,71,33,93,51,164
420060,201908,111,321,63,199,12,44,14,30,26,74
420070,201908,756,2404,557,1938,125,453,187,636,312,1089
420075,201908,78,216,36,116,8,26,7,12,15,38
420080,201908,347,1035,269,861,79,272,88,274,167,546
420090,201908,426,1367,252,920,61,243,51,173,112,416
420100,201908,1178,3183,981,2883,50,166,774,2243,824,2409
420110,201908,260,850,235,797,46,180,98,307,144,487
420120,201908,481,1361,310,984,65,226,119,333,184,559
420125,201908,322,1031,238,843,64,244,98,318,162,562
420127,201908,292,819,100,342,21,72,22,75,43,147
420130,201908,2644,7601,1960,6345,292,1178,1012,3062,1304,4240
420140,201908,3509,9690,2484,7871,668,2400,326,1017,994,3417
420150,201908,602,1578,392,1211,54,180,207,613,261,793
420160,201908,234,588,100,316,13,39,27,83,40,122
420165,201908,163,472,93,306,23,79,27,81,50,160
420170,201908,266,810,165,563,23,74,36,105,59,179
420180,201908,182,563,103,369,16,59,30,105,46,164
420190,201908,174,566,103,379,36,145,22,71,58,216
420195,201908,1384,3730,994,3064,295,1035,121,310,416,1345
420200,201908,3706,9551,2121,6477,333,1261,765,1965,1098,3226
420205,201908,1532,4160,1056,3262,165,521,580,1809,745,2330
420207,201908,1742,4704,1081,3402,203,729,426,1265,629,1994
420208,201908,347,984,200,713,35,142,81,277,116,419
420209,201908,142,471,87,304,23,91,27,90,50,181
420210,201908,2634,6970,1686,5401,358,1246,745,2338,1103,3584
420213,201908,768,2432,628,2131,136,499,304,1007,440,1506
420215,201908,217,653,142,485,37,141,17,47,54,188
420220,201908,246,741,152,520,31,121,65,201,96,322
420230,201908,4557,12768,3399,10554,519,1765,1743,5203,2262,6968
420240,201908,12291,34238,7461,23292,1004,3608,3661,10082,4665,13690
420243,201908,383,1107,305,951,45,151,177,528,222,679
420245,201908,1312,3504,912,2784,82,329,509,1454,591,1783
420250,201908,443,1298,377,1178,74,265,179,499,253,764
420253,201908,526,1335,381,1118,33,98,207,601,240,699
420257,201908,183,467,107,326,21,72,55,159,76,231
420260,201908,1100,2999,785,2515,134,477,441,1399,575,1876
420270,201908,488,1308,224,684,34,112,80,235,114,347
420280,201908,1227,3585,858,2849,176,645,258,837,434,1482
420285,201908,78,204,42,129,7,33,11,28,18,61
420287,201908,465,1136,323,915,92,267,106,305,198,572
420290,201908,4233,12181,3166,9745,490,1789,1681,4641,2171,6430
420300,201908,6884,19706,3885,12652,778,2771,962,2766,1740,5537
420310,201908,851,2030,414,1168,57,169,211,546,268,715
420315,201908,828,2431,561,1895,122,451,221,740,343,1191
420320,201908,4431,12831,3341,10861,1026,3678,739,2212,1765,5890
420325,201908,254,762,189,647,40,138,66,220,106,358
420330,201908,885,2693,574,1984,110,426,173,526,283,952
420340,201908,986,2867,698,2291,173,583,63,195,236,778
420350,201908,1326,3547,913,2753,98,335,586,1717,684,2052
420360,201908,2606,7449,1363,4617,259,946,136,441,395,1387
420370,201908,1068,2968,848,2581,101,368,546,1578,647,1946
420380,201908,4672,12641,3019,9496,651,2199,998,2981,1649,5180
420390,201908,1113,2768,731,1945,119,391,334,643,453,1034
420395,201908,1003,2968,640,2183,105,385,72,196,177,581
420400,201908,925,2718,607,2003,110,414,195,599,305,1013
420410,201908,515,1433,384,1162,37,134,245,699,282,833
420415,201908,301,914,227,751,58,214,81,270,139,484
420417,201908,636,1923,502,1635,132,433,173,579,305,1012
420419,201908,148,519,110,418,40,162,7,23,47,185
420420,201908,10638,28418,7006,21604,2151,7359,1711,4779,3862,12138
420425,201908,678,1823,454,1379,45,167,202,583,247,750
420430,201908,3066,8575,1839,5807,450,1530,545,1535,995,3065
420435,201908,277,711,120,399,17,58,53,175,70,233
420440,201908,701,2039,423,1388,113,411,151,432,264,843
420445,201908,305,782,177,520,36,115,63,168,99,283
420450,201908,690,2084,485,1615,94,381,162,466,256,847
420455,201908,2001,5098,1444,4197,190,681,721,1959,911,2640
420460,201908,8697,23814,6423,19542,1040,3578,3084,8921,4124,12499
420470,201908,618,1633,328,1056,68,253,71,188,139,441
420475,201908,60,165,28,94,10,33,3,13,13,46
420480,201908,5655,14249,3348,10206,690,2257,974,2943,1664,5200
420490,201908,380,1121,258,854,58,225,88,286,146,511
420500,201908,1384,4012,912,3057,164,593,372,1234,536,1827
420510,201908,166,481,85,284,11,41,26,82,37,123
420515,201908,44,124,30,93,1,1,12,42,13,43
420517,201908,761,2124,648,1926,43,125,491,1464,534,1589
420519,201908,313,749,207,588,27,84,105,304,132,388
420520,201908,370,998,169,583,26,87,14,45,40,132
420530,201908,817,2413,562,1861,108,399,176,510,284,909
420535,201908,224,658,90,307,19,77,28,89,47,166
420540,201908,31315,76020,19317,54902,3161,10046,6720,16221,9881,26267
420543,201908,222,674,167,535,25,77,85,266,110,343
420545,201908,1136,3436,866,2826,177,619,328,986,505,1605
420550,201908,3506,9761,2202,7380,425,1596,858,2878,1283,4474
420555,201908,307,905,206,679,31,114,106,328,137,442
420560,201908,425,1076,282,855,70,222,139,411,209,633
420570,201908,2111,6068,1578,4996,325,1131,579,1728,904,2859
420580,201908,1784,4626,1221,3731,283,907,432,1326,715,2233
420590,201908,2967,8048,1680,5200,315,1142,398,898,713,2040
420600,201908,983,2930,749,2450,121,442,363,1140,484,1582
420610,201908,366,1076,195,679,48,161,59,214,107,375
420620,201908,635,1602,405,1213,98,304,156,458,254,762
420630,201908,915,2776,653,2106,105,372,343,1022,448,1394
420640,201908,524,1484,242,854,66,228,25,75,91,303
420650,201908,3207,8787,1865,5796,296,1000,705,1899,1001,2899
420660,201908,358,958,227,690,47,148,61,175,108,323
420665,201908,548,1476,336,1092,63,224,134,386,197,610
420670,201908,1408,3872,902,2888,140,538,338,941,478,1479
420675,201908,145,408,81,282,22,94,26,74,48,168
420680,201908,343,803,174,562,30,117,74,225,104,342
420690,201908,843,2615,504,1749,77,322,117,309,194,631
420700,201908,2772,7486,2078,6268,281,953,1080,3112,1361,4065
420710,201908,779,2349,581,1893,67,274,331,987,398,1261
420720,201908,1306,3643,924,2985,221,716,399,1261,620,1977
420730,201908,2752,7414,2079,6304,350,1115,1127,3305,1477,4420
420740,201908,580,1788,360,1277,103,384,38,153,141,537
420750,201908,1878,5594,1215,4015,204,766,467,1417,671,2183
420757,201908,70,181,32,113,1,3,15,47,16,50
420760,201908,362,1079,153,487,37,135,30,70,67,205
420765,201908,404,1244,216,748,27,104,94,317,121,421
420768,201908,1239,3661,1051,3320,149,472,736,2293,885,2765
420770,201908,418,1150,188,671,32,127,80,270,112,397
420775,201908,360,1061,227,770,47,182,46,129,93,311
420780,201908,923,2595,538,1762,121,423,93,259,214,682
420785,201908,198,534,139,414,18,57,59,145,77,202
420790,201908,1024,3219,747,2627,148,604,366,1209,514,1813
420800,201908,705,1810,324,1015,86,292,70,211,156,503
420810,201908,1488,4816,1196,4188,350,1383,343,1016,693,2399
420820,201908,10977,28184,7677,22671,1563,5207,3372,8973,4935,14180
420830,201908,3277,8937,2399,7322,502,1668,944,2781,1446,4449
420840,201908,543,1662,247,912,69,269,34,111,103,380
420845,201908,2149,5651,1275,4055,238,885,486,1468,724,2353
420850,201908,1077,3552,655,2407,136,554,97,312,233,866
420860,201908,298,768,162,519,41,142,37,109,78,251
420870,201908,817,2243,618,1881,173,621,258,717,431,1338
420880,201908,976,3061,761,2621,160,634,271,858,431,1492
420890,201908,7639,20758,4367,13932,693,2435,1403,3863,2096,6298
420895,201908,158,478,97,317,24,79,29,98,53,177
420900,201908,1382,3545,818,2518,107,402,341,906,448,1308
420910,201908,26838,72269,16457,51718,2687,9523,6063,17024,8750,26547
420915,201908,549,1984,387,1512,60,242,188,735,248,977
420917,201908,348,911,179,518,26,84,80,223,106,307
420920,201908,78,214,26,95,0,0,4,10,4,10
420930,201908,17086,45232,11883,35912,2160,7212,5151,14694,7311,21906
420940,201908,2563,6470,1504,4595,376,1292,228,547,604,1839
420945,201908,132,395,102,322,25,92,37,99,62,191
420950,201908,318,937,170,582,27,112,36,102,63,214
420960,201908,986,2512,680,1963,118,409,280,699,398,1108
420970,201908,2411,6979,1587,5277,455,1563,252,867,707,2430
420980,201908,289,920,243,846,116,402,70,272,186,674
420985,201908,321,942,157,564,34,126,47,147,81,273
420990,201908,382,1172,196,717,36,133,31,87,67,220
421000,201908,513,1653,339,1225,76,304,83,260,159,564
421003,201908,482,1139,151,449,12,40,26,65,38,105
421005,201908,59,177,50,164,12,37,23,74,35,111
421010,201908,3299,9270,2361,7518,497,1778,588,1638,1085,3416
421020,201908,378,1177,294,1027,47,191,146,486,193,677
421030,201908,775,2422,603,2046,171,644,171,530,342,1174
421040,201908,698,1641,412,1199,38,122,242,694,280,816
421050,201908,1070,3014,658,2060,125,418,210,581,335,999
421055,201908,170,473,81,257,11,38,33,88,44,126
421060,201908,576,1724,358,1163,65,234,137,395,202,629
421070,201908,553,1700,308,1091,75,270,57,209,132,479
421080,201908,470,1372,398,1231,52,180,249,770,301,950
421085,201908,386,1131,139,511,27,101,19,57,46,158
421090,201908,293,761,172,510,18,57,58,156,76,213
421100,201908,947,2168,387,1154,101,338,63,164,164,502
421105,201908,1504,4190,1045,3267,177,555,447,1353,624,1908
421110,201908,1046,2974,875,2712,41,117,619,2005,660,2122
421120,201908,925,2942,657,2292,95,368,212,683,307,1051
421125,201908,262,705,207,619,74,247,69,164,143,411
421130,201908,4365,13128,3604,11601,831,3038,1881,5736,2712,8774
421140,201908,293,811,187,597,34,113,68,196,102,309
421145,201908,438,1259,274,893,60,220,125,376,185,596
421150,201908,565,1545,311,1005,62,213,101,310,163,523
421160,201908,544,1454,370,1143,47,160,230,691,277,851
421165,201908,191,576,117,392,27,89,45,148,72,237
421170,201908,1087,2908,837,2505,138,392,508,1552,646,1944
421175,201908,1080,2812,668,2146,133,485,269,806,402,1291
421180,201908,374,982,198,616,35,133,69,199,104,332
421185,201908,307,829,200,603,29,97,108,318,137,415
421187,201908,302,922,182,605,33,106,59,183,92,289
421189,201908,356,1034,265,842,41,129,96,291,137,420
421190,201908,9820,27045,6364,20499,1312,4645,1771,5293,3083,9938
421200,201908,662,2002,535,1736,72,256,288,897,360,1153
421205,201908,198,539,145,451,28,91,71,214,99,305
421210,201908,1071,2807,637,2042,156,503,205,669,361,1172
421220,201908,1352,4269,1058,3587,239,880,290,889,529,1769
421223,201908,366,1057,226,771,56,185,92,316,148,501
421225,201908,909,2782,777,2537,146,527,435,1423,581,1950
421227,201908,947,2515,544,1693,98,333,233,725,331,1058
421230,201908,603,1624,377,1200,92,302,120,392,212,694
421240,201908,267,821,105,403,14,69,16,59,30,128
421250,201908,1667,4337,1099,3384,174,577,510,1538,684,2115
421260,201908,174,513,47,178,11,47,11,40,22,87
421265,201908,616,1712,571,1649,13,44,527,1527,540,1571
421270,201908,396,1049,172,606,27,92,56,183,83,275
421280,201908,1604,4687,1186,3892,212,834,584,1759,796,2593
421290,201908,828,2308,441,1388,88,302,96,276,184,578
421300,201908,256,697,136,440,22,77,30,100,52,177
421310,201908,182,530,128,421,25,87,58,196,83,283
421315,201908,214,613,133,416,35,105,31,97,66,202
421320,201908,643,1895,307,1030,44,160,44,105,88,265
421330,201908,626,1873,441,1489,87,324,122,390,209,714
421335,201908,365,1125,294,996,63,240,111,368,174,608
421340,201908,1323,3837,946,3085,200,732,355,1081,555,1813
421350,201908,1257,3415,843,2666,173,667,350,1006,523,1673
421360,201908,2253,6236,1332,4338,274,1066,466,1311,740,2377
421370,201908,492,1619,288,1060,58,229,73,230,131,459
421380,201908,817,2239,697,2025,96,323,416,1161,512,1484
421390,201908,172,473,62,214,13,43,18,51,31,94
421400,201908,282,920,193,700,36,146,91,307,127,453
421410,201908,222,599,93,321,16,60,22,67,38,127
421415,201908,218,665,114,379,30,100,23,64,53,164
421420,201908,499,1433,413,1264,53,184,249,718,302,902
421430,201908,124,398,99,339,11,38,33,100,44,138
421440,201908,619,1654,378,1214,75,231,167,536,242,767
421450,201908,391,1193,239,820,29,119,40,149,69,268
421460,201908,327,962,194,681,29,98,33,95,62,193
421470,201908,258,768,143,504,26,103,53,192,79,295
421480,201908,2733,7480,1764,5606,395,1447,626,1766,1021,3213
421490,201908,110,355,68,240,6,24,20,49,26,73
421500,201908,2144,6488,1485,5082,416,1646,317,965,733,2611
421505,201908,289,865,255,806,36,126,155,471,191,597
421507,201908,409,1201,222,768,61,220,63,206,124,426
421510,201908,275,794,162,514,32,106,75,219,107,325
421520,201908,505,1361,312,927,39,134,174,478,213,612
421530,201908,324,1024,187,680,40,173,42,122,82,295
421535,201908,397,1076,240,774,41,154,119,355,160,509
421540,201908,256,627,127,404,16,54,42,121,58,175
421545,201908,696,2076,512,1720,110,432,238,736,348,1168
421550,201908,1930,5447,1553,4859,300,1020,805,2454,1105,3474
421555,201908,197,614,72,270,14,59,11,28,25,87
421560,201908,78,260,49,187,13,48,12,42,25,90
421565,201908,901,2382,613,1912,156,548,173,529,329,1077
421567,201908,453,1551,286,1048,114,431,61,200,175,631
421568,201908,332,1014,236,778,36,140,107,332,143,472
421569,201908,187,539,76,258,20,71,33,109,53,180
421570,201908,971,2721,694,2181,186,637,168,498,354,1135
421575,201908,279,847,213,676,41,147,84,224,125,371
421580,201908,3190,9158,2079,6761,398,1520,746,2047,1144,3567
421590,201908,143,463,110,375,37,133,29,85,66,218
421600,201908,523,1447,354,1093,83,271,93,246,176,517
421605,201908,744,1978,515,1585,100,287,219,694,319,981
421610,201908,1067,2971,657,2144,129,450,166,531,295,981
421620,201908,3926,10690,2228,7425,541,1963,531,1683,1072,3646
421625,201908,185,521,75,248,14,43,14,46,28,89
421630,201908,2444,6673,1433,4554,253,948,410,1098,663,2046
421635,201908,238,666,155,479,20,70,85,241,105,311
421640,201908,695,1934,496,1600,104,357,163,532,267,889
421650,201908,2204,6208,1391,4631,340,1294,339,938,679,2232
421660,201908,8472,24310,6093,19696,978,3613,2464,7232,3442,10845
421670,201908,761,2240,530,1697,99,359,253,776,352,1135
421680,201908,987,2832,753,2384,206,699,316,904,522,1603
421690,201908,1237,3652,851,2799,168,630,292,949,460,1579
421700,201908,466,1456,254,915,50,201,67,215,117,416
421710,201908,224,711,92,309,21,75,24,75,45,150
421715,201908,103,297,80,242,19,54,51,149,70,203
421720,201908,1945,5420,1103,3591,297,1073,286,783,583,1856
421725,201908,217,539,108,342,21,72,41,102,62,174
421730,201908,381,1124,196,589,20,64,99,275,119,339
421740,201908,656,1897,452,1445,128,414,100,287,228,701
421750,201908,896,2162,422,1257,93,308,157,421,250,729
421755,201908,178,493,97,295,15,60,45,120,60,180
421760,201908,874,2413,532,1747,98,359,161,453,259,812
421770,201908,2304,6284,1678,5152,428,1356,572,1882,1000,3238
421775,201908,215,568,136,403,20,66,63,168,83,234
421780,201908,800,2457,526,1852,111,436,194,632,305,1068
421790,201908,740,1921,420,1353,96,324,195,606,291,930
421795,201908,218,628,139,426,27,96,47,127,74,223
421800,201908,2448,6954,1797,5704,280,1013,922,2762,1202,3775
421810,201908,628,1768,429,1373,59,221,233,716,292,937
421820,201908,935,2780,512,1742,100,384,139,384,239,768
421825,201908,1318,3775,1168,3533,140,472,792,2320,932,2792
421830,201908,1964,6114,1647,5493,342,1234,702,2248,1044,3482
421835,201908,210,554,114,368,20,69,30,84,50,153
421840,201908,220,714,144,526,30,116,35,120,65,236
421850,201908,384,1108,210,723,43,166,65,159,108,325
421860,201908,303,892,177,624,24,97,57,177,81,274
421870,201908,3728,9680,2581,7452,494,1632,1182,3085,1676,4717
421875,201908,224,677,108,384,19,73,24,64,43,137
421880,201908,523,1474,350,1123,95,360,68,222,163,582
421885,201908,211,570,128,404,32,105,35,93,67,198
421890,201908,778,2451,586,2050,116,461,256,833,372,1294
421895,201908,395,1033,323,936,41,135,208,621,249,756
421900,201908,953,2485,627,1830,96,328,282,743,378,1071
421910,201908,324,980,222,754,49,192,51,145,100,337
421915,201908,375,1066,203,660,43,138,26,75,69,213
421917,201908,558,1375,321,1044,113,396,72,237,185,633
421920,201908,413,1280,293,1037,130,484,80,278,210,762
421930,201908,2415,6362,1142,3778,308,1133,214,635,522,1768
421935,201908,414,1335,326,1127,61,225,175,575,236,800
421940,201908,320,969,127,427,18,74,37,110,55,184
421950,201908,3027,7682,1493,4708,319,1114,337,935,656,2049
421960,201908,164,419,88,283,20,73,18,50,38,123
421970,201908,1923,5101,1094,3385,231,819,349,918,580,1737
421985,201908,254,661,153,461,18,62,51,146,69,208
422000,201908,1738,4751,1409,4173,160,548,913,2666,1073,3214
430003,201908,531,1506,344,1136,66,241,135,438,201,679
430005,201908,268,733,167,537,39,130,75,229,114,359
430010,201908,1705,4347,1366,3756,156,476,939,2481,1095,2957
430020,201908,576,1337,436,1145,59,177,271,679,330,856
430030,201908,1018,2459,566,1646,155,483,160,425,315,908
430040,201908,9609,23962,5612,16597,1474,4730,501,1611,1975,6341
430045,201908,553,1402,372,1056,30,97,219,597,249,694
430047,201908,253,548,93,266,20,64,23,66,43,130
430050,201908,857,2223,476,1434,112,352,116,340,228,692
430055,201908,261,664,114,343,13,52,62,165,75,217
430057,201908,95,215,32,89,7,25,7,17,14,42
430060,201908,16371,45451,12682,39426,2864,9475,5552,17202,8416,26677
430063,201908,865,2436,672,2019,131,391,363,1082,494,1473
430064,201908,988,2802,741,2263,210,676,259,746,469,1422
430066,201908,103,237,74,189,4,11,54,123,58,134
430070,201908,703,1787,90,303,7,26,11,30,18,56
430080,201908,791,2020,472,1367,78,261,217,538,295,799
430085,201908,873,2011,524,1438,87,246,226,596,313,842
430087,201908,516,1399,419,1256,71,211,241,738,312,949
430090,201908,570,1491,184,597,17,73,55,167,72,240
430100,201908,675,1684,369,1087,72,236,140,361,212,597
430105,201908,1088,2928,666,2188,133,486,309,1006,442,1492
430107,201908,184,551,111,362,22,81,30,79,52,160
430110,201908,2092,5262,1504,4368,232,721,828,2373,1060,3094
430120,201908,1329,4017,814,2669,154,529,345,1143,499,1672
430130,201908,3400,8188,2538,6953,990,2725,463,1498,1453,4223
430140,201908,917,2586,619,1986,150,484,269,850,419,1334
430150,201908,576,1501,308,944,70,225,95,286,165,511
430155,201908,251,657,119,371,17,51,20,52,37,103
430160,201908,18246,45186,14281,39216,2246,6619,7338,20096,9584,26715
430163,201908,2599,6506,1768,5125,113,343,1195,3464,1308,3807
430165,201908,336,827,83,276,15,37,14,38,29,75
430170,201908,919,2457,327,1126,58,210,58,182,116,392
430175,201908,662,2027,542,1759,143,455,255,807,398,1262
430180,201908,658,1682,520,1434,67,193,350,942,417,1135
430185,201908,462,1117,275,784,59,161,84,218,143,379
430187,201908,670,1640,473,1362,81,259,225,657,306,916
430190,201908,1416,3872,1129,3388,255,822,491,1389,746,2211
430192,201908,134,372,55,162,7,20,13,33,20,53
430195,201908,399,1196,52,187,7,21,5,20,12,41
430200,201908,1099,3337,886,2938,281,964,257,872,538,1836
430205,201908,485,1299,404,1131,14,48,339,921,353,969
430210,201908,4830,12549,3238,9230,647,1954,1015,2331,1662,4285
430215,201908,311,818,189,564,39,125,75,226,114,351
430220,201908,644,1599,163,550,32,134,36,90,68,224
430222,201908,184,548,134,434,15,58,53,161,68,219
430223,201908,241,655,195,570,26,78,115,326,141,404
430225,201908,16,35,12,29,1,2,9,18,10,20
430230,201908,1738,4939,1508,4586,155,472,1105,3357,1260,3829
430235,201908,289,873,195,649,47,174,59,168,106,342
430237,201908,532,1318,364,1022,21,76,243,648,264,724
430240,201908,1146,2596,636,1734,76,251,348,878,424,1129
430245,201908,674,2020,518,1699,162,528,233,776,395,1304
430250,201908,952,2518,720,2136,238,768,34,78,272,846
430258,201908,109,294,83,243,6,14,44,136,50,150
430260,201908,628,1708,441,1339,73,225,231,692,304,917
430265,201908,202,578,139,453,28,98,42,123,70,221
430270,201908,2714,6952,2152,6038,370,1123,1286,3483,1656,4606
430280,201908,4946,12065,3438,9344,746,2066,1432,3834,2178,5900
430290,201908,2110,4994,1775,4582,54,168,1511,3822,1565,3990
430300,201908,9014,23929,6927,20103,1218,3839,3461,9813,4679,13652
430310,201908,10604,27275,6968,20147,987,3248,3216,8586,4203,11834
430320,201908,960,2582,505,1607,67,195,269,880,336,1075
430330,201908,642,1620,398,1114,70,205,184,465,254,670
430340,201908,707,1585,366,1044,51,159,210,571,261,730
430350,201908,6751,18074,4937,14579,980,3036,2348,6688,3328,9724
430355,201908,335,871,109,366,22,67,16,50,38,117
430360,201908,836,2078,550,1564,128,401,201,520,329,921
430367,201908,334,821,178,516,42,129,67,195,109,324
430370,201908,490,1360,219,699,42,143,53,144,95,287
430380,201908,676,1713,325,1049,74,284,81,248,155,532
430390,201908,3069,7642,1667,4944,295,974,160,327,455,1301
430400,201908,1080,2325,828,1958,68,171,602,1364,670,1535
430410,201908,556,1367,373,1054,54,176,213,575,267,751
430420,201908,2739,7655,2056,6107,569,1751,763,2163,1332,3914
430430,201908,665,1732,306,952,68,209,65,200,133,409
430435,201908,1524,3930,1126,3256,232,706,503,1455,735,2161
430440,201908,3659,10470,2728,8608,410,1467,1485,4589,1895,6056
430450,201908,6719,17357,5274,14719,714,2236,2909,7845,3623,10081
430460,201908,29423,77292,20747,62524,4149,13784,9200,26272,13349,40056
430461,201908,388,974,101,313,10,31,29,76,39,107
430462,201908,251,688,145,478,20,66,46,159,66,225
430463,201908,4985,13911,3781,11706,763,2614,1771,5303,2534,7917
430465,201908,461,1232,378,1071,55,169,226,611,281,780
430466,201908,3889,10027,3029,8532,779,2275,1392,3721,2171,5996
430467,201908,498,1237,341,978,49,165,167,444,216,609
430468,201908,1325,3310,1035,2868,114,338,614,1649,728,1987
430469,201908,651,1837,78,272,12,41,11,15,23,56
430470,201908,5520,14598,3685,11244,1148,3750,897,2575,2045,6325
430471,201908,527,1589,442,1419,77,260,210,635,287,895
430480,201908,823,2205,421,1320,60,195,84,228,144,423
430485,201908,172,471,66,220,16,49,8,26,24,75
430490,201908,416,1091,221,656,26,92,104,274,130,366
430495,201908,364,1011,204,673,29,100,73,222,102,322
430500,201908,1017,2681,703,2134,212,688,207,564,419,1252
430510,201908,23879,63720,16689,49116,3212,10647,6799,18198,10011,28845
430511,201908,332,997,124,433,13,51,16,45,29,96
430512,201908,933,2168,716,1837,180,456,251,661,431,1117
430513,201908,782,1983,362,1052,54,161,182,510,236,671
430515,201908,386,1107,268,855,38,110,128,409,166,519
430517,201908,1044,3259,791,2652,147,493,391,1345,538,1838
430520,201908,1319,3490,666,2047,119,367,140,394,259,761
430530,201908,1069,2780,397,1251,77,246,88,268,165,514
430535,201908,3082,8193,2189,6519,332,1038,1071,3086,1403,4124
430537,201908,321,1132,291,1033,24,76,227,805,251,881
430540,201908,576,1419,337,1019,47,142,165,491,212,633
430543,201908,674,1287,398,962,63,127,198,514,261,641
430544,201908,638,1894,444,1437,105,360,191,602,296,962
430545,201908,2060,5526,1522,4680,322,1007,725,2272,1047,3279
430550,201908,407,1158,255,814,41,127,82,255,123,382
430558,201908,116,271,51,145,8,21,14,39,22,60
430560,201908,342,767,139,415,13,44,41,119,54,163
430570,201908,745,1793,545,1475,107,328,278,693,385,1021
430580,201908,913,2267,621,1810,151,480,253,698,404,1178
430583,201908,198,493,35,112,4,12,6,18,10,30
430585,201908,230,562,115,312,19,55,52,123,71,178
430587,201908,203,579,142,444,25,80,59,186,84,266
430590,201908,1403,3386,1166,3019,58,176,971,2461,1029,2637
430593,201908,18,64,12,42,1,3,6,20,7,23
430595,201908,434,1052,91,299,6,24,22,52,28,76
430597,201908,399,1068,213,644,25,80,71,160,96,240
430600,201908,1817,4725,800,2382,156,495,221,618,377,1113
430605,201908,1135,3190,822,2555,113,420,347,1021,460,1441
430607,201908,559,1316,422,1094,26,76,294,760,320,836
430610,201908,5678,13983,3763,10931,1084,3391,698,2093,1782,5484
430613,201908,259,602,71,201,9,30,17,39,26,69
430620,201908,578,1478,432,1192,63,195,234,599,297,794
430630,201908,435,1226,124,404,19,65,26,73,45,138
430632,201908,524,1413,233,727,31,99,104,309,135,408
430635,201908,533,1347,381,1064,48,143,262,722,310,865
430637,201908,455,1160,357,1007,43,136,211,567,254,703
430640,201908,1079,2798,602,1811,95,296,196,562,291,858
430642,201908,344,953,252,738,49,141,126,351,175,492
430645,201908,179,418,63,174,16,47,14,40,30,87
430650,201908,1553,4671,1273,4186,326,1077,601,2049,927,3126
430655,201908,260,646,147,417,21,63,66,163,87,226
430660,201908,4886,12983,3665,10797,857,2695,1580,4590,2437,7285
430670,201908,624,1540,473,1271,25,68,306,822,331,890
430673,201908,559,1292,210,628,43,134,76,215,119,349
430675,201908,203,585,51,182,16,64,18,60,34,124
430676,201908,4527,11603,3518,9978,463,1466,2147,5899,2610,7365
430680,201908,959,2641,578,1815,168,546,133,410,301,956
430690,201908,2992,8260,2362,7076,773,2429,613,1777,1386,4206
430692,201908,211,654,156,557,11,47,110,392,121,439
430693,201908,1021,2737,585,1820,112,405,138,386,250,791
430695,201908,491,1284,270,804,35,100,144,410,179,510
430697,201908,389,986,293,831,73,188,133,408,206,596
430700,201908,6727,16977,3616,11053,839,2724,507,1515,1346,4239
430705,201908,400,995,189,578,27,95,76,211,103,306
430710,201908,1650,3679,1141,2935,164,468,635,1593,799,2061
430720,201908,738,1783,382,1144,60,166,171,510,231,676
430730,201908,1060,2923,723,2255,110,323,355,1114,465,1437
430740,201908,603,1699,305,1034,50,180,80,278,130,458
430745,201908,438,1217,239,749,40,142,70,186,110,328
430750,201908,1312,3464,922,2751,194,600,478,1359,672,1959
430755,201908,467,1141,286,768,17,56,161,397,178,453
430760,201908,1963,5069,1536,4360,374,1119,655,1794,1029,2913
430770,201908,6011,15383,4583,13178,658,2096,2767,7703,3425,9799
430780,201908,2027,5046,1152,3514,235,747,369,1103,604,1850
430781,201908,431,1214,228,723,35,111,59,160,94,271
430783,201908,420,972,242,685,30,99,137,361,167,460
430786,201908,39,134,23,94,5,20,4,20,9,40
430790,201908,4508,11389,3003,8587,397,1304,1694,4471,2091,5775
430800,201908,768,1835,559,1484,42,119,365,957,407,1076
430805,201908,419,1141,253,753,23,86,153,410,176,496
430807,201908,392,901,199,542,12,38,105,262,117,300
430810,201908,821,2013,269,870,34,129,85,261,119,390
430820,201908,1360,3651,727,2383,157,538,167,560,324,1098
430825,201908,266,684,88,242,16,44,22,52,38,96
430830,201908,1659,4863,1345,4243,62,240,939,2920,1001,3160
430840,201908,940,2463,711,2053,99,304,469,1328,568,1632
430843,201908,121,296,41,123,4,12,20,52,24,64
430845,201908,395,969,255,726,69,209,84,221,153,430
430850,201908,2329,6186,1620,4793,262,845,696,2031,958,2876
430860,201908,837,1913,426,1210,60,205,205,493,265,698
430865,201908,507,1299,387,1088,64,191,201,546,265,737
430870,201908,643,1699,257,824,42,152,82,227,124,379
430880,201908,1298,3071,862,2376,161,473,432,1148,593,1621
430885,201908,202,500,90,295,9,33,51,162,60,195
430890,201908,1002,2647,671,2038,64,280,108,296,172,576
430900,201908,2939,6635,1982,5198,186,577,1247,3046,1433,3623
430905,201908,774,2017,482,1449,91,308,174,492,265,800
430910,201908,1482,4027,1015,3048,164,581,464,1226,628,1807
430912,201908,487,1353,317,1011,32,97,205,668,237,765
430915,201908,509,1563,364,1278,120,422,110,389,230,811
430920,201908,23058,59430,17474,49986,2561,8114,10116,27933,12677,36047
430925,201908,132,301,46,140,10,33,15,48,25,81
430930,201908,9873,23615,6036,17576,1242,3757,2368,7145,3610,10902
430940,201908,1126,3100,635,1957,186,608,118,275,304,883
430950,201908,720,1774,450,1274,43,152,266,677,309,829
430955,201908,232,623,73,235,15,44,20,57,35,101
430957,201908,180,621,169,593,29,107,97,333,126,440
430960,201908,1360,3244,776,2188,172,531,327,882,499,1413
430965,201908,1671,4063,1263,3411,72,217,947,2538,1019,2755
430970,201908,379,961,184,554,27,88,88,243,115,331
430975,201908,485,1506,365,1212,83,290,159,508,242,798
430980,201908,387,923,209,610,37,117,79,202,116,319
430990,201908,576,1672,336,1071,40,139,165,517,205,656
430995,201908,573,1504,414,1235,56,181,203,585,259,766
431000,201908,1335,3200,524,1555,91,292,35,81,126,373
431010,201908,2101,5526,1233,3966,236,806,158,427,394,1233
431020,201908,8255,18364,4778,12885,1126,3361,1540,3675,2666,7036
431030,201908,321,865,142,476,26,93,23,70,49,163
431033,201908,3432,8338,2114,6184,523,1591,698,2049,1221,3640
431036,201908,343,743,70,200,7,15,20,47,27,62
431040,201908,918,2393,590,1770,97,326,247,672,344,998
431041,201908,467,1087,338,898,34,83,195,514,229,597
431043,201908,388,939,196,611,45,156,79,242,124,398
431046,201908,110,286,45,136,3,8,12,35,15,43
431050,201908,1382,3476,979,2822,167,499,511,1476,678,1975
431053,201908,584,1634,311,1030,65,222,92,289,157,511
431055,201908,591,1476,495,1333,48,124,361,962,409,1086
431057,201908,271,789,124,422,20,69,38,118,58,187
431060,201908,5120,13852,3490,10911,919,3089,777,2461,1696,5550
431065,201908,461,1198,310,927,64,198,109,312,173,510
431070,201908,442,1292,242,812,60,222,41,124,101,346
431075,201908,220,663,137,464,26,89,37,128,63,217
431080,201908,622,1742,416,1302,87,306,140,416,227,722
431085,201908,711,1921,456,1310,74,217,224,617,298,834
431087,201908,455,1298,358,1086,26,73,237,739,263,812
431090,201908,430,1021,159,509,25,86,43,131,68,217
431100,201908,3222,7348,2255,6011,353,990,1104,2958,1457,3948
431110,201908,1384,3264,939,2482,256,675,382,973,638,1648
431112,201908,523,1565,427,1366,78,278,221,673,299,951
431113,201908,352,993,302,894,53,170,179,523,232,693
431115,201908,1050,2997,807,2531,121,434,448,1319,569,1753
431120,201908,2321,6683,1593,5152,532,1898,347,1003,879,2901
431123,201908,370,1052,233,750,44,118,123,417,167,535
431125,201908,1041,3127,782,2560,297,956,232,810,529,1766
431127,201908,247,650,55,182,7,22,6,17,13,39
431130,201908,3010,8033,2140,6440,391,1317,1005,2917,1396,4234
431140,201908,5054,12142,2795,7797,362,1065,1180,2929,1542,3994
431142,201908,496,1345,358,1084,52,167,207,625,259,792
431150,201908,1011,2766,696,2147,145,474,277,843,422,1317
431160,201908,686,1963,464,1481,85,302,149,461,234,763
431162,201908,532,1307,261,786,24,85,134,372,158,457
431164,201908,193,448,39,121,10,28,5,13,15,41
431170,201908,533,1486,359,1127,100,302,93,278,193,580
431171,201908,638,1562,520,1406,88,214,318,867,406,1081
431173,201908,405,1069,290,887,89,306,104,290,193,596
431175,201908,1091,2694,657,1924,127,386,208,584,335,970
431177,201908,710,2056,534,1754,143,515,266,851,409,1366
431179,201908,347,767,78,234,12,39,15,34,27,73
431180,201908,2323,6014,1384,4135,379,1113,312,934,691,2047
431190,201908,455,1249,234,746,32,98,62,167,94,265
431198,201908,320,982,272,894,102,352,70,253,172,605
431200,201908,374,958,75,227,14,38,4,12,18,50
431205,201908,190,546,89,308,22,86,30,101,52,187
431210,201908,611,1581,485,1395,123,341,232,696,355,1037
431213,201908,253,696,184,561,11,37,91,283,102,320
431215,201908,552,1339,235,712,27,89,100,272,127,361
431217,201908,160,435,104,322,8,33,62,171,70,204
431220,201908,601,1590,338,1051,39,146,178,508,217,654
431225,201908,1543,3761,1152,3080,118,344,768,2034,886,2378
431230,201908,674,1984,486,1520,63,221,281,834,344,1055
431235,201908,155,399,23,76,2,5,5,19,7,24
431237,201908,324,1047,272,920,51,189,136,439,187,628
431238,201908,25,64,19,50,6,14,5,12,11,26
431240,201908,3954,10236,3035,8716,568,1788,1481,4110,2049,5898
431242,201908,291,793,238,695,60,186,114,327,174,513
431244,201908,335,813,157,442,22,81,57,127,79,208
431245,201908,1324,3155,808,2217,100,285,389,1017,489,1302
431247,201908,229,625,114,366,26,92,27,68,53,160
431250,201908,1611,4299,1189,3672,260,822,579,1837,839,2659
431260,201908,229,648,132,448,21,89,44,138,65,227
431261,201908,236,749,190,666,20,80,94,306,114,386
431262,201908,385,1077,172,564,13,43,109,358,122,401
431265,201908,1504,3593,568,1688,68,240,194,482,262,722
431267,201908,269,739,150,451,5,21,101,272,106,293
431270,201908,2646,6162,1398,3989,353,1081,384,1114,737,2195
431275,201908,147,423,75,245,21,70,9,23,30,93
431280,201908,234,639,64,211,7,26,7,15,14,41
431290,201908,306,894,197,630,31,108,50,128,81,236
431295,201908,74,199,25,78,2,5,7,20,9,25
431300,201908,366,926,62,202,5,18,13,36,18,54
431301,201908,306,875,66,219,10,28,5,10,15,38
431303,201908,591,1579,334,1013,31,112,132,369,163,481
431306,201908,2152,5176,1236,3592,200,633,455,1165,655,1798
431308,201908,25,82,22,72,14,47,6,19,20,66
431310,201908,552,1576,366,1140,39,136,171,500,210,636
431320,201908,596,1661,281,953,40,131,49,148,89,279
431330,201908,1694,4091,769,2329,192,641,224,606,416,1247
431333,201908,236,648,112,330,22,61,37,101,59,162
431335,201908,40,112,23,76,6,14,3,3,9,17
431337,201908,2590,7103,1849,5802,411,1461,786,2332,1197,3793
431339,201908,412,1087,300,876,82,240,121,350,203,590
431340,201908,19703,48931,13354,37922,2561,7892,5224,13846,7785,21738
431342,201908,456,1011,328,824,17,46,286,713,303,759
431344,201908,392,1010,222,663,9,32,138,394,147,426
431346,201908,252,629,91,296,15,53,28,92,43,145
431349,201908,666,1753,357,1062,82,246,131,370,213,616
431350,201908,3997,10737,2910,8772,447,1499,1411,4139,1858,5638
431360,201908,585,1430,312,898,78,241,96,265,174,506
431365,201908,1796,4469,1456,3983,139,438,1055,2865,1194,3303
431370,201908,4174,10694,2998,8656,774,2369,1244,3667,2018,6036
431380,201908,772,2155,643,1931,40,135,428,1276,468,1411
431390,201908,2512,6270,1467,4325,204,693,606,1549,810,2242
431395,201908,1236,3236,869,2649,207,656,366,1120,573,1776
431400,201908,347,991,173,557,30,91,36,109,66,200
431402,201908,851,1972,602,1566,75,209,383,955,458,1164
431403,201908,181,502,142,429,24,82,73,183,97,265
431405,201908,4390,11817,3376,10153,645,2196,1564,4405,2209,6601
431406,201908,497,1464,364,1175,90,277,171,562,261,839
431407,201908,466,1291,303,936,63,222,139,411,202,633
431410,201908,16298,42282,10312,31045,1734,5968,4585,12732,6319,18700
431413,201908,241,623,58,186,5,15,6,17,11,32
431415,201908,688,1727,419,1272,77,268,168,452,245,720
431417,201908,554,1268,379,1002,55,158,207,535,262,693
431420,201908,1454,3451,1104,2944,180,501,553,1484,733,1985
431430,201908,535,1395,244,800,36,142,73,202,109,344
431440,201908,27794,67391,19611,54023,3788,11247,7156,18702,10944,29949
431442,201908,115,335,55,191,7,23,9,23,16,46
431445,201908,418,1189,136,471,15,46,13,46,28,92
431446,201908,300,860,206,661,48,172,86,257,134,429
431447,201908,637,1744,400,1229,83,274,145,447,228,721
431449,201908,723,1912,424,1251,78,219,174,498,252,717
431450,201908,2105,4518,1686,3918,95,239,1286,2886,1381,3125
431454,201908,39,116,35,107,6,19,13,40,19,59
431455,201908,593,1438,281,775,36,107,138,337,174,444
431460,201908,2868,7272,2050,5760,556,1634,581,1646,1137,3280
431470,201908,1433,4058,1001,3121,181,578,437,1380,618,1958
431475,201908,259,750,36,148,3,14,5,20,8,34
431477,201908,427,1128,251,756,39,116,102,272,141,388
431478,201908,283,744,59,188,16,45,6,16,22,61
431480,201908,3062,7838,2328,6657,530,1549,1166,3327,1696,4876
431490,201908,105254,256034,82263,219903,6982,21944,59163,151975,66145,173919
431500,201908,489,1274,355,1007,66,179,185,510,251,689
431505,201908,325,788,207,602,18,52,132,384,150,436
431507,201908,346,818,137,395,41,128,43,111,84,239
431510,201908,1544,4089,1048,3090,237,757,390,1131,627,1888
431513,201908,233,541,122,341,10,28,83,231,93,259
431514,201908,93,242,55,168,3,7,38,111,41,118
431515,201908,486,1255,337,972,68,204,167,456,235,660
431517,201908,75,214,58,172,12,35,22,64,34,99
431520,201908,431,1062,160,518,31,114,51,129,82,243
431530,201908,3938,8470,2310,6165,605,1651,458,1197,1063,2848
431531,201908,198,522,121,360,11,39,56,156,67,195
431532,201908,554,1320,331,918,74,221,129,345,203,566
431535,201908,255,680,100,320,21,73,19,48,40,121
431540,201908,1812,5806,1682,5613,62,250,1351,4510,1413,4760
431545,201908,352,929,60,189,9,25,13,40,22,65
431550,201908,1967,5192,1550,4386,268,823,783,2112,1051,2935
431555,201908,686,1590,426,1143,29,95,257,668,286,763
431560,201908,21385,53870,14019,41815,2889,9180,4316,13509,7205,22689
431570,201908,4750,11677,3679,10131,489,1544,2371,6245,2860,7789
431575,201908,241,647,181,529,37,95,42,114,79,209
431580,201908,582,1536,340,1024,45,162,174,485,219,647
431590,201908,659,1811,464,1401,94,292,183,562,277,854
431595,201908,338,941,214,666,43,139,88,252,131,391
431600,201908,1352,3240,975,2698,263,781,344,973,607,1754
431610,201908,1332,3498,895,2652,140,403,455,1373,595,1776
431620,201908,523,1383,220,673,39,128,91,253,130,381
431630,201908,1302,3298,567,1732,112,376,193,531,305,907
431640,201908,5952,15117,5177,14055,603,1727,3646,9937,4249,11664
431642,201908,498,1206,318,857,25,63,175,438,200,501
431643,201908,351,880,147,440,18,48,46,130,64,178
431645,201908,1778,4203,1394,3638,91,287,1055,2698,1146,2985
431647,201908,241,622,97,288,10,33,19,47,29,80
431650,201908,158,439,104,333,13,50,42,120,55,170
431660,201908,885,2424,463,1516,76,284,125,375,201,659
431670,201908,1137,2790,723,2035,112,330,369,989,481,1319
431673,201908,233,603,83,280,14,42,14,43,28,85
431675,201908,577,1437,117,374,10,38,26,64,36,102
431680,201908,7317,19338,5282,15349,1312,3982,2106,5988,3418,9970
431690,201908,21639,54604,14332,41287,3231,9845,5154,14934,8385,24779
431695,201908,152,393,96,293,15,58,44,106,59,164
431697,201908,466,1123,346,923,55,138,189,519,244,657
431700,201908,1407,3714,1168,3258,163,447,676,1864,839,2311
431710,201908,11676,29579,8398,24688,1776,5516,3721,11294,5497,16810
431720,201908,5820,15137,3501,10390,904,2834,516,1360,1420,4194
431725,201908,24,65,18,52,5,14,5,12,10,26
431730,201908,3687,9257,2339,6968,557,1791,710,2225,1267,4016
431740,201908,5033,12357,3248,9197,946,3025,685,1617,1631,4642
431750,201908,7197,18957,5742,16614,1203,3772,2643,7509,3846,11281
431755,201908,321,881,67,243,8,31,12,45,20,76
431760,201908,5548,12723,3551,9497,363,1160,2084,5167,2447,6327
431770,201908,1801,4384,1419,3867,98,317,1040,2747,1138,3064
431775,201908,205,537,93,288,22,60,15,41,37,101
431780,201908,1928,4904,1237,3599,224,728,492,1371,716,2099
431790,201908,842,2313,603,1827,112,336,259,752,371,1088
431795,201908,238,614,104,318,24,75,30,87,54,162
431800,201908,7514,19224,4929,14851,1409,4751,598,1876,2007,6627
431805,201908,303,722,84,279,6,20,32,100,38,120
431810,201908,3252,7903,2037,5611,373,1101,847,2218,1220,3319
431820,201908,2160,6054,1719,5304,493,1593,576,1846,1069,3439
431830,201908,8774,19732,6408,16363,1625,4707,2089,5331,3714,10038
431840,201908,2450,6685,1993,5894,349,1046,1147,3411,1496,4457
431842,201908,636,1590,209,654,28,101,64,180,92,281
431843,201908,312,852,238,700,34,109,114,306,148,415
431844,201908,231,614,68,229,19,69,20,68,39,137
431845,201908,515,1358,357,1037,26,77,210,604,236,681
431846,201908,281,750,239,686,16,49,201,575,217,624
431848,201908,155,391,83,255,9,31,10,21,19,52
431849,201908,409,991,60,181,5,12,6,20,11,32
431850,201908,3995,11077,3070,9176,724,2331,951,2799,1675,5130
431860,201908,677,1715,387,1123,69,210,192,526,261,736
431861,201908,104,277,48,149,12,38,14,35,26,73
431862,201908,434,1374,347,1219,77,303,168,565,245,868
431870,201908,17511,46580,14099,40825,2069,6682,7951,22104,10020,28786
431880,201908,3984,10453,2800,8289,487,1643,1204,3388,1691,5031
431890,201908,4177,10860,2552,7585,781,2505,383,1222,1164,3727
431900,201908,1018,2643,632,1875,103,347,309,851,412,1198
431910,201908,780,1902,259,755,48,139,71,167,119,306
431912,201908,457,1314,357,1126,70,232,206,645,276,877
431915,201908,1016,2624,805,2262,32,105,592,1620,624,1725
431920,201908,1141,2872,959,2602,38,122,801,2138,839,2260
431930,201908,686,1885,474,1494,128,364,224,733,352,1097
431935,201908,89,259,54,182,17,58,10,35,27,93
431936,201908,292,873,160,533,31,109,59,188,90,297
431937,201908,184,467,114,312,23,77,45,97,68,174
431940,201908,2824,6816,1609,4546,197,638,786,2108,983,2746
431950,201908,1782,4866,1468,4344,459,1375,568,1679,1027,3054
431960,201908,2818,7109,2053,5688,595,1699,534,1461,1129,3160
431970,201908,438,1134,156,486,35,107,37,102,72,209
431971,201908,57,145,31,98,4,16,5,11,9,27
431973,201908,466,1513,377,1335,42,160,271,958,313,1118
431975,201908,104,220,20,69,4,14,5,14,9,28
431980,201908,1065,2846,805,2391,184,587,350,987,534,1574
431990,201908,5831,14371,3806,11261,606,2054,1626,4561,2232,6615
432000,201908,10586,26305,7658,21577,1941,5595,3198,9055,5139,14650
432010,201908,1975,5158,1467,4190,232,740,802,2149,1034,2889
432020,201908,1736,4350,1161,3320,247,744,539,1442,786,2186
432023,201908,519,1267,263,750,47,153,121,306,168,459
432026,201908,1039,2931,735,2331,185,576,260,814,445,1390
432030,201908,342,891,192,583,29,87,94,284,123,371
432032,201908,387,1017,257,765,30,103,133,356,163,459
432035,201908,673,1920,589,1774,202,621,207,647,409,1268
432040,201908,1138,2630,386,1212,68,243,115,313,183,556
432045,201908,183,502,108,346,25,81,41,137,66,218
432050,201908,482,1286,357,1050,84,242,137,412,221,654
432055,201908,659,1774,413,1284,139,465,94,269,233,734
432057,201908,241,635,170,463,31,76,76,192,107,268
432060,201908,475,1143,145,459,30,107,44,115,74,222
432065,201908,221,624,150,466,29,82,55,165,84,247
432067,201908,731,2152,617,1880,61,199,415,1219,476,1418
432070,201908,1736,4646,1087,3328,235,806,303,824,538,1630
432080,201908,4152,10388,3144,8664,590,1874,1424,3734,2014,5608
432085,201908,381,970,255,773,78,229,94,301,172,530
432090,201908,1333,3493,934,2743,185,581,442,1227,627,1808
432100,201908,997,2646,435,1409,88,302,62,153,150,455
432110,201908,2132,5872,1412,4503,345,1252,112,337,457,1589
432120,201908,2729,7698,2177,6699,521,1762,698,2067,1219,3829
432130,201908,2461,6555,2069,5980,672,1984,818,2421,1490,4405
432132,201908,183,521,108,357,21,73,42,115,63,188
432135,201908,987,2424,629,1765,49,177,435,1182,484,1359
432140,201908,1562,4774,1163,3961,167,609,678,2310,845,2919
432143,201908,1371,3700,1070,3210,87,282,690,2050,777,2332
432145,201908,1400,3805,791,2454,130,437,216,558,346,995
432146,201908,110,316,69,239,20,76,17,50,37,126
432147,201908,492,1466,298,1017,92,336,63,183,155,519
432149,201908,430,1098,206,623,16,46,96,279,112,325
432150,201908,2935,7805,2140,6310,491,1642,724,2042,1215,3684
432160,201908,5028,13848,3753,11670,1019,3436,1229,3671,2248,7107
432162,201908,267,601,36,107,5,14,5,14,10,28
432163,201908,135,347,26,74,0,0,3,6,3,6
432166,201908,560,1615,422,1315,75,254,152,418,227,672
432170,201908,1332,3675,825,2684,169,609,260,790,429,1399
432180,201908,2582,6466,1346,4005,251,800,426,1117,677,1917
432183,201908,355,1038,225,728,53,199,74,227,127,426
432185,201908,806,2094,463,1417,34,114,249,718,283,832
432190,201908,1827,4566,1125,3328,240,791,476,1312,716,2103
432195,201908,966,2410,599,1742,166,453,216,659,382,1112
432200,201908,3140,8385,2199,6754,424,1314,1084,3398,1508,4712
432210,201908,369,996,222,698,41,153,102,281,143,434
432215,201908,637,1864,568,1757,47,138,415,1291,462,1429
432218,201908,256,653,113,329,19,62,49,130,68,192
432220,201908,3658,8845,2698,7283,460,1341,1466,3837,1926,5178
432225,201908,93,275,69,221,16,54,31,98,47,152
432230,201908,730,1803,393,1148,57,172,156,423,213,595
432232,201908,494,1234,300,885,76,249,106,293,182,542
432234,201908,287,754,122,368,25,63,15,42,40,105
432235,201908,81,229,26,84,5,15,6,23,11,38
432237,201908,359,925,306,833,15,37,231,606,246,643
432240,201908,14252,37600,10621,32350,843,2954,6639,20924,7482,23878
432250,201908,4498,13832,3698,12250,1085,3650,1363,4581,2448,8231
432252,201908,453,1125,270,771,41,127,125,338,166,465
432253,201908,1019,3155,593,2042,152,559,31,97,183,656
432254,201908,833,2060,164,540,31,100,18,49,49,149
432255,201908,122,307,60,187,7,25,26,69,33,94
432260,201908,4793,12535,3437,9906,962,2861,977,2776,1939,5637
432270,201908,1905,5475,1518,4681,457,1494,266,782,723,2276
432280,201908,1109,2899,599,1839,100,348,230,605,330,953
432285,201908,189,581,23,82,0,0,2,5,2,5
432290,201908,350,1018,179,596,60,200,31,71,91,271
432300,201908,25668,67531,19281,56761,2972,9741,10901,30902,13873,40643
432310,201908,758,2116,544,1712,59,193,353,1114,412,1307
432320,201908,217,513,70,207,10,37,25,65,35,102
432330,201908,219,557,71,233,9,25,16,47,25,72
432335,201908,196,560,60,217,7,31,12,34,19,65
432340,201908,319,770,130,411,18,61,37,102,55,163
432345,201908,610,1431,540,1343,17,44,425,1048,442,1092
432350,201908,336,898,171,560,30,105,61,193,91,298
432360,201908,225,664,44,147,4,15,18,54,22,69
432370,201908,315,795,204,598,20,60,129,367,149,427
432375,201908,497,1266,369,1014,67,165,184,511,251,676
432377,201908,199,634,35,130,5,20,3,6,8,26
432380,201908,1542,4275,986,3184,191,697,458,1410,649,2107
500020,201908,2418,6402,1674,5078,235,814,913,2668,1148,3482
500025,201908,1245,2974,763,2111,73,221,423,1116,496,1337
500060,201908,6909,19642,4925,15866,670,2234,2889,9632,3559,11866
500070,201908,4090,10773,2849,8641,547,1715,1244,3853,1791,5568
500080,201908,1376,3546,902,2693,166,560,381,1023,547,1583
500085,201908,2035,5063,1338,3917,307,957,653,1833,960,2790
500090,201908,1907,5182,1288,4079,252,835,474,1560,726,2395
500100,201908,3534,9153,2658,7678,462,1466,1236,3373,1698,4839
500110,201908,7619,20220,4786,15499,1094,3901,1372,5086,2466,8987
500124,201908,2011,6097,1614,5376,292,910,859,3023,1151,3933
500150,201908,1270,2949,772,2182,176,522,252,677,428,1199
500190,201908,4273,10591,2876,8371,704,2082,852,2474,1556,4556
500200,201908,2190,5237,1575,4194,203,561,917,2333,1120,2894
500210,201908,4517,11636,3303,9932,865,2644,1400,4288,2265,6932
500215,201908,1334,3834,930,3050,93,349,472,1556,565,1905
500220,201908,2478,7106,1633,5504,279,1001,486,1593,765,2594
500230,201908,2125,5088,1574,4266,207,541,983,2620,1190,3161
500240,201908,3538,10728,2429,8381,382,1453,903,3214,1285,4667
500260,201908,3099,6721,1872,4990,253,681,952,2446,1205,3127
500270,201908,136120,325937,77783,223049,14245,44348,26455,71170,40700,115518
500280,201908,1236,3166,838,2519,106,347,484,1407,590,1754
500290,201908,3632,8518,1956,5790,349,1163,629,1689,978,2852
500295,201908,3167,7884,1853,5424,313,1012,688,1747,1001,2759
500310,201908,903,1954,610,1579,102,223,316,845,418,1068
500315,201908,3416,9922,2729,8818,267,851,1857,6195,2124,7046
500320,201908,17965,50615,12490,41262,3282,11401,4156,14488,7438,25889
500325,201908,4230,9716,2864,7787,271,773,1795,4901,2066,5674
500330,201908,6751,15673,4280,11873,342,1058,2364,6652,2706,7710
500345,201908,2025,5015,1284,3806,328,1003,408,1175,736,2178
500348,201908,2480,6393,1869,5349,275,811,1023,2988,1298,3799
500350,201908,1271,3476,663,2121,71,236,279,868,350,1104
500370,201908,23877,63207,16246,50260,2470,8628,7871,24217,10341,32845
500375,201908,2443,6581,1625,4856,333,1079,527,1490,860,2569
500380,201908,3488,8855,2352,6897,657,2027,672,1987,1329,4014
500390,201908,512,1117,313,848,55,165,170,460,225,625
500400,201908,1258,3331,812,2435,155,521,278,763,433,1284
500410,201908,2369,6019,1678,4950,200,583,959,2888,1159,3471
500430,201908,2590,6578,1717,5196,251,871,677,2145,928,3016
500440,201908,1142,2802,683,2050,102,322,248,796,350,1118
500450,201908,1385,3550,759,2340,156,514,152,442,308,956
500460,201908,3623,9916,2169,7012,412,1500,661,2153,1073,3653
500470,201908,2434,6709,1466,4674,447,1570,276,741,723,2311
500480,201908,2170,6472,1846,5966,172,574,1256,4256,1428,4830
500490,201908,997,2364,559,1693,131,469,153,457,284,926
500500,201908,4245,11612,2713,9054,972,3745,488,1635,1460,5380
500510,201908,709,1823,443,1302,31,104,258,737,289,841
500515,201908,1834,4609,1410,3949,146,425,915,2508,1061,2933
500520,201908,3004,9919,2387,8656,663,2463,973,3658,1636,6121
500525,201908,862,2602,702,2349,68,253,415,1404,483,1657
500540,201908,4383,11568,2599,8356,736,2873,244,668,980,3541
500560,201908,5208,14879,4238,13562,317,1123,3228,10418,3545,11541
500568,201908,4350,9637,2551,6958,614,1835,818,2212,1432,4047
500570,201908,7482,17877,4282,12221,875,2732,1247,3300,2122,6032
500580,201908,3042,8245,2256,6871,477,1543,1078,3253,1555,4796
500600,201908,3115,7903,2162,6433,450,1361,920,2808,1370,4169
500620,201908,7444,20175,4919,15225,1123,3632,1658,4996,2781,8628
500625,201908,468,1279,259,809,48,167,96,265,144,432
500627,201908,734,1911,432,1339,66,210,142,436,208,646
500630,201908,6314,15088,3589,10378,752,2337,1076,3141,1828,5478
500635,201908,2832,9099,2181,8205,167,691,1529,6178,1696,6869
500640,201908,1675,3770,1103,2976,35,120,745,1934,780,2054
500660,201908,16590,45384,11473,37333,3868,13966,2716,9001,6584,22967
500690,201908,2139,5978,1459,4896,578,2209,93,206,671,2415
500710,201908,2902,8021,2200,6740,649,2094,644,1838,1293,3932
500720,201908,4972,12811,3096,9633,708,2358,826,2593,1534,4951
500730,201908,916,2384,553,1707,76,210,195,608,271,818
500740,201908,4598,11123,3138,8697,373,1096,1709,4734,2082,5830
500750,201908,970,2526,635,1910,93,283,230,604,323,887
500755,201908,894,2438,496,1647,104,363,77,228,181,591
500769,201908,4918,12386,2513,7606,493,1664,370,864,863,2528
500770,201908,1479,4052,927,3028,170,617,285,936,455,1553
500780,201908,1259,3142,798,2339,178,569,210,576,388,1145
500790,201908,7563,20090,5899,17343,1155,3672,3060,9035,4215,12707
500793,201908,1892,4917,1267,3809,385,1229,310,833,695,2062
500795,201908,2500,6505,2051,5918,101,282,1726,5115,1827,5397
500797,201908,702,1843,463,1392,121,372,161,477,282,849
500800,201908,2857,6773,1807,5205,591,1967,237,746,828,2713
500830,201908,17981,45887,11934,34604,2355,7415,4640,12624,6995,20039
500840,201908,1396,3498,795,2317,96,299,323,886,419,1185
510010,201908,1877,4345,1217,3426,131,370,805,2276,936,2646
510020,201908,3644,9465,1859,5749,413,1344,373,1017,786,2361
510025,201908,6867,17455,4170,12723,685,2311,1521,4430,2206,6741
510030,201908,2300,5253,1502,4095,351,938,530,1479,881,2417
510035,201908,1193,3106,716,2328,91,323,415,1419,506,1742
510040,201908,2209,5083,1590,4242,162,418,985,2698,1147,3116
510050,201908,1985,4501,1310,3544,185,575,829,2131,1014,2706
510060,201908,1386,3567,1004,2949,198,643,309,861,507,1504
510080,201908,1211,3274,789,2523,238,801,226,635,464,1436
510100,201908,671,1612,447,1233,56,161,230,607,286,768
510120,201908,263,501,147,361,4,15,113,283,117,298
510125,201908,2136,5407,1662,4689,203,766,794,2064,997,2830
510130,201908,1465,3728,1014,2997,217,708,304,902,521,1610
510140,201908,2918,7824,2019,6649,760,2925,652,1943,1412,4868
510160,201908,1698,4441,1222,3805,207,640,820,2575,1027,3215
510170,201908,4592,12435,3340,10356,826,2622,1297,4107,2123,6729
510180,201908,13671,32228,8152,23517,1916,5994,2314,7542,4230,13536
510185,201908,1668,4447,1084,3592,428,1408,297,1230,725,2638
510190,201908,2004,5815,1312,4568,376,1446,243,881,619,2327
510250,201908,14779,39064,11726,34714,2289,7032,6302,19321,8591,26353
510260,201908,2044,8410,1647,7673,286,1426,954,4873,1240,6299
510263,201908,3034,8677,1823,6106,310,1151,215,622,525,1773
510267,201908,4758,13855,2790,9443,596,2121,326,1048,922,3169
510268,201908,1308,3285,933,2660,112,314,569,1584,681,1898
510269,201908,1038,2885,636,2098,170,610,190,576,360,1186
510270,201908,2888,8467,1973,6753,376,1401,751,2513,1127,3914
510279,201908,1773,4730,1157,3634,228,801,485,1428,713,2229
510285,201908,1080,2945,750,2372,223,786,166,471,389,1257
510300,201908,3664,9410,2683,8049,421,1239,1534,4842,1955,6081
510305,201908,1479,4159,878,2957,178,631,215,780,393,1411
510310,201908,922,2345,632,1850,184,562,177,530,361,1092
510320,201908,3674,9507,2535,7487,567,1789,654,1957,1221,3746
510325,201908,4430,13331,3395,11494,986,3490,1154,4002,2140,7492
510330,201908,2853,8739,1901,6998,375,1400,672,2822,1047,4222
510335,201908,4630,13443,3435,11624,528,1923,1882,6554,2410,8477
510336,201908,479,1390,347,1176,72,231,151,552,223,783
510337,201908,1617,4872,1076,3858,428,1666,178,653,606,2319
510340,201908,89384,202659,53251,148035,13847,45091,14224,36264,28071,81355
510343,201908,1047,2917,706,2238,122,425,291,882,413,1307
510345,201908,1261,3652,913,2962,168,549,384,1193,552,1742
510350,201908,2844,7591,1799,5761,392,1297,682,2149,1074,3446
510360,201908,1874,3975,1165,3125,68,169,831,2340,899,2509
510370,201908,1731,5165,1237,4238,187,701,696,2405,883,3106
510380,201908,562,1428,299,941,67,238,92,276,159,514
510385,201908,1189,4027,851,3369,95,410,521,2151,616,2561
510390,201908,1132,3255,793,2774,216,736,342,1307,558,2043
510395,201908,726,1643,473,1266,32,94,268,774,300,868
510410,201908,4605,13199,3382,10902,670,2238,1776,5876,2446,8114
510420,201908,2230,4901,1511,3918,123,367,959,2447,1082,2814
510450,201908,505,1256,281,829,69,197,44,152,113,349
510452,201908,698,1977,464,1524,73,242,223,729,296,971
510454,201908,915,2573,689,2164,70,190,425,1419,495,1609
510455,201908,897,2556,626,1971,102,385,239,679,341,1064
510460,201908,1836,4620,1287,3776,119,414,804,2230,923,2644
510480,201908,4703,11712,3058,8487,616,1889,1141,3000,1757,4889
510490,201908,1668,4508,1232,3921,206,668,717,2312,923,2980
510500,201908,1584,4057,937,2927,184,615,317,982,501,1597
510510,201908,3357,10117,2483,8426,680,2558,704,2503,1384,5061
510515,201908,5395,14408,3435,10636,810,2780,832,2296,1642,5076
510517,201908,1087,3197,820,2720,248,920,139,393,387,1313
510520,201908,2097,4291,1192,3175,70,196,641,1813,711,2009
510523,201908,1015,2676,738,2193,154,436,391,1186,545,1622
510525,201908,6306,17817,4627,14402,806,2831,2028,5880,2834,8711
510530,201908,541,1399,391,1181,37,123,234,678,271,801
510550,201908,2547,7620,1833,6320,457,1645,721,2500,1178,4145
510558,201908,2102,5666,1502,4713,167,503,748,2500,915,3003
510560,201908,1616,4710,936,3327,208,806,237,895,445,1701
510562,201908,5189,14010,3644,11055,946,3122,1126,3468,2072,6590
510590,201908,3093,7806,2216,6666,221,713,1510,4582,1731,5295
510600,201908,1512,3504,942,2611,192,536,372,1029,564,1565
510610,201908,2796,6826,1880,5541,187,644,1137,3334,1324,3978
510615,201908,2475,6448,1620,4986,299,931,831,2629,1130,3560
510617,201908,954,2825,696,2392,117,457,395,1410,512,1867
510618,201908,1247,3384,847,2657,175,603,404,1232,579,1835
510619,201908,722,1872,440,1357,74,246,95,275,169,521
510620,201908,1413,3244,631,1989,161,601,40,89,201,690
510621,201908,1480,4033,892,2906,198,712,265,811,463,1523
510622,201908,4378,12561,2994,9464,1063,3609,423,1198,1486,4807
510623,201908,2691,6929,1842,5530,432,1549,470,1333,902,2882
510624,201908,1669,4311,704,2413,90,333,152,441,242,774
510625,201908,2730,6744,1447,4403,282,989,313,931,595,1920
510626,201908,1512,3699,916,2750,271,936,206,615,477,1551
510627,201908,599,1578,335,1047,88,288,79,263,167,551
510628,201908,1543,3575,990,2822,197,595,406,1152,603,1747
510629,201908,1582,4665,1162,3852,268,962,390,1284,658,2246
510630,201908,3224,9200,1843,6458,428,1597,319,1204,747,2801
510631,201908,567,1370,399,1128,15,42,308,882,323,924
510637,201908,3354,8323,2370,6793,634,2014,639,1795,1273,3809
510642,201908,5286,15680,4115,13851,1089,3890,1626,5697,2715,9587
510645,201908,841,1813,486,1327,109,313,208,527,317,840
510650,201908,6946,18284,5549,16737,678,1885,3849,12599,4527,14484
510665,201908,1818,4121,1046,2854,152,442,435,1228,587,1670
510670,201908,414,876,232,606,26,75,129,338,155,413
510675,201908,5838,16541,4000,13020,1219,4293,645,2064,1864,6357
510677,201908,2117,5520,1435,4479,208,710,716,2209,924,2919
510680,201908,685,1847,393,1275,82,285,70,212,152,497
510682,201908,1609,4862,1170,4084,385,1481,234,785,619,2266
510685,201908,614,1812,449,1474,68,235,203,653,271,888
510700,201908,3883,9718,2723,8005,331,1099,1844,5366,2175,6465
510704,201908,10393,25026,6643,18392,1362,4054,1838,4840,3200,8894
510706,201908,1943,5840,1362,4898,259,937,706,2765,965,3702
510710,201908,2620,6806,1713,5048,375,1166,584,1625,959,2791
510715,201908,612,1397,451,1171,48,138,203,541,251,679
510718,201908,2429,5371,1344,4007,501,1506,323,1233,824,2739
510719,201908,419,886,247,660,32,82,140,358,172,440
510720,201908,956,2329,617,1801,122,391,248,683,370,1074
510724,201908,748,2055,495,1589,79,281,228,701,307,982
510726,201908,1142,2093,569,1370,65,167,280,670,345,837
510729,201908,621,1485,271,833,42,146,61,194,103,340
510730,201908,2959,7312,1971,5729,316,1012,859,2455,1175,3467
510735,201908,1046,3053,777,2656,84,335,549,1866,633,2201
510740,201908,885,2210,538,1541,82,239,256,727,338,966
510757,201908,550,1750,442,1569,150,575,141,476,291,1051
510760,201908,41891,93480,23986,65554,5294,16618,7199,17838,12493,34456
510770,201908,4274,9765,2935,8103,282,748,1943,5609,2225,6357
510774,201908,354,958,239,737,38,121,116,368,154,489
510775,201908,605,1675,420,1368,99,365,89,270,188,635
510776,201908,462,1181,315,882,82,232,91,267,173,499
510777,201908,1574,4255,1125,3647,151,578,708,2245,859,2823
510779,201908,606,1657,459,1419,52,150,272,881,324,1031
510780,201908,3681,9743,2681,8248,639,1965,1134,3883,1773,5848
510785,201908,2074,5543,1153,3789,301,1054,175,648,476,1702
510787,201908,2599,7518,1684,5545,621,2161,150,478,771,2639
510788,201908,664,1589,450,1256,74,198,180,583,254,781
510790,201908,16768,44365,9815,30863,2154,7556,1458,3929,3612,11485
510792,201908,8782,23936,5357,17251,1105,3964,1020,2991,2125,6955
510794,201908,1233,3353,803,2591,248,879,168,460,416,1339
510795,201908,8070,21880,5230,16601,1245,4319,1296,4104,2541,8423
510800,201908,1749,4615,1112,3483,393,1237,133,374,526,1611
510805,201908,1602,4443,1053,3383,235,825,320,896,555,1721
510810,201908,652,1382,412,1041,108,293,172,429,280,722
510820,201908,783,1515,419,1045,35,108,201,505,236,613
510830,201908,856,2122,597,1765,64,175,401,1247,465,1422
510835,201908,576,1431,375,1133,49,161,202,597,251,758
510840,201908,49531,109615,34320,90528,6372,16038,17766,50776,24138,66814
510850,201908,1889,4595,1034,3196,322,1102,96,238,418,1340
510860,201908,2465,6686,1559,5128,475,1809,145,466,620,2275
510880,201908,663,1955,501,1634,128,435,196,649,324,1084
510885,201908,568,1435,390,1163,67,237,125,353,192,590
510890,201908,648,1905,482,1617,115,415,211,702,326,1117
510895,201908,1241,3268,824,2567,197,719,323,910,520,1629
520005,201908,2293,6097,1794,5480,487,1474,791,2721,1278,4195
520010,201908,2211,6528,1575,5219,405,1480,422,1227,827,2707
520013,201908,2725,7224,1840,5548,418,1288,497,1615,915,2903
520015,201908,533,1361,392,1159,94,302,129,396,223,698
520017,201908,1093,2897,824,2476,114,363,503,1477,617,1840
520020,201908,394,923,300,796,34,118,203,506,237,624
520025,201908,32999,93274,28468,86833,2915,9632,20217,61255,23132,70887
520030,201908,5372,14204,4290,12625,390,1283,2855,8319,3245,9602
520050,201908,413,972,262,707,15,37,152,429,167,466
520055,201908,1504,3838,1018,2885,69,187,577,1585,646,1772
520060,201908,1424,4080,1052,3371,284,986,251,809,535,1795
520080,201908,1861,4835,1388,4184,261,807,618,2046,879,2853
520082,201908,877,2276,701,1973,69,188,396,1153,465,1341
520085,201908,817,2259,631,1946,122,396,269,778,391,1174
520090,201908,863,1700,583,1389,65,119,442,1103,507,1222
520110,201908,38840,106873,27010,87007,8713,31574,2046,5915,10759,37489
520120,201908,201,491,115,347,14,49,40,120,54,169
520130,201908,3697,9312,2898,8010,551,1579,1256,3490,1807,5069
520140,201908,39791,110146,28234,89834,10407,35625,3383,11190,13790,46815
520145,201908,547,1295,368,1026,70,214,185,469,255,683
520150,201908,602,1408,435,1185,76,201,234,652,310,853
520160,201908,820,1899,580,1525,102,253,272,736,374,989
520170,201908,5064,10362,3415,8445,204,566,2602,6292,2806,6858
520180,201908,2086,5822,1705,5233,361,1216,846,2553,1207,3769
520215,201908,1863,4498,1311,3620,312,933,486,1294,798,2227
520235,201908,603,1442,364,1068,36,120,141,398,177,518
520250,201908,1517,3981,1098,3300,354,1177,210,637,564,1814
520260,201908,832,1947,500,1379,100,281,197,543,297,824
520280,201908,699,1786,523,1495,119,342,230,698,349,1040
520310,201908,1166,2618,744,1984,174,504,279,782,453,1286
520320,201908,1692,4657,1293,3991,156,536,662,2003,818,2539
520330,201908,3784,10515,2736,8743,449,1711,1298,4000,1747,5711
520340,201908,2314,5215,1450,3992,180,464,840,2404,1020,2868
520350,201908,2979,7294,2134,5940,634,1870,775,2128,1409,3998
520355,201908,1811,5062,1295,4003,365,1231,380,1080,745,2311
520357,201908,772,1928,578,1620,42,118,410,1169,452,1287
520360,201908,706,1878,525,1565,165,515,139,449,304,964
520380,201908,1284,3253,759,2268,82,272,377,1037,459,1309
520390,201908,1003,2234,580,1696,173,550,166,515,339,1065
520393,201908,544,1318,360,1024,52,179,160,405,212,584
520396,201908,789,2139,661,1916,60,200,437,1212,497,1412
520400,201908,1628,4109,1262,3603,196,600,794,2283,990,2883
520410,201908,1895,4232,1104,3034,177,519,489,1283,666,1802
520420,201908,390,909,292,731,30,84,207,482,237,566
520425,201908,1478,3637,904,2609,235,702,265,742,500,1444
520430,201908,2240,5201,1209,3591,224,780,42,111,266,891
520440,201908,3040,7404,1833,5267,453,1411,463,1269,916,2680
520450,201908,11972,29294,7844,22738,2479,7791,1114,3313,3593,11104
520455,201908,672,1876,484,1581,131,463,133,434,264,897
520460,201908,917,2289,765,2083,92,218,586,1631,678,1849
520465,201908,794,2071,631,1833,96,310,404,1122,500,1432
520470,201908,1945,5372,1586,4904,396,1207,773,2568,1169,3775
520480,201908,920,2589,613,2054,194,658,126,453,320,1111
520485,201908,1540,4363,1291,4010,192,609,852,2616,1044,3225
520490,201908,3990,11127,2970,9516,932,3018,1155,3850,2087,6868
520495,201908,1532,3411,1158,2909,57,164,910,2267,967,2431
520500,201908,1359,3624,923,2785,211,692,340,1026,551,1718
520505,201908,729,1727,506,1425,72,203,287,798,359,1001
520510,201908,7600,19568,5030,15469,1188,4093,1301,4267,2489,8360
520520,201908,1137,2961,848,2498,205,633,263,775,468,1408
520530,201908,2023,6039,1493,5094,497,1776,417,1571,914,3347
520540,201908,2896,7830,1748,5436,332,1088,381,1134,713,2222
520545,201908,927,2504,708,2146,145,423,265,819,410,1242
520547,201908,794,2217,632,1924,171,539,275,831,446,1370
520549,201908,12662,35065,10359,31445,1641,5265,6465,19480,8106,24745
520551,201908,4432,12261,3713,11199,432,1554,2555,7464,2987,9018
520552,201908,843,2192,698,2013,131,376,423,1285,554,1661
520570,201908,561,1305,373,1035,101,258,127,387,228,645
520580,201908,2271,5298,1716,4627,132,409,1205,3218,1337,3627
520590,201908,1217,3240,850,2585,235,725,186,572,421,1297
520620,201908,8239,22638,6482,20024,1655,5238,2842,9026,4497,14264
520630,201908,752,1965,463,1439,80,253,97,312,177,565
520640,201908,2460,6129,1862,5089,468,1272,731,2077,1199,3349
520650,201908,892,2154,630,1752,108,305,299,878,407,1183
520660,201908,523,1263,249,758,45,159,60,176,105,335
520670,201908,922,2570,778,2362,72,230,506,1476,578,1706
520680,201908,708,1766,515,1463,89,237,253,740,342,977
520690,201908,355,844,240,678,74,199,70,220,144,419
520710,201908,476,1136,305,841,10,29,201,531,211,560
520725,201908,1578,3789,1094,2994,132,402,668,1747,800,2149
520735,201908,726,1824,485,1429,109,303,173,548,282,851
520740,201908,2041,4727,1546,4106,271,680,848,2379,1119,3059
520750,201908,665,1646,463,1318,86,239,220,640,306,879
520753,201908,1362,3641,1035,3011,199,604,410,1123,609,1727
520760,201908,1165,2593,1040,2433,60,116,894,2152,954,2268
520780,201908,1523,3653,1095,3037,117,340,533,1427,650,1767
520790,201908,3381,8029,2324,6370,277,770,1305,3785,1582,4555
520800,201908,15398,40606,12094,35800,2134,6465,6893,21025,9027,27490
520810,201908,1310,2767,927,2322,162,444,548,1425,710,1869
520815,201908,608,1811,436,1461,84,290,114,395,198,685
520830,201908,1862,4026,1289,3364,51,135,1012,2580,1063,2715
520840,201908,2396,6553,1937,5960,824,2695,527,1742,1351,4437
520850,201908,686,1833,478,1505,168,594,101,322,269,916
520860,201908,6221,17163,4666,14608,1182,3994,1719,5320,2901,9314
520870,201908,98223,233371,65930,184703,16335,49517,21331,58044,37666,107561
520880,201908,6502,18775,5034,16201,1242,4164,1758,5684,3000,9848
520890,201908,3818,9532,2600,7589,567,1772,1067,3101,1634,4873
520910,201908,4525,11612,2850,8622,716,2353,584,1766,1300,4119
520915,201908,635,1740,392,1228,70,233,113,338,183,571
520920,201908,4548,10513,3046,8468,392,1133,1632,4600,2024,5733
520929,201908,729,1754,509,1386,87,211,236,697,323,908
520940,201908,990,2667,774,2356,53,184,563,1667,616,1851
520945,201908,487,1110,391,961,28,63,273,653,301,716
520960,201908,1033,2655,808,2278,109,320,510,1391,619,1711
520970,201908,2484,7038,1990,6212,529,1800,492,1619,1021,3419
520980,201908,788,1961,576,1653,120,376,222,594,342,970
520990,201908,2999,8242,2411,7438,340,1054,1521,4749,1861,5803
520993,201908,1086,2599,718,1983,86,272,416,1090,502,1362
520995,201908,2263,5827,1700,5042,286,864,672,2034,958,2898
521000,201908,8425,22355,5707,17530,1272,4048,1626,4969,2898,9017
521010,201908,3781,9831,2798,8129,304,896,1573,4510,1877,5406
521015,201908,764,1936,539,1526,54,166,320,856,374,1022
521020,201908,3068,8003,1799,5505,536,1740,161,517,697,2257
521030,201908,495,1086,339,863,48,100,156,436,204,536
521040,201908,7648,18673,5620,15490,1198,3459,2357,6599,3555,10058
521056,201908,891,2398,694,2111,218,657,203,681,421,1338
521060,201908,988,2596,730,2142,58,169,368,1082,426,1251
521080,201908,1121,2494,571,1600,76,232,222,539,298,771
521090,201908,3368,8962,2254,6840,624,1999,278,884,902,2883
521100,201908,1771,4176,1263,3449,211,574,708,1951,919,2525
521120,201908,4782,11229,3335,9394,245,625,1638,5272,1883,5897
521130,201908,938,2160,566,1544,29,102,300,841,329,943
521140,201908,1255,3271,897,2630,134,417,405,1167,539,1584
521150,201908,12463,27808,7733,21043,1440,4491,3454,9455,4894,13946
521160,201908,653,1414,457,1107,54,130,281,651,335,781
521170,201908,1064,2523,763,2047,69,190,507,1326,576,1516
521180,201908,6945,19741,5710,17522,1050,3507,2737,8069,3787,11576
521190,201908,10516,27027,5983,19006,1512,5056,1179,3932,2691,8988
521200,201908,735,1835,497,1424,56,162,268,761,324,923
521205,201908,615,1549,462,1297,15,40,334,902,349,942
521210,201908,713,1820,410,1210,103,332,68,151,171,483
521220,201908,3871,9669,2485,7366,535,1749,674,1885,1209,3634
521225,201908,344,768,259,669,39,104,163,412,202,516
521230,201908,1299,3498,1176,3332,419,1195,567,1691,986,2886
521250,201908,30624,84197,23930,74336,9008,29241,6996,23069,16004,52310
521260,201908,583,1367,421,1101,63,171,233,599,296,770
521270,201908,1812,4626,1559,4315,91,226,1180,3288,1271,3514
521280,201908,1879,5089,1389,4243,353,1167,519,1594,872,2761
521290,201908,476,1167,331,972,46,158,189,531,235,689
521295,201908,1085,2392,848,2135,73,170,647,1712,720,1882
521300,201908,1913,4773,1504,4206,292,753,898,2593,1190,3346
521305,201908,719,1772,489,1407,61,167,278,805,339,972
521308,201908,4745,12902,3368,10231,381,1163,1858,5534,2239,6697
521310,201908,8446,21934,5649,17032,1295,4220,2050,5870,3345,10090
521340,201908,419,968,293,782,22,66,205,527,227,593
521350,201908,2048,5296,1546,4510,167,570,1021,2853,1188,3423
521370,201908,1215,3192,736,2346,206,740,101,343,307,1083
521375,201908,1374,3480,958,2867,225,674,304,971,529,1645
521377,201908,1468,3180,1061,2665,79,154,859,2242,938,2396
521380,201908,6072,16359,3936,12292,435,1531,951,3130,1386,4661
521385,201908,638,1553,491,1366,71,192,270,810,341,1002
521390,201908,695,1744,489,1420,147,462,169,508,316,970
521400,201908,2583,5982,1994,5267,228,604,1405,3827,1633,4431
521405,201908,1293,3345,952,2772,194,577,418,1210,612,1787
521410,201908,779,2108,609,1824,119,345,299,962,418,1307
521440,201908,1315,3424,943,2826,290,947,248,728,538,1675
521450,201908,3947,11924,2904,9828,732,2501,766,2712,1498,5213
521460,201908,5794,15593,4154,12635,1480,4666,857,2632,2337,7298
521470,201908,667,1835,401,1259,58,170,125,377,183,547
521480,201908,350,885,200,591,35,106,50,129,85,235
521483,201908,2457,5973,1683,4723,395,1176,599,1636,994,2812
521486,201908,1704,4052,1271,3442,81,232,935,2501,1016,2733
521487,201908,448,1103,316,908,59,174,138,410,197,584
521490,201908,874,2376,639,1982,45,172,450,1348,495,1520
521500,201908,2088,5289,1522,4342,100,352,1061,2949,1161,3301
521520,201908,745,1717,509,1367,88,248,208,561,296,809
521523,201908,11457,36503,9640,33418,2711,10181,2540,9006,5251,19187
521525,201908,1062,2456,776,2047,80,218,544,1423,624,1641
521530,201908,2315,6037,1325,3977,292,932,313,973,605,1905
521540,201908,853,2167,544,1638,74,262,236,738,310,1000
521550,201908,1300,3345,761,2263,148,490,209,641,357,1131
521560,201908,4345,11755,2991,9909,523,2041,1478,5068,2001,7109
521565,201908,626,1551,489,1357,78,209,297,805,375,1014
521570,201908,3736,10030,2430,7523,477,1686,273,893,750,2579
521580,201908,527,1303,300,892,44,144,80,194,124,338
521590,201908,633,1546,466,1295,102,305,238,635,340,940
521600,201908,393,1085,242,762,41,107,75,238,116,345
521630,201908,1702,3817,1012,2748,211,600,331,872,542,1472
521640,201908,1875,4454,1296,3606,291,877,421,1121,712,1998
521645,201908,547,1436,349,1070,78,219,114,354,192,573
521680,201908,1139,3494,879,2965,251,919,109,388,360,1307
521690,201908,520,1350,447,1233,64,191,263,702,327,893
521710,201908,3070,7926,1977,6036,371,1292,438,1261,809,2553
521720,201908,2213,5279,1466,4107,175,539,814,2243,989,2782
521730,201908,3669,10656,2822,9145,845,3068,599,1638,1444,4706
521740,201908,3965,10497,2975,9027,805,2629,1020,3229,1825,5858
521760,201908,14523,41110,11402,36181,3241,11290,3892,12696,7133,23986
521770,201908,2953,7299,1971,5618,607,1857,466,1324,1073,3181
521800,201908,6165,17064,4625,14459,1164,3757,1595,5422,2759,9179
521805,201908,526,1264,378,1042,128,332,147,423,275,755
521810,201908,719,1685,485,1352,75,212,240,687,315,899
521830,201908,5346,15035,4312,13463,358,1320,2986,9169,3344,10489
521839,201908,682,1725,489,1385,92,285,234,590,326,875
521850,201908,5297,13068,3315,9796,527,1718,292,763,819,2481
521860,201908,1712,4560,1168,3575,198,652,363,1079,561,1731
521870,201908,685,1922,468,1499,104,351,120,345,224,696
521878,201908,677,1777,481,1402,71,237,234,611,305,848
521880,201908,18576,45424,12372,35908,3195,9801,3964,11779,7159,21580
521890,201908,3136,8381,2056,6339,544,1777,328,920,872,2697
521900,201908,1600,3834,960,2864,297,853,163,512,460,1365
521910,201908,1177,2608,774,2109,75,197,438,1248,513,1445
521920,201908,459,1286,333,1044,62,210,137,423,199,633
521925,201908,777,2113,577,1794,100,316,267,805,367,1121
521930,201908,5130,12885,3468,10299,935,2643,1237,4058,2172,6701
521935,201908,973,2382,643,1771,72,204,354,916,426,1120
521940,201908,1285,2920,837,2301,188,562,327,870,515,1432
521945,201908,544,1528,428,1315,99,299,205,656,304,955
521950,201908,730,1776,520,1463,133,395,233,611,366,1006
521960,201908,740,2005,483,1484,61,207,236,671,297,878
521970,201908,2534,6360,2073,5809,159,448,1591,4511,1750,4959
521971,201908,775,1885,540,1537,146,419,136,379,282,798
521973,201908,1212,3239,940,2795,55,208,651,1884,706,2092
521975,201908,12019,32178,9947,29260,1607,4946,6129,17974,7736,22920
521980,201908,2573,6114,1958,5292,168,420,1436,3935,1604,4355
521990,201908,1138,3162,895,2742,163,513,398,1228,561,1741
522000,201908,2783,7388,2141,6586,247,754,1395,4438,1642,5192
522005,201908,336,818,249,691,51,133,121,343,172,476
522010,201908,3929,9798,2750,7863,702,2134,835,2330,1537,4464
522015,201908,951,2544,678,2102,167,526,248,782,415,1308
522020,201908,5280,12731,3460,9817,729,2192,1382,3990,2111,6182
522026,201908,655,1850,474,1494,83,283,159,481,242,764
522028,201908,477,1264,340,997,59,175,139,384,198,559
522040,201908,3039,6962,2153,5773,270,792,1405,3673,1675,4465
522045,201908,17340,49289,12780,40853,3082,10537,3197,9834,6279,20371
522050,201908,1012,2667,695,2137,167,544,252,735,419,1279
522060,201908,2542,6998,1966,6079,200,617,1142,3650,1342,4267
522068,201908,1803,4767,1415,4282,156,420,1023,3180,1179,3600
522070,201908,628,1601,511,1421,25,80,402,1078,427,1158
522100,201908,651,1719,448,1373,48,148,238,721,286,869
522108,201908,910,2461,710,2151,51,226,554,1598,605,1824
522119,201908,1537,3984,1160,3452,186,572,601,1836,787,2408
522130,201908,367,923,258,778,50,155,136,438,186,593
522140,201908,16920,45796,12017,37006,3244,10680,2875,8457,6119,19137
522145,201908,822,2026,566,1634,143,397,231,689,374,1086
522150,201908,1055,2613,742,2094,209,582,212,626,421,1208
522155,201908,939,2418,725,2071,128,353,407,1167,535,1520
522157,201908,538,1371,457,1259,27,97,350,957,377,1054
522160,201908,6004,15882,3891,11904,1064,3535,297,966,1361,4501
522170,201908,2672,6904,1949,5808,344,1075,1019,3029,1363,4104
522180,201908,463,1140,292,845,59,168,28,98,87,266
522185,201908,16981,43030,12306,36605,5226,16597,2765,8951,7991,25548
522190,201908,770,1860,526,1434,110,301,190,523,300,824
522200,201908,1699,4925,1073,3585,208,751,125,368,333,1119
522205,201908,1640,3852,1242,3308,119,351,866,2279,985,2630
522220,201908,1292,3331,951,2787,165,480,472,1409,637,1889
522230,201908,1145,3012,934,2703,227,796,464,1242,691,2038
530010,201908,167872,467672,137777,420358,24059,80527,75078,224348,99137,304875
110001,201909,3729,10608,2462,8164,607,2134,962,3215,1569,5349
110002,201909,11049,29309,7620,23352,2191,7112,2192,6782,4383,13894
110003,201909,597,1768,411,1373,105,378,100,319,205,697
110004,201909,9936,26666,6500,20309,1530,5122,1782,5746,3312,10868
110005,201909,2419,6343,1518,4743,347,1187,428,1430,775,2617
110006,201909,1692,4732,1005,3278,211,764,179,533,390,1297
110007,201909,1306,3341,800,2505,273,908,203,752,476,1660
110008,201909,3172,9054,2299,7688,264,868,1537,5406,1801,6274
110009,201909,4058,11562,2572,8768,641,2262,959,3351,1600,5613
110010,201909,6490,21869,4945,18882,1114,4214,2379,9951,3493,14165
110011,201909,6268,17047,4305,13427,1584,5119,624,2054,2208,7173
110012,201909,13684,34742,7950,24444,2043,6631,800,2679,2843,9310
110013,201909,5056,14929,3689,12130,1583,5414,501,1821,2084,7235
110014,201909,3539,9601,2355,7340,626,2020,880,2711,1506,4731
110015,201909,4937,13083,2748,8669,698,2388,491,1440,1189,3828
110018,201909,3397,8691,1944,6091,400,1421,576,1743,976,3164
110020,201909,70517,172441,48976,142322,11013,32937,20382,64152,31395,97089
110025,201909,4784,11797,3058,8772,672,2063,1350,3850,2022,5913
110026,201909,450,1209,322,1015,88,288,131,429,219,717
110028,201909,6136,15942,3710,11493,1011,3380,569,1745,1580,5125
110029,201909,1364,3331,758,2278,178,543,299,947,477,1490
110030,201909,12135,28433,7483,21600,1642,5468,1756,5388,3398,10856
110032,201909,2838,8239,1814,6028,583,1954,416,1442,999,3396
110033,201909,3428,11003,2666,9539,977,3581,658,2628,1635,6209
110034,201909,3294,7952,2123,6306,663,2141,789,2452,1452,4593
110037,201909,1539,4692,1172,4011,274,936,549,1927,823,2863
110040,201909,2876,8196,2031,6598,614,2150,583,1811,1197,3961
110045,201909,4857,14193,3662,12002,994,3514,1333,4384,2327,7898
110050,201909,1696,4746,1184,3807,484,1671,229,756,713,2427
110060,201909,729,2208,500,1693,207,750,68,226,275,976
110070,201909,1601,5124,1200,4208,391,1464,238,762,629,2226
110080,201909,5940,14106,4300,12164,525,1369,2983,8930,3508,10299
110090,201909,536,1455,372,1163,87,302,165,497,252,799
110092,201909,1117,3338,808,2739,139,479,421,1521,560,2000
110094,201909,2680,8065,2009,6817,853,3049,371,1326,1224,4375
110100,201909,1647,4976,1322,4308,345,1177,601,1962,946,3139
110110,201909,1674,4745,1134,3766,380,1314,246,878,626,2192
110120,201909,1207,3632,886,2989,234,834,285,962,519,1796
110130,201909,2473,6422,1561,4751,336,1138,558,1694,894,2832
110140,201909,1948,5921,1333,4624,359,1266,341,1231,700,2497
110143,201909,1274,3485,853,2639,279,839,166,535,445,1374
110145,201909,796,2155,507,1628,127,415,171,575,298,990
110146,201909,424,1139,297,949,61,186,138,474,199,660
110147,201909,731,1924,440,1325,67,216,171,448,238,664
110148,201909,755,2170,435,1495,112,434,51,174,163,608
110149,201909,2911,8172,2009,6709,748,2561,426,1556,1174,4117
110150,201909,2544,6300,1651,5042,539,1777,448,1579,987,3356
110155,201909,646,1957,476,1556,115,387,163,511,278,898
110160,201909,1421,4495,1021,3584,315,1110,245,909,560,2019
110170,201909,2141,5606,1284,3896,260,818,649,1911,909,2729
110175,201909,1586,4577,1111,3722,204,724,487,1716,691,2440
110180,201909,1309,3688,871,2791,158,517,434,1379,592,1896
120001,201909,3016,9090,2502,8338,417,1431,1602,5484,2019,6915
120005,201909,1925,7404,1743,7135,166,761,1361,5656,1527,6417
120010,201909,5129,15723,4328,14458,478,1563,3098,10660,3576,12223
120013,201909,2138,7777,1944,7521,465,1740,1174,4833,1639,6573
120017,201909,2378,8767,2123,8372,347,1378,1387,5797,1734,7175
120020,201909,14601,58455,13478,56218,1150,5407,10511,44163,11661,49570
120025,201909,2973,8696,2400,7979,413,1368,1614,5525,2027,6893
120030,201909,6455,25507,6045,24758,398,2207,4773,19570,5171,21777
120032,201909,1613,7395,1542,7248,96,625,1284,5938,1380,6563
120033,201909,4006,14959,3757,14514,132,744,3255,12463,3387,13207
120034,201909,2583,9443,2194,8727,118,709,1804,7008,1922,7717
120035,201909,3483,14441,3298,14085,291,1391,2661,11488,2952,12879
120038,201909,2673,8698,2299,8086,542,1984,1220,4358,1762,6342
120039,201909,1988,8685,1853,8386,148,899,1459,6537,1607,7436
120040,201909,41937,134983,36308,125560,5488,20012,22707,79495,28195,99507
120042,201909,3322,12553,3029,11960,147,798,2499,9788,2646,10586
120043,201909,1382,5585,1256,5381,42,241,1136,4886,1178,5127
120045,201909,5962,15820,5211,14970,122,500,4766,13541,4888,14041
120050,201909,9205,33376,8404,32126,436,2252,6938,26547,7374,28799
120060,201909,9537,36954,8776,35780,408,2395,7604,30795,8012,33190
120070,201909,3075,10078,2670,9518,264,964,1907,7057,2171,8021
120080,201909,4148,13758,3706,13052,507,1920,2630,9390,3137,11310
130002,201909,3023,12105,2710,11630,192,880,2296,9975,2488,10855
130006,201909,2370,8958,1945,8171,188,865,1453,6107,1641,6972
130008,201909,2561,9083,2273,8640,76,411,1936,7339,2012,7750
130010,201909,3920,11431,3284,10703,76,241,3025,9978,3101,10219
130014,201909,2904,8830,2263,7744,426,1477,1367,4777,1793,6254
130020,201909,2683,10637,2435,10238,149,880,1945,8117,2094,8997
130030,201909,9774,32171,8904,31137,271,991,7940,28173,8211,29164
130040,201909,3709,11273,3091,10425,179,628,2525,8598,2704,9226
130050,201909,7535,27587,6288,25972,175,921,5703,23744,5878,24665
130060,201909,7466,29789,6417,28401,490,2778,5232,22990,5722,25768
130063,201909,6253,20579,5586,19835,215,947,5062,18048,5277,18995
130068,201909,3675,13347,3117,12445,243,1364,2309,9030,2552,10394
130070,201909,7470,21211,6160,19757,306,1012,5155,16885,5461,17897
130080,201909,6726,25248,5915,24282,263,1541,4963,20653,5226,22194
130083,201909,2702,8993,2417,8639,182,743,2039,7300,2221,8043
130090,201909,3389,10625,3011,10135,63,285,2619,8970,2682,9255
130100,201909,7822,23720,6704,22540,65,160,6280,21694,6345,21854
130110,201909,8397,24167,6896,22281,972,2563,5069,17539,6041,20102
130115,201909,5324,16728,4619,15914,98,349,4104,14360,4202,14709
130120,201909,14010,50047,12503,48058,1126,4832,10201,39446,11327,44278
130130,201909,5174,16843,4035,15359,431,1771,2990,11432,3421,13203
130140,201909,7036,24968,6340,24180,194,1055,5610,21482,5804,22537
130150,201909,3658,13639,3434,13376,88,567,3133,12199,3221,12766
130160,201909,4970,17961,4299,17106,279,1291,3641,14629,3920,15920
130165,201909,3231,12326,3047,12084,128,587,2740,10924,2868,11511
130170,201909,11617,34581,9315,31889,747,2951,7447,25633,8194,28584
130180,201909,4487,14302,4247,14029,44,250,4093,13461,4137,13711
130185,201909,18221,45237,14896,41670,917,1691,12704,37328,13621,39019
130190,201909,18753,62393,15176,57015,1841,7144,10627,41117,12468,48261
130195,201909,2414,8878,1975,8321,69,379,1747,7385,1816,7764
130200,201909,2540,7255,2108,6672,115,454,1736,5446,1851,5900
130210,201909,1276,4850,1144,4694,95,563,916,3662,1011,4225
130220,201909,2250,7963,1985,7596,69,359,1728,6632,1797,6991
130230,201909,4456,18724,3891,17901,265,1602,3300,15167,3565,16769
130240,201909,11827,35817,9620,32832,202,1169,8580,29178,8782,30347
130250,201909,25773,78048,22181,73976,1759,5519,17816,61608,19575,67127
130255,201909,4277,14579,3750,13641,166,789,3040,11049,3206,11838
130260,201909,253183,718810,206895,650438,56868,190348,95458,306379,152326,496727
130270,201909,8658,31972,7328,29870,1125,4619,4951,20942,6076,25561
130280,201909,3491,14126,3201,13806,101,514,2964,12941,3065,13455
130290,201909,13019,44331,11382,42279,654,2664,9668,36518,10322,39182
130300,201909,4662,16455,4231,15848,158,871,3656,13634,3814,14505
130310,201909,5974,20674,5235,19667,314,1424,4359,16421,4673,17845
130320,201909,3427,11134,2891,10460,356,1257,2158,8046,2514,9303
130330,201909,4568,14715,3702,13623,206,937,3172,11637,3378,12574
130340,201909,22895,73435,19771,69807,1475,4815,16426,59909,17901,64724
130350,201909,3891,14330,3514,13841,151,884,3073,11963,3224,12847
130353,201909,7025,19508,5682,17771,863,2602,3925,12739,4788,15341
130356,201909,4975,16256,4196,15017,705,2496,2644,9919,3349,12415
130360,201909,3037,9434,2613,8931,74,246,2412,8306,2486,8552
130370,201909,5634,22154,4957,21205,300,1598,4102,17451,4402,19049
130380,201909,7027,29400,6537,28702,384,2217,5540,24077,5924,26294
130390,201909,5875,24716,5177,23518,572,3052,3737,16979,4309,20031
130395,201909,2297,7374,1963,6817,198,726,1481,5121,1679,5847
130400,201909,2709,8622,2339,8133,97,340,2081,7346,2178,7686
130406,201909,10829,38578,9222,36535,1684,6716,6278,25710,7962,32426
130410,201909,4144,14860,3527,13783,1089,4429,1571,6361,2660,10790
130420,201909,13236,47051,11115,44431,930,4838,8743,34954,9673,39792
130423,201909,4210,13483,3699,12897,177,854,3249,11176,3426,12030
130426,201909,2809,11049,2644,10830,81,451,2435,9984,2516,10435
130430,201909,4171,11963,3629,11230,293,1073,2959,8988,3252,10061
130440,201909,4756,15036,4120,14278,134,558,3767,13141,3901,13699
140002,201909,2201,6569,1907,6196,95,366,1595,5179,1690,5545
140005,201909,3211,8963,2867,8571,146,394,2485,7570,2631,7964
140010,201909,53087,140530,41597,123365,10761,33585,17145,52084,27906,85669
140015,201909,3614,11097,3078,10436,203,692,2682,9222,2885,9914
140017,201909,3933,11476,3447,10854,292,916,2736,8857,3028,9773
140020,201909,5141,15318,4407,14321,260,1111,3550,11436,3810,12547
140023,201909,2340,7066,1911,6471,211,723,1406,4862,1617,5585
140028,201909,2038,5284,1735,4896,102,332,1381,3870,1483,4202
140030,201909,5104,13278,4522,12602,354,734,3871,11171,4225,11905
140040,201909,2423,9685,2227,9398,97,590,1986,8252,2083,8842
140045,201909,2512,9145,2114,8594,354,1267,1441,6292,1795,7559
140047,201909,5784,16726,4852,15346,650,2129,3386,10836,4036,12965
140050,201909,1372,4060,1147,3735,128,435,842,2789,970,3224
140060,201909,1615,4331,1356,3947,120,329,1059,3151,1179,3480
140070,201909,1802,9430,1741,9286,121,811,1442,7618,1563,8429
150010,201909,45060,112571,40897,107260,955,2444,36604,95679,37559,98123
150013,201909,1933,5022,1586,4643,145,304,1237,3833,1382,4137
150020,201909,14183,42939,13197,41645,1187,3033,11124,36106,12311,39139
150030,201909,8568,32368,7818,31438,413,1913,6821,27544,7234,29457
150034,201909,4212,10598,3487,9663,230,590,2915,8229,3145,8819
150040,201909,16290,42168,14298,39953,1317,2157,11750,35785,13067,37942
150050,201909,6874,24268,6311,23497,135,632,5764,21663,5899,22295
150060,201909,21141,58302,17145,52292,2836,8818,10779,33643,13615,42461
150070,201909,6570,25016,5801,24087,205,1055,5195,21817,5400,22872
150080,201909,91949,206008,77394,186304,18554,48710,23892,70440,42446,119150
150085,201909,7289,21635,6642,20845,140,477,6210,19575,6350,20052
150090,201909,9715,36523,9151,35393,649,2712,7413,28764,8062,31476
150095,201909,5499,16444,4845,15605,269,653,4070,13637,4339,14290
150100,201909,2892,10258,2562,9684,203,729,2001,7680,2204,8409
150110,201909,4298,18099,4040,17791,219,1043,3665,16232,3884,17275
150120,201909,7730,24761,7416,24373,266,729,6634,22452,6900,23181
150125,201909,727,1991,544,1738,107,398,311,974,418,1372
150130,201909,22192,64674,19283,60324,2898,8082,13371,43758,16269,51840
150140,201909,237550,556367,201908,506771,31581,77352,118416,310429,149997,387781
150145,201909,4301,13180,3649,12220,875,2635,2132,7797,3007,10432
150150,201909,15540,40429,13663,38026,650,1950,11375,31650,12025,33600
150157,201909,3373,9418,2773,8639,295,955,1983,6394,2278,7349
150160,201909,2921,8871,2727,8571,576,1747,1662,5410,2238,7157
150170,201909,24223,80005,21099,74705,4000,13334,12851,48403,16851,61737
150172,201909,4624,12886,3722,11609,256,737,2833,9102,3089,9839
150175,201909,1582,5041,1333,4569,236,844,783,2706,1019,3550
150178,201909,10327,28420,8579,26362,234,670,7606,23686,7840,24356
150180,201909,21699,78399,19912,76270,1024,3739,17478,68263,18502,72002
150190,201909,6655,22675,6221,22101,277,1227,5440,19219,5717,20446
150195,201909,5169,16793,4928,16431,83,455,4583,15111,4666,15566
150200,201909,5769,17030,5289,16499,62,164,4999,15732,5061,15896
150210,201909,25298,89865,23691,87615,1828,6773,19592,74081,21420,80854
150215,201909,7355,21052,6278,19458,1216,3676,3626,11792,4842,15468
150220,201909,11770,34000,10351,31937,1115,3351,7102,22368,8217,25719
150230,201909,12326,35244,10724,33116,1183,3319,7441,23953,8624,27272
150240,201909,31500,88210,25915,78476,7597,23437,8553,26496,16150,49933
150250,201909,4112,16116,3898,15842,593,2368,2974,12381,3567,14749
150260,201909,2679,8931,2441,8551,182,628,1893,6716,2075,7344
150270,201909,8594,24884,6018,20433,2010,7119,1754,6342,3764,13461
150275,201909,6733,21705,6195,20940,226,909,5406,18160,5632,19069
150276,201909,2259,6117,1936,5728,250,673,1339,4339,1589,5012
150277,201909,5164,13685,4178,12545,327,894,3223,10289,3550,11183
150280,201909,6667,27183,6462,26813,509,2117,5416,22710,5925,24827
150285,201909,3241,11454,2854,10845,250,1002,2068,7979,2318,8981
150290,201909,10550,28818,9585,27770,327,724,8665,25695,8992,26419
150293,201909,9249,23088,6899,19957,1102,3154,4070,12445,5172,15599
150295,201909,7757,20926,5564,17968,1956,6866,1816,6535,3772,13401
150300,201909,2331,7062,2092,6746,50,200,1887,6087,1937,6287
150304,201909,4003,12036,3266,10860,608,1918,1989,6907,2597,8825
150307,201909,6036,19597,5603,18899,358,1181,4613,15747,4971,16928
150309,201909,6156,18844,4930,16680,939,3107,2707,9560,3646,12667
150310,201909,7259,28673,6908,28240,230,1278,6109,25180,6339,26458
150320,201909,9339,25533,8521,24390,431,1331,6612,18843,7043,20174
150330,201909,13781,44918,12741,43207,1377,4433,9575,33334,10952,37767
150340,201909,2527,7380,2250,6976,344,990,1568,5003,1912,5993
150345,201909,7873,23417,7137,22436,406,1352,6109,19280,6515,20632
150350,201909,8828,22769,8108,21826,747,1436,6628,18458,7375,19894
150360,201909,23647,66310,18940,60212,2018,5612,13231,44448,15249,50060
150370,201909,10227,32036,8509,29677,952,2944,6252,23184,7204,26128
150375,201909,3412,14000,3081,13507,256,1244,2551,11279,2807,12523
150380,201909,10883,28158,8986,25631,159,580,7883,22506,8042,23086
150390,201909,7829,31765,7068,30530,1079,4167,4954,22612,6033,26779
150400,201909,6367,23204,6109,22703,278,1117,5308,19780,5586,20897
150405,201909,9169,24457,8075,23118,488,1126,6519,19309,7007,20435
150410,201909,1892,6095,1606,5591,198,637,1059,3762,1257,4399
150420,201909,39639,111636,30395,97698,8884,29967,10075,37530,18959,67497
150430,201909,8331,24632,7623,23694,835,2037,5987,19400,6822,21437
150440,201909,5443,17902,5026,17273,680,2103,3640,12961,4320,15064
150442,201909,24861,60843,20570,55297,2234,5942,14249,39148,16483,45090
150445,201909,6241,19376,5511,18249,202,724,4724,15659,4926,16383
150450,201909,5001,21704,4687,21260,361,1839,4016,18180,4377,20019
150460,201909,8384,27621,7701,26746,254,1024,6616,23751,6870,24775
150470,201909,21196,55215,18871,52564,430,1121,17654,49297,18084,50418
150475,201909,4694,15154,4113,14245,178,678,3414,11946,3592,12624
150480,201909,13430,44051,12073,41985,2214,7115,7990,29525,10204,36640
150490,201909,8164,28652,7598,27928,256,1149,6780,25017,7036,26166
150495,201909,5174,18054,4985,17768,119,612,4550,16095,4669,16707
150497,201909,2869,9218,2309,8216,550,1998,1181,4483,1731,6481
150500,201909,3263,8453,2903,7937,252,625,2266,6216,2518,6841
150503,201909,4629,12202,3194,10266,977,3337,1022,3733,1999,7070
150506,201909,9947,30470,8452,28387,1789,5271,5360,19750,7149,25021
150510,201909,9643,35448,8386,33068,1132,4279,5677,23436,6809,27715
150520,201909,7121,27434,6812,27044,229,1353,6153,24304,6382,25657
150530,201909,12238,41846,10649,39549,1577,4715,7611,30191,9188,34906
150540,201909,4923,13613,4199,12513,194,548,3549,10603,3743,11151
150543,201909,7101,19264,5795,17597,546,1706,4343,13741,4889,15447
150548,201909,10026,31493,9067,30203,302,1123,7978,26665,8280,27788
150549,201909,1977,5990,1708,5619,47,206,1484,4869,1531,5075
150550,201909,19264,57280,16168,52198,3861,12744,7346,25274,11207,38018
150553,201909,24375,73155,19192,63858,6056,20670,6426,23199,12482,43869
150555,201909,1839,4941,1427,4291,132,318,996,3113,1128,3431
150560,201909,1801,5536,1601,5143,266,809,936,3134,1202,3943
150563,201909,2384,7421,2021,6780,448,1578,1100,3691,1548,5269
150565,201909,4243,13746,3750,12944,110,507,3076,10704,3186,11211
150570,201909,6126,19932,5772,19422,256,989,5045,16919,5301,17908
150580,201909,10150,40904,8999,39604,636,3222,7354,33303,7990,36525
150590,201909,7771,27334,6807,26147,205,1212,6131,23396,6336,24608
150600,201909,9429,31776,8791,30971,231,930,8084,28629,8315,29559
150610,201909,2800,8362,2510,7879,100,381,2088,6492,2188,6873
150611,201909,3126,8973,2778,8464,86,342,2455,7399,2541,7741
150613,201909,13122,36376,9843,30754,1853,6184,4868,15200,6721,21384
150616,201909,3248,8970,2348,7471,585,1927,957,3010,1542,4937
150618,201909,6770,19843,5460,17783,529,1646,3509,12030,4038,13676
150619,201909,6121,17569,5101,16084,165,641,4254,13421,4419,14062
150620,201909,6450,21452,5578,19994,701,2436,3901,14386,4602,16822
150630,201909,6043,16643,5539,16004,443,1180,4568,13411,5011,14591
150635,201909,4531,12624,3820,11470,508,1478,2510,7718,3018,9196
150640,201909,2192,6443,2004,6215,30,97,1868,5875,1898,5972
150650,201909,11303,31749,9921,29452,3042,8500,4375,14162,7417,22662
150655,201909,5806,16565,5245,15736,218,648,4525,13580,4743,14228
150658,201909,4386,12496,3450,11064,553,1874,2098,7060,2651,8934
150660,201909,5651,16285,5046,15416,453,1303,3558,11090,4011,12393
150670,201909,8179,19205,6410,17189,648,1478,5035,14131,5683,15609
150680,201909,65974,195796,50191,170784,12374,41421,22630,86261,35004,127682
150690,201909,2894,7842,2578,7451,111,267,2285,6747,2396,7014
150700,201909,6059,18103,5419,17265,340,945,4351,14226,4691,15171
150710,201909,3743,12525,3415,11993,257,940,2626,9349,2883,10289
150715,201909,4950,14410,4091,13074,324,1006,3209,10400,3533,11406
150720,201909,6745,24406,6288,23640,437,1819,5219,19708,5656,21527
150730,201909,11382,35457,9984,33412,1123,3933,7565,25810,8688,29743
150740,201909,3884,10987,3424,10251,305,803,2594,7907,2899,8710
150745,201909,5028,14367,4034,12892,812,2744,2607,8367,3419,11111
150746,201909,1614,4983,1471,4767,79,262,1208,3919,1287,4181
150747,201909,4683,15247,4178,14388,741,2272,2756,9968,3497,12240
150750,201909,3600,11412,3028,10513,220,801,2334,8307,2554,9108
150760,201909,11805,34719,10747,33329,1486,4219,7686,24525,9172,28744
150770,201909,6273,22795,5964,22425,196,640,5456,21075,5652,21715
150775,201909,862,2486,674,2215,127,462,374,1230,501,1692
150780,201909,4564,13719,4078,13143,128,368,3712,12191,3840,12559
150790,201909,5530,15986,4797,15192,200,497,3981,13713,4181,14210
150795,201909,13269,42179,11816,39807,3112,9916,6581,23688,9693,33604
150796,201909,3676,9270,3201,8691,171,420,2727,7502,2898,7922
150797,201909,3933,12283,3372,11450,147,439,2855,9832,3002,10271
150800,201909,13131,41455,11969,39955,1444,4415,9187,31686,10631,36101
150803,201909,6890,22576,6497,21968,341,1163,5597,19044,5938,20207
150805,201909,3460,10800,2933,9998,240,833,2256,7803,2496,8636
150808,201909,5981,17057,4306,14251,1675,6040,592,2213,2267,8253
150810,201909,20397,54561,15402,48459,3279,10563,7931,27111,11210,37674
150812,201909,5353,15206,4697,14061,431,1362,3461,10167,3892,11529
150815,201909,9149,27492,7713,25700,616,2070,6292,21277,6908,23347
150820,201909,11840,32563,9961,30223,1014,2670,7697,24292,8711,26962
150830,201909,11239,42341,10625,41574,398,1949,9280,36919,9678,38868
150835,201909,2227,7528,1934,6982,366,1309,1045,3808,1411,5117
150840,201909,7137,20677,5660,18171,983,3390,3064,9718,4047,13108
160005,201909,1167,3236,1041,3057,51,182,888,2606,939,2788
160010,201909,2435,6319,2287,6157,20,106,2222,5912,2242,6018
160015,201909,2591,7774,2338,7443,74,266,2142,6825,2216,7091
160020,201909,1994,6581,1767,6286,175,615,1388,5041,1563,5656
160021,201909,1060,4151,979,4043,67,389,801,3233,868,3622
160023,201909,1230,4382,1081,4130,112,381,768,3097,880,3478
160025,201909,1857,5452,1785,5368,10,33,1753,5284,1763,5317
160027,201909,8841,24645,7923,23494,616,1709,6435,19438,7051,21147
160030,201909,66785,192505,53840,175013,11731,35952,29284,104609,41015,140561
160040,201909,5545,19191,5016,18493,88,418,4655,17252,4743,17670
160050,201909,4625,14456,3655,13086,1445,4959,1270,5578,2715,10537
160053,201909,3678,11640,3374,11266,251,753,2803,9629,3054,10382
160055,201909,894,2633,865,2599,29,90,806,2423,835,2513
160060,201909,23796,64885,19449,59859,991,3183,15534,49797,16525,52980
160070,201909,2767,10508,2492,10062,208,816,1952,8147,2160,8963
160080,201909,3245,10500,2946,10150,48,235,2707,9396,2755,9631
170025,201909,599,1610,432,1358,81,255,223,708,304,963
170030,201909,1182,3593,886,3035,148,501,430,1495,578,1996
170035,201909,1447,3778,1031,3094,99,336,615,1850,714,2186
170040,201909,1826,5276,1425,4709,99,388,867,2975,966,3363
170070,201909,1776,4185,1235,3500,77,277,736,2121,813,2398
170100,201909,2422,6988,1986,6260,187,564,1282,4129,1469,4693
170105,201909,718,2102,481,1577,119,353,178,590,297,943
170110,201909,888,2772,677,2362,127,471,288,1007,415,1478
170130,201909,1295,3908,916,3172,176,646,437,1550,613,2196
170190,201909,1329,3811,895,3081,316,1111,165,751,481,1862
170200,201909,1835,4528,1122,3310,219,686,366,1082,585,1768
170210,201909,23638,64933,17792,54995,6403,21465,1931,7086,8334,28551
170215,201909,1298,3526,1064,3212,50,213,831,2497,881,2710
170220,201909,5742,18039,4806,16301,1277,4128,2088,7667,3365,11795
170230,201909,1207,3636,895,3011,266,902,174,637,440,1539
170240,201909,2611,7362,1977,6333,151,585,1359,4226,1510,4811
170255,201909,3946,11499,2749,9240,504,1733,1231,4251,1735,5984
170270,201909,962,2331,619,1850,29,83,385,1136,414,1219
170290,201909,2896,8594,2455,8032,109,375,1959,6600,2068,6975
170300,201909,1923,5299,1546,4734,181,578,1036,3210,1217,3788
170305,201909,652,1801,520,1574,65,233,262,775,327,1008
170307,201909,913,3173,728,2793,106,443,405,1562,511,2005
170310,201909,1562,3965,1061,3124,173,551,486,1435,659,1986
170320,201909,1016,2646,755,2228,69,215,479,1426,548,1641
170330,201909,894,2770,806,2629,45,207,665,2117,710,2324
170360,201909,478,1314,331,1056,26,86,211,639,237,725
170370,201909,1274,3448,909,2837,290,885,222,817,512,1702
170380,201909,1731,5057,1269,4319,118,454,715,2518,833,2972
170382,201909,532,1601,427,1410,41,179,302,950,343,1129
170384,201909,1550,5611,1257,5021,266,1113,618,2501,884,3614
170386,201909,860,2386,523,1712,77,302,179,542,256,844
170388,201909,602,1716,419,1387,64,240,187,624,251,864
170389,201909,999,3150,835,2866,39,156,638,2224,677,2380
170390,201909,1659,3862,1212,3307,62,157,973,2738,1035,2895
170410,201909,545,1627,390,1329,22,97,250,842,272,939
170460,201909,368,967,286,828,44,124,175,521,219,645
170510,201909,882,2613,632,2138,42,183,400,1301,442,1484
170550,201909,6371,17216,4574,14213,1227,4116,1064,3545,2291,7661
170555,201909,1333,3710,1025,3222,58,196,545,1765,603,1961
170560,201909,1020,2905,751,2512,66,258,467,1664,533,1922
170600,201909,1291,3487,1038,3115,213,501,594,1946,807,2447
170610,201909,1669,4486,1194,3758,72,258,751,2357,823,2615
170625,201909,423,1170,252,800,34,96,89,285,123,381
170650,201909,1235,3721,951,3233,148,510,507,1808,655,2318
170700,201909,3259,9672,2414,8079,488,1677,1070,3661,1558,5338
170710,201909,1506,4010,1127,3363,157,516,692,2052,849,2568
170720,201909,1768,4488,1384,3913,75,162,1020,3003,1095,3165
170730,201909,989,2752,724,2310,143,417,339,1161,482,1578
170740,201909,2027,6847,1719,6242,197,766,1187,4305,1384,5071
170755,201909,872,2463,596,1944,52,212,297,923,349,1135
170765,201909,1163,3001,793,2413,159,484,342,1093,501,1577
170770,201909,1767,5206,1447,4701,172,534,951,3174,1123,3708
170820,201909,3261,9975,2638,8807,480,1708,1327,4499,1807,6207
170825,201909,916,2213,737,1958,77,215,527,1395,604,1610
170830,201909,1359,3704,1124,3331,27,102,903,2671,930,2773
170900,201909,2593,8423,2190,7817,181,696,1720,6212,1901,6908
170930,201909,3567,9971,2709,8357,620,2021,974,2971,1594,4992
170950,201909,10768,29933,7227,23456,2128,7793,911,3197,3039,10990
170980,201909,431,1186,345,1049,16,74,248,709,264,783
171050,201909,1564,5037,1357,4656,53,261,1122,3817,1175,4078
171070,201909,1313,3834,1111,3538,289,926,515,1845,804,2771
171090,201909,1026,2548,824,2253,75,207,562,1536,637,1743
171110,201909,554,1518,387,1204,61,203,178,497,239,700
171150,201909,1078,2709,623,1911,70,250,373,1122,443,1372
171180,201909,757,2116,489,1587,74,219,207,685,281,904
171190,201909,1693,5804,1450,5363,236,945,859,3272,1095,4217
171195,201909,795,2610,652,2337,92,385,392,1377,484,1762
171200,201909,512,1476,384,1248,68,238,178,575,246,813
171215,201909,349,988,274,860,43,148,176,536,219,684
171240,201909,746,2507,603,2220,37,184,399,1453,436,1637
171245,201909,636,1936,483,1600,46,172,291,929,337,1101
171250,201909,1017,2659,727,2215,131,420,361,1113,492,1533
171270,201909,402,1519,315,1321,67,315,125,552,192,867
171280,201909,841,2570,652,2232,71,222,369,1330,440,1552
171320,201909,3947,11204,3033,9589,619,1959,1193,3940,1812,5899
171330,201909,2644,7251,2010,6174,387,1138,982,3119,1369,4257
171360,201909,1385,4071,1098,3646,82,311,796,2692,878,3003
171370,201909,653,1690,499,1460,50,142,338,1011,388,1153
171380,201909,1444,4200,1192,3828,107,335,846,2795,953,3130
171395,201909,940,2645,632,2049,66,244,375,1189,441,1433
171420,201909,1865,5620,1343,4565,235,883,592,2009,827,2892
171430,201909,1015,3064,834,2703,63,239,560,1757,623,1996
171488,201909,2284,6813,1761,5932,305,1070,879,3048,1184,4118
171500,201909,974,2451,734,2072,39,122,550,1548,589,1670
171510,201909,766,2566,666,2364,42,185,463,1631,505,1816
171515,201909,449,1189,315,962,32,127,188,540,220,667
171525,201909,664,1946,510,1675,32,135,305,938,337,1073
171550,201909,328,966,234,800,30,121,136,452,166,573
171570,201909,1077,3308,889,2965,139,472,519,1769,658,2241
171575,201909,1769,4753,1105,3530,139,466,483,1533,622,1999
171610,201909,5595,15801,4121,13231,917,3258,1168,3970,2085,7228
171620,201909,2602,7437,2186,6826,116,457,1747,5434,1863,5891
171630,201909,945,2565,752,2290,107,330,502,1578,609,1908
171650,201909,1992,5778,1509,4910,389,1373,470,1647,859,3020
171660,201909,2273,5829,1532,4566,240,675,791,2414,1031,3089
171665,201909,1288,3636,966,3102,162,593,461,1502,623,2095
171670,201909,1819,4933,1384,4209,212,714,777,2329,989,3043
171700,201909,1193,3436,863,2839,105,326,488,1617,593,1943
171720,201909,790,2050,609,1763,53,192,435,1226,488,1418
171750,201909,1217,3475,837,2776,207,700,112,471,319,1171
171780,201909,1209,3087,864,2584,69,232,606,1774,675,2006
171790,201909,1374,4620,1108,4060,227,843,501,1923,728,2766
171800,201909,714,1975,525,1685,67,265,298,944,365,1209
171820,201909,10706,30341,7848,25324,1957,6561,2551,8788,4508,15349
171830,201909,1472,4875,1228,4419,117,528,788,2806,905,3334
171840,201909,728,1951,576,1709,24,67,391,1159,415,1226
171845,201909,587,1512,424,1268,52,193,254,750,306,943
171850,201909,851,2924,717,2615,74,354,502,1765,576,2119
171855,201909,1001,3067,838,2771,75,250,526,1708,601,1958
171865,201909,368,1180,292,1042,48,192,143,476,191,668
171870,201909,783,2238,545,1785,68,240,280,928,348,1168
171875,201909,1231,3684,985,3280,49,217,745,2450,794,2667
171880,201909,1126,3516,990,3327,34,133,795,2694,829,2827
171884,201909,797,2267,584,1905,112,414,216,752,328,1166
171886,201909,1385,3884,966,3156,284,1025,194,643,478,1668
171888,201909,727,2065,494,1620,33,130,310,989,343,1119
171889,201909,390,1206,315,1062,73,268,129,430,202,698
171890,201909,1086,3025,805,2581,181,547,441,1477,622,2024
171900,201909,525,1830,361,1401,77,298,142,565,219,863
172000,201909,553,1696,462,1520,44,158,269,858,313,1016
172010,201909,1016,3553,860,3221,78,338,517,1873,595,2211
172015,201909,355,1270,258,1060,61,260,107,459,168,719
172020,201909,2504,7373,2217,6983,156,580,1664,5351,1820,5931
172025,201909,723,2008,523,1675,38,145,360,1152,398,1297
172030,201909,1215,3631,1037,3350,43,182,820,2636,863,2818
172049,201909,1259,3077,837,2464,178,497,463,1456,641,1953
172065,201909,1445,3617,1121,3217,108,235,903,2750,1011,2985
172080,201909,2269,6752,1827,5954,103,397,1213,3922,1316,4319
172085,201909,459,1275,294,912,55,166,105,310,160,476
172090,201909,3910,10000,2989,8778,137,465,2260,6651,2397,7116
172093,201909,457,1339,329,1112,26,117,184,597,210,714
172097,201909,594,1589,414,1274,56,175,201,625,257,800
172100,201909,47361,118199,32025,93338,6141,19845,10918,32647,17059,52492
172110,201909,1566,5747,1342,5380,153,622,970,4090,1123,4712
172120,201909,4717,14106,3685,12440,494,1732,2084,7277,2578,9009
172125,201909,298,818,219,686,21,68,119,370,140,438
172130,201909,631,1576,505,1379,25,93,358,908,383,1001
172208,201909,2438,6147,1960,5514,177,445,1401,4040,1578,4485
172210,201909,2646,6944,2006,6117,383,1226,1088,3440,1471,4666
210005,201909,18753,54465,14353,47116,4282,14602,5442,18683,9724,33285
210010,201909,1920,5939,1734,5690,66,305,1501,4927,1567,5232
210015,201909,3271,9882,2923,9418,108,294,2547,8314,2655,8608
210020,201909,7435,17220,6408,16025,85,236,5950,14903,6035,15139
210030,201909,4732,15734,4415,15266,204,950,3814,13113,4018,14063
210040,201909,1812,4379,1635,4164,28,49,1528,3933,1556,3982
210043,201909,6250,17764,5204,16374,511,1544,3890,12569,4401,14113
210047,201909,6652,20954,5451,19284,157,796,4705,16594,4862,17390
210050,201909,2185,7453,1712,6580,174,785,1194,4551,1368,5336
210055,201909,1833,5972,1667,5704,63,264,1412,4811,1475,5075
210060,201909,6995,26071,6210,24619,751,3101,4319,17611,5070,20712
210070,201909,7109,20234,6700,19717,42,171,6395,18845,6437,19016
210080,201909,4064,13981,3874,13758,40,238,3646,13016,3686,13254
210083,201909,5573,15916,4584,14861,51,269,4326,14003,4377,14272
210087,201909,3015,8275,2630,7775,113,274,2260,6842,2373,7116
210090,201909,9300,29179,8662,28046,440,1300,7441,24190,7881,25490
210095,201909,6253,20427,5775,19855,215,933,4921,17326,5136,18259
210100,201909,6731,20581,6056,19510,314,1093,4957,16009,5271,17102
210110,201909,3021,10342,2802,10071,67,426,2563,9094,2630,9520
210120,201909,22363,62161,18614,57181,2066,5310,12615,41118,14681,46428
210125,201909,4286,11708,3767,11074,803,1837,2651,8421,3454,10258
210130,201909,4273,11409,3529,10461,163,379,3002,8995,3165,9374
210135,201909,1464,4439,1265,4115,65,205,1019,3360,1084,3565
210140,201909,17532,47429,13525,42200,2611,7975,7614,24876,10225,32851
210150,201909,4369,10584,3857,9862,127,352,3366,8490,3493,8842
210160,201909,16219,48137,14113,45384,1288,4363,10068,33386,11356,37749
210170,201909,14819,46771,13828,45460,701,2202,12191,40272,12892,42474
210173,201909,2296,8723,2104,8367,66,418,1868,7421,1934,7839
210177,201909,3379,9333,2992,8862,114,204,2680,8225,2794,8429
210180,201909,1426,3881,1255,3662,31,91,1140,3312,1171,3403
210190,201909,5124,14394,4424,13373,76,389,3792,11230,3868,11619
210193,201909,1240,3698,1107,3489,36,145,879,2818,915,2963
210197,201909,2013,6472,1860,6249,147,503,1520,5187,1667,5690
210200,201909,7391,24172,6655,22946,494,1828,5323,18393,5817,20221
210203,201909,6839,20555,5918,19318,438,1488,4808,15928,5246,17416
210207,201909,3608,9398,2950,8659,137,332,2459,7400,2596,7732
210210,201909,8147,26547,7508,25674,127,769,6827,23226,6954,23995
210215,201909,2242,7409,2026,7092,51,270,1810,6325,1861,6595
210220,201909,6098,21131,5785,20641,202,1272,5048,17577,5250,18849
210230,201909,5156,15720,4648,14961,362,957,3914,12867,4276,13824
210232,201909,11180,35488,9217,32529,1527,5450,5819,21853,7346,27303
210235,201909,3353,10037,2939,9476,65,304,2610,8411,2675,8715
210237,201909,2642,8943,2346,8579,31,190,2178,7962,2209,8152
210240,201909,2590,8218,2382,7846,83,356,2066,6706,2149,7062
210250,201909,5551,17057,5056,16437,75,423,4544,14751,4619,15174
210255,201909,2431,7539,2056,6849,297,990,1291,4282,1588,5272
210260,201909,5439,16398,4795,15445,239,893,4108,13177,4347,14070
210270,201909,4710,13181,4216,12545,108,505,3755,11067,3863,11572
210275,201909,3540,8968,3126,8461,48,115,2860,7818,2908,7933
210280,201909,5407,15694,4335,13989,274,1174,3116,9863,3390,11037
210290,201909,7052,19405,6343,18512,132,421,5805,16935,5937,17356
210300,201909,32503,88812,26698,80657,1772,5600,19852,61896,21624,67496
210310,201909,3027,7861,2667,7325,121,273,2322,6431,2443,6704
210312,201909,2674,6949,2353,6586,42,183,2169,5994,2211,6177
210315,201909,2939,8267,2498,7764,64,171,2280,7234,2344,7405
210317,201909,4096,13031,3716,12581,116,612,3328,11189,3444,11801
210320,201909,18786,57569,17161,55426,435,2155,15200,48714,15635,50869
210325,201909,3477,10095,3029,9516,74,240,2732,8706,2806,8946
210330,201909,23577,68592,19725,63330,5590,16344,9831,35992,15421,52336
210340,201909,9862,29551,8826,28080,699,2248,6803,22135,7502,24383
210350,201909,9283,26948,8139,25528,163,577,7208,22727,7371,23304
210355,201909,4238,14434,3739,13648,108,571,3202,11733,3310,12304
210360,201909,13297,41890,11916,39854,577,2614,9340,30767,9917,33381
210370,201909,10594,24063,8270,21591,235,437,7576,20199,7811,20636
210375,201909,3257,8660,2433,7569,632,2001,1138,3893,1770,5894
210380,201909,5433,14130,4724,13279,225,564,4048,11463,4273,12027
210390,201909,2489,8997,2323,8685,133,624,1925,7152,2058,7776
210400,201909,4414,13691,3919,13072,149,492,3483,11747,3632,12239
210405,201909,6823,18597,5481,16670,1028,2941,3137,10113,4165,13054
210407,201909,1951,6525,1627,5915,85,384,1313,4705,1398,5089
210408,201909,2448,9295,2294,9051,144,719,1858,7327,2002,8046
210409,201909,3762,13070,3441,12623,104,601,2850,10470,2954,11071
210410,201909,3361,10326,2835,9458,181,681,2125,7067,2306,7748
210420,201909,3857,12377,3478,11724,204,595,2927,9988,3131,10583
210430,201909,2236,6558,2010,6272,83,242,1783,5597,1866,5839
210440,201909,4218,11669,3767,11065,69,270,3474,10133,3543,10403
210450,201909,2410,7204,2089,6711,98,347,1722,5516,1820,5863
210455,201909,4189,11122,3143,9789,937,2923,1497,4869,2434,7792
210460,201909,3586,10464,3084,9804,78,340,2703,8525,2781,8865
210462,201909,1564,4875,1348,4516,39,172,1096,3662,1135,3834
210465,201909,2599,7670,2275,7216,55,226,1987,6297,2042,6523
210467,201909,5669,18557,5048,17747,307,1252,4233,14982,4540,16234
210470,201909,2076,5413,1419,4478,80,186,1083,3550,1163,3736
210480,201909,15957,47363,13252,44008,1195,3604,9777,34692,10972,38296
210490,201909,3688,9351,2973,8337,71,215,2579,7229,2650,7444
210500,201909,6163,24114,5718,23320,361,1803,4694,18986,5055,20789
210510,201909,5978,19994,5282,19223,118,539,4727,17459,4845,17998
210515,201909,3702,10864,3226,10334,111,392,2829,9169,2940,9561
210520,201909,2505,7211,2250,6889,76,269,1982,6015,2058,6284
210530,201909,52397,127070,40652,109767,6551,22247,11116,38471,17667,60718
210535,201909,3025,10383,2817,10055,106,427,2381,8575,2487,9002
210540,201909,14256,41774,11923,38514,1392,4217,8468,28415,9860,32632
210542,201909,6341,14989,5125,13641,322,560,4296,12133,4618,12693
210545,201909,2195,6901,2070,6689,48,200,1822,5812,1870,6012
210547,201909,3481,12607,3055,11755,311,1164,2193,8721,2504,9885
210550,201909,6133,18539,4885,16595,323,1234,3651,12703,3974,13937
210560,201909,3459,10689,3106,10115,120,401,2607,8455,2727,8856
210565,201909,1434,4827,1200,4471,63,349,944,3535,1007,3884
210570,201909,10463,28764,9289,27338,287,875,8266,24665,8553,25540
210580,201909,2889,7913,2457,7394,163,326,1997,6298,2160,6624
210590,201909,4246,12797,3705,12085,78,425,3290,10673,3368,11098
210592,201909,2574,7653,2374,7315,31,155,2124,6474,2155,6629
210594,201909,2505,6776,1919,5874,90,261,1425,4508,1515,4769
210596,201909,2484,8924,2217,8378,128,539,1773,6747,1901,7286
210598,201909,1830,5357,1675,5124,34,152,1515,4591,1549,4743
210600,201909,3025,8107,2419,7242,83,208,1967,5998,2050,6206
210610,201909,2586,7463,2250,7050,60,306,1934,6000,1994,6306
210620,201909,2662,7277,2231,6753,52,146,2036,6276,2088,6422
210630,201909,3008,10204,2741,9775,123,617,2271,7973,2394,8590
210632,201909,4339,14184,3866,13486,240,1041,3047,10532,3287,11573
210635,201909,1755,6247,1649,6059,132,464,1345,5062,1477,5526
210637,201909,2314,7825,2049,7429,160,692,1540,5639,1700,6331
210640,201909,4632,16589,4390,16297,62,311,4142,15351,4204,15662
210650,201909,7308,20921,6654,20070,68,329,6183,18654,6251,18983
210660,201909,8113,24066,7163,22525,270,1053,6203,19273,6473,20326
210663,201909,2528,7497,2344,7279,117,290,2041,6493,2158,6783
210667,201909,1867,6159,1734,5965,43,183,1573,5441,1616,5624
210670,201909,4405,15130,4038,14545,129,648,3501,12514,3630,13162
210675,201909,5016,13674,4314,12743,212,514,3623,10938,3835,11452
210680,201909,4226,10738,3570,9923,117,206,3195,9086,3312,9292
210690,201909,7538,23589,6540,22450,246,1143,5759,19816,6005,20959
210700,201909,2672,7365,2159,6664,139,398,1673,5387,1812,5785
210710,201909,4941,15486,4342,14622,115,612,3810,12702,3925,13314
210720,201909,2860,9468,2606,9150,57,336,2345,8167,2402,8503
210725,201909,1320,4470,1134,4179,45,195,809,3103,854,3298
210730,201909,1176,3153,981,2881,58,153,805,2371,863,2524
210735,201909,4584,13695,3912,12780,210,690,3327,11083,3537,11773
210740,201909,5166,13999,4513,13271,110,392,3764,11009,3874,11401
210745,201909,4374,11987,4041,11544,128,370,3677,10503,3805,10873
210750,201909,22392,57193,19449,53515,1534,4018,13774,39834,15308,43852
210760,201909,5804,15510,5014,14659,29,71,4773,14068,4802,14139
210770,201909,6081,15732,5259,14791,52,229,4936,13815,4988,14044
210780,201909,7032,22846,6241,21510,532,1696,4905,17237,5437,18933
210790,201909,4338,13602,3923,13042,224,618,3158,11118,3382,11736
210800,201909,4869,12963,4165,12025,61,243,3776,10776,3837,11019
210805,201909,3884,14281,3719,14035,110,609,3316,12416,3426,13025
210810,201909,4821,14168,4395,13623,218,494,3783,12020,4001,12514
210820,201909,6808,19523,5688,17714,700,2244,3472,11094,4172,13338
210825,201909,6698,20764,6095,19964,237,823,5312,17564,5549,18387
210830,201909,7498,21455,6928,20750,407,949,5971,18356,6378,19305
210840,201909,3210,8557,2863,8072,66,228,2544,7054,2610,7282
210845,201909,6417,17530,5796,16845,22,72,5617,16376,5639,16448
210850,201909,5777,19885,4906,18545,248,1228,3866,14647,4114,15875
210860,201909,20573,53632,17235,49411,766,1983,14002,42032,14768,44015
210870,201909,6990,18766,5729,17288,211,623,5010,15177,5221,15800
210880,201909,4293,13233,3884,12753,196,739,3215,10567,3411,11306
210890,201909,3931,11669,3534,11197,233,614,2899,9473,3132,10087
210900,201909,4368,12877,3312,10894,1353,4737,530,1962,1883,6699
210905,201909,1951,5465,1638,5048,45,84,1493,4702,1538,4786
210910,201909,7083,21547,5946,19728,852,2869,3865,12931,4717,15800
210920,201909,3253,10696,2817,10115,78,447,2520,8959,2598,9406
210923,201909,1430,4439,1250,4131,56,206,952,3148,1008,3354
210927,201909,5213,16470,4577,15738,199,743,3893,13597,4092,14340
210930,201909,2448,8479,2161,7928,166,710,1642,5976,1808,6686
210940,201909,4005,11375,3749,11065,107,436,3434,10008,3541,10444
210945,201909,6148,18072,5555,17360,232,702,4761,15131,4993,15833
210950,201909,5009,14296,3850,12642,594,1585,2557,9065,3151,10650
210955,201909,1530,4907,1326,4546,141,487,944,3305,1085,3792
210960,201909,8780,26502,7589,24727,1216,3675,4904,16751,6120,20426
210970,201909,1256,3906,1002,3473,47,213,786,2636,833,2849
210975,201909,1645,5275,1471,4992,84,301,1168,3963,1252,4264
210980,201909,10013,23026,8702,21671,94,200,8235,20619,8329,20819
210990,201909,15450,44415,12293,40234,736,2669,9368,31092,10104,33761
211000,201909,14146,42230,11948,39607,618,2308,9769,33250,10387,35558
211003,201909,5495,16676,4643,15634,123,488,4035,13874,4158,14362
211010,201909,6424,23229,5807,22450,96,490,5267,20633,5363,21123
211020,201909,7796,23540,6901,22481,236,985,5997,19571,6233,20556
211023,201909,1923,6416,1832,6292,90,377,1556,5296,1646,5673
211027,201909,2935,9547,2823,9361,168,552,2473,8159,2641,8711
211030,201909,3852,10720,3436,10211,253,575,2790,8558,3043,9133
211040,201909,4504,16401,4196,15853,127,749,3727,13950,3854,14699
211050,201909,9042,23484,8222,22420,133,387,7590,20688,7723,21075
211060,201909,6817,20877,6274,20149,138,568,5772,18523,5910,19091
211065,201909,2134,6043,1764,5563,82,260,1457,4705,1539,4965
211070,201909,7120,23381,6168,21894,476,1729,4852,17393,5328,19122
211080,201909,1246,3495,988,3091,32,173,755,2225,787,2398
211085,201909,1976,5732,1698,5353,71,177,1492,4818,1563,4995
211090,201909,3162,8794,2839,8388,39,200,2620,7669,2659,7869
211100,201909,6696,17063,6196,16443,43,134,5705,15206,5748,15340
211102,201909,2932,10291,2708,9961,132,640,2352,8550,2484,9190
211105,201909,2301,7375,1919,6646,179,654,1360,4681,1539,5335
211107,201909,4467,14339,3835,13393,143,628,3152,11225,3295,11853
211110,201909,5812,16133,4495,14106,392,1155,3281,10512,3673,11667
211120,201909,42460,106551,36448,99617,4831,12257,23573,68850,28404,81107
211125,201909,2053,6090,1724,5582,40,158,1453,4713,1493,4871
211130,201909,190547,456160,169037,428499,24501,61701,74702,216921,99203,278622
211140,201909,4864,14639,4283,13855,197,595,3656,11867,3853,12462
211150,201909,9224,25473,7860,23671,339,1002,6631,20075,6970,21077
211153,201909,2462,7250,1974,6649,281,1022,1292,4554,1573,5576
211157,201909,1062,3404,881,3083,34,179,647,2235,681,2414
211160,201909,3875,11249,3079,10051,151,608,2309,7417,2460,8025
211163,201909,1675,5285,1535,5085,24,123,1384,4641,1408,4764
211167,201909,1524,4897,1428,4740,30,148,1314,4324,1344,4472
211170,201909,6365,15699,5948,15219,41,139,5674,14449,5715,14588
211172,201909,2372,6588,2032,6070,97,324,1658,4792,1755,5116
211174,201909,2810,8253,2555,7959,48,249,2349,7273,2397,7522
211176,201909,4200,12076,3236,10649,165,692,2576,8430,2741,9122
211178,201909,4627,10797,3965,10069,36,154,3751,9436,3787,9590
211180,201909,3903,13062,3623,12640,193,755,3095,10794,3288,11549
211190,201909,2989,8944,2558,8289,31,173,2227,7160,2258,7333
211195,201909,1304,3802,1121,3522,45,119,955,3058,1000,3177
211200,201909,2011,5813,1619,5299,192,626,1155,3855,1347,4481
211210,201909,6287,19173,5702,18399,266,1050,4928,15788,5194,16838
211220,201909,35279,90395,28898,82543,2677,7367,21465,62773,24142,70140
211223,201909,4995,13414,4223,12365,397,1168,3159,9285,3556,10453
211227,201909,1729,5838,1567,5601,37,183,1393,5044,1430,5227
211230,201909,7094,21257,6275,19988,389,1142,5077,16393,5466,17535
211240,201909,8076,25865,7625,25273,147,796,7042,23073,7189,23869
211245,201909,6769,17358,6195,16766,71,205,6006,16259,6077,16464
211250,201909,13065,40450,11826,38864,521,2221,9917,32172,10438,34393
211260,201909,7766,25500,7052,24524,196,907,6365,22197,6561,23104
211270,201909,10341,33258,8930,31315,378,1747,7319,25753,7697,27500
211280,201909,12542,35264,11165,33539,938,2297,8957,28072,9895,30369
211285,201909,1696,5699,1483,5388,166,667,991,3695,1157,4362
211290,201909,7250,22213,6625,21341,168,750,5754,18399,5922,19149
211300,201909,7851,22284,7006,21138,153,545,6254,18773,6407,19318
211400,201909,11152,32449,9135,29609,1095,3556,6143,20845,7238,24401
220005,201909,1790,4813,1625,4573,38,156,1364,3759,1402,3915
220010,201909,1461,4193,1211,3748,31,132,931,2843,962,2975
220020,201909,3384,9714,2944,9057,167,609,2377,7211,2544,7820
220025,201909,2218,5083,1888,4578,23,60,1579,3706,1602,3766
220027,201909,1225,3165,1057,2947,19,64,900,2457,919,2521
220030,201909,3223,8301,3026,8025,82,250,2674,6988,2756,7238
220040,201909,6831,20832,6031,19287,1340,3968,3378,11293,4718,15261
220045,201909,1445,4464,1200,4035,35,178,970,3203,1005,3381
220050,201909,4562,12677,3877,11728,79,398,3526,10479,3605,10877
220060,201909,2387,5053,2014,4619,25,56,1899,4337,1924,4393
220070,201909,2459,6260,2102,5733,77,165,1723,4701,1800,4866
220080,201909,673,1936,576,1792,29,121,495,1505,524,1626
220090,201909,1735,4254,1443,3848,19,66,1210,3323,1229,3389
220095,201909,636,1631,604,1597,22,34,549,1462,571,1496
220100,201909,1355,3751,1085,3313,48,175,864,2565,912,2740
220105,201909,1959,6162,1710,5658,148,514,1252,4162,1400,4676
220110,201909,3374,9335,3149,8922,45,220,2825,7877,2870,8097
220115,201909,2604,7699,2403,7409,67,258,2179,6630,2246,6888
220117,201909,1345,3265,1032,2822,13,55,865,2319,878,2374
220120,201909,12393,33905,11357,32578,92,342,10694,30613,10786,30955
220130,201909,1075,2953,904,2714,18,101,810,2386,828,2487
220140,201909,2007,4276,1720,3930,123,325,1476,3293,1599,3618
220150,201909,6272,18768,5807,18011,134,677,4917,14893,5051,15570
220155,201909,1114,3249,886,2823,26,101,640,2000,666,2101
220157,201909,1035,2556,877,2310,18,81,710,1794,728,1875
220160,201909,2747,7739,2366,7052,35,178,1970,5753,2005,5931
220170,201909,1514,4016,1269,3651,11,60,1141,3237,1152,3297
220173,201909,2065,5803,1591,4926,40,178,1314,3943,1354,4121
220177,201909,1956,5600,1858,5487,11,39,1826,5392,1837,5431
220180,201909,1095,2720,885,2355,2,12,687,1706,689,1718
220190,201909,6464,16726,5427,15276,355,1143,4117,11556,4472,12699
220191,201909,1425,4474,1298,4244,68,270,968,3063,1036,3333
220192,201909,1835,4959,1422,4223,32,114,1163,3391,1195,3505
220194,201909,1664,4813,1480,4498,66,261,1211,3600,1277,3861
220196,201909,1880,5032,1708,4756,31,141,1450,3939,1481,4080
220198,201909,1274,3522,1068,3256,10,38,982,3019,992,3057
220200,201909,5026,14566,4360,13686,150,576,3661,11487,3811,12063
220202,201909,2145,6054,1839,5551,31,158,1578,4672,1609,4830
220205,201909,2501,7130,2223,6650,52,228,1880,5497,1932,5725
220207,201909,765,2298,629,2062,63,226,399,1308,462,1534
220208,201909,1639,5114,1336,4507,176,643,758,2509,934,3152
220209,201909,1566,4484,1355,4123,27,119,1096,3298,1123,3417
220210,201909,1606,4069,1377,3703,21,78,1163,3069,1184,3147
220211,201909,1568,4069,1448,3901,20,76,1260,3413,1280,3489
220213,201909,1732,4658,1497,4218,31,117,1216,3317,1247,3434
220217,201909,2049,6236,1935,6112,30,88,1814,5791,1844,5879
220220,201909,10087,26660,8303,23841,503,1310,5846,17350,6349,18660
220225,201909,1034,2712,836,2462,7,37,767,2228,774,2265
220230,201909,5738,14175,4915,13040,190,480,4203,11167,4393,11647
220240,201909,2855,8417,2609,7971,111,362,2109,6456,2220,6818
220245,201909,1649,4005,1291,3552,9,48,1178,3263,1187,3311
220250,201909,2983,8307,2611,7825,18,100,2427,7230,2445,7330
220253,201909,1584,4336,1370,3967,73,250,1135,3181,1208,3431
220255,201909,1824,4461,1528,4019,42,189,1281,3220,1323,3409
220260,201909,4205,13002,3658,12039,162,628,2937,9627,3099,10255
220265,201909,1208,3946,1092,3774,39,180,919,3098,958,3278
220270,201909,6285,19777,5881,19035,217,1038,4936,15412,5153,16450
220271,201909,1439,3711,1249,3448,26,101,1110,3051,1136,3152
220272,201909,1745,5015,1542,4636,76,236,1131,3308,1207,3544
220273,201909,1202,3446,994,3060,42,168,762,2293,804,2461
220275,201909,2247,5415,1758,4726,34,112,1530,4114,1564,4226
220277,201909,2098,5348,1803,4893,33,107,1533,4060,1566,4167
220280,201909,1611,3843,1323,3452,29,103,1140,2918,1169,3021
220285,201909,1415,3618,1192,3347,13,64,1082,2992,1095,3056
220290,201909,6083,17691,4810,15884,340,1259,3542,11887,3882,13146
220300,201909,1926,5653,1566,5164,39,241,1302,4202,1341,4443
220310,201909,2998,8093,2319,7294,43,211,1936,6045,1979,6256
220320,201909,2978,8850,2290,7532,102,460,1755,5591,1857,6051
220323,201909,1595,4718,1264,4167,58,237,1049,3394,1107,3631
220325,201909,1252,3708,1064,3386,27,137,876,2724,903,2861
220327,201909,1439,4143,1261,3842,52,221,1040,3085,1092,3306
220330,201909,4282,10424,3561,9537,71,213,3174,8421,3245,8634
220335,201909,1700,5083,1516,4857,24,90,1374,4390,1398,4480
220340,201909,1810,4781,1393,4090,52,179,966,2728,1018,2907
220342,201909,1121,3320,990,3116,44,218,781,2401,825,2619
220345,201909,3079,6973,2413,6015,15,54,2192,5429,2207,5483
220350,201909,3221,8312,2577,7338,135,416,1868,5284,2003,5700
220360,201909,1201,3082,944,2658,16,55,768,2138,784,2193
220370,201909,8618,24856,7799,23551,173,751,6845,20358,7018,21109
220375,201909,1577,4513,1400,4297,7,31,1326,4090,1333,4121
220380,201909,1494,3556,1201,3131,15,48,1056,2709,1071,2757
220385,201909,817,1955,653,1658,10,29,569,1429,579,1458
220390,201909,9364,24906,7189,21446,1847,5391,2854,9311,4701,14702
220400,201909,1459,3508,1097,2954,22,65,856,2250,878,2315
220410,201909,1118,3089,904,2729,48,149,734,2172,782,2321
220415,201909,795,2057,664,1840,20,60,530,1444,550,1504
220420,201909,1944,5389,1558,4659,47,138,1219,3592,1266,3730
220430,201909,2471,6697,2334,6496,81,261,2012,5525,2093,5786
220435,201909,1697,4419,1462,4072,44,154,1202,3274,1246,3428
220440,201909,2347,7439,2031,6932,112,465,1674,5611,1786,6076
220450,201909,2426,6336,1971,5763,84,294,1640,4799,1724,5093
220455,201909,1316,4039,1242,3939,19,91,1106,3493,1125,3584
220460,201909,932,2312,866,2233,27,79,754,1914,781,1993
220465,201909,2282,7133,2016,6711,165,560,1511,5103,1676,5663
220470,201909,3372,9459,3000,8861,83,235,2440,7114,2523,7349
220480,201909,2571,6772,2044,5902,160,413,1420,4072,1580,4485
220490,201909,2421,6183,2092,5749,29,143,1841,4976,1870,5119
220500,201909,2586,6855,2333,6451,44,177,1946,5186,1990,5363
220510,201909,2505,7107,1966,6131,85,264,1540,4811,1625,5075
220515,201909,1612,3919,1467,3713,32,59,1289,3248,1321,3307
220520,201909,4843,12628,4358,11931,104,300,3805,10350,3909,10650
220525,201909,1271,3239,1104,3023,12,60,1010,2721,1022,2781
220527,201909,1306,3657,1116,3376,13,51,959,2949,972,3000
220530,201909,1403,3512,1203,3253,32,112,1109,2945,1141,3057
220535,201909,781,2203,728,2133,37,133,590,1698,627,1831
220540,201909,3200,10233,3014,9887,116,426,2566,8365,2682,8791
220545,201909,1341,4157,1243,3995,65,264,1033,3268,1098,3532
220550,201909,8394,25785,7484,24258,482,1706,5683,18241,6165,19947
220551,201909,1383,3971,1204,3656,28,118,993,2956,1021,3074
220552,201909,1561,4532,1270,4010,38,188,1006,3057,1044,3245
220553,201909,1591,4308,1385,4021,51,116,1117,3330,1168,3446
220554,201909,863,2300,624,1891,52,125,408,1241,460,1366
220555,201909,2163,6625,1965,6336,46,218,1604,5270,1650,5488
220556,201909,1176,3452,1015,3123,64,262,716,2085,780,2347
220557,201909,1585,4847,1329,4329,71,266,971,3059,1042,3325
220558,201909,1375,3570,1065,3134,22,90,919,2676,941,2766
220559,201909,1632,4198,1383,3809,6,23,1111,3100,1117,3123
220560,201909,1741,3935,1394,3487,34,69,1259,3164,1293,3233
220570,201909,7061,21180,6426,20286,430,1401,5109,16156,5539,17557
220580,201909,6869,19001,6305,18077,94,357,5699,16193,5793,16550
220585,201909,1955,6226,1675,5710,45,155,1371,4710,1416,4865
220590,201909,1291,3567,1056,3205,81,256,759,2296,840,2552
220595,201909,2475,6782,2236,6457,23,104,2004,5732,2027,5836
220600,201909,1378,3088,1155,2805,99,138,958,2403,1057,2541
220605,201909,1618,4704,1368,4260,20,119,1100,3328,1120,3447
220610,201909,2685,7979,2522,7752,27,117,2357,7230,2384,7347
220620,201909,7847,24293,7209,23435,204,1063,6520,20869,6724,21932
220630,201909,358,1068,271,904,25,87,173,585,198,672
220635,201909,1583,5054,1399,4652,52,253,1056,3410,1108,3663
220640,201909,2497,6850,2121,6301,87,345,1711,5006,1798,5351
220650,201909,1981,5483,1701,5032,27,93,1391,4105,1418,4198
220660,201909,2609,8164,2243,7532,98,482,1830,5981,1928,6463
220665,201909,1234,3777,1045,3459,35,183,851,2748,886,2931
220667,201909,1585,4980,1412,4646,64,265,1135,3698,1199,3963
220669,201909,1642,5021,1574,4913,61,287,1364,4148,1425,4435
220670,201909,2177,5716,1721,5066,22,86,1483,4353,1505,4439
220672,201909,3156,7746,2536,7000,113,342,2209,6046,2322,6388
220675,201909,1198,3293,1088,3097,40,121,891,2514,931,2635
220680,201909,2637,7277,2509,7090,100,238,2285,6489,2385,6727
220690,201909,1483,3967,1319,3719,83,235,1042,2940,1125,3175
220695,201909,848,2383,790,2265,20,64,684,1959,704,2023
220700,201909,9444,23536,7504,20820,341,1023,5804,15926,6145,16949
220710,201909,882,2462,655,2021,27,101,499,1499,526,1600
220720,201909,2107,4975,1893,4681,17,68,1635,3980,1652,4048
220730,201909,1274,3598,1072,3261,18,98,919,2721,937,2819
220735,201909,947,2225,719,1865,13,48,613,1537,626,1585
220740,201909,1362,3612,1078,3246,35,102,904,2750,939,2852
220750,201909,3777,9663,3298,8961,216,511,2847,7785,3063,8296
220755,201909,1223,3076,1013,2746,32,112,800,2089,832,2201
220760,201909,3014,8536,2632,8015,91,304,2319,7129,2410,7433
220770,201909,20924,63624,17614,57805,5717,19623,6272,21219,11989,40842
220775,201909,1098,2852,1012,2744,12,52,975,2626,987,2678
220777,201909,1626,4133,1230,3511,32,78,933,2659,965,2737
220779,201909,1301,3237,1129,2996,22,71,986,2598,1008,2669
220780,201909,5441,13947,4763,12890,219,720,3921,10330,4140,11050
220785,201909,1464,3238,1288,3008,9,20,1245,2895,1254,2915
220790,201909,9866,28345,8899,26944,236,1114,7486,22306,7722,23420
220793,201909,894,2361,708,2031,17,43,581,1691,598,1734
220795,201909,1361,3567,1211,3371,17,58,1080,3005,1097,3063
220800,201909,17142,39052,14400,35292,671,1629,11066,26883,11737,28512
220810,201909,2886,8113,2447,7310,46,158,2031,5981,2077,6139
220820,201909,5024,13075,4302,12036,339,805,3210,9017,3549,9822
220830,201909,7114,19001,6394,17982,243,788,5385,14954,5628,15742
220840,201909,11911,36735,9927,32596,2347,7356,4661,15957,7008,23313
220850,201909,3119,9667,2772,9226,70,372,2439,8073,2509,8445
220855,201909,650,1689,562,1551,12,57,501,1358,513,1415
220860,201909,997,2493,853,2259,20,78,754,1960,774,2038
220865,201909,2488,6575,1923,5603,87,294,1437,4080,1524,4374
220870,201909,2863,8114,2381,7483,40,190,2179,6805,2219,6995
220880,201909,5251,12478,4530,11591,84,319,4148,10463,4232,10782
220885,201909,1371,4244,1127,3840,56,240,900,3073,956,3313
220887,201909,1503,3295,1240,2948,7,27,1162,2731,1169,2758
220890,201909,1394,4337,1201,4019,49,175,984,3318,1033,3493
220900,201909,2003,4833,1661,4376,29,74,1460,3813,1489,3887
220910,201909,1472,4112,1245,3776,62,200,1021,3081,1083,3281
220915,201909,933,2517,728,2125,7,28,565,1583,572,1611
220920,201909,1325,4383,1133,4113,72,338,922,3323,994,3661
220930,201909,1626,4514,1401,4174,25,89,1288,3807,1313,3896
220935,201909,1053,3019,838,2572,27,106,566,1634,593,1740
220937,201909,1331,3571,1140,3267,21,79,937,2651,958,2730
220940,201909,1479,4215,1176,3653,40,148,887,2714,927,2862
220945,201909,425,1490,368,1360,18,101,271,971,289,1072
220950,201909,1409,3266,891,2435,15,54,710,1868,725,1922
220955,201909,1573,4085,1318,3642,40,128,1100,2991,1140,3119
220960,201909,819,2096,617,1760,13,51,466,1272,479,1323
220965,201909,1746,4822,1523,4494,23,144,1317,3784,1340,3928
220970,201909,1856,4548,1357,3787,38,97,1122,3096,1160,3193
220975,201909,676,2011,582,1892,19,112,515,1605,534,1717
220980,201909,1138,3200,1010,3025,31,125,848,2513,879,2638
220985,201909,1177,3175,1035,2956,44,149,829,2278,873,2427
220987,201909,1418,4238,1226,3894,56,238,988,3081,1044,3319
220990,201909,1674,4634,1472,4333,21,116,1237,3571,1258,3687
220995,201909,1062,3236,848,2841,40,152,628,2089,668,2241
220997,201909,2386,7075,2194,6778,47,222,1978,6029,2025,6251
221000,201909,4163,11642,3788,11103,101,496,3253,9336,3354,9832
221005,201909,1458,3870,1332,3657,30,142,1151,3029,1181,3171
221010,201909,1178,2756,947,2468,26,64,822,2097,848,2161
221020,201909,1474,4512,1365,4299,21,96,1063,3301,1084,3397
221030,201909,1584,4015,1353,3725,29,95,1180,3266,1209,3361
221035,201909,1465,3833,1260,3557,22,40,1107,3214,1129,3254
221037,201909,640,1811,532,1616,9,41,368,1065,377,1106
221038,201909,508,1436,397,1218,17,59,280,850,297,909
221039,201909,852,2329,731,2116,17,72,603,1677,620,1749
221040,201909,3988,12015,3487,11112,153,553,2772,8799,2925,9352
221050,201909,3795,10103,3335,9507,60,238,3011,8519,3071,8757
221060,201909,8255,22916,6817,20663,233,691,5567,16962,5800,17653
221062,201909,1138,3732,969,3431,40,193,788,2737,828,2930
221063,201909,1022,2896,860,2656,65,227,647,1971,712,2198
221065,201909,2556,6631,2255,6092,23,101,1979,5238,2002,5339
221070,201909,3186,10096,2650,8986,295,992,1668,5765,1963,6757
221080,201909,3480,8505,2805,7492,57,220,2324,6093,2381,6313
221090,201909,1391,3628,1122,3154,11,46,966,2649,977,2695
221093,201909,1304,3692,1203,3478,117,337,841,2389,958,2726
221095,201909,886,2309,736,2071,8,25,611,1684,619,1709
221097,201909,807,2128,614,1774,21,70,457,1261,478,1331
221100,201909,105370,283150,88714,255753,10382,31750,58127,163673,68509,195423
221110,201909,9709,29008,8928,28002,160,813,8017,24827,8177,25640
221120,201909,4536,12773,4045,11953,174,557,3483,10240,3657,10797
221130,201909,5056,13355,3732,10736,761,2092,1788,5196,2549,7288
221135,201909,1561,4238,1405,4022,38,140,1245,3536,1283,3676
221140,201909,1286,3084,1088,2821,10,37,967,2448,977,2485
221150,201909,1070,2653,840,2250,19,87,662,1654,681,1741
221160,201909,730,1811,633,1682,19,37,525,1398,544,1435
221170,201909,957,2779,877,2636,21,68,753,2255,774,2323
230010,201909,3072,8038,2458,6978,55,184,1940,5398,1995,5582
230015,201909,2919,9550,2578,8860,182,741,1803,6141,1985,6882
230020,201909,12690,40246,11908,39009,353,1546,10079,32656,10432,34202
230030,201909,12620,31955,10631,29301,198,613,9346,25702,9544,26315
230040,201909,4444,11522,3686,10282,63,296,3054,8362,3117,8658
230050,201909,2753,8627,2045,6915,321,1045,895,2938,1216,3983
230060,201909,2284,6252,1825,5427,39,174,1461,4263,1500,4437
230070,201909,3775,10174,3040,8725,150,459,2117,6016,2267,6475
230075,201909,8991,29146,8225,27785,426,1913,6616,21925,7042,23838
230080,201909,3031,6335,2306,5435,6,23,2097,4948,2103,4971
230090,201909,4189,10438,3528,9361,146,408,2830,7451,2976,7859
230100,201909,17488,46229,15503,43457,1248,3658,10975,30815,12223,34473
230110,201909,12368,36837,10505,33107,1714,5357,5679,17953,7393,23310
230120,201909,7147,19584,6304,18180,508,1336,4653,13601,5161,14937
230125,201909,3075,8182,2501,7250,65,237,1950,5582,2015,5819
230130,201909,5555,17239,4512,14922,318,1122,3054,9927,3372,11049
230140,201909,3359,10127,2862,9102,105,427,2190,6773,2295,7200
230150,201909,1550,4661,1284,4054,204,548,756,2476,960,3024
230160,201909,6383,16735,5476,15318,203,735,4430,12109,4633,12844
230170,201909,6031,17292,4973,15126,302,930,3614,10794,3916,11724
230180,201909,1617,4487,1365,4002,26,113,1099,3110,1125,3223
230185,201909,4202,12158,3557,11069,246,842,2638,8191,2884,9033
230190,201909,12741,37335,10779,33679,1562,5069,6024,18728,7586,23797
230195,201909,5150,15256,4676,14370,338,1053,3579,10936,3917,11989
230200,201909,4904,13552,4129,12049,141,479,3171,9051,3312,9530
230205,201909,3916,11979,3493,11304,155,616,2656,8452,2811,9068
230210,201909,10201,24694,8568,22448,354,1157,6724,17273,7078,18430
230220,201909,13292,33778,11783,31573,483,1367,9892,26223,10375,27590
230230,201909,6733,20388,6022,18898,379,1220,4467,13939,4846,15159
230240,201909,12405,33465,10909,30976,279,1110,9077,25294,9356,26404
230250,201909,8708,24848,8241,24091,250,910,6585,18693,6835,19603
230260,201909,14231,43073,12373,39694,1548,4937,7244,23608,8792,28545
230270,201909,7299,20003,5610,16803,476,1420,3758,11276,4234,12696
230280,201909,20242,54095,16394,47556,502,2126,12963,36170,13465,38296
230290,201909,4733,13217,3972,11759,292,769,2970,8823,3262,9592
230300,201909,4688,12691,4278,12103,90,306,3746,10489,3836,10795
230310,201909,4559,13007,3840,11733,135,579,2787,8276,2922,8855
230320,201909,7587,21936,6435,19793,268,1075,4907,14774,5175,15849
230330,201909,4564,12537,3697,10857,165,545,2760,7938,2925,8483
230340,201909,3521,11030,2991,9953,272,944,1999,6575,2271,7519
230350,201909,17154,47901,15140,44818,904,3150,10059,29973,10963,33123
230360,201909,2753,7552,2204,6551,139,405,1479,4357,1618,4762
230365,201909,3014,7515,2491,6718,45,228,2108,5607,2153,5835
230370,201909,55682,157182,47318,144330,7519,23194,27483,85446,35002,108640
230380,201909,6327,17664,4972,15095,135,537,3650,10860,3785,11397
230390,201909,3295,9839,2861,9132,112,484,2207,6952,2319,7436
230393,201909,3068,9275,2472,8069,80,444,1900,5932,1980,6376
230395,201909,5790,15792,5037,14497,349,947,3504,10116,3853,11063
230400,201909,5536,15398,4894,14320,114,580,3903,11057,4017,11637
230410,201909,14170,42036,11587,37185,958,3322,7796,24906,8754,28228
230420,201909,27581,76713,22438,67467,2811,8836,12569,37570,15380,46406
230423,201909,4650,13811,4036,12572,87,388,3259,9962,3346,10350
230425,201909,5426,16911,4925,15862,394,1360,3542,11319,3936,12679
230426,201909,2688,7156,1949,5691,34,130,1461,4177,1495,4307
230427,201909,1855,5245,1298,4031,69,234,878,2621,947,2855
230428,201909,9216,24973,7976,23080,1111,3239,4741,13588,5852,16827
230430,201909,4776,13589,3802,11900,151,546,2880,8854,3031,9400
230435,201909,5519,14684,4648,13185,538,1496,2961,8394,3499,9890
230440,201909,396770,994841,328224,891516,36323,104419,206326,554184,242649,658603
230445,201909,4227,11255,3403,9804,189,537,2323,6571,2512,7108
230450,201909,3519,10270,3054,9555,252,1016,2215,6706,2467,7722
230460,201909,2098,5871,1829,5442,68,270,1518,4494,1586,4764
230465,201909,3905,11005,3317,9890,95,410,2486,7105,2581,7515
230470,201909,10804,36195,9756,34191,814,3398,7027,24166,7841,27564
230480,201909,1397,4076,1167,3655,87,348,831,2495,918,2843
230490,201909,2431,6793,2051,6085,166,535,1303,3665,1469,4200
230495,201909,5717,17044,5006,15740,369,1424,3298,10241,3667,11665
230500,201909,9054,29346,8207,27779,271,1140,6693,22535,6964,23675
230510,201909,1608,4978,1212,4085,192,695,570,1889,762,2584
230520,201909,4455,12697,3841,11567,309,884,2703,8125,3012,9009
230523,201909,14339,42640,11453,36378,2678,8455,3135,10556,5813,19011
230526,201909,3753,10722,3161,9660,163,526,2342,7149,2505,7675
230530,201909,5297,16511,4455,14848,314,1171,3198,10555,3512,11726
230533,201909,4134,10331,3512,9303,91,259,2908,7609,2999,7868
230535,201909,5149,14411,4368,13079,207,666,3133,9445,3340,10111
230540,201909,15844,43416,13698,40171,244,1034,11436,33094,11680,34128
230550,201909,20080,53862,16128,46999,1472,4437,10244,29618,11716,34055
230560,201909,7921,19482,6312,16882,55,241,5484,14522,5539,14763
230565,201909,2988,8364,2487,7425,83,363,1880,5499,1963,5862
230570,201909,3448,8787,2944,8119,66,215,2470,6772,2536,6987
230580,201909,10491,27602,9024,25500,327,1011,7543,21142,7870,22153
230590,201909,8774,25207,7245,22358,426,1548,5304,15810,5730,17358
230600,201909,3635,9529,2809,8027,87,289,1937,5558,2024,5847
230610,201909,6468,17935,5734,16723,450,1293,4518,13128,4968,14421
230620,201909,2075,5637,1557,4599,118,378,960,2750,1078,3128
230625,201909,7547,21734,6330,19468,1924,6135,1738,5716,3662,11851
230630,201909,10446,31355,9070,28514,1649,4915,4935,16025,6584,20940
230640,201909,27231,82665,24535,78292,1381,5452,19315,60713,20696,66165
230650,201909,5120,14052,4327,12632,147,635,3459,9804,3606,10439
230655,201909,9201,31408,8668,30454,626,2321,6873,24346,7499,26667
230660,201909,5986,17809,4875,15797,165,863,3954,12528,4119,13391
230670,201909,6030,14523,4426,11895,130,430,3566,9350,3696,9780
230680,201909,2543,7028,2161,6345,139,412,1547,4565,1686,4977
230690,201909,6961,20771,6050,18924,412,1455,3811,11673,4223,13128
230700,201909,9504,24543,7956,21726,318,917,6031,16107,6349,17024
230710,201909,6555,20807,5706,19007,588,2047,3891,12741,4479,14788
230720,201909,1914,5648,1530,4847,125,380,1010,3125,1135,3505
230725,201909,3822,11639,3396,10818,403,1415,1889,5917,2292,7332
230730,201909,54349,149030,42622,130466,9691,32063,14261,45648,23952,77711
230740,201909,5946,16641,5077,15221,122,493,4104,12193,4226,12686
230750,201909,8256,22189,6848,19823,169,639,5412,15217,5581,15856
230760,201909,10825,28915,9512,26881,565,1871,7107,19577,7672,21448
230763,201909,4615,12885,3885,11509,137,605,3093,8859,3230,9464
230765,201909,39046,107180,32420,96272,5388,16652,15707,46450,21095,63102
230770,201909,24763,61919,20746,56484,2221,6232,13625,37109,15846,43341
230780,201909,5987,21349,5526,20302,778,2924,3297,12379,4075,15303
230790,201909,2914,8516,2600,7991,111,491,1950,5828,2061,6319
230800,201909,7664,24607,6802,22835,779,2890,4157,13672,4936,16562
230810,201909,11463,34258,10181,32159,406,1561,7814,24183,8220,25744
230820,201909,3268,10747,2722,9484,271,1121,1637,5410,1908,6531
230830,201909,7499,20488,6350,18520,156,681,5214,14814,5370,15495
230835,201909,4175,10047,3158,8405,73,221,2607,6820,2680,7041
230837,201909,3072,9484,2638,8693,107,519,2117,6757,2224,7276
230840,201909,8621,25579,7470,23688,635,1992,5490,17548,6125,19540
230850,201909,9324,27346,7836,24343,363,1336,5613,17191,5976,18527
230860,201909,4970,12879,4181,11710,73,268,3672,10194,3745,10462
230870,201909,16176,39839,13876,35993,409,1129,11307,29026,11716,30155
230880,201909,2065,6355,1875,6023,53,292,1473,4590,1526,4882
230890,201909,4492,14483,4092,13677,339,1276,2945,9645,3284,10921
230900,201909,2893,8408,2473,7585,186,655,1659,4945,1845,5600
230910,201909,2956,8046,2406,7151,65,320,1952,5720,2017,6040
230920,201909,4444,12718,3744,11578,147,604,2894,8714,3041,9318
230930,201909,6313,17853,5284,15939,311,952,3699,11126,4010,12078
230940,201909,7675,20025,6691,18512,193,532,5640,15484,5833,16016
230945,201909,6457,18640,5519,16782,344,1202,3867,11583,4211,12785
230950,201909,6223,15671,5526,14746,120,275,4869,13113,4989,13388
230960,201909,12576,37047,11156,34371,1676,5228,5846,18199,7522,23427
230970,201909,12929,34766,10793,31398,1782,5240,5837,17209,7619,22449
230980,201909,2646,7781,2303,7159,396,1187,1393,4456,1789,5643
230990,201909,1640,4631,1368,4086,65,271,951,2711,1016,2982
231000,201909,2407,6444,1988,5622,73,198,1457,4036,1530,4234
231010,201909,3292,7873,2657,6792,51,185,2283,5657,2334,5842
231020,201909,7889,25257,7050,23524,1309,4098,4004,13865,5313,17963
231025,201909,7251,20377,6331,18856,777,2279,4328,13024,5105,15303
231030,201909,7142,21433,5603,18121,901,2859,2961,9600,3862,12459
231040,201909,2910,8501,2540,7815,109,360,1992,6037,2101,6397
231050,201909,11519,30038,9185,25821,659,1854,6772,18584,7431,20438
231060,201909,2743,7859,2407,7298,64,244,1963,5905,2027,6149
231070,201909,7762,22702,6545,20544,776,2511,4085,12727,4861,15238
231080,201909,3892,11222,3351,10314,131,588,2542,7655,2673,8243
231085,201909,6435,15988,5156,14417,217,570,4004,11176,4221,11746
231090,201909,4347,11425,3185,9128,97,384,2219,6122,2316,6506
231095,201909,2197,6596,1735,5574,138,460,1176,3762,1314,4222
231100,201909,3009,8818,2486,7826,130,475,1869,5831,1999,6306
231110,201909,3428,10240,3139,9697,121,461,2385,7237,2506,7698
231120,201909,2142,6355,1800,5762,86,333,1268,3997,1354,4330
231123,201909,1856,4838,1537,4282,75,183,1132,3143,1207,3326
231126,201909,5339,14863,4251,12764,234,726,3131,9237,3365,9963
231130,201909,20447,53322,17045,48927,1057,3894,12470,35024,13527,38918
231135,201909,4047,11425,3364,10093,140,507,2442,7178,2582,7685
231140,201909,16365,46429,13086,40500,608,2575,9128,27426,9736,30001
231150,201909,5466,15206,4246,12805,691,2113,1937,5955,2628,8068
231160,201909,5973,18294,5262,16956,809,2473,3007,9969,3816,12442
231170,201909,4309,12762,3518,11189,190,687,2431,7471,2621,8158
231180,201909,13822,39645,11296,34195,3021,8911,4006,12442,7027,21353
231190,201909,3739,10630,3118,9465,76,341,2427,7157,2503,7498
231195,201909,4617,14215,3871,12671,207,804,2875,9223,3082,10027
231200,201909,7660,24217,6650,22104,237,1171,5176,16658,5413,17829
231210,201909,4741,14037,4021,12793,194,730,3016,9379,3210,10109
231220,201909,11612,30577,9010,25571,443,1373,6627,18128,7070,19501
231230,201909,9080,29075,8035,27206,443,1823,5985,20194,6428,22017
231240,201909,10930,32289,9635,29800,1519,4634,5765,18013,7284,22647
231250,201909,2054,5323,1317,3674,95,272,795,2157,890,2429
231260,201909,3131,8982,2710,8311,267,789,1851,5815,2118,6604
231270,201909,6337,16621,5172,14693,139,546,3944,10958,4083,11504
231280,201909,1636,5182,1521,4965,91,313,1148,3712,1239,4025
231290,201909,36572,109783,30527,97222,5209,16510,14257,45152,19466,61662
231300,201909,3934,10993,3085,9249,226,721,2018,5937,2244,6658
231310,201909,7107,18682,5667,15995,495,1433,3822,10584,4317,12017
231320,201909,7624,21063,5915,17977,95,455,4625,13843,4720,14298
231325,201909,2455,6589,1982,5842,175,454,1314,3949,1489,4403
231330,201909,9371,28420,7700,25020,1418,4426,4090,13783,5508,18209
231335,201909,5737,15035,4832,13575,80,363,4248,11763,4328,12126
231340,201909,16886,52913,15078,49665,1329,4438,10856,36113,12185,40551
231350,201909,15552,42503,14132,40494,317,1140,12641,35824,12958,36964
231355,201909,4330,13021,3874,12181,239,833,2967,9234,3206,10067
231360,201909,7075,21513,6136,19861,299,1098,4831,15576,5130,16674
231370,201909,2173,5932,1720,5107,35,115,1330,3906,1365,4021
231375,201909,4337,13562,3943,12895,143,648,3265,10547,3408,11195
231380,201909,5885,15973,5328,15206,179,486,4350,12569,4529,13055
231390,201909,3317,9715,2966,9132,149,573,2173,6486,2322,7059
231395,201909,3833,11403,3180,10361,476,1525,1807,5999,2283,7524
231400,201909,9289,26910,7880,24288,294,1219,5990,18056,6284,19275
231410,201909,14463,45302,13036,42897,657,2513,10429,33835,11086,36348
240010,201909,2464,6611,1901,5554,200,635,1149,3264,1349,3899
240020,201909,11927,33924,10067,30574,690,2553,6662,19844,7352,22397
240030,201909,2755,6926,2526,6579,102,314,2187,5592,2289,5906
240040,201909,791,2273,644,1992,31,114,458,1357,489,1471
240050,201909,3106,8374,2566,7382,49,145,2022,5720,2071,5865
240060,201909,1360,3663,1131,3245,30,100,915,2574,945,2674
240070,201909,2062,6035,1902,5710,188,599,1410,4137,1598,4736
240080,201909,2834,7741,2359,6848,54,211,1834,5208,1888,5419
240090,201909,2211,5485,1789,4754,17,54,1504,3948,1521,4002
240100,201909,9642,24080,7692,20469,239,757,6039,15496,6278,16253
240110,201909,4263,12240,3636,11099,176,650,2665,7990,2841,8640
240120,201909,3297,9068,2512,8149,208,757,1743,5785,1951,6542
240130,201909,3579,7507,2997,6745,35,107,2740,6062,2775,6169
240140,201909,1802,5391,1536,4888,168,586,1036,3250,1204,3836
240145,201909,6448,18115,5296,16078,805,2491,3016,9201,3821,11692
240150,201909,868,2557,786,2388,52,184,611,1797,663,1981
240160,201909,1409,4292,1188,3869,49,237,875,2841,924,3078
240165,201909,945,2598,786,2282,45,140,623,1785,668,1925
240170,201909,2361,6507,1982,5810,202,662,1331,3775,1533,4437
240180,201909,2933,8709,2322,7474,542,1669,1085,3674,1627,5343
240185,201909,1191,3814,1081,3635,56,229,898,2974,954,3203
240190,201909,1009,2984,884,2768,24,107,743,2333,767,2440
240200,201909,10432,27165,8403,23619,889,2715,4827,13281,5716,15996
240210,201909,2938,7451,2537,6848,32,158,2148,5606,2180,5764
240220,201909,7208,21704,6453,20505,370,1638,4996,15464,5366,17102
240230,201909,5741,14705,4634,12810,208,585,3685,10167,3893,10752
240240,201909,1835,5312,1107,3499,125,421,407,1130,532,1551
240250,201909,2821,7569,2513,7120,117,327,2075,5885,2192,6212
240260,201909,13715,40678,11826,37366,1674,5038,7349,24280,9023,29318
240270,201909,2193,6556,1919,6129,103,333,1440,4686,1543,5019
240280,201909,1642,4221,1392,3820,50,144,1122,3026,1172,3170
240290,201909,1176,3418,955,2921,28,116,673,1931,701,2047
240300,201909,2165,5583,1535,4382,73,226,1005,2791,1078,3017
240310,201909,8364,22215,6607,19046,850,2575,3519,9979,4369,12554
240320,201909,2029,5531,1463,4414,31,143,1107,3170,1138,3313
240325,201909,29047,78950,22551,67363,4354,13579,9301,28135,13655,41714
240330,201909,1685,4592,1275,3808,45,155,885,2518,930,2673
240340,201909,1941,4511,1587,3961,60,145,1303,3191,1363,3336
240350,201909,2063,5373,1891,5181,22,92,1712,4684,1734,4776
240360,201909,8096,22768,7233,21385,891,2623,4968,14992,5859,17615
240370,201909,1884,5046,1449,4141,78,233,998,2785,1076,3018
240375,201909,864,2196,722,1927,24,92,588,1512,612,1604
240380,201909,2212,6292,1613,4957,139,411,973,2921,1112,3332
240390,201909,974,2423,661,1813,28,71,426,1097,454,1168
240400,201909,1361,3434,1065,2900,38,147,745,1914,783,2061
240410,201909,558,1715,466,1509,50,212,290,884,340,1096
240420,201909,4537,16030,3976,14761,476,2150,2301,8294,2777,10444
240430,201909,3258,8635,2745,7662,198,623,1995,5376,2193,5999
240440,201909,2521,5563,2114,4999,150,320,1669,3922,1819,4242
240450,201909,4357,12021,3422,10243,314,1056,2068,5955,2382,7011
240460,201909,2821,8130,2570,7725,263,836,1985,5955,2248,6791
240470,201909,3483,10496,2660,8789,449,1411,1407,4816,1856,6227
240480,201909,531,1482,366,1120,27,92,174,517,201,609
240485,201909,2061,5877,1687,5156,140,438,1149,3531,1289,3969
240490,201909,1652,4223,1289,3555,73,177,974,2694,1047,2871
240500,201909,2092,5662,1826,5230,76,233,1523,4331,1599,4564
240510,201909,1656,4369,1463,4093,74,277,1208,3273,1282,3550
240520,201909,1344,3403,1050,2990,44,156,808,2266,852,2422
240530,201909,2033,5991,1850,5683,113,349,1479,4529,1592,4878
240540,201909,2233,5603,1935,5132,60,134,1682,4433,1742,4567
240550,201909,678,1938,616,1818,24,99,490,1385,514,1484
240560,201909,3197,8390,2714,7733,292,758,1972,5707,2264,6465
240570,201909,2744,7210,1806,5113,265,780,753,1970,1018,2750
240580,201909,7864,23013,7029,21482,542,1635,5645,17283,6187,18918
240590,201909,694,1848,602,1690,14,50,461,1270,475,1320
240600,201909,1772,4789,1292,3779,48,162,868,2446,916,2608
240610,201909,4150,11297,3486,10059,132,450,2645,7478,2777,7928
240615,201909,1140,3082,902,2608,59,208,626,1711,685,1919
240620,201909,1834,5180,1553,4672,87,255,1241,3692,1328,3947
240630,201909,2018,5848,1818,5488,128,328,1292,4009,1420,4337
240640,201909,906,2456,714,2124,27,112,537,1560,564,1672
240650,201909,3893,10776,3403,9879,195,597,2640,7581,2835,8178
240660,201909,2977,7707,2641,7266,52,169,2399,6596,2451,6765
240670,201909,2377,6691,1932,5785,139,434,1266,3702,1405,4136
240680,201909,1595,4268,1262,3692,51,171,972,2759,1023,2930
240690,201909,947,2411,752,2078,14,64,606,1606,620,1670
240700,201909,2343,6829,1936,6076,62,240,1528,4696,1590,4936
240710,201909,15799,41214,13217,36670,1914,5181,7960,22167,9874,27348
240720,201909,5018,12613,4361,11641,416,1186,3155,8302,3571,9488
240725,201909,1095,3154,841,2625,33,118,568,1720,601,1838
240730,201909,2106,5973,1764,5306,65,235,1346,3959,1411,4194
240740,201909,1789,4814,1462,4197,43,175,1077,2920,1120,3095
240750,201909,2144,7118,1789,6360,260,1018,967,3470,1227,4488
240760,201909,1525,3699,1072,3002,51,103,835,2383,886,2486
240770,201909,3158,8726,2664,8008,128,507,2134,6278,2262,6785
240780,201909,4872,13337,3896,11713,490,1482,2422,7435,2912,8917
240790,201909,840,2401,691,2105,12,51,521,1546,533,1597
240800,201909,44074,108171,34283,93016,4743,13327,17544,47544,22287,60871
240810,201909,82449,217616,70167,196716,10165,28946,42915,119121,53080,148067
240820,201909,5618,16916,4833,15486,671,2156,2986,9704,3657,11860
240830,201909,8547,24741,7694,23404,257,1142,6333,18944,6590,20086
240840,201909,1126,2825,886,2417,32,91,628,1640,660,1731
240850,201909,1241,3424,894,2683,38,125,520,1508,558,1633
240860,201909,1228,3338,918,2771,17,77,684,1961,701,2038
240870,201909,1102,2816,839,2346,124,360,476,1325,600,1685
240880,201909,1258,3980,1116,3702,77,326,881,2856,958,3182
240890,201909,4406,12071,3299,9919,466,1531,1663,4788,2129,6319
240895,201909,2582,8157,2344,7796,136,482,2039,6767,2175,7249
240910,201909,3164,8774,2714,7924,61,228,2243,6438,2304,6666
240920,201909,805,2283,680,2069,64,188,390,1227,454,1415
240930,201909,3644,8371,3019,7608,183,267,2312,6074,2495,6341
240933,201909,1747,4212,1416,3715,44,169,1219,3143,1263,3312
240940,201909,5988,14779,4700,12592,397,1111,3143,8136,3540,9247
240950,201909,960,2897,837,2661,31,136,682,2114,713,2250
240960,201909,674,2062,600,1912,31,114,466,1448,497,1562
240970,201909,1833,4726,1482,4129,59,223,1219,3275,1278,3498
240980,201909,3138,9478,2832,8905,135,563,2272,6980,2407,7543
240990,201909,2512,7138,2242,6606,255,836,1589,4497,1844,5333
241000,201909,906,2404,721,2049,35,81,527,1496,562,1577
241010,201909,2741,8794,2505,8276,168,677,1864,6017,2032,6694
241020,201909,2055,5536,1498,4397,155,455,948,2737,1103,3192
241025,201909,1706,4921,1339,4202,46,197,953,2938,999,3135
241030,201909,2466,7733,1987,6709,228,792,1295,4364,1523,5156
241040,201909,2233,7096,1985,6672,92,429,1605,5328,1697,5757
241050,201909,1286,3565,1045,3114,40,136,795,2315,835,2451
241060,201909,707,2013,627,1837,28,95,446,1253,474,1348
241070,201909,637,1749,559,1614,14,49,432,1200,446,1249
241080,201909,1110,3151,833,2588,9,38,612,1879,621,1917
241090,201909,1995,5802,1608,5143,57,288,1268,3980,1325,4268
241100,201909,1144,3235,894,2689,64,200,596,1739,660,1939
241105,201909,987,3008,794,2622,254,830,258,882,512,1712
241110,201909,906,2601,681,2110,39,138,457,1352,496,1490
241120,201909,7426,21098,6294,19078,978,2909,3617,11294,4595,14203
241140,201909,3206,8524,2562,7225,161,454,1867,5140,2028,5594
241142,201909,755,2038,547,1629,26,96,320,882,346,978
241150,201909,5810,15289,5144,14165,151,538,4228,11398,4379,11936
241160,201909,1129,3035,920,2657,142,412,576,1610,718,2022
241170,201909,1289,3292,1114,2992,30,122,939,2403,969,2525
241180,201909,1001,2597,720,2055,75,204,407,1126,482,1330
241190,201909,1086,2867,888,2471,20,77,655,1743,675,1820
241200,201909,18267,48248,15748,44252,2522,7092,9287,26185,11809,33277
241210,201909,1357,3700,965,2903,120,396,558,1618,678,2014
241220,201909,8476,25419,7385,23543,1794,5662,3441,11458,5235,17120
241230,201909,2853,7610,2524,7077,95,328,2115,5798,2210,6126
241240,201909,1155,3256,687,2191,58,194,321,1027,379,1221
241250,201909,5185,15268,4200,13376,182,833,3091,9450,3273,10283
241255,201909,2071,6628,1801,6021,110,475,1331,4323,1441,4798
241260,201909,4766,12553,3714,10740,90,400,2930,8259,3020,8659
241270,201909,1730,5037,1427,4433,120,419,997,3055,1117,3474
241280,201909,2137,5393,1839,4843,68,190,1545,4001,1613,4191
241290,201909,3375,8275,2515,6859,75,293,2004,5280,2079,5573
241300,201909,1412,3794,1109,3238,36,129,764,2157,800,2286
241310,201909,2044,5194,1740,4763,15,74,1464,4015,1479,4089
241320,201909,970,3143,802,2801,92,378,503,1738,595,2116
241330,201909,1751,4535,1356,4024,21,90,1159,3423,1180,3513
241335,201909,3064,8655,2727,8020,95,338,2284,6631,2379,6969
241340,201909,1527,4367,1173,3618,249,781,487,1489,736,2270
241350,201909,1968,5742,1740,5322,95,329,1332,4010,1427,4339
241355,201909,1272,3436,1046,2999,19,66,824,2331,843,2397
241360,201909,2070,5373,1535,4258,46,137,1122,3002,1168,3139
241370,201909,1323,3666,1020,3039,55,187,706,2000,761,2187
241380,201909,594,1680,471,1428,71,200,256,791,327,991
241390,201909,2683,7999,2389,7547,176,531,1855,5898,2031,6429
241400,201909,3433,9579,3082,9056,165,541,2516,7311,2681,7852
241410,201909,2340,6993,1881,6046,335,1112,959,3070,1294,4182
241415,201909,1612,4773,1319,4195,61,229,948,2942,1009,3171
241420,201909,2132,6979,1814,6404,439,1690,854,2989,1293,4679
241430,201909,576,1603,392,1167,27,100,248,696,275,796
241440,201909,7160,22611,6434,21317,361,1417,5120,16720,5481,18137
241445,201909,1070,2770,969,2641,22,54,878,2443,900,2497
241450,201909,2560,6461,2209,5898,376,843,1476,4066,1852,4909
241460,201909,3561,9722,2912,8341,173,541,2083,5819,2256,6360
241470,201909,1392,3634,1113,3229,24,87,916,2644,940,2731
241475,201909,1157,3312,892,2789,26,137,648,1920,674,2057
241480,201909,2731,8638,2280,7680,737,2466,724,2734,1461,5200
241490,201909,644,1540,513,1354,23,68,354,907,377,975
241500,201909,798,2288,707,2167,7,31,640,1965,647,1996
250010,201909,2530,7543,2087,6628,60,242,1524,4701,1584,4943
250020,201909,1580,4298,1105,3356,37,98,810,2420,847,2518
250030,201909,6770,18667,6004,17466,496,1526,4519,12933,5015,14459
250040,201909,4010,12362,3451,11322,210,825,2485,7980,2695,8805
250050,201909,3490,9487,3171,9019,107,408,2615,7360,2722,7768
250053,201909,1154,3316,1042,3137,74,252,759,2270,833,2522
250057,201909,656,2316,615,2250,7,32,552,2059,559,2091
250060,201909,5298,14079,4810,13460,319,856,3909,11019,4228,11875
250070,201909,3913,11025,3374,10067,47,204,2709,7876,2756,8080
250073,201909,730,1956,596,1751,5,24,488,1385,493,1409
250077,201909,2188,5937,1635,5003,66,231,1216,3691,1282,3922
250080,201909,4672,11913,4054,11089,73,334,3509,9436,3582,9770
250090,201909,3176,7900,2788,7375,56,169,2397,6218,2453,6387
250100,201909,3586,11054,3267,10449,167,629,2583,8048,2750,8677
250110,201909,4787,13451,4314,12764,292,1082,3354,9685,3646,10767
250115,201909,662,1748,471,1451,10,56,336,1016,346,1072
250120,201909,1837,5369,1526,4838,32,152,1195,3749,1227,3901
250130,201909,5377,14933,4560,13748,75,401,3800,11250,3875,11651
250135,201909,1161,3188,1039,2987,14,61,933,2658,947,2719
250140,201909,2181,6529,2040,6338,124,569,1717,5193,1841,5762
250150,201909,4757,14933,4280,14081,160,704,3433,11064,3593,11768
250153,201909,1417,3696,1172,3324,25,79,959,2678,984,2757
250157,201909,1682,5080,1502,4717,70,286,1194,3676,1264,3962
250160,201909,3856,9654,3099,8616,32,147,2764,7634,2796,7781
250170,201909,1806,4639,1612,4349,31,124,1388,3677,1419,3801
250180,201909,19090,47092,16440,43629,809,2550,12753,33014,13562,35564
250190,201909,4009,10857,3364,9849,363,1049,2233,6436,2596,7485
250200,201909,1894,5106,1609,4686,55,186,1363,3954,1418,4140
250205,201909,800,2520,688,2329,19,92,575,1927,594,2019
250210,201909,1551,4726,1403,4480,49,256,1116,3476,1165,3732
250215,201909,1481,4110,1227,3729,67,240,765,2300,832,2540
250220,201909,641,1822,519,1635,34,130,347,1041,381,1171
250230,201909,1555,3552,1119,2887,24,70,905,2260,929,2330
250240,201909,2225,6740,1971,6292,41,188,1670,5253,1711,5441
250250,201909,4498,12539,3886,11633,83,276,3297,9870,3380,10146
250260,201909,1681,4688,1399,4210,42,139,1115,3312,1157,3451
250270,201909,1187,3586,1060,3428,67,229,797,2652,864,2881
250280,201909,3192,9067,2819,8479,101,327,2250,6723,2351,7050
250290,201909,1602,4208,1346,3841,26,76,1063,3049,1089,3125
250300,201909,5413,14513,4931,13954,201,920,4083,11078,4284,11998
250310,201909,1108,3057,928,2759,35,114,718,2108,753,2222
250320,201909,10987,25360,9525,23633,268,765,8408,20561,8676,21326
250330,201909,2277,6447,1907,5961,107,367,1532,4749,1639,5116
250340,201909,1077,2745,951,2578,6,15,867,2328,873,2343
250350,201909,3966,11113,3544,10440,143,381,2866,8660,3009,9041
250355,201909,1956,5952,1748,5661,28,154,1572,5053,1600,5207
250360,201909,1751,4877,1571,4615,36,128,1300,3807,1336,3935
250370,201909,12697,33270,10524,29989,288,1106,8692,24338,8980,25444
250375,201909,1173,3052,944,2771,6,18,879,2608,885,2626
250380,201909,1574,4097,1439,3916,29,128,1249,3281,1278,3409
250390,201909,1742,4516,1477,4085,100,258,1154,3184,1254,3442
250400,201909,68049,166511,48472,136187,13212,39257,15263,44736,28475,83993
250403,201909,1671,4747,1505,4541,71,354,1164,3348,1235,3702
250407,201909,1197,3046,970,2707,61,136,705,2000,766,2136
250410,201909,598,1621,522,1495,5,13,438,1241,443,1254
250415,201909,1793,5114,1590,4779,36,163,1361,4052,1397,4215
250420,201909,1191,3373,1084,3235,14,66,1015,3018,1029,3084
250430,201909,6148,15217,5234,13967,134,437,4344,11361,4478,11798
250435,201909,1509,4171,1213,3661,13,56,930,2766,943,2822
250440,201909,4521,11975,3870,11166,66,217,3412,9825,3478,10042
250450,201909,1771,4793,1488,4406,29,123,1241,3661,1270,3784
250460,201909,7247,19571,6417,18353,314,953,5219,14860,5533,15813
250470,201909,1525,3936,1264,3542,53,169,978,2678,1031,2847
250480,201909,4060,10940,3491,10270,15,61,3163,9417,3178,9478
250485,201909,714,1617,520,1342,34,68,379,944,413,1012
250490,201909,4998,12074,4455,11434,184,577,3903,9819,4087,10396
250500,201909,1948,5385,1729,5007,68,227,1416,4089,1484,4316
250510,201909,5391,13572,4638,12579,84,250,4092,11152,4176,11402
250520,201909,1797,4877,1533,4493,130,425,1089,3156,1219,3581
250523,201909,2221,5434,1972,5119,76,317,1639,4104,1715,4421
250527,201909,1652,4271,1491,4081,30,80,1300,3600,1330,3680
250530,201909,595,1577,509,1461,7,20,447,1279,454,1299
250535,201909,1322,3904,1204,3671,26,126,981,2886,1007,3012
250540,201909,2962,6768,2434,6176,72,123,2138,5514,2210,5637
250550,201909,764,2462,665,2273,22,94,503,1686,525,1780
250560,201909,1658,4603,1463,4309,44,173,1218,3482,1262,3655
250570,201909,2611,7841,2232,7142,77,311,1755,5492,1832,5803
250580,201909,1058,2741,938,2573,47,172,784,2101,831,2273
250590,201909,816,2287,719,2144,22,96,601,1777,623,1873
250600,201909,8070,20583,6738,18856,311,940,5556,15449,5867,16389
250610,201909,3013,8379,2691,7905,114,450,2237,6439,2351,6889
250620,201909,730,1962,616,1752,12,53,469,1302,481,1355
250625,201909,2512,7239,2246,6802,44,231,1887,5537,1931,5768
250630,201909,9698,27224,7900,23915,849,2666,5110,15085,5959,17751
250640,201909,3245,9133,2971,8760,68,347,2558,7355,2626,7702
250650,201909,929,2266,774,2054,16,55,669,1734,685,1789
250660,201909,1546,3867,1307,3548,39,122,1097,2893,1136,3015
250670,201909,2297,7169,2102,6824,47,213,1825,5801,1872,6014
250680,201909,5845,13389,5185,12635,84,316,4740,11334,4824,11650
250690,201909,6713,15347,5782,14159,102,277,5146,12440,5248,12717
250700,201909,4243,11938,3690,11093,360,1107,2683,7972,3043,9079
250710,201909,4367,12547,3741,11679,277,969,2715,8451,2992,9420
250720,201909,2734,7250,2461,6862,38,188,2162,5934,2200,6122
250730,201909,4067,10810,3557,10131,109,427,2962,8184,3071,8611
250740,201909,1951,4917,1588,4433,101,272,1215,3383,1316,3655
250750,201909,97311,243578,83057,223480,7108,20873,60046,158273,67154,179146
250760,201909,2326,5993,2032,5518,94,278,1600,4226,1694,4504
250770,201909,3873,11845,3487,11318,355,1202,2535,8215,2890,9417
250780,201909,1688,4587,1406,4058,69,243,1056,2965,1125,3208
250790,201909,2405,7201,2084,6717,175,673,1392,4384,1567,5057
250800,201909,2412,6441,2083,5909,82,174,1711,4884,1793,5058
250810,201909,1247,3351,1004,2990,20,51,864,2588,884,2639
250820,201909,1917,5434,1783,5281,36,159,1626,4773,1662,4932
250830,201909,5627,16808,4674,14929,268,1035,3237,10035,3505,11070
250840,201909,764,2414,652,2190,17,69,482,1626,499,1695
250850,201909,1767,5348,1590,5036,34,176,1325,4076,1359,4252
250855,201909,938,2747,813,2533,63,219,611,1888,674,2107
250860,201909,3025,9075,2518,8183,447,1532,1424,4626,1871,6158
250870,201909,1021,2803,857,2523,37,131,698,2028,735,2159
250880,201909,1581,4090,1293,3670,106,319,948,2685,1054,3004
250890,201909,9792,26144,8770,24733,439,1863,6961,18635,7400,20498
250900,201909,2746,7781,2357,7051,65,255,1987,5801,2052,6056
250905,201909,2335,6702,2140,6408,50,207,1931,5758,1981,5965
250910,201909,5946,14775,4872,13528,95,336,4147,11579,4242,11915
250915,201909,2021,4849,1484,4267,17,42,1315,3856,1332,3898
250920,201909,3456,8823,3009,8131,319,773,2192,5888,2511,6661
250930,201909,2166,5847,1966,5579,53,219,1699,4717,1752,4936
250933,201909,1147,3422,1015,3176,20,110,771,2333,791,2443
250937,201909,688,1862,563,1649,21,77,426,1261,447,1338
250939,201909,1719,4631,1496,4333,63,209,1168,3353,1231,3562
250940,201909,3824,10387,3379,9786,35,145,2950,8505,2985,8650
250950,201909,1670,4287,1349,3879,19,75,1141,3241,1160,3316
250960,201909,1091,3207,956,2988,27,142,779,2338,806,2480
250970,201909,8179,21305,7146,19649,269,875,5809,15612,6078,16487
250980,201909,2450,6547,2194,6151,38,155,1861,5087,1899,5242
250990,201909,1957,6006,1634,5413,59,278,1227,4007,1286,4285
251000,201909,2030,5717,1651,5087,36,165,1361,4157,1397,4322
251010,201909,2584,7315,2350,6951,23,101,2132,6284,2155,6385
251020,201909,1648,4441,1484,4189,32,148,1296,3578,1328,3726
251030,201909,975,2606,808,2291,34,98,569,1585,603,1683
251040,201909,1814,5224,1537,4741,47,220,1215,3702,1262,3922
251050,201909,1065,2899,899,2577,47,154,655,1811,702,1965
251060,201909,1036,2246,780,1924,6,28,638,1530,644,1558
251065,201909,446,1231,354,1069,14,41,252,732,266,773
251070,201909,699,1832,598,1688,7,29,506,1404,513,1433
251080,201909,18128,46764,14854,41867,1734,5200,9778,27520,11512,32720
251090,201909,2662,7732,2255,6984,56,192,1829,5640,1885,5832
251100,201909,788,2511,705,2360,27,103,535,1723,562,1826
251110,201909,1658,4484,1413,4045,46,131,1098,3111,1144,3242
251120,201909,6958,19982,5894,18636,243,1007,4676,14624,4919,15631
251130,201909,3851,8713,3407,8212,133,325,3006,7214,3139,7539
251140,201909,4188,11708,3768,11114,79,338,3158,9182,3237,9520
251150,201909,2618,7605,2353,7183,113,486,1913,5667,2026,6153
251160,201909,2036,6017,1781,5651,74,285,1496,4676,1570,4961
251170,201909,1509,4172,1341,3951,37,143,1158,3381,1195,3524
251180,201909,2571,6967,2124,6344,169,494,1434,4258,1603,4752
251190,201909,4298,11259,3964,10869,43,226,3609,9696,3652,9922
251200,201909,4232,12504,3770,11899,83,352,3279,10369,3362,10721
251203,201909,921,3005,852,2857,28,126,645,2099,673,2225
251207,201909,1058,2928,817,2514,19,98,579,1725,598,1823
251210,201909,7263,18800,5868,16939,250,637,4507,13185,4757,13822
251220,201909,1170,2866,902,2494,52,125,708,1982,760,2107
251230,201909,4570,12661,3931,11575,129,504,3121,8941,3250,9445
251240,201909,3547,9778,2955,8811,146,454,2237,6526,2383,6980
251250,201909,9781,26513,8628,24594,831,2512,6309,17443,7140,19955
251260,201909,471,1374,432,1305,12,62,341,986,353,1048
251270,201909,4192,13086,3749,12483,105,439,3114,10549,3219,10988
251272,201909,1337,3650,1204,3462,40,169,1007,2805,1047,2974
251274,201909,883,2466,714,2171,57,202,482,1377,539,1579
251275,201909,1195,3334,1019,3059,39,185,776,2235,815,2420
251276,201909,1323,3544,1159,3332,33,162,938,2606,971,2768
251278,201909,564,1586,502,1488,38,106,370,1109,408,1215
251280,201909,2201,6088,1958,5695,50,195,1631,4652,1681,4847
251290,201909,5781,13766,5284,13139,134,488,4639,11088,4773,11576
251300,201909,820,2436,746,2328,7,30,638,1979,645,2009
251310,201909,2707,7785,2356,7219,51,263,1883,5620,1934,5883
251315,201909,1659,5245,1526,5010,67,223,1154,3732,1221,3955
251320,201909,1587,4217,1114,3390,31,111,828,2485,859,2596
251330,201909,2035,4767,1676,4337,22,81,1523,3962,1545,4043
251335,201909,998,3047,910,2909,25,104,787,2458,812,2562
251340,201909,3612,8832,2877,7828,114,352,2183,5859,2297,6211
251350,201909,1043,3051,931,2866,31,134,767,2304,798,2438
251360,201909,1778,5035,1446,4572,22,97,1240,3924,1262,4021
251365,201909,683,1921,538,1618,8,26,416,1243,424,1269
251370,201909,22363,60093,19374,55869,2258,6779,12711,36943,14969,43722
251380,201909,1161,3347,1028,3115,17,98,863,2524,880,2622
251385,201909,720,1862,559,1577,16,55,421,1136,437,1191
251390,201909,6277,18517,5501,17248,510,1701,3576,11166,4086,12867
251392,201909,962,2630,793,2373,26,117,620,1813,646,1930
251394,201909,596,1774,487,1578,21,88,364,1157,385,1245
251396,201909,685,1851,582,1675,19,63,405,1141,424,1204
251398,201909,921,2369,653,1892,16,66,493,1390,509,1456
251400,201909,1177,2951,952,2631,27,96,753,2006,780,2102
251410,201909,1458,3448,1183,3043,20,91,1018,2532,1038,2623
251420,201909,1863,4994,1533,4606,39,149,1192,3549,1231,3698
251430,201909,1511,4642,1344,4358,35,171,1161,3735,1196,3906
251440,201909,1104,3115,895,2714,31,93,709,2160,740,2253
251445,201909,1496,4269,1386,4107,36,152,1168,3370,1204,3522
251450,201909,4292,12773,3855,12107,90,413,3233,10030,3323,10443
251455,201909,861,2625,779,2473,25,105,600,1870,625,1975
251460,201909,871,2511,767,2345,19,73,638,1942,657,2015
251465,201909,424,1256,360,1126,6,24,272,833,278,857
251470,201909,1153,3209,858,2598,66,228,524,1489,590,1717
251480,201909,969,2576,800,2280,18,83,621,1690,639,1773
251490,201909,1851,4932,1466,4396,51,165,1090,3257,1141,3422
251500,201909,1894,5372,1739,5151,39,166,1563,4580,1602,4746
251510,201909,2625,7928,2166,6979,128,475,1437,4518,1565,4993
251520,201909,936,2481,711,2054,63,167,472,1342,535,1509
251530,201909,14222,34384,11565,31053,113,631,10216,26897,10329,27528
251540,201909,2822,8295,2547,7776,99,362,2063,6174,2162,6536
251550,201909,3662,8779,2914,7826,82,203,2451,6581,2533,6784
251560,201909,563,1689,488,1570,62,211,333,1031,395,1242
251570,201909,907,2592,739,2238,20,90,577,1692,597,1782
251580,201909,1895,4495,1686,4183,50,197,1464,3489,1514,3686
251590,201909,1563,3980,1324,3694,59,190,1073,2895,1132,3085
251593,201909,855,2540,785,2424,81,271,519,1560,600,1831
251597,201909,2070,5815,1875,5554,23,103,1649,4817,1672,4920
251600,201909,6296,17111,5558,15973,165,549,4629,13103,4794,13652
251610,201909,3201,9087,2734,8218,255,706,1887,5761,2142,6467
251615,201909,1223,3067,982,2692,20,57,784,2097,804,2154
251620,201909,18238,42592,14175,37659,132,448,12000,32298,12132,32746
251630,201909,4601,10895,3699,9648,197,554,2858,7353,3055,7907
251640,201909,2043,5712,1829,5338,32,165,1577,4470,1609,4635
251650,201909,3983,10607,3467,9940,118,381,2979,8506,3097,8887
251660,201909,3425,10244,3016,9518,78,372,2502,7728,2580,8100
251670,201909,3994,11393,3549,10765,48,253,3147,9439,3195,9692
251675,201909,636,1835,567,1747,79,249,376,1160,455,1409
251680,201909,2496,6710,2072,6134,39,149,1690,4995,1729,5144
251690,201909,3096,8737,2600,7846,78,250,1971,5858,2049,6108
251700,201909,1966,5747,1696,5403,42,197,1444,4507,1486,4704
251710,201909,770,2007,513,1472,41,145,300,842,341,987
251720,201909,1283,3657,1047,3231,23,103,803,2401,826,2504
251740,201909,599,1686,478,1456,36,137,340,990,376,1127
260005,201909,29291,61788,23919,54906,1651,3799,18426,41462,20077,45261
260010,201909,9864,26064,8120,23266,465,1433,4899,14083,5364,15516
260020,201909,6672,15788,5707,14388,116,511,4762,11804,4878,12315
260030,201909,6532,16960,5502,15416,163,525,4442,12343,4605,12868
260040,201909,7599,20168,6290,18147,519,1450,4290,12600,4809,14050
260050,201909,13520,35468,11287,32994,163,734,10311,30155,10474,30889
260060,201909,3894,9936,3339,9024,172,451,2670,7164,2842,7615
260070,201909,10192,25974,8765,23895,392,1343,6983,18555,7375,19898
260080,201909,6487,14852,5685,13760,113,384,4775,11272,4888,11656
260090,201909,4675,12097,4152,11397,529,1454,2880,7939,3409,9393
260100,201909,2974,8095,2512,7399,62,287,2039,5894,2101,6181
260105,201909,4959,13433,4421,12726,141,501,3684,10472,3825,10973
260110,201909,22077,60821,19658,57297,1053,3564,16078,46110,17131,49674
260120,201909,14244,38497,11895,34910,1547,4469,7382,22079,8929,26548
260130,201909,2974,7818,2668,7358,202,600,1996,5380,2198,5980
260140,201909,12725,29133,10926,26942,597,1670,9089,22044,9686,23714
260150,201909,3537,8300,3028,7676,97,327,2626,6539,2723,6866
260160,201909,6457,16966,5430,15667,93,370,4845,14074,4938,14444
260170,201909,18793,45740,15938,41791,1133,2933,12407,32272,13540,35205
260180,201909,3401,9177,2943,8547,81,317,2519,7177,2600,7494
260190,201909,18328,36960,15350,33462,166,471,13534,28851,13700,29322
260200,201909,10973,26405,9449,24472,441,1039,7953,20754,8394,21793
260210,201909,11646,33115,9852,30181,322,1273,7850,23870,8172,25143
260220,201909,10214,24806,9428,23790,170,595,8302,20555,8472,21150
260230,201909,10510,26084,9159,24255,207,699,7698,20001,7905,20700
260240,201909,2631,7890,2294,7253,131,464,1777,5558,1908,6022
260250,201909,2141,5674,1869,5257,120,288,1418,3981,1538,4269
260260,201909,12656,33316,11262,31120,417,1434,8919,24086,9336,25520
260270,201909,4019,9982,3523,9356,137,542,2908,7527,3045,8069
260280,201909,12581,38125,11302,36322,496,2105,9540,30222,10036,32327
260290,201909,38420,99026,33077,91044,3679,10340,22268,60986,25947,71326
260300,201909,9625,25873,8319,24068,230,990,6932,19932,7162,20922
260310,201909,4811,12631,4286,11951,297,800,3339,9397,3636,10197
260320,201909,7537,21774,6427,19880,257,805,5233,16202,5490,17007
260330,201909,2486,7681,2196,7079,70,273,1768,5548,1838,5821
260340,201909,2027,5436,1738,4989,31,144,1468,4114,1499,4258
260345,201909,24091,63668,20195,57853,3106,9557,10543,29552,13649,39109
260350,201909,5241,12563,4586,11780,95,270,4050,10349,4145,10619
260360,201909,2435,6366,2215,5962,34,164,1559,4120,1593,4284
260370,201909,5451,15715,4706,14435,227,822,3611,10972,3838,11794
260380,201909,4833,14453,4139,13290,166,612,3092,9783,3258,10395
260390,201909,4350,13176,3645,11708,198,670,2509,7879,2707,8549
260392,201909,3359,10755,2990,10279,127,744,2387,8182,2514,8926
260400,201909,16836,39724,14617,36815,508,1530,11488,27846,11996,29376
260410,201909,70033,171561,53767,148457,9749,28419,24560,69271,34309,97690
260415,201909,4418,12137,3813,11108,76,326,3078,8803,3154,9129
260420,201909,12594,26339,10668,24178,127,362,9773,21893,9900,22255
260430,201909,2749,8499,2340,7696,109,444,1656,5388,1765,5832
260440,201909,3579,9426,3153,8734,78,285,2630,7132,2708,7417
260450,201909,5630,14370,5056,13647,298,674,4132,11321,4430,11995
260460,201909,5081,15328,4333,13975,483,1764,2574,8100,3057,9864
260470,201909,4919,12910,4139,11996,99,252,3757,11060,3856,11312
260480,201909,3961,10523,3304,9576,220,787,2286,6637,2506,7424
260490,201909,5253,12168,4651,11254,44,166,4194,9957,4238,10123
260500,201909,5955,15091,5097,13855,416,1108,3604,9853,4020,10961
260510,201909,9486,23569,7988,21488,133,519,7017,18649,7150,19168
260515,201909,4101,11379,3167,9556,139,431,2113,6205,2252,6636
260520,201909,16974,39559,14856,36793,872,2149,11956,29252,12828,31401
260530,201909,9607,27585,8240,25460,176,819,7007,21342,7183,22161
260540,201909,7007,15301,6209,14274,215,499,5492,12524,5707,13023
260545,201909,44,134,17,68,2,7,4,10,6,17
260550,201909,2981,8347,2440,7420,115,475,1646,4877,1761,5352
260560,201909,5971,15244,5017,13866,133,535,4175,11273,4308,11808
260570,201909,7581,20808,6650,19540,428,1391,5200,15252,5628,16643
260580,201909,4429,10556,3954,9913,25,100,3621,9039,3646,9139
260590,201909,6634,15475,5561,14259,229,597,4626,11929,4855,12526
260600,201909,29629,77627,24173,69091,1168,3719,18154,51033,19322,54752
260610,201909,6990,18312,6303,17393,390,1183,4728,12911,5118,14094
260620,201909,15521,40997,13614,38212,1340,4238,9728,26715,11068,30953
260630,201909,2300,6275,1882,5604,36,154,1509,4388,1545,4542
260640,201909,20732,47731,17463,43899,849,2193,13965,34793,14814,36986
260650,201909,5757,15560,4708,14216,162,670,4006,11980,4168,12650
260660,201909,7078,18764,6069,17393,169,720,5140,14401,5309,15121
260670,201909,2130,5605,1767,5056,72,191,1335,3774,1407,3965
260680,201909,26491,63887,22227,57695,1662,4614,15454,39339,17116,43953
260690,201909,3554,9196,2904,8206,100,364,2283,6366,2383,6730
260700,201909,5951,17340,5624,16955,23,74,5447,16549,5470,16623
260710,201909,1303,3493,1146,3278,35,141,892,2544,927,2685
260720,201909,21793,56113,19062,52252,2158,6108,13224,35849,15382,41957
260730,201909,7297,21429,6438,20201,277,1056,5345,16488,5622,17544
260740,201909,1321,3693,1097,3336,12,67,869,2681,881,2748
260750,201909,6858,19181,5845,17865,115,399,5220,16142,5335,16541
260760,201909,5540,13207,4746,12243,194,562,3875,10011,4069,10573
260765,201909,7629,22437,6643,21051,452,1905,4656,14386,5108,16291
260770,201909,3802,9803,3199,8782,85,286,2561,6931,2646,7217
260775,201909,5128,13685,4526,12758,203,750,3509,9566,3712,10316
260780,201909,3544,10519,3146,9874,278,1090,2049,6194,2327,7284
260790,201909,114862,259468,95095,233085,14692,35101,58802,144125,73494,179226
260795,201909,2975,7770,2550,7181,103,348,1955,5511,2058,5859
260800,201909,5363,12569,4776,11731,151,492,4174,9887,4325,10379
260805,201909,3535,10102,2966,9084,170,624,2190,6580,2360,7204
260810,201909,6482,17562,5686,16022,525,1449,4051,11192,4576,12641
260820,201909,4293,10244,3794,9621,119,435,3130,7755,3249,8190
260825,201909,2884,8624,2495,7939,114,430,1860,5831,1974,6261
260830,201909,4222,12273,3516,10992,469,1319,2226,7152,2695,8471
260840,201909,4126,10828,3679,10189,204,554,3052,8440,3256,8994
260845,201909,4114,10977,3672,10180,245,679,2764,7602,3009,8281
260850,201909,4735,13204,3980,11721,341,1089,2617,7480,2958,8569
260860,201909,3435,9722,2894,8784,90,339,2328,6868,2418,7207
260870,201909,4465,10741,3841,9972,83,343,3408,8658,3491,9001
260875,201909,6614,16651,5426,14870,580,1602,3690,10077,4270,11679
260880,201909,9554,26842,8309,24646,481,1418,6530,19398,7011,20816
260890,201909,12937,33471,11236,30848,666,2032,8132,21745,8798,23777
260900,201909,5154,14719,4280,13387,288,1028,2889,8918,3177,9946
260910,201909,3136,8645,2711,7983,103,344,2136,6234,2239,6578
260915,201909,5128,15091,4515,14350,56,295,4114,13070,4170,13365
260920,201909,3267,8209,2777,7656,88,252,2356,6536,2444,6788
260930,201909,3583,11417,3092,10510,173,719,2304,7628,2477,8347
260940,201909,14327,34591,12466,31906,764,2096,9525,23882,10289,25978
260950,201909,6484,17572,5255,15393,379,1320,3328,9290,3707,10610
260960,201909,65979,150256,52856,132900,6112,16045,33235,82160,39347,98205
260970,201909,5273,14120,4693,13326,174,471,3623,10275,3797,10746
260980,201909,4437,12980,3937,12333,62,228,3573,11293,3635,11521
260990,201909,17797,49527,15020,45717,902,3112,11577,34858,12479,37970
261000,201909,15897,37922,13388,34601,430,1577,10671,26859,11101,28436
261010,201909,2373,6214,2077,5805,70,187,1807,5056,1877,5243
261020,201909,6029,16474,5133,14909,222,803,4114,11464,4336,12267
261030,201909,3999,11516,3449,10589,138,555,2726,8135,2864,8690
261040,201909,5089,15032,4096,13053,175,704,3028,9434,3203,10138
261050,201909,7615,20038,6915,18893,449,969,5153,14140,5602,15109
261060,201909,13667,34531,11987,32448,318,1054,9976,26674,10294,27728
261070,201909,60664,133279,50125,119234,2855,6780,38092,88816,40947,95596
261080,201909,6237,15432,5710,14742,137,348,5248,13522,5385,13870
261090,201909,18273,44153,16256,41531,330,1192,14061,35270,14391,36462
261100,201909,8154,22813,7036,21138,527,1706,5098,15338,5625,17044
261110,201909,59809,168661,50038,151423,7971,25272,28349,85423,36320,110695
261120,201909,3751,9322,3205,8580,88,229,2752,7374,2840,7603
261130,201909,7239,17687,6352,16480,129,362,5598,14426,5727,14788
261140,201909,3551,8219,3160,7705,162,436,2546,6079,2708,6515
261150,201909,5244,13790,4616,12841,84,318,4007,10994,4091,11312
261153,201909,1830,5514,1589,5052,58,222,1102,3496,1160,3718
261160,201909,201797,473114,163428,419316,40325,106566,67804,176557,108129,283123
261170,201909,5892,14807,5255,13837,358,897,4182,10926,4540,11823
261180,201909,9533,24005,8336,22413,461,1275,6051,16231,6512,17506
261190,201909,4519,13391,4035,12562,223,945,3101,9326,3324,10271
261200,201909,3308,7666,2948,7171,137,364,2470,5878,2607,6242
261210,201909,1909,4600,1606,4180,62,190,1343,3432,1405,3622
261220,201909,13452,38373,11114,33943,1420,4683,6332,19041,7752,23724
261230,201909,4061,11657,3391,10708,61,255,2802,8914,2863,9169
261240,201909,5121,13015,4490,12023,239,672,3720,9815,3959,10487
261245,201909,3507,9965,2960,8983,77,355,2347,6897,2424,7252
261247,201909,2854,8579,2368,7673,138,508,1638,5251,1776,5759
261250,201909,21285,49049,18319,45541,1601,3641,14021,35642,15622,39283
261255,201909,3991,11839,3270,10439,140,626,2407,7417,2547,8043
261260,201909,12692,34151,10956,31913,362,1523,9351,26777,9713,28300
261270,201909,4149,10647,3672,10003,167,534,3071,8203,3238,8737
261280,201909,2532,7099,2222,6561,76,293,1766,5091,1842,5384
261290,201909,2905,7608,2460,7083,79,320,1992,5747,2071,6067
261300,201909,11823,33528,10001,30404,585,2155,7186,21367,7771,23522
261310,201909,8569,22035,7290,20238,686,2132,5220,14083,5906,16215
261320,201909,5884,16694,5121,15393,84,390,4291,12665,4375,13055
261330,201909,5892,14529,5306,13752,131,466,4625,11771,4756,12237
261340,201909,4106,11753,3566,11026,154,591,2876,8771,3030,9362
261350,201909,8663,25265,7682,23614,121,576,6288,18971,6409,19547
261360,201909,8062,19637,6832,17886,233,734,5432,13773,5665,14507
261370,201909,22107,55974,18589,51058,2165,5915,11897,32855,14062,38770
261380,201909,3917,11960,3487,11191,458,1579,2281,7203,2739,8782
261390,201909,16042,46007,13458,41764,1179,3983,8858,27305,10037,31288
261400,201909,4558,14539,3947,13229,164,757,2946,9584,3110,10341
261410,201909,9314,23554,7684,20969,549,1514,5911,15852,6460,17366
261420,201909,7138,21650,6465,20812,781,2898,4525,14442,5306,17340
261430,201909,3369,9501,2819,8644,68,285,2343,7065,2411,7350
261440,201909,1440,4314,1203,3847,40,198,856,2609,896,2807
261450,201909,14936,40367,13247,37697,230,905,10965,31063,11195,31968
261460,201909,7363,20323,6533,19073,163,647,5468,15754,5631,16401
261470,201909,4159,10354,3650,9673,33,168,3116,8239,3149,8407
261480,201909,4927,15208,4243,14042,203,857,3282,10610,3485,11467
261485,201909,4920,14036,4198,12871,367,1254,2916,8752,3283,10006
261500,201909,5660,14709,4939,13713,393,977,3460,9918,3853,10895
261510,201909,1850,5568,1591,5121,62,227,1190,3884,1252,4111
261520,201909,2348,7203,2120,6724,91,327,1509,4792,1600,5119
261530,201909,11398,33823,9208,29665,1008,3861,4583,14228,5591,18089
261540,201909,7924,22803,7104,21591,1049,3182,4045,12847,5094,16029
261550,201909,3588,9592,3109,8830,210,680,2236,6201,2446,6881
261560,201909,7697,22959,6662,21407,344,1302,5012,16100,5356,17402
261570,201909,3441,9282,2747,8148,202,735,1891,5453,2093,6188
261580,201909,6544,17347,5762,16306,122,576,5130,14297,5252,14873
261590,201909,2628,6775,2102,6017,74,241,1567,4445,1641,4686
261600,201909,4994,12834,4188,11620,379,948,2831,8142,3210,9090
261610,201909,2251,6259,1835,5550,89,333,1298,3882,1387,4215
261618,201909,2508,6338,2176,5848,72,221,1752,4638,1824,4859
261620,201909,4019,11471,3719,11028,873,2310,2265,7077,3138,9387
261630,201909,6252,17522,5301,15739,371,1338,3564,10128,3935,11466
261640,201909,36583,82459,31263,75816,1706,3474,23911,59404,25617,62878
261650,201909,4126,10250,3565,9515,155,505,2668,7037,2823,7542
270010,201909,4212,14327,3658,13363,166,940,2869,10203,3035,11143
270020,201909,3825,9666,3357,9062,149,504,2847,7501,2996,8005
270030,201909,32045,88088,27173,80321,3735,10819,17967,53412,21702,64231
270040,201909,10780,29062,9275,27270,364,1507,7676,22247,8040,23754
270050,201909,5470,12624,4655,11708,190,490,4108,10352,4298,10842
270060,201909,2008,5216,1684,4840,116,316,1355,3940,1471,4256
270070,201909,4589,12966,3984,12100,152,573,3324,9906,3476,10479
270080,201909,1411,3876,1171,3461,40,129,894,2534,934,2663
270090,201909,1805,5513,1611,5148,73,318,1296,4013,1369,4331
270100,201909,5455,14583,4731,13517,177,684,3854,10740,4031,11424
270110,201909,3205,7676,2562,6908,142,366,2025,5673,2167,6039
270120,201909,2831,7699,2455,7198,74,321,2081,6011,2155,6332
270130,201909,5066,13141,4391,12340,131,438,3768,10582,3899,11020
270135,201909,1998,4822,1698,4484,56,182,1514,3965,1570,4147
270140,201909,9681,22562,7765,19872,325,1189,6149,14896,6474,16085
270150,201909,2713,8106,2507,7809,5,27,2382,7409,2387,7436
270160,201909,5968,16525,5175,15586,63,383,4785,14265,4848,14648
270170,201909,3391,9919,2856,9170,191,893,2131,6559,2322,7452
270180,201909,2219,6862,2026,6608,41,200,1804,5828,1845,6028
270190,201909,1626,4848,1452,4625,41,212,1256,3948,1297,4160
270200,201909,2365,7206,2044,6757,116,455,1505,4898,1621,5353
270210,201909,5675,13443,4876,12538,95,386,4467,11292,4562,11678
270220,201909,1405,3734,1119,3328,201,618,631,1848,832,2466
270230,201909,9045,25342,7475,22890,659,2277,5251,15827,5910,18104
270235,201909,5702,17616,4923,16348,138,658,3980,13004,4118,13662
270240,201909,10454,28495,8428,25770,831,2792,6089,18559,6920,21351
270250,201909,2762,7035,2408,6533,201,539,1857,5054,2058,5593
270255,201909,4446,12761,3432,10881,121,495,2570,8005,2691,8500
270260,201909,5539,16384,5031,15547,109,551,4368,13142,4477,13693
270270,201909,1017,2668,852,2457,106,313,613,1739,719,2052
270280,201909,3905,9368,3100,8349,459,757,2169,6283,2628,7040
270290,201909,7471,23786,6709,22506,197,913,5749,19046,5946,19959
270300,201909,4128,10904,3227,9917,166,510,2463,7696,2629,8206
270310,201909,6911,19383,5959,17940,134,677,5033,14722,5167,15399
270320,201909,5426,15867,4716,14522,484,1562,3307,9949,3791,11511
270330,201909,3787,12500,3371,11867,253,1061,2589,9019,2842,10080
270340,201909,1601,4412,1388,4125,58,182,1144,3365,1202,3547
270350,201909,1802,4358,1482,3965,168,483,1010,2734,1178,3217
270360,201909,2497,6405,2232,6102,72,185,2040,5592,2112,5777
270370,201909,1355,4251,1229,4004,42,206,1002,3199,1044,3405
270375,201909,3070,7188,2572,6629,19,57,2412,6229,2431,6286
270380,201909,5498,15687,4622,14516,633,1989,2936,9522,3569,11511
270390,201909,1184,2999,968,2745,22,99,800,2252,822,2351
270400,201909,6118,16351,5142,14816,215,674,4037,11433,4252,12107
270410,201909,4505,13152,3916,12207,179,644,3220,9946,3399,10590
270420,201909,5405,16120,4902,15382,139,679,4223,12957,4362,13636
270430,201909,133751,321983,105266,285278,21228,59934,49755,136710,70983,196644
270440,201909,4701,12747,4053,11947,89,384,3488,10155,3577,10539
270450,201909,6725,18381,5970,17473,250,940,5040,14668,5290,15608
270460,201909,3755,8328,3262,7756,117,277,2958,6971,3075,7248
270470,201909,10879,30489,9438,28388,755,2471,7085,21280,7840,23751
270480,201909,2862,7683,2443,7069,107,439,1975,5545,2082,5984
270490,201909,943,2655,819,2502,47,171,660,1977,707,2148
270500,201909,4859,14932,4336,14091,255,997,3381,10823,3636,11820
270510,201909,5453,14717,4633,13633,361,1446,3440,9606,3801,11052
270520,201909,3786,10957,2984,9541,650,2153,1200,3961,1850,6114
270530,201909,1178,3425,1013,3166,48,139,740,2334,788,2473
270540,201909,2124,6260,1850,5905,62,299,1596,4980,1658,5279
270550,201909,6597,17249,5330,15845,550,1352,4023,12426,4573,13778
270560,201909,2942,7754,2559,7230,158,498,2023,5647,2181,6145
270570,201909,4076,11504,3445,10532,110,411,2809,8467,2919,8878
270580,201909,2274,6470,2064,6160,97,290,1770,5246,1867,5536
270590,201909,1601,4778,1475,4613,18,92,1390,4326,1408,4418
270600,201909,2699,8364,2446,7977,52,281,2164,6944,2216,7225
270610,201909,3641,9502,3100,8786,87,329,2746,7678,2833,8007
270620,201909,1187,3674,1084,3475,39,172,923,2870,962,3042
270630,201909,16873,41662,14607,38517,627,2037,12198,31421,12825,33458
270640,201909,5266,15221,4575,14116,160,658,3732,11233,3892,11891
270642,201909,2462,7960,2178,7485,162,730,1654,5518,1816,6248
270644,201909,3518,8840,2868,7989,235,615,2173,6152,2408,6767
270650,201909,3050,9081,2687,8549,414,1381,1808,5693,2222,7074
270660,201909,2040,5136,1669,4607,84,309,1254,3389,1338,3698
270670,201909,15625,36698,13047,33538,433,1371,11018,27685,11451,29056
270680,201909,5331,13034,4753,12382,127,189,4441,11731,4568,11920
270690,201909,8842,22093,7300,20153,675,1799,5469,15126,6144,16925
270700,201909,523,1575,459,1467,27,112,345,1091,372,1203
270710,201909,5412,16383,4866,15556,236,1020,3952,12358,4188,13378
270720,201909,3395,10163,3003,9489,68,387,2645,8176,2713,8563
270730,201909,8032,18048,7085,17001,234,506,5645,14841,5879,15347
270740,201909,2334,6171,2071,5856,105,370,1712,4730,1817,5100
270750,201909,5556,14904,4868,14001,121,530,4225,12049,4346,12579
270760,201909,3243,9204,2822,8632,55,292,2385,7194,2440,7486
270770,201909,20236,49458,16008,44282,2574,6512,9946,28986,12520,35498
270780,201909,1722,4995,1588,4807,99,369,1283,3805,1382,4174
270790,201909,1482,4281,1240,3920,99,338,841,2623,940,2961
270800,201909,10604,29316,9498,27767,359,1362,8117,23242,8476,24604
270810,201909,3238,9279,2525,8047,179,706,1764,5494,1943,6200
270820,201909,1665,4978,1391,4514,55,249,1076,3408,1131,3657
270830,201909,5166,12348,4156,11098,167,562,3345,8796,3512,9358
270840,201909,8085,24079,7221,22874,193,1074,6323,19465,6516,20539
270850,201909,8899,21356,7938,20182,657,1933,6539,16251,7196,18184
270860,201909,12335,29198,10258,26752,374,1266,8580,21894,8954,23160
270870,201909,2078,5924,1735,5351,212,694,1171,3648,1383,4342
270880,201909,8004,23957,7155,22678,234,1022,5911,18359,6145,19381
270890,201909,2677,7373,2276,6805,184,606,1593,4697,1777,5303
270895,201909,2991,9467,2741,9131,82,451,2405,7832,2487,8283
270900,201909,1783,4612,1340,3892,41,123,1052,3035,1093,3158
270910,201909,3786,11104,3251,10216,109,432,2590,8013,2699,8445
270915,201909,9109,26467,7388,23534,668,2536,4986,15452,5654,17988
270920,201909,5112,15971,4607,15119,181,877,3753,11889,3934,12766
270930,201909,16881,39690,13113,35256,1823,4425,8954,24984,10777,29409
270940,201909,6321,17000,5442,15925,197,963,4385,12422,4582,13385
280010,201909,667,1835,532,1546,13,51,377,982,390,1033
280020,201909,4642,11987,3963,10913,484,1248,2649,7358,3133,8606
280030,201909,71773,170247,55823,147599,12564,33506,24389,67048,36953,100554
280040,201909,2937,8257,2557,7671,256,845,1713,5055,1969,5900
280050,201909,3810,10913,3279,10054,545,1735,1946,5959,2491,7694
280060,201909,5404,14481,4300,12776,772,2385,2141,6594,2913,8979
280067,201909,6786,17004,5771,15473,325,915,4212,11055,4537,11970
280070,201909,1888,5703,1764,5492,89,333,1473,4488,1562,4821
280100,201909,3825,10341,3211,9334,313,958,2257,6509,2570,7467
280110,201909,1355,3706,1181,3441,23,108,1027,2915,1050,3023
280120,201909,7364,21555,6583,20281,742,2116,4846,15215,5588,17331
280130,201909,8927,21070,7818,19484,438,1177,6314,15591,6752,16768
280140,201909,5435,13124,4773,12224,222,643,4016,10173,4238,10816
280150,201909,3968,9963,3433,9270,218,580,2800,7531,3018,8111
280160,201909,1225,3520,1017,3159,108,351,672,2039,780,2390
280170,201909,5119,13544,4557,12785,238,698,3628,10133,3866,10831
280190,201909,1182,2662,1005,2414,60,156,788,1849,848,2005
280200,201909,1256,3315,1031,2968,94,328,730,2050,824,2378
280210,201909,15857,40404,13772,37351,1598,4582,8758,23617,10356,28199
280220,201909,1748,4696,1483,4329,42,212,1220,3523,1262,3735
280230,201909,3992,10209,3445,9398,262,660,2503,6803,2765,7463
280240,201909,3323,8882,2987,8385,57,295,2535,6904,2592,7199
280250,201909,840,2144,674,1883,60,194,425,1146,485,1340
280260,201909,2095,5164,1865,4881,38,100,1723,4508,1761,4608
280270,201909,2282,6390,2023,5967,114,410,1696,4883,1810,5293
280280,201909,4108,12394,3658,11747,450,1334,2596,8619,3046,9953
280290,201909,17188,45934,14754,42480,1322,4142,10045,29060,11367,33202
280300,201909,11405,28289,9915,26668,275,838,7646,22020,7921,22858
280310,201909,1339,3468,1105,3066,36,121,823,2211,859,2332
280320,201909,8433,22929,7280,21179,833,2494,4891,14008,5724,16502
280330,201909,4561,11375,3828,10337,259,711,2817,7542,3076,8253
280340,201909,5447,11323,4577,10384,219,393,3973,9144,4192,9537
280350,201909,24928,59246,21726,54913,1221,3353,16940,42015,18161,45368
280360,201909,5708,15953,4960,14673,772,2339,2880,8562,3652,10901
280370,201909,2171,5346,1774,4667,56,157,1410,3617,1466,3774
280380,201909,966,2668,817,2461,74,230,545,1644,619,1874
280390,201909,3556,8924,2936,7905,129,339,2338,6233,2467,6572
280400,201909,3827,9847,3275,9071,462,1137,2067,5988,2529,7125
280410,201909,2181,6129,1732,5346,198,643,1024,3078,1222,3721
280420,201909,4306,11566,3912,11042,86,324,3548,9939,3634,10263
280430,201909,2007,4924,1758,4586,64,253,1426,3577,1490,3830
280440,201909,4242,11452,3704,10640,172,598,3089,8646,3261,9244
280445,201909,2274,5758,2005,5276,52,171,1526,3836,1578,4007
280450,201909,10203,23381,8889,21630,654,1278,6817,16933,7471,18211
280460,201909,6765,16226,6116,15300,405,978,5104,12652,5509,13630
280470,201909,1681,4817,1440,4378,56,218,1063,3147,1119,3365
280480,201909,40345,98703,34836,90990,2820,8089,24997,63890,27817,71979
280490,201909,3623,10317,3117,9445,83,363,2431,7145,2514,7508
280500,201909,983,2364,830,2153,31,120,699,1771,730,1891
280510,201909,2520,6524,2166,6002,82,309,1663,4497,1745,4806
280520,201909,1583,4058,1382,3784,69,190,1102,2978,1171,3168
280530,201909,2558,6337,2175,5819,312,714,1514,4144,1826,4858
280540,201909,8881,23939,8062,22732,238,882,7030,19468,7268,20350
280550,201909,6569,15434,5340,13663,228,780,4295,10574,4523,11354
280560,201909,6959,19728,6516,19048,137,534,5722,16501,5859,17035
280570,201909,6321,15473,5107,13899,206,720,3801,10193,4007,10913
280580,201909,5506,14994,4721,13782,502,1425,3317,9710,3819,11135
280590,201909,2894,6547,2440,6017,117,440,1897,4455,2014,4895
280600,201909,3497,9433,3078,8819,161,517,2203,6300,2364,6817
280610,201909,2459,6065,2211,5697,141,363,1801,4590,1942,4953
280620,201909,5302,13153,4488,12058,404,913,3176,8847,3580,9760
280630,201909,3763,10741,3423,10240,173,609,2754,8152,2927,8761
280640,201909,2384,6413,2106,6093,62,191,1871,5410,1933,5601
280650,201909,1185,3109,941,2737,100,330,672,1869,772,2199
280660,201909,3227,7430,2818,6934,122,307,2460,6002,2582,6309
280670,201909,19192,43502,16575,40146,863,2313,13320,31844,14183,34157
280680,201909,2722,6581,2318,5998,204,392,1679,4385,1883,4777
280690,201909,918,2308,759,2086,30,97,591,1590,621,1687
280700,201909,1130,2876,964,2615,21,94,767,2029,788,2123
280710,201909,14951,33803,12621,31138,469,943,10834,27208,11303,28151
280720,201909,2636,5988,2158,5421,75,234,1482,3902,1557,4136
280730,201909,1043,2700,928,2508,50,148,703,1845,753,1993
280740,201909,13982,34235,11856,30965,818,2273,8416,21478,9234,23751
280750,201909,3531,9963,3082,9160,178,617,2221,6472,2399,7089
280760,201909,6213,16859,5419,15621,543,1482,3650,10752,4193,12234
290010,201909,3148,6631,2060,4920,9,32,1679,3817,1688,3849
290020,201909,5384,14298,4887,13648,350,688,4095,11810,4445,12498
290030,201909,4361,10300,3589,9437,169,419,3030,8026,3199,8445
290035,201909,5159,11313,4189,10045,381,605,3294,8258,3675,8863
290040,201909,4169,10180,3551,9424,117,309,2827,7814,2944,8123
290050,201909,2028,6494,1698,5775,123,500,1144,3794,1267,4294
290060,201909,1293,3152,942,2575,69,237,635,1686,704,1923
290070,201909,35661,79194,30630,72816,1806,4529,23517,55257,25323,59786
290080,201909,5271,15583,4484,14386,464,1646,3095,9984,3559,11630
290090,201909,2171,4200,1553,3538,21,67,1413,3181,1434,3248
290100,201909,9664,25470,7824,22674,1237,3372,4383,13189,5620,16561
290110,201909,5078,13545,4508,12590,362,1074,3223,8919,3585,9993
290115,201909,3965,11473,3337,10372,226,769,2481,7632,2707,8401
290120,201909,6371,15897,5387,14556,126,452,4666,12411,4792,12863
290130,201909,4610,11190,3617,9925,159,515,2831,7686,2990,8201
290135,201909,4170,9829,3373,8509,222,578,2564,6298,2786,6876
290140,201909,4454,11868,3485,10560,99,397,2959,8873,3058,9270
290150,201909,2434,6379,2098,5954,147,431,1597,4517,1744,4948
290160,201909,3149,7456,2799,6981,305,668,2135,5389,2440,6057
290170,201909,3254,8440,2879,8015,111,320,2557,7157,2668,7477
290180,201909,2929,8008,2403,7140,79,292,1952,5736,2031,6028
290190,201909,4100,11807,3598,11122,159,681,2943,8931,3102,9612
290195,201909,2326,5806,1833,5119,28,144,1526,4223,1554,4367
290200,201909,4040,11275,3297,10038,218,747,2495,7517,2713,8264
290205,201909,3332,8590,2933,7999,135,496,2304,6065,2439,6561
290210,201909,13193,36717,11576,34264,915,2485,8860,26729,9775,29214
290220,201909,2802,7060,2450,6604,132,383,1989,5310,2121,5693
290225,201909,3304,7035,2561,6245,171,299,2139,5319,2310,5618
290230,201909,2480,6542,2248,6268,33,110,2018,5599,2051,5709
290240,201909,3603,9123,2899,8211,82,285,2448,6893,2530,7178
290250,201909,4001,11637,3389,10742,125,432,2745,8846,2870,9278
290260,201909,5310,13257,4354,11890,191,673,3557,9461,3748,10134
290265,201909,3452,10182,2779,8865,155,592,2049,6440,2204,7032
290270,201909,11084,37719,10416,36575,535,2384,8376,29008,8911,31392
290280,201909,5874,17644,5080,16077,318,1146,3672,11475,3990,12621
290290,201909,9755,28580,7922,25158,820,2866,5207,16213,6027,19079
290300,201909,4201,11452,3099,9364,170,580,2208,6652,2378,7232
290310,201909,1541,3885,1250,3519,73,298,944,2560,1017,2858
290320,201909,23663,62431,18761,54849,4197,12174,9009,27566,13206,39740
290323,201909,3728,10136,3228,9373,101,320,2584,7450,2685,7770
290327,201909,4118,11935,3480,10687,271,797,2453,7474,2724,8271
290330,201909,2158,4553,1682,4035,48,99,1488,3589,1536,3688
290340,201909,5564,14206,4316,12637,474,1442,3075,9127,3549,10569
290350,201909,4670,12982,3848,11586,283,888,2748,8287,3031,9175
290360,201909,4988,13188,4372,12368,121,370,3793,10736,3914,11106
290370,201909,5224,12675,3829,10855,160,363,2839,8205,2999,8568
290380,201909,5539,14768,4691,13590,111,302,4072,11950,4183,12252
290390,201909,14330,40257,11955,36665,1267,3760,8013,25039,9280,28799
290395,201909,2754,8084,2246,7194,73,349,1747,5487,1820,5836
290400,201909,3676,9922,2943,8711,86,376,2252,6474,2338,6850
290405,201909,4509,13296,3822,12078,282,959,2686,8606,2968,9565
290410,201909,5656,15568,4354,13403,126,589,3304,9827,3430,10416
290420,201909,2924,8274,2402,7431,70,267,1856,5692,1926,5959
290430,201909,3090,8573,2520,7677,258,819,1660,5022,1918,5841
290440,201909,2786,7046,1987,5786,41,131,1422,4216,1463,4347
290450,201909,3326,8709,2644,7683,147,459,1984,5744,2131,6203
290460,201909,11572,32535,9723,29017,1961,5972,4538,13436,6499,19408
290470,201909,4392,10968,3248,9371,364,1143,1859,5430,2223,6573
290475,201909,6414,18621,5390,16776,119,611,4343,13188,4462,13799
290480,201909,1726,4415,1431,3984,88,296,988,2623,1076,2919
290485,201909,4471,13163,3956,12414,121,619,3344,10257,3465,10876
290490,201909,9071,21389,8045,19996,499,1204,6348,15863,6847,17067
290500,201909,3828,11621,2945,9651,527,1812,1347,4296,1874,6108
290510,201909,3336,8427,2790,7717,78,271,2397,6562,2475,6833
290515,201909,3668,10038,3152,9344,49,153,2804,8474,2853,8627
290520,201909,11158,32011,8595,26984,497,1743,5401,16645,5898,18388
290530,201909,4909,14065,4164,12840,135,502,3493,10728,3628,11230
290540,201909,3384,9030,3025,8593,71,244,2765,7819,2836,8063
290550,201909,4274,11206,3703,10535,16,74,3414,9820,3430,9894
290560,201909,6416,16672,4866,14341,428,1553,3207,9094,3635,10647
290570,201909,42289,104930,37863,99279,2416,6570,30583,79591,32999,86161
290580,201909,7743,22918,6717,21417,623,2020,4874,15862,5497,17882
290590,201909,6972,21590,5912,19672,136,562,4813,16033,4949,16595
290600,201909,18376,51413,16303,48073,696,2251,13049,38328,13745,40579
290610,201909,2513,7923,1955,6762,95,406,1362,4643,1457,5049
290620,201909,6471,18106,5556,16570,200,586,4646,13804,4846,14390
290630,201909,9053,22147,7178,19653,600,1608,5521,15225,6121,16833
290640,201909,2704,7068,2065,6116,73,227,1528,4524,1601,4751
290650,201909,12512,31854,11151,30253,2738,7071,6492,18597,9230,25668
290660,201909,3637,9365,3025,8480,50,126,2276,6609,2326,6735
290670,201909,6531,18356,5561,16747,397,1154,4260,12971,4657,14125
290680,201909,10604,29677,8951,27217,191,1034,7367,21872,7558,22906
290682,201909,4664,12220,4055,11377,133,328,3425,9674,3558,10002
290685,201909,3323,7595,2383,6246,187,469,1523,4231,1710,4700
290687,201909,6548,17817,5301,15749,705,2014,3377,10283,4082,12297
290689,201909,2733,7733,2159,6701,120,368,1610,5020,1730,5388
290690,201909,5501,14192,4433,12685,348,1060,3209,9070,3557,10130
290700,201909,2571,7075,2263,6668,79,259,1861,5516,1940,5775
290710,201909,8301,23402,7056,21652,163,684,5994,18330,6157,19014
290720,201909,18585,50820,16826,48121,926,3041,13347,37588,14273,40629
290730,201909,7052,16917,6007,15686,295,639,4719,12450,5014,13089
290740,201909,1025,2784,775,2362,35,141,615,1870,650,2011
290750,201909,10839,27261,9369,24843,708,2036,6848,17596,7556,19632
290755,201909,2054,5791,1656,5055,99,323,1150,3500,1249,3823
290760,201909,3706,10900,2946,9439,206,623,1949,6407,2155,7030
290770,201909,2594,8387,2351,8085,51,267,1983,6852,2034,7119
290780,201909,8201,20320,7040,18758,280,647,5578,15069,5858,15716
290790,201909,4633,12684,4030,11859,152,439,3380,10082,3532,10521
290800,201909,7143,14808,5076,12372,325,758,3755,9225,4080,9983
290810,201909,5406,14263,4305,12630,116,387,3231,9633,3347,10020
290820,201909,4768,12932,4283,12204,180,548,3264,9411,3444,9959
290830,201909,4511,10231,4044,9635,40,118,3551,8333,3591,8451
290840,201909,16426,44208,14300,40874,1817,4338,9325,28095,11142,32433
290850,201909,6412,15769,5776,15071,274,676,4899,12924,5173,13600
290860,201909,5925,17339,5168,16432,216,744,4366,14085,4582,14829
290870,201909,4728,13064,3590,10941,114,398,2548,7680,2662,8078
290880,201909,1369,3453,1092,3091,66,187,769,2225,835,2412
290890,201909,9020,18456,8071,17367,157,364,7554,16153,7711,16517
290900,201909,2292,6031,1723,5076,99,276,1111,3240,1210,3516
290910,201909,5053,12176,3859,10358,43,148,3236,8599,3279,8747
290920,201909,5049,12635,4615,12116,53,124,4351,11495,4404,11619
290930,201909,7657,21449,6151,18813,188,872,4812,14242,5000,15114
290940,201909,3662,10305,3035,9409,176,670,2386,7394,2562,8064
290950,201909,1457,3687,1192,3301,63,175,852,2373,915,2548
290960,201909,5434,14393,4865,13676,159,439,4103,11517,4262,11956
290970,201909,3422,9937,2773,8788,111,406,2121,6715,2232,7121
290980,201909,11829,28698,9927,25717,821,2306,6164,15496,6985,17802
290990,201909,9300,24976,8132,23061,286,1144,6774,18556,7060,19700
291000,201909,3381,8887,2648,7963,135,402,2148,6541,2283,6943
291005,201909,14921,36823,13129,34450,959,2481,10513,27474,11472,29955
291010,201909,2940,8935,2370,7723,118,443,1581,5016,1699,5459
291020,201909,1260,3120,1002,2637,22,78,734,1833,756,1911
291030,201909,2424,5968,1680,4656,98,269,1080,2899,1178,3168
291040,201909,5263,14684,4456,13530,170,697,3512,10587,3682,11284
291050,201909,7450,19825,6407,18330,716,2267,4512,12669,5228,14936
291060,201909,5774,18141,4977,17022,342,1485,3782,12817,4124,14302
291070,201909,15535,42223,13010,38175,473,1646,10530,30646,11003,32292
291072,201909,23525,60965,16903,49321,3246,9836,7237,21325,10483,31161
291075,201909,5209,13136,4640,12237,111,313,3839,9918,3950,10231
291077,201909,1556,4074,1209,3466,43,111,870,2489,913,2600
291080,201909,90582,234046,71674,206615,23480,69488,18021,55548,41501,125036
291085,201909,5563,14143,4682,12790,202,653,3911,10578,4113,11231
291090,201909,1959,3675,1427,3085,31,72,1190,2542,1221,2614
291100,201909,3130,6935,2175,5772,115,340,1666,4346,1781,4686
291110,201909,5937,17653,5024,16076,327,1348,3756,11520,4083,12868
291120,201909,7529,18574,6373,17086,321,938,4855,12963,5176,13901
291125,201909,2142,3791,1572,3154,130,193,1191,2483,1321,2676
291130,201909,3168,9107,2330,7435,89,407,1670,5125,1759,5532
291140,201909,4726,12902,3440,10490,423,1135,2164,6650,2587,7785
291150,201909,2358,5232,1867,4674,7,27,1761,4396,1768,4423
291160,201909,5050,13902,4150,12574,390,1230,2741,8237,3131,9467
291165,201909,2110,5781,1617,4850,42,184,1174,3375,1216,3559
291170,201909,20436,51917,17105,46283,966,2856,11283,30043,12249,32899
291180,201909,5946,14056,4403,11888,327,840,3340,9065,3667,9905
291185,201909,3059,8320,2689,7714,80,251,2073,5923,2153,6174
291190,201909,7478,18526,6182,16824,321,1013,4855,13155,5176,14168
291200,201909,2735,7593,2023,6228,98,330,1228,3659,1326,3989
291210,201909,6809,14917,5180,13009,149,503,3891,9766,4040,10269
291220,201909,3942,11343,3557,10741,196,725,2772,8258,2968,8983
291230,201909,4388,9539,3378,8420,46,107,3026,7621,3072,7728
291240,201909,4174,10745,3594,9783,60,212,3094,8300,3154,8512
291250,201909,3384,10002,2654,8669,165,533,1714,5620,1879,6153
291260,201909,1416,3331,1177,3020,32,98,967,2485,999,2583
291270,201909,5243,13892,4130,12215,628,1847,2624,7898,3252,9745
291280,201909,2443,6126,1833,5204,126,432,1191,3258,1317,3690
291290,201909,5767,15340,4486,13305,346,1143,3080,9047,3426,10190
291300,201909,3793,10287,2907,8804,119,431,2192,6516,2311,6947
291310,201909,5051,13539,4291,12118,110,376,3602,9985,3712,10361
291320,201909,6046,16976,4659,14356,1097,3139,2265,7418,3362,10557
291330,201909,1768,4471,1461,3957,76,208,1089,2899,1165,3107
291340,201909,4150,10737,3394,9443,83,269,2592,7072,2675,7341
291345,201909,2904,8823,2649,8424,114,415,2208,7002,2322,7417
291350,201909,6737,16936,5236,15057,64,214,4492,13138,4556,13352
291360,201909,35845,83548,28357,74291,2920,7793,18303,48796,21223,56589
291370,201909,7741,21442,6909,20196,509,1642,5159,14849,5668,16491
291380,201909,3314,9277,2951,8757,85,413,2453,7146,2538,7559
291390,201909,12971,28188,10133,25041,386,994,8450,20811,8836,21805
291400,201909,13344,34693,11046,31200,1544,3859,6613,20003,8157,23862
291410,201909,2823,7454,2164,6324,46,197,1592,4542,1638,4739
291420,201909,1926,4768,1502,4234,38,152,1295,3636,1333,3788
291430,201909,2804,7953,2410,7298,102,454,1896,5559,1998,6013
291440,201909,6214,18011,5334,16528,308,1053,4212,13030,4520,14083
291450,201909,8866,22514,7376,20786,99,180,6467,18829,6566,19009
291460,201909,15119,40519,13300,37782,647,2120,10096,28410,10743,30530
291465,201909,8898,22432,7050,20308,172,778,6010,17157,6182,17935
291470,201909,15589,35889,13072,33064,614,1459,9808,25450,10422,26909
291480,201909,40326,90217,29418,75118,3719,9906,15474,39431,19193,49337
291490,201909,5512,13877,4820,13055,146,483,4344,11696,4490,12179
291500,201909,4939,12149,4099,11027,68,303,3693,9858,3761,10161
291510,201909,4089,10321,3078,9026,61,319,2538,7387,2599,7706
291520,201909,4471,10237,3387,8807,168,480,2600,6704,2768,7184
291530,201909,2220,5195,1578,4341,292,723,920,2759,1212,3482
291535,201909,3269,9720,2943,9132,176,513,2261,7133,2437,7646
291540,201909,2231,5072,1549,4234,53,207,1290,3442,1343,3649
291550,201909,5486,12726,4298,11182,396,892,2933,7771,3329,8663
291560,201909,18617,43268,13158,36363,1175,3158,8413,24083,9588,27241
291570,201909,2385,5679,1882,5044,50,139,1565,4313,1615,4452
291580,201909,6142,16045,4815,14253,220,755,3608,10521,3828,11276
291590,201909,2016,5131,1753,4800,94,335,1500,4012,1594,4347
291600,201909,5003,12273,3734,10262,413,1261,2413,6413,2826,7674
291610,201909,5695,15166,5196,14599,93,342,4747,13313,4840,13655
291620,201909,3106,6956,2277,6030,108,293,1774,4763,1882,5056
291630,201909,3183,7276,2362,6210,222,672,1741,4492,1963,5164
291640,201909,15075,37824,11407,32428,1784,4902,5036,15067,6820,19969
291650,201909,9274,23531,8188,22212,536,1082,6876,19090,7412,20172
291660,201909,2043,5030,1482,4143,132,464,961,2519,1093,2983
291670,201909,2052,5387,1729,4933,100,251,1340,3866,1440,4117
291680,201909,3998,9939,3235,8792,296,835,2293,6177,2589,7012
291685,201909,4610,11032,3658,9812,217,442,2788,7768,3005,8210
291690,201909,4157,9209,2820,7289,210,460,2178,5647,2388,6107
291700,201909,8496,24760,7500,22981,342,1251,6095,18330,6437,19581
291710,201909,5136,12422,3841,10573,232,728,2777,7490,3009,8218
291720,201909,4293,13192,3584,11760,386,1384,2386,7630,2772,9014
291730,201909,6232,16143,5360,14982,282,862,4376,12177,4658,13039
291733,201909,2878,7342,2430,6746,71,199,1780,5161,1851,5360
291735,201909,2900,7559,2313,6548,77,227,1766,4964,1843,5191
291740,201909,3833,9935,2855,8178,97,295,2037,5691,2134,5986
291750,201909,19245,46154,15548,40653,1460,3807,10578,27761,12038,31568
291760,201909,10141,29557,7910,25846,2421,8940,2136,6972,4557,15912
291770,201909,6922,18777,5735,16678,395,1205,4205,11939,4600,13144
291780,201909,5025,13490,4531,12765,91,355,3939,10950,4030,11305
291790,201909,2619,7426,2390,7125,254,651,1782,5457,2036,6108
291800,201909,28310,72041,21200,61231,3277,9156,10876,32516,14153,41672
291810,201909,10603,25414,8791,23174,238,674,7585,19913,7823,20587
291820,201909,3763,10005,3269,9335,98,318,2603,7466,2701,7784
291830,201909,4263,10295,3574,9343,196,491,2845,7462,3041,7953
291835,201909,6382,19130,4941,16298,634,2200,3008,10072,3642,12272
291840,201909,46634,127992,40148,118085,4462,14014,27892,81700,32354,95714
291845,201909,2377,6309,1885,5693,97,323,1525,4644,1622,4967
291850,201909,3889,11158,3221,10026,257,745,2310,7378,2567,8123
291855,201909,2175,4318,1706,3784,42,108,1543,3410,1585,3518
291860,201909,2228,5839,1526,4466,46,140,1028,2884,1074,3024
291870,201909,1298,3249,858,2477,53,155,571,1617,624,1772
291875,201909,2754,8263,2384,7505,73,290,1774,5430,1847,5720
291880,201909,5519,15733,4753,14449,235,715,3587,10907,3822,11622
291890,201909,1552,3259,1000,2604,119,289,684,1781,803,2070
291900,201909,1152,2899,892,2478,22,84,702,1898,724,1982
291905,201909,2525,6402,2015,5571,82,280,1517,4044,1599,4324
291910,201909,2903,7373,2430,6804,59,221,2120,5937,2179,6158
291915,201909,7320,20870,5955,18512,248,895,4448,13848,4696,14743
291920,201909,25175,66655,21457,61373,2288,7102,14670,41162,16958,48264
291930,201909,2468,6740,2096,6200,256,779,1363,4033,1619,4812
291940,201909,3931,10089,2575,7757,192,582,1494,4429,1686,5011
291950,201909,9011,27230,7668,24588,348,1290,5309,16828,5657,18118
291955,201909,14883,37676,13281,35591,1126,3157,10387,27850,11513,31007
291960,201909,3024,8109,2493,7359,120,404,1946,5814,2066,6218
291970,201909,4341,11180,3678,10303,139,479,2789,7816,2928,8295
291980,201909,9736,27714,7697,24310,759,2275,4942,15871,5701,18146
291990,201909,2153,5652,1843,5297,23,102,1734,4985,1757,5087
291992,201909,3915,9522,3036,8360,238,566,2405,6735,2643,7301
291995,201909,2075,5635,1672,5027,47,213,1301,3805,1348,4018
292000,201909,2609,6195,2118,5588,98,398,1679,4370,1777,4768
292010,201909,5820,13474,4706,11894,196,603,3884,9601,4080,10204
292020,201909,4492,13021,3706,11613,199,753,2709,8228,2908,8981
292030,201909,1773,5473,1640,5236,75,279,1054,3290,1129,3569
292040,201909,4247,11099,3354,9768,239,662,2563,7617,2802,8279
292045,201909,3959,10430,2937,8914,44,120,2572,7977,2616,8097
292050,201909,6379,18014,5109,15701,257,929,3236,9758,3493,10687
292060,201909,11508,26712,10634,25632,546,1224,9210,21989,9756,23213
292070,201909,5775,15021,5094,14183,284,839,4392,12120,4676,12959
292080,201909,3172,7949,2597,7216,80,265,2299,6348,2379,6613
292090,201909,4488,9779,3210,8250,247,677,2437,6311,2684,6988
292100,201909,10379,25554,8793,23512,1043,2949,5888,15659,6931,18608
292105,201909,3397,8647,2964,8033,86,207,2412,6559,2498,6766
292110,201909,5893,14567,4124,11662,973,2790,1881,5324,2854,8114
292120,201909,6741,17408,5532,15340,361,1087,4204,11415,4565,12502
292130,201909,3356,8081,2744,7317,114,352,2150,5642,2264,5994
292140,201909,5079,11967,4221,10700,294,744,3371,8480,3665,9224
292145,201909,2292,6686,1933,6053,58,179,1490,4698,1548,4877
292150,201909,13469,37242,11889,34722,292,1205,9838,28297,10130,29502
292160,201909,2994,7340,2254,6387,55,161,1836,5370,1891,5531
292170,201909,8180,21902,6805,19579,385,1278,5041,14235,5426,15513
292180,201909,2762,7559,2004,6168,185,560,1253,3785,1438,4345
292190,201909,2833,7517,2406,6865,116,369,1837,5215,1953,5584
292200,201909,7959,20300,5922,17383,1013,3085,3167,9504,4180,12589
292205,201909,3882,10671,3331,9834,68,312,2920,8525,2988,8837
292210,201909,6354,14969,5119,13386,96,436,4572,11769,4668,12205
292220,201909,2092,5082,1841,4685,57,173,1453,3563,1510,3736
292225,201909,3159,9294,2770,8706,72,339,2345,7228,2417,7567
292230,201909,8509,20277,7591,19096,183,634,6469,15940,6652,16574
292240,201909,4678,13623,4039,12444,309,932,2811,8671,3120,9603
292250,201909,5248,14174,4703,13316,474,1307,3314,9451,3788,10758
292260,201909,3340,8805,2995,8361,120,325,2577,7202,2697,7527
292265,201909,3299,9073,2760,8237,71,335,2169,6307,2240,6642
292270,201909,4351,9969,3466,8914,148,360,2825,7282,2973,7642
292273,201909,2609,5694,2075,5028,59,108,1567,3999,1626,4107
292275,201909,1644,4297,1299,3814,57,154,979,2923,1036,3077
292280,201909,2603,6205,2097,5616,96,201,1765,4868,1861,5069
292285,201909,2552,6211,2012,5470,82,217,1614,4394,1696,4611
292290,201909,7297,19522,5829,17438,172,654,4760,14195,4932,14849
292300,201909,10001,25580,7806,22677,752,2373,5355,15506,6107,17879
292303,201909,2869,8263,2516,7704,71,199,2115,6505,2186,6704
292305,201909,2345,6298,2174,6060,48,226,1957,5342,2005,5568
292310,201909,6618,16820,5684,15668,152,530,4920,13399,5072,13929
292320,201909,6061,16507,4809,14192,240,769,3570,10267,3810,11036
292330,201909,2791,6072,2187,5396,104,228,1685,4304,1789,4532
292335,201909,4704,12139,4186,11400,248,606,3522,9665,3770,10271
292340,201909,5619,15619,4645,13750,216,661,3464,10137,3680,10798
292350,201909,2503,6713,2071,6138,76,285,1684,4976,1760,5261
292360,201909,4779,12874,3971,11481,244,817,2801,7859,3045,8676
292370,201909,10626,24458,9107,22426,138,480,8409,20361,8547,20841
292380,201909,6715,18861,5992,17568,416,1230,4539,13228,4955,14458
292390,201909,4382,8544,3195,7156,97,190,2811,6304,2908,6494
292400,201909,21680,62368,18779,57667,1744,5616,13042,39984,14786,45600
292405,201909,4094,10274,3468,9313,111,303,2841,7546,2952,7849
292410,201909,2136,5094,1824,4709,63,160,1620,4187,1683,4347
292420,201909,3539,10691,3219,10167,124,599,2734,8404,2858,9003
292430,201909,4750,14269,3629,12225,312,1131,2363,7891,2675,9022
292440,201909,8369,26711,7728,25710,130,686,6913,22880,7043,23566
292450,201909,3851,11127,3045,9530,101,401,2370,7379,2471,7780
292460,201909,4781,13216,3907,11724,374,1080,2775,8361,3149,9441
292465,201909,2567,6735,2146,6158,92,214,1495,4611,1587,4825
292467,201909,1823,5144,1624,4870,237,630,1112,3474,1349,4104
292470,201909,2965,7505,2290,6435,64,136,1787,5031,1851,5167
292480,201909,6323,15018,5036,13458,70,282,4541,11996,4611,12278
292490,201909,2059,5429,1710,4908,106,274,1282,3745,1388,4019
292500,201909,6348,17508,5116,15255,527,1664,3362,9899,3889,11563
292510,201909,12475,33691,9848,29702,489,1829,7152,21451,7641,23280
292520,201909,6810,17055,5998,15867,489,1363,4609,12077,5098,13440
292525,201909,5797,13748,4748,12559,106,302,4157,11088,4263,11390
292530,201909,26181,70239,20168,60049,5284,15859,7529,23102,12813,38961
292540,201909,4226,7964,3323,6987,108,186,2967,6256,3075,6442
292550,201909,7976,21166,6077,18820,437,1408,4439,14292,4876,15700
292560,201909,4220,10699,3632,9913,83,270,2999,8169,3082,8439
292570,201909,3674,9636,3097,8647,80,299,2612,7106,2692,7405
292575,201909,6922,19811,6343,19015,350,1045,5128,15480,5478,16525
292580,201909,7472,18834,6237,17004,128,424,5260,14183,5388,14607
292590,201909,7286,19369,6270,17647,246,802,5280,14549,5526,15351
292593,201909,2807,6923,2320,6114,69,165,1950,5112,2019,5277
292595,201909,5417,14422,4644,13474,161,537,3885,11169,4046,11706
292600,201909,10947,29709,9379,27307,342,957,7397,21595,7739,22552
292610,201909,4069,10636,3418,9480,202,478,2542,7158,2744,7636
292620,201909,6484,17629,5357,16292,111,273,4945,15282,5056,15555
292630,201909,8363,20488,6774,17942,619,1663,4515,11965,5134,13628
292640,201909,8075,23981,7045,22274,197,850,5011,15865,5208,16715
292650,201909,4502,11037,4038,10432,108,294,3677,9379,3785,9673
292660,201909,11190,30318,9519,27828,446,1427,7373,21470,7819,22897
292665,201909,2153,6423,1891,6081,70,220,1595,5203,1665,5423
292670,201909,3505,9441,2691,7919,121,398,1833,5300,1954,5698
292680,201909,3929,10444,3099,8953,206,556,2245,6361,2451,6917
292690,201909,2603,6744,1798,5412,201,567,1070,3385,1271,3952
292700,201909,9727,26473,8436,24479,762,2075,5774,17228,6536,19303
292710,201909,2445,7664,2259,7407,49,187,2025,6682,2074,6869
292720,201909,8915,21344,7532,19770,243,673,6006,15990,6249,16663
292730,201909,4412,10295,4149,9972,198,311,3669,8975,3867,9286
292740,201909,311353,761499,271415,702627,39531,103152,169351,435658,208882,538810
292750,201909,6155,16396,5360,15220,247,724,4105,11791,4352,12515
292760,201909,3856,11158,3354,10251,232,809,2458,7425,2690,8234
292770,201909,5860,15733,4691,14049,765,2401,2865,8802,3630,11203
292780,201909,2029,4175,1504,3504,42,139,1197,2643,1239,2782
292790,201909,4100,8708,3135,7660,158,417,2623,6418,2781,6835
292800,201909,11004,27668,9457,25315,329,935,7870,20800,8199,21735
292805,201909,3404,8287,2666,7288,113,331,2086,5667,2199,5998
292810,201909,10536,27795,8293,24293,217,908,6194,17598,6411,18506
292820,201909,7463,20442,5352,16954,483,1601,3623,11316,4106,12917
292830,201909,2887,6797,2452,6259,91,303,2092,5290,2183,5593
292840,201909,8704,22759,7409,20996,156,623,6425,17818,6581,18441
292850,201909,2461,6531,2068,5944,136,419,1462,4166,1598,4585
292860,201909,16783,37364,15014,35184,555,1358,12731,29467,13286,30825
292870,201909,17260,43325,14851,39890,943,2733,10077,26716,11020,29449
292880,201909,10873,29573,9304,27203,302,1279,7344,20734,7646,22013
292890,201909,6821,19079,5999,17852,217,883,5148,15141,5365,16024
292895,201909,2904,6281,2135,5127,92,223,1719,4081,1811,4304
292900,201909,2549,6923,2334,6578,58,234,1907,5203,1965,5437
292905,201909,4292,11231,3360,9846,160,554,2465,7116,2625,7670
292910,201909,4818,13161,4376,12518,233,712,3337,9451,3570,10163
292920,201909,9630,26504,8949,25518,261,980,7757,21705,8018,22685
292925,201909,5345,15092,4494,13581,220,686,3299,9803,3519,10489
292930,201909,6399,18923,5430,17035,475,1703,3439,10452,3914,12155
292935,201909,2349,6015,1828,5425,33,152,1622,4829,1655,4981
292937,201909,2949,7203,2566,6716,59,187,2264,5894,2323,6081
292940,201909,2871,7297,2276,6404,182,442,1656,4815,1838,5257
292950,201909,9484,24137,8277,22287,507,1256,6253,16752,6760,18008
292960,201909,5168,12516,4341,11350,122,341,3480,8968,3602,9309
292970,201909,3769,10969,3312,10267,95,453,2765,8567,2860,9020
292975,201909,4477,9647,3961,9059,150,282,3570,8260,3720,8542
292980,201909,3285,7940,2651,6994,90,281,2140,5535,2230,5816
292990,201909,11265,30759,9390,27428,669,2101,6923,19918,7592,22019
293000,201909,2551,6134,2194,5606,37,138,1747,4460,1784,4598
293010,201909,17822,45794,14337,40221,1907,5535,8810,24609,10717,30144
293015,201909,7970,24530,6262,21196,421,1576,4246,14470,4667,16046
293020,201909,9786,28455,8798,27034,129,632,7869,24306,7998,24938
293030,201909,5245,14001,3970,12038,107,375,2762,8537,2869,8912
293040,201909,3973,10913,3369,10068,70,280,2927,8710,2997,8990
293050,201909,21492,53539,19082,50004,986,2766,14526,37521,15512,40287
293060,201909,3394,8980,2769,7863,245,733,1925,5359,2170,6092
293070,201909,24560,59771,20853,54897,2204,6064,14527,38288,16731,44352
293075,201909,3385,10777,2959,10066,182,764,2336,7927,2518,8691
293076,201909,3576,8763,3205,8307,71,182,2801,7317,2872,7499
293077,201909,6017,16736,4816,14833,447,1479,3094,9747,3541,11226
293080,201909,4725,13937,4046,12781,101,451,3246,10049,3347,10500
293090,201909,3184,9265,2421,8007,214,750,1610,5320,1824,6070
293100,201909,5572,15034,4563,13217,217,686,3567,10172,3784,10858
293105,201909,3607,11425,3176,10548,206,751,2311,7566,2517,8317
293110,201909,2356,5896,1973,5337,63,245,1628,4270,1691,4515
293120,201909,4325,11819,3834,11026,122,337,3192,9178,3314,9515
293130,201909,3726,10242,3261,9629,84,341,2803,8182,2887,8523
293135,201909,28991,68797,21255,58219,3354,9988,10056,27681,13410,37669
293140,201909,2352,5266,2023,4850,70,161,1686,4027,1756,4188
293150,201909,5239,15717,4360,14032,357,1227,3008,9685,3365,10912
293160,201909,3765,9209,3212,8600,230,401,2689,7530,2919,7931
293170,201909,4689,10025,4072,9237,133,292,3521,7933,3654,8225
293180,201909,4267,11964,3520,10644,108,454,2797,8237,2905,8691
293190,201909,13837,37999,12176,35617,174,749,10733,31193,10907,31942
293200,201909,8124,20309,6557,17850,212,816,5238,13914,5450,14730
293210,201909,5195,13730,4411,12503,308,856,3354,9518,3662,10374
293220,201909,4938,12933,3657,10743,863,2570,1452,4359,2315,6929
293230,201909,3909,10039,2896,8577,216,707,1994,5961,2210,6668
293240,201909,4412,11647,3529,10205,74,202,2711,8079,2785,8281
293245,201909,3769,10209,3392,9676,150,500,2864,8038,3014,8538
293250,201909,5671,13360,4698,12113,161,405,3946,10152,4107,10557
293260,201909,4349,11882,3557,10648,121,385,2520,7509,2641,7894
293270,201909,6986,15681,5577,14151,405,641,4366,11835,4771,12476
293280,201909,4558,11948,3969,11124,251,609,3087,8723,3338,9332
293290,201909,13665,40850,12075,38326,1949,6260,7513,24269,9462,30529
293300,201909,5707,13856,4894,12651,292,725,3597,9333,3889,10058
293305,201909,3906,9573,3421,8944,39,120,3077,7997,3116,8117
293310,201909,2132,5418,1755,4801,50,152,1384,3719,1434,3871
293315,201909,3995,9642,3285,8555,180,431,2697,7026,2877,7457
293317,201909,2519,6106,2216,5680,157,313,1728,4488,1885,4801
293320,201909,11433,28354,10317,27073,289,808,9152,23912,9441,24720
293325,201909,1711,4326,1339,3809,189,545,853,2430,1042,2975
293330,201909,47340,140724,38919,125461,8166,26865,17498,57621,25664,84486
293340,201909,2196,6188,1835,5560,100,345,1291,3850,1391,4195
293345,201909,3343,9206,2668,8198,330,786,1810,5992,2140,6778
293350,201909,6599,18840,5748,17857,61,289,5275,16575,5336,16864
293360,201909,15263,38194,12919,35130,335,1361,11325,30202,11660,31563
310010,201909,805,1901,542,1521,47,162,251,660,298,822
310020,201909,2257,6342,1603,5132,350,1240,296,892,646,2132
310030,201909,1869,5377,1451,4619,223,769,886,2733,1109,3502
310040,201909,918,2415,734,2096,35,137,497,1332,532,1469
310050,201909,1473,4491,1264,4158,150,611,798,2523,948,3134
310060,201909,3131,8945,2713,8397,101,431,2222,6793,2323,7224
310070,201909,333,756,228,601,5,12,172,452,177,464
310080,201909,737,1958,501,1512,79,270,213,603,292,873
310090,201909,4529,12240,3689,10849,301,956,2638,7623,2939,8579
310100,201909,3299,9343,2773,8441,88,402,2219,6543,2307,6945
310110,201909,4599,12223,3547,10351,770,2436,1514,4245,2284,6681
310120,201909,613,1516,390,1147,46,165,232,619,278,784
310130,201909,361,964,304,876,33,123,214,582,247,705
310140,201909,252,726,177,595,40,157,68,197,108,354
310150,201909,5043,13540,3699,10970,554,1871,1688,4728,2242,6599
310160,201909,7139,18086,5043,14639,1045,3301,1748,5081,2793,8382
310163,201909,997,2975,793,2583,200,743,263,780,463,1523
310170,201909,8799,22790,7013,19981,617,1807,4979,14150,5596,15957
310180,201909,1695,4254,1238,3510,144,463,766,2086,910,2549
310190,201909,2540,7472,1974,6421,466,1701,275,807,741,2508
310200,201909,1750,5262,1247,4221,216,826,527,1748,743,2574
310205,201909,1091,3030,808,2566,156,552,336,1055,492,1607
310210,201909,2604,6960,2112,6099,115,367,1569,4410,1684,4777
310220,201909,1145,3137,889,2675,99,332,583,1690,682,2022
310230,201909,2173,6133,1737,5275,245,854,1044,2957,1289,3811
310240,201909,883,2787,738,2526,44,185,526,1762,570,1947
310250,201909,1005,2705,804,2380,21,85,580,1684,601,1769
310260,201909,2749,7197,1669,5265,499,1846,412,957,911,2803
310270,201909,2683,6717,2090,5900,102,381,1712,4785,1814,5166
310280,201909,2295,5435,1757,4639,290,825,952,2374,1242,3199
310285,201909,1815,5870,1529,5348,168,675,923,3182,1091,3857
310290,201909,1097,2893,891,2522,206,682,477,1197,683,1879
310300,201909,1413,4206,1208,3841,161,644,677,1982,838,2626
310310,201909,299,753,187,544,34,103,98,279,132,382
310320,201909,514,1335,338,1035,27,102,182,536,209,638
310330,201909,467,1104,275,756,38,126,117,282,155,408
310340,201909,7485,20612,5981,18022,897,2625,2984,9238,3881,11863
310350,201909,11977,29039,7979,22481,1639,4859,3300,9030,4939,13889
310360,201909,472,1097,349,937,11,36,256,676,267,712
310370,201909,1241,3910,1028,3489,218,811,320,1100,538,1911
310375,201909,805,2037,543,1646,90,285,263,792,353,1077
310380,201909,362,807,191,534,32,96,87,223,119,319
310390,201909,425,1280,334,1108,88,321,92,254,180,575
310400,201909,9257,22632,6428,18258,766,2515,3764,10372,4530,12887
310410,201909,833,2409,538,1862,96,354,178,579,274,933
310420,201909,4049,10390,2626,7614,376,1234,1019,2689,1395,3923
310430,201909,1440,3934,919,2944,195,704,319,909,514,1613
310440,201909,583,1508,402,1182,36,142,232,651,268,793
310445,201909,1312,3824,968,3141,44,163,700,2225,744,2388
310450,201909,4657,11741,3470,9843,162,616,2606,7147,2768,7763
310460,201909,1537,4067,1052,3157,185,592,335,965,520,1557
310470,201909,3768,8228,2922,7136,290,733,2114,5180,2404,5913
310480,201909,888,2358,679,1975,96,303,427,1210,523,1513
310490,201909,2768,7630,2143,6533,264,980,1158,3282,1422,4262
310500,201909,1346,3842,978,3193,177,661,490,1544,667,2205
310510,201909,1941,5128,1206,3731,241,828,434,1354,675,2182
310520,201909,1181,3056,849,2470,131,351,471,1374,602,1725
310530,201909,723,1854,404,1223,63,227,120,289,183,516
310540,201909,3011,8618,2474,7674,566,1840,1105,3287,1671,5127
310550,201909,1217,3145,828,2469,71,257,482,1354,553,1611
310560,201909,13769,36234,9701,29087,1643,5626,3832,10317,5475,15943
310570,201909,1041,2766,822,2454,63,234,579,1693,642,1927
310590,201909,3996,10711,3180,9217,226,771,1825,4990,2051,5761
310600,201909,1323,3911,1065,3390,156,564,555,1650,711,2214
310610,201909,478,1256,293,940,51,180,149,443,200,623
310620,201909,162832,417265,116360,332483,18729,61697,54541,140045,73270,201742
310630,201909,4258,11765,3398,10117,278,949,2190,6283,2468,7232
310640,201909,964,2923,794,2570,176,640,316,951,492,1591
310650,201909,2363,6859,1708,5600,185,655,957,3029,1142,3684
310660,201909,1231,3363,1020,3090,33,123,866,2587,899,2710
310665,201909,1343,3508,1061,3095,30,119,885,2569,915,2688
310670,201909,51900,135513,43423,120734,4447,14341,29400,77586,33847,91927
310680,201909,704,1714,577,1526,16,64,478,1218,494,1282
310690,201909,1750,4689,1263,3855,119,419,702,2040,821,2459
310700,201909,475,1060,370,936,30,100,275,665,305,765
310710,201909,5245,15152,3721,12905,881,3530,535,1731,1416,5261
310720,201909,931,2269,724,1996,42,143,522,1387,564,1530
310730,201909,9401,25809,8038,23585,382,1461,5928,16989,6310,18450
310740,201909,5544,15486,3681,11504,638,2157,1222,3556,1860,5713
310750,201909,1172,2811,829,2303,122,385,397,1015,519,1400
310760,201909,542,1424,390,1193,23,74,210,657,233,731
310770,201909,1058,2953,718,2403,80,319,362,1134,442,1453
310780,201909,4158,10128,3447,9069,83,259,2732,7138,2815,7397
310790,201909,1772,5645,1527,5118,390,1397,322,1004,712,2401
310800,201909,2124,6350,1513,5088,365,1440,99,290,464,1730
310810,201909,1123,2896,896,2459,42,135,631,1679,673,1814
310820,201909,1150,2996,678,2163,150,523,157,498,307,1021
310825,201909,2409,7596,1940,6781,82,489,1526,5122,1608,5611
310830,201909,1564,4533,1053,3458,208,777,442,1360,650,2137
310840,201909,1786,4889,1256,3978,349,1229,300,834,649,2063
310850,201909,1462,4033,1232,3712,54,270,949,2716,1003,2986
310855,201909,3080,8198,2355,7019,180,609,1637,4768,1817,5377
310860,201909,6722,19570,5357,16861,529,1807,3302,10401,3831,12208
310870,201909,999,2399,754,2032,59,155,551,1496,610,1651
310880,201909,987,2943,757,2473,102,347,443,1403,545,1750
310890,201909,2235,6386,1397,4689,279,1004,201,578,480,1582
310900,201909,3806,10655,2570,7945,378,1215,1130,3235,1508,4450
310910,201909,1924,4848,1265,3720,117,426,234,610,351,1036
310920,201909,1830,4832,1379,4124,207,667,766,2243,973,2910
310925,201909,931,2591,744,2272,78,273,495,1438,573,1711
310930,201909,5567,14849,3940,12202,778,2515,1885,5985,2663,8500
310940,201909,6281,15406,4977,13439,224,806,3699,9638,3923,10444
310945,201909,1251,3290,979,2852,114,376,556,1577,670,1953
310950,201909,1842,5504,1188,4015,228,855,414,1244,642,2099
310960,201909,679,1761,397,1234,79,275,106,314,185,589
310970,201909,1108,3300,759,2535,206,734,147,452,353,1186
310980,201909,283,678,182,515,19,59,117,325,136,384
310990,201909,1208,3419,910,2874,170,559,440,1365,610,1924
311000,201909,3897,10983,2837,9159,706,2454,1153,3580,1859,6034
311010,201909,828,2494,654,2125,225,801,236,735,461,1536
311020,201909,977,2553,623,1903,52,172,313,935,365,1107
311030,201909,1514,3829,1022,2985,199,673,470,1255,669,1928
311040,201909,295,922,228,764,66,232,67,209,133,441
311050,201909,2588,6525,1927,5530,376,1208,929,2561,1305,3769
311060,201909,2854,7445,1996,5765,304,1034,795,2077,1099,3111
311070,201909,2164,5545,1527,4487,187,691,772,2131,959,2822
311080,201909,1035,2438,844,2125,46,166,645,1522,691,1688
311090,201909,1961,6314,1529,5501,344,1411,476,1669,820,3080
311100,201909,2074,5979,1220,4219,246,960,198,614,444,1574
311110,201909,3576,7425,1953,5128,376,1049,732,1950,1108,2999
311115,201909,1301,3066,1063,2737,68,180,852,2152,920,2332
311120,201909,6248,16512,4609,13463,712,2356,1699,4384,2411,6740
311130,201909,1833,4805,1363,4142,120,475,763,2230,883,2705
311140,201909,1343,3350,1011,2886,78,255,654,1846,732,2101
311150,201909,1497,4734,1163,4068,187,734,627,2115,814,2849
311160,201909,3473,10044,2392,8033,609,2302,714,2322,1323,4624
311170,201909,853,2215,674,1965,42,119,431,1319,473,1438
311180,201909,1289,2911,790,2159,157,460,355,961,512,1421
311190,201909,915,2526,664,2032,114,392,258,693,372,1085
311200,201909,1818,4995,1252,3866,286,970,394,1087,680,2057
311205,201909,842,2579,691,2264,42,192,422,1315,464,1507
311210,201909,997,2931,863,2758,116,343,633,2071,749,2414
311220,201909,723,2044,596,1818,54,186,358,1032,412,1218
311230,201909,7450,22554,5510,18562,976,3438,2074,7141,3050,10579
311240,201909,950,2528,720,2205,157,508,321,982,478,1490
311250,201909,892,2556,678,2159,165,513,288,895,453,1408
311260,201909,2444,6110,1511,4460,245,791,627,1712,872,2503
311265,201909,1270,3348,937,2783,41,168,660,1874,701,2042
311270,201909,2901,8694,2511,8037,169,748,1867,5686,2036,6434
311280,201909,1100,2846,481,1568,94,329,59,178,153,507
311290,201909,1815,5581,1662,5254,161,528,1126,3544,1287,4072
311300,201909,4588,13067,3744,11612,213,919,2929,8835,3142,9754
311310,201909,543,1508,455,1354,46,144,258,739,304,883
311320,201909,3028,9333,2550,8247,404,1501,1173,3485,1577,4986
311330,201909,4735,12780,3811,11247,416,1372,2153,6429,2569,7801
311340,201909,9774,27813,7598,23857,2142,7296,1959,5820,4101,13116
311350,201909,2227,5623,1536,4351,143,479,833,2102,976,2581
311360,201909,1092,2718,676,2037,209,714,203,558,412,1272
311370,201909,4411,10905,3237,8989,162,647,2094,5483,2256,6130
311380,201909,356,1104,265,917,68,240,105,372,173,612
311390,201909,1646,5126,1284,4611,538,2201,311,971,849,3172
311400,201909,1346,3753,972,3038,137,461,397,1115,534,1576
311410,201909,1528,4542,1253,4157,203,768,705,2357,908,3125
311420,201909,1419,4162,944,3139,181,663,198,527,379,1190
311430,201909,3503,9407,2235,6863,453,1435,669,2066,1122,3501
311440,201909,2431,7001,1714,5742,378,1486,562,1807,940,3293
311450,201909,1659,5027,1184,4108,298,1159,311,931,609,2090
311455,201909,942,2152,624,1676,169,464,236,649,405,1113
311460,201909,459,1434,305,1115,66,320,85,262,151,582
311470,201909,452,1433,296,1049,75,313,40,126,115,439
311480,201909,1057,2798,881,2533,54,146,685,1993,739,2139
311490,201909,224,661,170,552,34,134,81,231,115,365
311500,201909,408,1018,304,863,28,95,190,514,218,609
311510,201909,2975,7916,1951,6053,308,1084,784,2246,1092,3330
311520,201909,539,1585,484,1475,73,266,278,811,351,1077
311530,201909,8431,19787,5190,14461,1262,3911,1327,3550,2589,7461
311535,201909,746,2051,482,1506,75,250,161,467,236,717
311540,201909,488,1544,428,1430,84,307,264,865,348,1172
311545,201909,1988,5718,1716,5327,95,370,1325,4025,1420,4395
311547,201909,1439,3739,1252,3446,49,151,873,2447,922,2598
311550,201909,2630,7444,2050,6331,316,1116,874,2578,1190,3694
311560,201909,281,620,178,473,23,73,98,228,121,301
311570,201909,1734,4042,1222,3325,45,133,960,2653,1005,2786
311580,201909,2133,3964,1367,3065,140,290,929,2114,1069,2404
311590,201909,471,1262,379,1132,63,207,204,602,267,809
311600,201909,1712,3863,1444,3537,52,121,1245,3004,1297,3125
311610,201909,2184,7278,1799,6416,229,881,962,3391,1191,4272
311615,201909,2941,8660,2415,7755,133,507,1873,5896,2006,6403
311620,201909,423,1141,365,1069,14,55,299,867,313,922
311630,201909,1306,3637,1046,3105,92,303,694,1963,786,2266
311640,201909,529,1496,402,1257,65,239,191,560,256,799
311650,201909,1812,4759,1496,4256,130,424,1014,2797,1144,3221
311660,201909,2649,7589,1883,6088,360,1292,484,1322,844,2614
311670,201909,1480,3913,1063,3170,160,545,462,1371,622,1916
311680,201909,2088,6065,1551,5072,192,630,990,3231,1182,3861
311690,201909,563,1212,430,1045,39,83,310,792,349,875
311700,201909,2205,5326,1720,4635,29,133,1448,3782,1477,3915
311710,201909,1448,4191,995,3332,242,887,380,1250,622,2137
311720,201909,389,1181,307,1026,24,103,174,565,198,668
311730,201909,3777,9618,2371,6972,719,2268,442,1343,1161,3611
311740,201909,828,2262,696,2097,33,89,607,1868,640,1957
311750,201909,3731,11361,3027,10109,438,1609,1712,5473,2150,7082
311760,201909,581,1685,480,1504,66,268,230,612,296,880
311770,201909,1948,5689,1488,4830,260,935,670,2063,930,2998
311780,201909,1214,3507,790,2631,163,619,231,666,394,1285
311783,201909,2175,6051,1766,5321,52,233,1402,4061,1454,4294
311787,201909,681,1975,494,1538,76,261,192,514,268,775
311790,201909,1412,3777,906,2863,242,840,249,746,491,1586
311800,201909,4601,13841,3656,11786,755,2621,626,1805,1381,4426
311810,201909,907,2808,710,2436,56,218,452,1532,508,1750
311820,201909,756,1875,552,1548,79,256,327,863,406,1119
311830,201909,8023,23226,5318,17318,1501,5267,657,2047,2158,7314
311840,201909,3288,8625,2728,7802,258,770,2001,5685,2259,6455
311850,201909,323,877,259,758,16,45,170,480,186,525
311860,201909,54123,137895,40740,114960,6220,18825,22478,60781,28698,79606
311870,201909,1852,4945,1213,3770,203,703,453,1265,656,1968
311880,201909,6107,15963,5071,14491,285,747,3871,11182,4156,11929
311890,201909,1520,3778,1168,3267,86,286,818,2181,904,2467
311900,201909,711,1865,528,1601,61,219,353,1041,414,1260
311910,201909,4064,10513,3021,9135,557,1675,1513,4678,2070,6353
311920,201909,1968,5423,1552,4791,115,337,967,3038,1082,3375
311930,201909,3274,7947,2370,6648,803,2425,712,1872,1515,4297
311940,201909,13849,36982,10053,29714,1479,4862,4656,12879,6135,17741
311950,201909,2112,5926,1552,4932,90,394,1006,3111,1096,3505
311960,201909,484,1207,388,1062,25,104,247,605,272,709
311970,201909,427,1392,286,1033,53,217,58,179,111,396
311980,201909,432,1180,214,734,30,107,63,214,93,321
311990,201909,532,1260,336,974,75,263,144,373,219,636
311995,201909,940,2620,465,1494,17,58,63,146,80,204
312000,201909,590,1569,487,1419,45,146,319,922,364,1068
312010,201909,879,2501,673,2137,58,212,403,1222,461,1434
312015,201909,1323,3951,1164,3679,65,292,907,2781,972,3073
312020,201909,1241,3839,953,3259,227,818,261,848,488,1666
312030,201909,1996,4969,1743,4678,25,103,1603,4275,1628,4378
312040,201909,729,2248,539,1833,61,223,254,855,315,1078
312050,201909,1183,3769,929,3246,213,857,270,841,483,1698
312060,201909,828,2061,533,1681,141,449,235,750,376,1199
312070,201909,849,2498,594,1980,55,204,301,961,356,1165
312080,201909,2602,6404,1915,5384,115,371,1232,3301,1347,3672
312083,201909,830,2197,620,1869,58,208,407,1166,465,1374
312087,201909,2356,6275,1920,5580,52,175,1502,4358,1554,4533
312090,201909,9316,24941,7072,21276,1134,3804,3393,9960,4527,13764
312100,201909,1476,4414,1102,3722,112,500,576,1858,688,2358
312110,201909,970,3056,808,2719,205,804,266,795,471,1599
312120,201909,748,2053,506,1622,151,564,163,435,314,999
312125,201909,1690,4411,1384,3957,122,403,1008,2773,1130,3176
312130,201909,916,2268,673,1862,56,157,276,721,332,878
312140,201909,705,2058,573,1789,121,420,250,716,371,1136
312150,201909,449,1279,377,1122,16,69,268,737,284,806
312160,201909,7707,21703,5772,18201,780,2860,2750,8166,3530,11026
312170,201909,878,2415,667,1992,36,139,447,1283,483,1422
312180,201909,1318,3600,1029,3022,162,508,500,1412,662,1920
312190,201909,567,1635,395,1285,73,259,110,344,183,603
312200,201909,4560,12337,3590,10783,1088,3258,1321,4078,2409,7336
312210,201909,1300,3012,927,2456,36,118,679,1756,715,1874
312220,201909,1711,5307,1460,4830,112,409,918,3031,1030,3440
312230,201909,11796,31059,7566,23155,1933,6613,1462,3884,3395,10497
312235,201909,1858,4865,1467,4260,81,303,1056,2973,1137,3276
312240,201909,646,2140,483,1784,109,442,140,511,249,953
312245,201909,2516,6705,2053,5988,69,240,1655,4789,1724,5029
312247,201909,887,2218,618,1812,119,376,307,907,426,1283
312250,201909,953,2549,608,1853,74,229,252,768,326,997
312260,201909,824,2338,660,2070,36,154,481,1448,517,1602
312270,201909,680,1862,510,1537,29,128,282,767,311,895
312280,201909,402,1184,307,1014,97,329,42,123,139,452
312290,201909,696,2091,549,1809,114,431,187,584,301,1015
312300,201909,903,2728,603,2008,161,581,112,307,273,888
312310,201909,775,2480,624,2160,104,398,285,951,389,1349
312320,201909,1795,4718,1269,3763,335,1032,263,760,598,1792
312330,201909,839,2503,657,2125,60,208,414,1303,474,1511
312340,201909,261,681,182,548,45,161,70,184,115,345
312350,201909,256,528,185,449,17,49,128,296,145,345
312352,201909,1568,4715,1374,4368,98,331,859,2885,957,3216
312360,201909,2437,7202,1750,5791,365,1309,497,1575,862,2884
312370,201909,1707,4620,1384,4059,199,659,765,2128,964,2787
312380,201909,2128,4824,1754,4359,10,40,1565,3847,1575,3887
312385,201909,1217,3378,914,2811,148,499,435,1291,583,1790
312390,201909,1826,5316,1336,4370,201,757,477,1397,678,2154
312400,201909,2697,8026,2195,7076,706,2396,686,2207,1392,4603
312410,201909,11010,30848,8911,27227,1633,5186,4780,14427,6413,19613
312420,201909,3516,9786,2917,8738,555,1792,1531,4462,2086,6254
312430,201909,7537,20223,6098,17634,442,1486,4200,11840,4642,13326
312440,201909,851,2752,651,2282,356,1315,71,214,427,1529
312450,201909,1103,3316,835,2826,245,887,284,990,529,1877
312460,201909,426,1138,290,926,33,124,153,497,186,621
312470,201909,461,1126,291,826,40,131,115,281,155,412
312480,201909,1062,2674,720,2164,99,311,355,1032,454,1343
312490,201909,2022,4979,1511,4199,211,606,800,2162,1011,2768
312500,201909,917,2307,725,2022,45,163,491,1348,536,1511
312510,201909,3450,9287,2508,7507,692,1992,694,2130,1386,4122
312520,201909,153,457,126,406,35,120,53,166,88,286
312530,201909,561,1404,479,1301,13,48,426,1159,439,1207
312540,201909,1501,4304,990,3228,158,564,514,1610,672,2174
312550,201909,733,1966,545,1579,31,110,359,955,390,1065
312560,201909,1929,4966,1560,4397,72,226,1205,3411,1277,3637
312570,201909,2059,5229,1554,4576,450,1392,608,1812,1058,3204
312580,201909,587,1656,426,1308,55,198,201,572,256,770
312590,201909,1575,4685,1264,4055,97,425,762,2271,859,2696
312595,201909,1722,5263,1471,4822,285,883,863,2975,1148,3858
312600,201909,1034,2540,513,1613,91,337,136,424,227,761
312610,201909,5884,15086,3663,10844,533,1707,1281,3558,1814,5265
312620,201909,2468,6459,1799,5533,52,242,1436,4471,1488,4713
312630,201909,252,763,184,637,32,140,77,252,109,392
312640,201909,509,1419,337,1120,44,148,123,428,167,576
312650,201909,2038,5337,1372,4040,66,220,954,2665,1020,2885
312660,201909,1283,3176,962,2625,77,269,656,1683,733,1952
312670,201909,4734,12740,3910,11404,177,782,2821,7817,2998,8599
312675,201909,1190,3223,968,2876,55,205,777,2257,832,2462
312680,201909,1337,3841,1111,3486,58,272,901,2725,959,2997
312690,201909,2640,5827,2071,5133,66,186,1744,4266,1810,4452
312695,201909,927,2604,767,2326,38,101,584,1784,622,1885
312700,201909,2006,5334,1437,4287,149,517,822,2312,971,2829
312705,201909,1295,3277,1095,2955,19,69,957,2556,976,2625
312707,201909,1313,3911,1015,3360,69,352,637,1979,706,2331
312710,201909,6257,14399,3576,10104,978,2989,979,2872,1957,5861
312720,201909,1020,2815,759,2379,97,324,462,1399,559,1723
312730,201909,1613,3862,1156,3222,91,292,675,1802,766,2094
312733,201909,1383,3656,1041,3026,39,150,696,1920,735,2070
312735,201909,610,1684,514,1498,70,236,327,850,397,1086
312737,201909,793,1828,529,1429,73,217,302,758,375,975
312738,201909,599,1574,416,1251,46,164,217,611,263,775
312740,201909,413,1014,227,692,52,176,57,144,109,320
312750,201909,1372,4235,1088,3681,207,764,435,1383,642,2147
312760,201909,1754,5251,1223,4125,222,796,435,1411,657,2207
312770,201909,42182,101661,25448,72989,5505,16754,8339,23457,13844,40211
312780,201909,2368,7197,1988,6557,230,871,1284,4181,1514,5052
312790,201909,245,586,134,413,8,38,49,125,57,163
312800,201909,4736,13639,3603,11429,896,3041,1226,3777,2122,6818
312810,201909,1565,4157,1000,3215,245,892,346,983,591,1875
312820,201909,1718,4698,1370,4041,46,186,1018,2911,1064,3097
312825,201909,1305,3114,1113,2853,22,74,943,2367,965,2441
312830,201909,2716,7724,1508,5149,320,1226,366,1179,686,2405
312840,201909,1214,3423,924,2896,112,435,446,1305,558,1740
312850,201909,855,2116,588,1702,29,115,344,913,373,1028
312860,201909,1204,3071,790,2435,211,693,174,503,385,1196
312870,201909,5952,16209,3502,11350,620,2191,801,2462,1421,4653
312880,201909,1345,3417,1032,2896,36,143,589,1650,625,1793
312890,201909,2099,5466,1452,4314,109,332,731,2208,840,2540
312900,201909,1129,2944,903,2657,79,257,528,1655,607,1912
312910,201909,1549,2874,796,1879,141,286,317,719,458,1005
312920,201909,962,2650,640,2077,130,494,260,766,390,1260
312930,201909,2088,5319,1626,4619,358,1039,724,2057,1082,3096
312940,201909,896,2528,694,2208,80,313,338,1015,418,1328
312950,201909,3063,7675,1950,5820,504,1663,633,1781,1137,3444
312960,201909,1754,4753,1476,4317,82,220,1137,3419,1219,3639
312965,201909,1612,4605,1331,4141,122,433,906,2739,1028,3172
312970,201909,1193,3430,924,2973,162,624,485,1433,647,2057
312980,201909,21416,59900,17093,51987,3102,10420,8734,25019,11836,35439
312990,201909,451,1174,273,860,53,194,120,356,173,550
313000,201909,449,1300,332,1081,33,139,186,565,219,704
313005,201909,2463,7165,2067,6492,141,464,1496,4628,1637,5092
313010,201909,4575,12896,3656,11335,660,2269,2132,6413,2792,8682
313020,201909,900,2736,588,2009,109,406,107,310,216,716
313030,201909,1092,2607,726,2040,67,243,466,1235,533,1478
313040,201909,757,2372,601,2018,43,176,356,1136,399,1312
313050,201909,1666,4729,1144,3919,198,828,343,1028,541,1856
313055,201909,1827,5037,1631,4736,66,217,1363,3917,1429,4134
313060,201909,924,2262,615,1757,192,629,137,308,329,937
313065,201909,1581,4852,1384,4511,65,281,1039,3281,1104,3562
313070,201909,941,2486,700,2056,71,228,401,1139,472,1367
313080,201909,368,1014,259,793,52,180,89,221,141,401
313090,201909,4688,12889,4001,11735,412,1389,2579,7413,2991,8802
313100,201909,1304,3421,989,2955,34,148,745,2165,779,2313
313110,201909,1402,3774,992,3032,97,377,564,1586,661,1963
313115,201909,2335,6905,1890,6034,265,943,974,2916,1239,3859
313120,201909,3554,8412,2584,7119,258,806,1601,4381,1859,5187
313130,201909,28240,74656,21443,61808,2465,8088,11996,32548,14461,40636
313140,201909,566,1277,339,938,22,75,224,613,246,688
313150,201909,1307,3722,944,3013,270,919,252,742,522,1661
313160,201909,980,2519,753,2147,33,121,553,1528,586,1649
313170,201909,10792,31346,7502,24878,1360,4865,2861,8941,4221,13806
313180,201909,2090,5583,1462,4347,176,557,820,2391,996,2948
313190,201909,4068,11785,2870,9278,521,1834,985,2959,1506,4793
313200,201909,1040,2954,901,2714,18,78,760,2199,778,2277
313210,201909,3643,10760,2978,9571,370,1350,1792,5547,2162,6897
313220,201909,1683,4467,1094,3331,173,602,420,1117,593,1719
313230,201909,2936,8242,2417,7621,64,233,1988,6367,2052,6600
313240,201909,8989,22214,5367,16282,963,3353,2228,6156,3191,9509
313250,201909,5856,17336,4454,14429,746,2494,2081,6621,2827,9115
313260,201909,578,1539,400,1204,54,205,186,518,240,723
313270,201909,5393,14176,4305,12543,610,1835,2782,8206,3392,10041
313280,201909,433,1221,275,891,41,143,108,337,149,480
313290,201909,878,2761,660,2391,219,870,213,741,432,1611
313300,201909,1508,4100,1066,3293,288,947,213,573,501,1520
313310,201909,1042,3131,791,2567,122,471,215,596,337,1067
313320,201909,2069,5516,1431,4468,267,947,616,1903,883,2850
313330,201909,3927,10537,2979,9088,166,684,1944,5852,2110,6536
313340,201909,1279,2915,897,2369,89,242,632,1665,721,1907
313350,201909,2212,6298,1423,4498,190,679,547,1539,737,2218
313360,201909,1264,3145,826,2417,137,478,424,1151,561,1629
313370,201909,1302,3736,1103,3340,137,507,630,1743,767,2250
313375,201909,1604,4145,930,2880,182,642,214,624,396,1266
313380,201909,5670,14452,3909,11140,740,2329,1759,4494,2499,6823
313390,201909,817,2637,709,2460,48,222,472,1567,520,1789
313400,201909,3602,8995,2775,7849,167,513,2129,5914,2296,6427
313410,201909,1262,3336,947,2766,58,202,692,1978,750,2180
313420,201909,14607,32787,7033,19814,1604,5025,959,2648,2563,7673
313430,201909,851,2538,643,2124,113,445,263,769,376,1214
313440,201909,5900,12887,3807,10130,301,865,2462,6514,2763,7379
313450,201909,608,1690,419,1296,79,262,144,392,223,654
313460,201909,2037,5897,1618,5239,326,1209,765,2348,1091,3557
313470,201909,2826,7273,2214,6395,254,709,1405,4145,1659,4854
313480,201909,903,2615,488,1671,78,288,127,399,205,687
313490,201909,2033,4765,933,2900,308,1082,124,391,432,1473
313500,201909,420,1240,322,1009,43,138,115,342,158,480
313505,201909,9448,25440,8062,23548,327,1192,6555,19028,6882,20220
313507,201909,1439,3827,1176,3416,25,108,938,2665,963,2773
313510,201909,12371,34477,9875,29810,1208,3957,4949,14490,6157,18447
313520,201909,13416,38614,10761,33942,658,2454,7854,24256,8512,26710
313530,201909,510,1504,381,1221,33,114,158,463,191,577
313535,201909,2273,6261,1937,5630,198,501,1300,3762,1498,4263
313540,201909,729,2200,560,1778,108,349,234,689,342,1038
313545,201909,1132,3791,950,3414,161,604,511,1766,672,2370
313550,201909,1672,5159,1377,4453,333,1203,663,2032,996,3235
313560,201909,2551,5089,1869,4260,59,110,1588,3621,1647,3731
313570,201909,903,2708,728,2378,171,588,299,917,470,1505
313580,201909,5352,14289,4042,12084,510,1634,2296,6921,2806,8555
313590,201909,926,2697,732,2412,207,727,314,1085,521,1812
313600,201909,3740,10281,3111,9280,99,414,2576,7547,2675,7961
313610,201909,976,2502,776,2144,100,292,479,1262,579,1554
313620,201909,5209,13979,4049,11842,577,1856,2234,6262,2811,8118
313630,201909,8145,20051,5563,16082,630,2097,3186,8972,3816,11069
313640,201909,1006,2379,605,1836,188,586,181,576,369,1162
313650,201909,1661,5077,1352,4555,88,359,899,3037,987,3396
313652,201909,737,2393,663,2222,117,430,403,1310,520,1740
313655,201909,1117,2891,883,2578,44,149,702,2031,746,2180
313657,201909,1198,3201,935,2781,42,171,692,1949,734,2120
313660,201909,850,2388,686,2078,90,334,396,1119,486,1453
313665,201909,4413,12013,3354,10074,440,1476,1978,5686,2418,7162
313670,201909,45555,112734,28094,82557,4436,14291,12052,33460,16488,47751
313680,201909,988,2683,815,2412,65,224,532,1513,597,1737
313690,201909,780,2482,587,2099,140,539,165,562,305,1101
313695,201909,1700,4734,1306,4086,80,272,895,2784,975,3056
313700,201909,2928,9535,2539,9025,251,956,1903,6747,2154,7703
313710,201909,1320,3094,929,2554,75,215,630,1737,705,1952
313720,201909,5126,14259,3578,11059,558,1973,1528,4309,2086,6282
313730,201909,1245,2883,926,2445,77,179,631,1648,708,1827
313740,201909,1570,5625,1261,4808,317,1367,217,714,534,2081
313750,201909,1847,5068,1417,4234,276,914,630,1755,906,2669
313753,201909,2039,4921,1343,3805,129,391,769,2103,898,2494
313760,201909,4867,13469,3526,10857,797,2639,1408,4068,2205,6707
313770,201909,3804,10844,2990,9503,201,698,2172,6933,2373,7631
313780,201909,3951,10697,2832,8750,250,927,740,2330,990,3257
313790,201909,468,1473,414,1371,47,178,230,732,277,910
313800,201909,1326,3136,972,2608,128,396,516,1295,644,1691
313810,201909,1538,3989,1203,3512,58,228,900,2559,958,2787
313820,201909,14598,35141,9285,25464,1555,4601,3162,8389,4717,12990
313830,201909,347,1012,255,802,48,148,104,299,152,447
313835,201909,901,2699,726,2366,66,259,387,1186,453,1445
313840,201909,6453,17056,4591,13846,1201,3802,971,2985,2172,6787
313850,201909,913,2265,718,1987,126,430,376,919,502,1349
313860,201909,2501,6828,1831,5502,296,1011,738,2064,1034,3075
313862,201909,1403,3007,643,1848,43,136,327,905,370,1041
313865,201909,2328,6326,1960,5730,110,338,1485,4268,1595,4606
313867,201909,1137,3509,949,3153,134,451,635,2122,769,2573
313868,201909,1674,5193,1366,4550,51,253,1061,3409,1112,3662
313870,201909,758,2080,546,1692,101,333,203,570,304,903
313880,201909,1450,3850,1057,3186,176,593,489,1323,665,1916
313890,201909,1946,4333,1436,3670,55,167,1038,2606,1093,2773
313900,201909,3764,11193,2675,8943,703,2602,659,2028,1362,4630
313910,201909,583,1753,427,1448,92,349,95,300,187,649
313920,201909,2842,8958,2379,7983,488,1624,1192,4001,1680,5625
313925,201909,1529,3936,1216,3356,192,501,764,2109,956,2610
313930,201909,4607,14004,3713,12371,271,1081,2468,8065,2739,9146
313940,201909,8133,23929,5721,19622,903,3712,1430,5333,2333,9045
313950,201909,4953,11203,3469,9312,436,1472,2035,5365,2471,6837
313960,201909,5296,13181,3483,10094,794,2556,1095,2902,1889,5458
313970,201909,1374,3814,1155,3421,20,72,750,2177,770,2249
313980,201909,1291,3386,829,2626,126,465,312,945,438,1410
313990,201909,1774,5789,1249,4543,343,1393,367,1173,710,2566
314000,201909,9193,24143,7622,21455,554,1979,5148,14182,5702,16161
314010,201909,1344,3362,1071,2983,51,174,798,2155,849,2329
314015,201909,1876,5244,1403,4432,198,761,731,2214,929,2975
314020,201909,471,1297,288,942,58,238,51,179,109,417
314030,201909,726,2116,577,1827,63,217,301,935,364,1152
314040,201909,620,1681,493,1434,80,266,257,717,337,983
314050,201909,1704,4576,1209,3650,158,553,626,1761,784,2314
314053,201909,1751,5266,1394,4544,263,836,704,2403,967,3239
314055,201909,2226,6095,1904,5597,47,179,1552,4561,1599,4740
314060,201909,1205,3241,896,2742,35,147,619,1862,654,2009
314070,201909,4363,12225,3384,10409,711,2178,1460,4405,2171,6583
314080,201909,2073,5493,1321,4110,189,704,533,1476,722,2180
314085,201909,1994,5838,1632,5261,259,876,894,2893,1153,3769
314090,201909,4171,11752,3548,10767,225,902,2273,6870,2498,7772
314100,201909,3104,7379,2368,6350,60,175,1823,4864,1883,5039
314110,201909,4208,12075,3424,10560,400,1451,1971,5708,2371,7159
314120,201909,812,1900,305,932,73,264,53,150,126,414
314130,201909,604,1560,354,1092,26,100,196,602,222,702
314140,201909,4449,12821,3442,10816,491,1659,1682,5144,2173,6803
314150,201909,1467,3701,1061,2979,90,261,702,1910,792,2171
314160,201909,2111,5717,1506,4583,221,739,632,1917,853,2656
314170,201909,923,2626,735,2250,52,187,453,1290,505,1477
314180,201909,5284,14900,4247,13192,390,1327,2496,7716,2886,9043
314190,201909,571,1452,387,1162,70,234,173,468,243,702
314200,201909,2800,7955,2278,7036,127,473,1640,4917,1767,5390
314210,201909,1933,5152,1514,4379,171,528,775,2176,946,2704
314220,201909,1269,3524,882,2837,190,723,330,967,520,1690
314225,201909,1061,3069,879,2779,73,220,634,2034,707,2254
314230,201909,741,1932,603,1758,70,229,390,1166,460,1395
314240,201909,974,2677,754,2353,186,596,301,951,487,1547
314250,201909,504,1405,309,995,45,148,118,345,163,493
314260,201909,904,2540,713,2254,161,553,384,1164,545,1717
314270,201909,3177,9071,2578,8123,87,360,1905,5920,1992,6280
314280,201909,3227,7506,2059,5679,256,798,1050,2724,1306,3522
314290,201909,4384,11456,3585,10026,303,871,2458,6749,2761,7620
314300,201909,1718,5001,1147,3749,253,916,364,1122,617,2038
314310,201909,4100,10885,2746,8514,882,2948,478,1348,1360,4296
314315,201909,898,3142,768,2864,59,286,521,1872,580,2158
314320,201909,2719,7478,1721,5565,330,1167,608,1894,938,3061
314330,201909,45996,129199,34156,108174,9676,31841,7358,24396,17034,56237
314340,201909,2131,5312,1188,3580,254,909,304,756,558,1665
314345,201909,1350,4097,1104,3644,147,512,648,2102,795,2614
314350,201909,836,2290,542,1757,110,397,130,365,240,762
314360,201909,552,1585,330,1100,52,187,104,318,156,505
314370,201909,683,1868,536,1644,26,105,392,1155,418,1260
314380,201909,1044,2934,697,2271,170,631,164,524,334,1155
314390,201909,12017,31119,7510,22636,1564,5048,2232,6041,3796,11089
314400,201909,3850,11523,2914,9721,785,2729,1058,3636,1843,6365
314410,201909,2619,7332,1759,5687,253,912,627,2114,880,3026
314420,201909,803,1973,589,1668,26,123,413,1088,439,1211
314430,201909,6958,17547,4812,13810,742,2272,2160,5905,2902,8177
314435,201909,1591,4348,1253,3765,58,222,921,2722,979,2944
314437,201909,893,2325,623,1852,60,205,310,900,370,1105
314440,201909,589,1700,412,1336,114,406,87,238,201,644
314450,201909,1307,3545,1088,3199,95,314,670,1911,765,2225
314460,201909,3127,9659,2211,7616,571,2089,463,1549,1034,3638
314465,201909,2140,6269,1830,5662,53,204,1379,4116,1432,4320
314467,201909,800,2195,681,1991,23,73,547,1551,570,1624
314470,201909,2075,6054,1644,5139,294,1003,735,2148,1029,3151
314480,201909,6031,17539,4253,13712,729,2640,1466,4183,2195,6823
314490,201909,967,2675,708,2111,72,231,429,1232,501,1463
314500,201909,1613,3979,1144,3272,244,706,448,1299,692,2005
314505,201909,1924,4769,1575,4280,97,267,1149,3060,1246,3327
314510,201909,1800,4719,1224,3829,252,881,547,1674,799,2555
314520,201909,4469,13862,3130,10867,637,2442,412,1232,1049,3674
314530,201909,5312,17352,4751,16242,357,1516,3429,11448,3786,12964
314535,201909,2533,6638,2024,5875,102,367,1534,4402,1636,4769
314537,201909,1078,3118,827,2683,54,216,577,1831,631,2047
314540,201909,376,962,250,738,20,68,126,350,146,418
314545,201909,1759,4408,1542,4139,35,94,1310,3626,1345,3720
314550,201909,618,1534,457,1296,42,160,246,627,288,787
314560,201909,3835,11771,2803,9379,474,1747,944,2903,1418,4650
314570,201909,286,791,210,650,27,101,95,296,122,397
314580,201909,406,1213,301,997,90,315,83,281,173,596
314585,201909,615,1961,466,1621,62,262,213,713,275,975
314587,201909,1954,5369,1468,4586,201,577,823,2640,1024,3217
314590,201909,3571,9882,2435,7680,363,1269,993,2930,1356,4199
314600,201909,1794,5002,1013,3448,199,736,128,403,327,1139
314610,201909,8401,21497,5681,17466,1045,3703,2373,7236,3418,10939
314620,201909,2161,5143,1678,4514,46,163,1380,3650,1426,3813
314625,201909,1472,4151,1250,3837,40,236,1041,3116,1081,3352
314630,201909,5137,13384,4196,12100,122,494,3468,9980,3590,10474
314640,201909,626,1526,441,1225,64,215,237,603,301,818
314650,201909,817,1892,482,1363,48,158,244,587,292,745
314655,201909,1549,4291,1086,3437,176,540,526,1642,702,2182
314660,201909,327,769,211,555,9,20,130,324,139,344
314670,201909,1636,3778,1105,3000,25,87,715,1910,740,1997
314675,201909,1685,4531,1445,4121,89,317,1111,3055,1200,3372
314690,201909,2006,5707,1525,4949,455,1603,461,1501,916,3104
314700,201909,9605,27248,6045,20063,1217,4468,1683,5397,2900,9865
314710,201909,7264,20575,5072,15868,1002,3418,1485,4122,2487,7540
314720,201909,2007,5948,1320,4482,285,1079,350,1125,635,2204
314730,201909,1994,5482,1387,4290,298,975,441,1299,739,2274
314740,201909,2732,7777,2125,6664,280,947,1097,3363,1377,4310
314750,201909,306,843,234,694,24,86,132,343,156,429
314760,201909,1770,5412,1114,3846,178,707,265,743,443,1450
314770,201909,1078,3170,533,1729,47,163,160,471,207,634
314780,201909,332,794,219,626,43,146,116,290,159,436
314790,201909,9476,25793,6304,19816,1486,5326,1911,5524,3397,10850
314795,201909,1398,3791,1182,3409,33,153,928,2555,961,2708
314800,201909,10344,26369,5902,17899,1145,3841,1321,3544,2466,7385
314810,201909,8015,21659,5660,17464,1468,4829,1786,5436,3254,10265
314820,201909,1065,2700,826,2326,56,219,530,1418,586,1637
314830,201909,1390,4314,1155,3831,236,846,527,1740,763,2586
314840,201909,847,2735,667,2431,59,303,467,1624,526,1927
314850,201909,1940,4700,1559,4200,41,139,1339,3616,1380,3755
314860,201909,3064,9287,2527,8219,273,1068,1652,5201,1925,6269
314870,201909,6143,15969,4633,13887,309,1025,3369,10110,3678,11135
314875,201909,1692,5143,1492,4881,100,275,1213,4026,1313,4301
314880,201909,836,2053,641,1758,29,90,420,1158,449,1248
314890,201909,403,1199,291,945,46,171,114,337,160,508
314900,201909,630,1715,485,1474,94,315,185,543,279,858
314910,201909,1561,4510,1150,3824,239,920,524,1600,763,2520
314915,201909,2133,6362,1785,5756,121,411,1197,3789,1318,4200
314920,201909,451,1168,284,907,7,24,192,618,199,642
314930,201909,5020,14445,3717,11970,689,2384,1443,4354,2132,6738
314940,201909,385,995,316,873,31,83,200,521,231,604
314950,201909,450,1164,284,877,27,114,143,397,170,511
314960,201909,763,1884,589,1581,28,86,438,1125,466,1211
314970,201909,809,2320,619,1933,118,387,285,838,403,1225
314980,201909,1271,3334,889,2744,193,678,364,1106,557,1784
314990,201909,2254,6548,1478,4741,322,1142,291,801,613,1943
314995,201909,1575,4423,1238,3821,52,215,812,2380,864,2595
315000,201909,1089,2845,773,2337,64,220,508,1496,572,1716
315010,201909,365,1027,263,835,43,168,127,369,170,537
315015,201909,2162,6210,1877,5728,187,636,1219,3675,1406,4311
315020,201909,745,2214,523,1700,72,293,219,637,291,930
315030,201909,552,1487,349,1091,83,258,76,224,159,482
315040,201909,752,2220,634,1943,80,268,408,1252,488,1520
315050,201909,1070,2766,797,2362,59,222,446,1301,505,1523
315053,201909,1087,2863,816,2373,51,158,486,1359,537,1517
315057,201909,1592,5022,1333,4532,153,531,884,3016,1037,3547
315060,201909,550,1682,393,1358,75,276,97,315,172,591
315070,201909,509,1346,350,1062,88,297,88,237,176,534
315080,201909,2654,7819,2025,6543,319,1075,1099,3443,1418,4518
315090,201909,770,2387,552,1944,91,348,204,681,295,1029
315100,201909,1156,3511,710,2473,141,556,292,909,433,1465
315110,201909,1613,4051,1187,3372,132,361,591,1726,723,2087
315120,201909,11242,26790,8067,21898,1188,3017,4123,11676,5311,14693
315130,201909,1311,3763,1054,3283,130,467,427,1255,557,1722
315140,201909,2793,7841,2117,6604,386,1335,1045,3048,1431,4383
315150,201909,4111,10073,2770,7839,444,1431,1272,3466,1716,4897
315160,201909,1579,3947,1008,3017,237,739,425,1253,662,1992
315170,201909,1340,4264,902,3198,218,817,188,647,406,1464
315180,201909,15722,38604,7908,23737,1142,3830,2411,6336,3553,10166
315190,201909,2033,4576,1579,3973,203,485,1146,2907,1349,3392
315200,201909,3608,10524,2571,8605,792,2879,603,1922,1395,4801
315210,201909,7619,20104,5226,14963,643,2004,2557,6665,3200,8669
315213,201909,1091,2875,931,2654,19,57,761,2154,780,2211
315217,201909,2605,7857,2014,6817,97,480,1365,4429,1462,4909
315220,201909,7708,21248,6108,18424,1270,4076,2531,7623,3801,11699
315230,201909,3041,7170,2544,6541,167,288,1984,5373,2151,5661
315240,201909,2302,6914,1930,6231,452,1546,979,3126,1431,4672
315250,201909,10860,29788,7605,23610,1285,4316,3273,9727,4558,14043
315260,201909,921,2576,473,1569,81,259,35,108,116,367
315270,201909,759,2213,511,1713,69,255,165,473,234,728
315280,201909,2717,6876,1538,4659,384,1265,239,716,623,1981
315290,201909,1123,2819,657,2069,192,667,166,511,358,1178
315300,201909,620,1508,407,1202,103,348,176,516,279,864
315310,201909,1252,3579,911,2910,72,253,493,1491,565,1744
315320,201909,657,1947,459,1555,68,281,196,609,264,890
315330,201909,739,2554,392,1583,68,306,116,418,184,724
315340,201909,2915,7180,2086,5959,161,530,1278,3602,1439,4132
315350,201909,1502,4137,1145,3571,165,592,639,1951,804,2543
315360,201909,1597,4807,1149,3809,163,585,472,1461,635,2046
315370,201909,431,1259,336,1064,62,184,141,437,203,621
315380,201909,168,505,124,398,31,100,26,56,57,156
315390,201909,1057,3062,803,2558,155,565,333,966,488,1531
315400,201909,3862,10857,3017,9259,449,1435,1579,4667,2028,6102
315410,201909,2192,5111,1656,4326,459,1282,258,720,717,2002
315415,201909,1219,3354,969,2973,208,745,401,1243,609,1988
315420,201909,1199,3476,763,2604,151,550,137,426,288,976
315430,201909,3465,8501,2403,6851,430,1448,1029,2735,1459,4183
315440,201909,974,2624,775,2279,72,257,450,1228,522,1485
315445,201909,1934,4715,1375,3903,100,325,982,2745,1082,3070
315450,201909,2131,6055,1738,5436,237,713,1074,3395,1311,4108
315460,201909,33039,94183,27065,83166,4884,16712,13705,39576,18589,56288
315470,201909,474,1343,362,1118,31,113,221,648,252,761
315480,201909,1143,3372,789,2590,162,546,249,794,411,1340
315490,201909,2844,7116,1892,5603,288,873,674,1955,962,2828
315500,201909,493,1345,292,897,35,133,128,335,163,468
315510,201909,1185,3182,1016,2932,22,102,873,2473,895,2575
315520,201909,1024,2828,796,2439,58,219,581,1720,639,1939
315530,201909,545,1601,423,1365,129,458,189,575,318,1033
315540,201909,1320,3642,899,2834,104,382,385,1188,489,1570
315550,201909,1788,4670,1114,3449,241,828,283,862,524,1690
315560,201909,6082,18793,5159,17078,298,996,3454,11562,3752,12558
315570,201909,1877,5211,1524,4616,90,361,922,2685,1012,3046
315580,201909,2417,5860,1796,4864,286,920,711,1811,997,2731
315590,201909,853,2260,663,1953,77,275,343,943,420,1218
315600,201909,2373,7612,1699,6249,246,876,902,3437,1148,4313
315610,201909,858,2209,634,1789,112,377,285,696,397,1073
315620,201909,403,1167,318,1027,46,162,198,655,244,817
315630,201909,849,2303,659,1982,129,414,276,775,405,1189
315640,201909,328,846,257,754,25,98,157,433,182,531
315645,201909,909,2392,607,1878,154,510,153,455,307,965
315650,201909,1669,4158,1334,3675,34,134,1101,2916,1135,3050
315660,201909,2388,5859,1760,4772,99,290,1261,3289,1360,3579
315670,201909,12804,35549,9685,29824,1934,6188,4338,12899,6272,19087
315680,201909,2945,8776,2130,7184,335,1291,1016,3246,1351,4537
315690,201909,2793,7165,1663,5047,368,1113,515,1716,883,2829
315700,201909,7438,21002,5554,17204,928,3064,2514,7438,3442,10502
315710,201909,1796,4548,1263,3715,48,231,889,2486,937,2717
315720,201909,4176,11766,3499,10542,172,737,2513,7262,2685,7999
315725,201909,1880,5215,1417,4343,139,417,957,2986,1096,3403
315727,201909,542,1410,392,1157,56,188,161,449,217,637
315730,201909,580,1810,505,1660,84,312,200,622,284,934
315733,201909,1225,3094,824,2371,126,443,316,858,442,1301
315737,201909,1098,3204,857,2720,40,157,593,1827,633,1984
315740,201909,841,2384,652,1990,81,298,397,1128,478,1426
315750,201909,1220,3299,962,2850,81,253,616,1839,697,2092
315760,201909,1111,2686,992,2535,46,137,840,2103,886,2240
315765,201909,1838,4904,1497,4458,26,89,1310,3894,1336,3983
315770,201909,872,2538,681,2269,269,988,149,407,418,1395
315780,201909,26402,73555,22034,65747,1504,5638,14850,42260,16354,47898
315790,201909,3470,10860,2933,9816,325,1156,1766,5988,2091,7144
315800,201909,1196,4349,830,3326,144,634,219,798,363,1432
315810,201909,1278,3229,1059,2848,47,168,832,2134,879,2302
315820,201909,2509,7000,2024,6264,180,656,1384,4220,1564,4876
315830,201909,1002,2938,723,2399,65,238,311,995,376,1233
315840,201909,806,1966,517,1435,43,144,253,654,296,798
315850,201909,1102,3329,874,2915,171,617,431,1354,602,1971
315860,201909,459,1352,314,1081,74,267,86,277,160,544
315870,201909,450,1182,354,1038,26,91,242,662,268,753
315880,201909,1029,2719,672,2077,92,351,158,438,250,789
315890,201909,1572,4606,1246,4126,324,1154,604,1943,928,3097
315895,201909,5706,15573,4249,12684,432,1496,2241,6239,2673,7735
315900,201909,782,2049,672,1892,61,188,494,1340,555,1528
315910,201909,504,1441,421,1300,57,209,285,838,342,1047
315920,201909,1441,3724,777,2394,129,457,247,712,376,1169
315930,201909,1040,2397,675,1843,118,322,305,835,423,1157
315935,201909,749,2261,590,1961,109,373,210,706,319,1079
315940,201909,565,1620,444,1421,49,168,231,708,280,876
315950,201909,1143,3142,941,2817,88,255,710,2129,798,2384
315960,201909,4021,11385,2324,7938,789,3065,162,334,951,3399
315970,201909,619,1646,477,1455,59,207,320,969,379,1176
315980,201909,4078,8925,2153,5787,380,1084,746,1836,1126,2920
315990,201909,3415,8749,2639,7428,259,789,1568,4315,1827,5104
316000,201909,497,1329,369,1140,57,220,167,477,224,697
316010,201909,798,2118,580,1750,35,125,371,1044,406,1169
316020,201909,916,2817,737,2458,81,340,433,1343,514,1683
316030,201909,2677,7606,1995,6374,232,775,1260,4069,1492,4844
316040,201909,2271,6578,1620,5331,310,1119,359,1050,669,2169
316045,201909,2009,5296,1816,5052,68,155,1551,4425,1619,4580
316050,201909,364,1041,268,866,36,133,146,454,182,587
316060,201909,664,1724,489,1449,25,116,333,935,358,1051
316070,201909,5108,14446,4141,12576,741,2359,1919,5655,2660,8014
316080,201909,663,2076,499,1734,125,461,73,244,198,705
316090,201909,400,1203,279,938,38,154,138,405,176,559
316095,201909,1231,3861,982,3251,259,892,320,1040,579,1932
316100,201909,2375,7126,1654,5495,306,1103,580,1751,886,2854
316105,201909,833,2219,644,1935,42,146,450,1374,492,1520
316110,201909,12748,37712,10618,34050,891,3276,7156,22642,8047,25918
316120,201909,1101,3228,674,2171,126,425,180,468,306,893
316130,201909,1153,2580,715,1893,62,189,415,1070,477,1259
316140,201909,1117,3041,714,2284,109,380,356,1110,465,1490
316150,201909,1719,3845,1414,3456,190,583,577,1310,767,1893
316160,201909,989,2764,797,2421,49,178,524,1533,573,1711
316165,201909,840,2099,624,1747,93,323,322,832,415,1155
316170,201909,1051,2660,777,2235,57,208,529,1461,586,1669
316180,201909,1190,3392,770,2506,140,541,158,453,298,994
316190,201909,2507,7197,1424,4576,211,698,520,1494,731,2192
316200,201909,2999,8721,2138,7067,509,1803,423,1367,932,3170
316210,201909,4046,11943,2865,9289,1062,3710,203,544,1265,4254
316220,201909,579,1775,376,1294,95,363,40,161,135,524
316225,201909,1524,3487,1125,2813,41,162,853,1984,894,2146
316230,201909,386,1052,290,891,30,90,175,546,205,636
316240,201909,5421,15856,4745,14695,371,1271,3613,10974,3984,12245
316245,201909,2808,9460,2511,8956,144,846,1889,6367,2033,7213
316250,201909,9516,23381,6577,18627,1492,4612,2225,6128,3717,10740
316255,201909,2861,8055,2486,7446,144,498,1841,5542,1985,6040
316257,201909,1282,3210,896,2532,127,370,459,1248,586,1618
316260,201909,1871,4970,1413,4218,128,414,772,2363,900,2777
316265,201909,1125,3078,878,2652,35,134,621,1814,656,1948
316270,201909,3488,11022,2936,9749,523,1839,1361,4319,1884,6158
316280,201909,2769,8180,2340,7335,328,1119,1294,3903,1622,5022
316290,201909,3336,9275,2634,7953,315,1121,1124,3284,1439,4405
316292,201909,4736,12792,3777,11158,469,1520,2497,7108,2966,8628
316294,201909,774,2294,560,1915,99,380,143,477,242,857
316295,201909,2761,7837,2258,6962,135,530,1567,4552,1702,5082
316300,201909,931,2826,779,2568,47,185,540,1764,587,1949
316310,201909,786,2059,481,1519,92,361,80,211,172,572
316320,201909,572,1639,433,1395,54,208,204,636,258,844
316330,201909,1030,2798,766,2314,50,197,550,1587,600,1784
316340,201909,983,2742,715,2229,69,284,402,1180,471,1464
316350,201909,1191,3497,1011,3200,94,318,705,2211,799,2529
316360,201909,627,1659,498,1447,49,157,360,1011,409,1168
316370,201909,4680,12803,3427,10418,691,2401,1168,3143,1859,5544
316380,201909,1646,3954,1272,3433,47,98,930,2533,977,2631
316390,201909,803,2166,562,1729,217,758,107,298,324,1056
316400,201909,1080,3114,684,2298,117,433,233,704,350,1137
316410,201909,1064,3116,892,2848,59,206,699,2206,758,2412
316420,201909,1835,5150,1596,4845,56,209,1317,3931,1373,4140
316430,201909,811,2182,493,1578,92,331,146,457,238,788
316440,201909,687,2177,534,1912,125,512,103,343,228,855
316443,201909,514,1463,382,1211,100,349,77,233,177,582
316447,201909,1828,5023,1589,4625,39,156,1320,3769,1359,3925
316450,201909,2136,6570,1606,5457,218,796,957,3187,1175,3983
316460,201909,968,2514,771,2192,136,425,460,1232,596,1657
316470,201909,6198,18000,4351,14064,759,2805,1645,4887,2404,7692
316480,201909,200,557,166,501,40,118,82,242,122,360
316490,201909,294,800,207,646,27,94,83,214,110,308
316500,201909,1108,3562,702,2541,153,599,151,523,304,1122
316510,201909,686,2271,533,1970,112,425,240,902,352,1327
316520,201909,1059,2709,821,2300,124,408,397,1026,521,1434
316530,201909,1033,2751,754,2246,93,372,375,981,468,1353
316540,201909,787,2115,618,1849,108,378,289,787,397,1165
316550,201909,1329,3974,1137,3589,64,243,857,2664,921,2907
316553,201909,3571,10810,2433,8022,457,1657,779,2304,1236,3961
316555,201909,2434,7963,2214,7656,126,461,1751,6139,1877,6600
316556,201909,543,1317,375,1031,23,71,221,567,244,638
316557,201909,952,3022,808,2763,313,1125,233,782,546,1907
316560,201909,288,838,204,716,57,242,56,159,113,401
316570,201909,1147,3421,951,3043,238,779,360,1139,598,1918
316580,201909,367,777,220,538,35,99,112,256,147,355
316590,201909,1248,3318,883,2589,156,424,470,1331,626,1755
316600,201909,931,2921,791,2615,131,471,410,1325,541,1796
316610,201909,557,1795,472,1665,55,246,285,965,340,1211
316620,201909,1952,5400,1677,5026,85,275,1265,3815,1350,4090
316630,201909,1526,4584,1221,4016,334,1103,484,1720,818,2823
316640,201909,131,347,101,302,18,61,47,120,65,181
316650,201909,999,3264,798,2936,67,281,498,1859,565,2140
316660,201909,186,473,75,233,6,20,10,32,16,52
316670,201909,1766,4509,1280,3708,311,976,463,1304,774,2280
316680,201909,2079,5341,1572,4457,104,313,1205,3357,1309,3670
316690,201909,1198,3534,925,2995,178,631,416,1308,594,1939
316695,201909,999,2925,817,2595,36,148,562,1762,598,1910
316700,201909,372,879,310,806,14,46,233,566,247,612
316710,201909,2851,9505,2141,7993,455,1792,828,3074,1283,4866
316720,201909,19351,53878,13859,42984,2642,8741,5602,16547,8244,25288
316730,201909,398,1125,313,952,48,166,149,406,197,572
316740,201909,672,2023,581,1869,60,237,368,1171,428,1408
316750,201909,362,1089,274,917,54,214,124,377,178,591
316760,201909,3510,11242,2814,9782,1128,4232,662,2171,1790,6403
316770,201909,1513,3575,1195,3142,26,88,1013,2700,1039,2788
316780,201909,524,1603,406,1368,148,558,63,187,211,745
316790,201909,665,1814,459,1399,107,345,129,351,236,696
316800,201909,5912,16917,4656,14574,446,1625,2521,7597,2967,9222
316805,201909,1003,2219,797,1991,62,173,619,1555,681,1728
316810,201909,626,1756,411,1285,84,308,189,537,273,845
316820,201909,300,724,145,439,11,44,63,182,74,226
316830,201909,666,1878,535,1661,77,289,328,968,405,1257
316840,201909,2670,7175,2150,6256,229,809,1393,3849,1622,4658
316850,201909,1894,5011,1327,3980,214,694,571,1667,785,2361
316860,201909,17564,46309,12934,39248,2206,7730,6038,17786,8244,25516
316870,201909,6978,19401,5143,15841,812,2811,2308,6603,3120,9414
316880,201909,767,2109,609,1889,125,427,283,840,408,1267
316890,201909,1069,2407,612,1777,105,378,333,854,438,1232
316900,201909,2128,5881,1619,4850,323,1073,535,1464,858,2537
316905,201909,511,1535,396,1302,97,353,159,524,256,877
316910,201909,833,2246,518,1685,138,501,47,139,185,640
316920,201909,1555,3998,1020,3128,207,703,388,1159,595,1862
316930,201909,7165,20894,5076,16982,1081,3877,1280,4150,2361,8027
316935,201909,3766,10375,2669,8270,491,1635,1084,3247,1575,4882
316940,201909,6342,18900,4751,15455,795,2852,1762,5327,2557,8179
316950,201909,1791,4224,1368,3630,52,157,1119,2925,1171,3082
316960,201909,4943,11361,3553,9360,393,1149,2319,5952,2712,7101
316970,201909,3382,9871,2919,8956,564,1814,1132,3332,1696,5146
316980,201909,649,2004,474,1649,152,593,75,266,227,859
316990,201909,10134,28103,6943,21311,1928,6325,933,2551,2861,8876
317000,201909,2480,7508,2193,7076,168,517,1614,5217,1782,5734
317005,201909,2457,7177,1930,6062,307,993,1006,3101,1313,4094
317010,201909,22430,52934,13387,39080,2961,9392,4723,14216,7684,23608
317020,201909,60222,143652,33331,96358,6232,19650,10074,26842,16306,46492
317030,201909,634,1758,506,1580,20,90,394,1217,414,1307
317040,201909,10277,26429,7169,21044,1641,5131,2651,7916,4292,13047
317043,201909,802,1867,580,1551,69,190,398,1065,467,1255
317047,201909,1133,2750,765,2147,98,278,458,1257,556,1535
317050,201909,1132,3504,772,2644,104,367,318,964,422,1331
317052,201909,2284,6577,1823,5807,284,920,1106,3519,1390,4439
317057,201909,1643,4114,1170,3290,45,174,763,2094,808,2268
317060,201909,431,1141,259,780,39,135,111,300,150,435
317065,201909,1182,3477,953,3041,46,173,606,1804,652,1977
317070,201909,7049,19551,4783,15097,982,3548,1265,3717,2247,7265
317075,201909,844,2240,578,1758,104,355,211,581,315,936
317080,201909,5724,13683,4149,11088,1201,3445,1301,3276,2502,6721
317090,201909,4273,13123,3831,12386,316,993,2793,9013,3109,10006
317100,201909,2442,5777,1543,4344,369,1109,578,1569,947,2678
317103,201909,1863,5546,1592,5068,108,555,1148,3423,1256,3978
317107,201909,1321,3616,1026,3034,54,229,637,1659,691,1888
317110,201909,694,1581,332,1018,48,186,108,327,156,513
317115,201909,1049,3025,882,2718,43,120,623,1929,666,2049
317120,201909,11642,32658,9039,28267,1172,4246,5029,15222,6201,19468
317130,201909,10215,24139,6190,17538,1094,3408,2067,5761,3161,9169
317140,201909,689,1833,525,1570,43,134,341,1048,384,1182
317150,201909,982,2383,735,2064,32,109,567,1557,599,1666
317160,201909,3461,8441,2255,6562,185,586,1274,3734,1459,4320
317170,201909,1806,4584,1247,3588,204,688,491,1204,695,1892
317180,201909,1751,5641,1294,4508,266,998,338,1112,604,2110
317190,201909,1202,3283,892,2788,111,353,514,1592,625,1945
317200,201909,4713,12505,3491,10328,1002,3234,673,1807,1675,5041
317210,201909,1143,2827,874,2457,34,124,638,1814,672,1938
317220,201909,249,772,207,681,55,185,74,257,129,442
320010,201909,4398,12971,3514,11202,382,1363,2248,7018,2630,8381
320013,201909,1608,4712,1061,3508,173,571,504,1698,677,2269
320016,201909,2938,7645,2281,6645,115,320,1821,5270,1936,5590
320020,201909,3685,9828,2687,8103,665,2159,931,2885,1596,5044
320030,201909,1529,4480,1040,3446,205,737,354,1095,559,1832
320035,201909,1747,4949,1438,4405,373,1262,620,1839,993,3101
320040,201909,3682,10741,3008,9444,427,1465,1657,5037,2084,6502
320050,201909,1708,3902,1464,3542,215,620,856,1993,1071,2613
320060,201909,11089,31150,8125,25203,1315,4507,3738,10931,5053,15438
320070,201909,1374,3932,929,3007,176,639,323,995,499,1634
320080,201909,5396,14074,3740,10784,819,2476,1339,3700,2158,6176
320090,201909,7659,20745,5061,15354,1148,3789,1926,5417,3074,9206
320100,201909,2633,7554,2085,6544,389,1339,1078,3323,1467,4662
320110,201909,1430,3619,1062,3007,182,550,521,1429,703,1979
320115,201909,1730,5695,1472,5242,631,2374,425,1574,1056,3948
320120,201909,18681,48825,12689,37871,1970,6414,5606,16045,7576,22459
320130,201909,40113,114295,32927,101074,4789,16131,18907,56435,23696,72566
320140,201909,2825,8199,2072,6629,348,1266,871,2758,1219,4024
320150,201909,12558,33169,8619,25321,2333,7395,1525,4060,3858,11455
320160,201909,5246,15088,3877,12418,667,2244,1827,5783,2494,8027
320170,201909,1393,4124,1024,3382,293,974,402,1376,695,2350
320180,201909,671,2165,539,1893,183,690,143,477,326,1167
320190,201909,2634,8520,1996,7038,481,1785,526,1787,1007,3572
320200,201909,1068,2984,775,2430,199,711,263,821,462,1532
320210,201909,4283,11082,3266,9278,548,1704,1749,4737,2297,6441
320220,201909,2454,6705,1829,5619,350,1184,866,2548,1216,3732
320225,201909,1310,4140,887,3091,336,1243,159,545,495,1788
320230,201909,4438,12586,3360,10770,813,2848,1310,4082,2123,6930
320240,201909,14053,36699,10358,30591,2466,7807,3822,11030,6288,18837
320245,201909,2895,8817,2313,7613,921,3154,492,1573,1413,4727
320250,201909,1882,5357,1223,3775,305,1038,327,910,632,1948
320255,201909,1659,5365,1454,5004,464,1619,686,2464,1150,4083
320260,201909,1018,3070,713,2308,177,654,196,534,373,1188
320265,201909,2309,7304,1904,6482,912,3268,356,1197,1268,4465
320270,201909,2146,6268,1607,5170,360,1244,668,2145,1028,3389
320280,201909,6082,16712,4824,14463,1152,3630,1946,5750,3098,9380
320290,201909,1286,3859,810,2672,220,795,194,591,414,1386
320300,201909,3315,10402,2671,8987,820,2977,550,1717,1370,4694
320305,201909,4857,14037,3760,11834,759,2565,1816,5551,2575,8116
320310,201909,1874,5331,1284,4032,237,781,555,1687,792,2468
320313,201909,2256,5784,1378,4050,303,992,318,875,621,1867
320316,201909,1390,4078,1165,3651,181,581,683,2140,864,2721
320320,201909,20253,53874,14058,43028,3358,10769,5269,16112,8627,26881
320330,201909,2867,7906,2219,6717,471,1405,1114,3453,1585,4858
320332,201909,5570,15882,4447,13881,1155,3863,2058,6368,3213,10231
320334,201909,1697,4986,1178,3874,269,1048,249,649,518,1697
320335,201909,1378,4102,889,2955,223,793,202,607,425,1400
320340,201909,4528,11709,3756,10506,485,1478,2179,6141,2664,7619
320350,201909,4993,12582,3420,9685,459,1381,1783,4856,2242,6237
320360,201909,1397,3586,1018,2861,132,357,502,1365,634,1722
320370,201909,2336,7486,1819,6327,563,2021,606,2080,1169,4101
320380,201909,2292,6316,1902,5667,250,793,1190,3479,1440,4272
320390,201909,6898,19066,5066,15319,1088,3468,2000,5745,3088,9213
320400,201909,3121,9014,2418,7527,669,2222,915,2721,1584,4943
320405,201909,4254,11424,3148,9510,540,1753,1446,4281,1986,6034
320410,201909,4624,12179,3460,10290,626,1860,1713,5308,2339,7168
320420,201909,2777,7477,2132,6403,685,2281,444,1276,1129,3557
320425,201909,1998,4786,1529,4029,93,268,1036,2649,1129,2917
320430,201909,2817,7175,2188,5975,306,932,1392,3616,1698,4548
320435,201909,2200,6967,1711,5978,601,2184,520,1848,1121,4032
320440,201909,1331,3718,950,2966,147,511,429,1280,576,1791
320450,201909,1546,4564,1206,3915,291,1063,525,1581,816,2644
320455,201909,3907,11958,2549,8685,683,2474,709,2275,1392,4749
320460,201909,2007,6078,1380,4673,339,1203,353,1132,692,2335
320465,201909,1147,3303,853,2716,132,457,453,1429,585,1886
320470,201909,3527,9902,2400,7472,571,1932,559,1591,1130,3523
320480,201909,1576,4486,1289,3975,223,794,701,2071,924,2865
320490,201909,19692,52406,14168,42417,2556,8463,5775,16969,8331,25432
320495,201909,1303,3578,884,2775,184,655,326,969,510,1624
320500,201909,48773,132190,39039,114895,5891,18708,22231,62776,28122,81484
320501,201909,4136,12064,2954,9896,833,3087,1002,3288,1835,6375
320503,201909,1937,5884,1355,4626,407,1508,453,1412,860,2920
320506,201909,2477,7470,1697,5705,514,1850,188,626,702,2476
320510,201909,9379,25899,7531,22588,942,3224,4534,13134,5476,16358
320515,201909,1661,4600,1256,3758,371,1201,404,1152,775,2353
320517,201909,2048,6347,1600,5390,538,1955,416,1381,954,3336
320520,201909,32767,86453,24022,71488,4434,14408,10180,29313,14614,43721
320530,201909,29099,78547,22611,66866,2383,8418,13855,38584,16238,47002
330010,201909,20275,55285,16405,48659,2519,7935,10063,29240,12582,37175
330015,201909,1454,3651,1124,3110,200,624,601,1582,801,2206
330020,201909,19575,49300,16759,45249,2206,6796,12048,31632,14254,38428
330022,201909,1866,5045,1405,4234,239,737,808,2412,1047,3149
330023,201909,4688,11373,3244,9254,611,1888,1648,4559,2259,6447
330025,201909,4797,11764,3171,9052,928,2841,984,2747,1912,5588
330030,201909,10032,27239,7468,22848,849,3051,4500,13077,5349,16128
330040,201909,13864,36632,10868,31375,1124,3674,7111,19692,8235,23366
330045,201909,80908,193851,66535,175215,5428,14444,52271,136438,57699,150882
330050,201909,2350,6268,1706,5180,369,1206,791,2261,1160,3467
330060,201909,4664,12583,3835,11142,777,2484,1729,4651,2506,7135
330070,201909,21144,54882,17068,48707,2952,8936,9712,27492,12664,36428
330080,201909,8507,21893,7284,20114,979,2845,4945,13496,5924,16341
330090,201909,3414,7165,2187,5492,144,391,1479,3681,1623,4072
330093,201909,2390,5980,1750,5014,131,406,1279,3644,1410,4050
330095,201909,1171,3373,894,2836,79,303,535,1561,614,1864
330100,201909,67657,182038,57170,166109,3734,13013,43074,122891,46808,135904
330110,201909,1969,5658,1655,5108,276,926,881,2636,1157,3562
330115,201909,2063,5224,1552,4464,238,761,917,2549,1155,3310
330120,201909,3442,7827,2499,6549,257,748,1668,4207,1925,4955
330130,201909,3754,10423,3100,9438,441,1406,1932,5836,2373,7242
330140,201909,3454,9158,2727,8083,408,1327,1679,4849,2087,6176
330150,201909,2099,5692,1593,4850,325,1044,720,2148,1045,3192
330160,201909,1311,3575,1002,3055,172,587,546,1586,718,2173
330170,201909,97407,250055,79046,224529,11111,31234,52569,150877,63680,182111
330180,201909,2020,4971,1532,4239,111,357,1026,2732,1137,3089
330185,201909,9226,23832,7684,21579,603,2043,5917,16111,6520,18154
330187,201909,3912,10058,3080,8783,434,1369,1877,5312,2311,6681
330190,201909,30429,75597,26031,69405,2017,5807,20463,53804,22480,59611
330200,201909,14932,39077,12233,35581,2438,6778,7691,22947,10129,29725
330205,201909,1996,5004,1503,4173,92,309,1035,2771,1127,3080
330210,201909,3360,8542,2400,6794,374,1176,1098,2864,1472,4040
330220,201909,10844,27538,7563,21852,1704,5426,2598,6941,4302,12367
330225,201909,3535,9135,2673,7785,217,757,1876,5292,2093,6049
330227,201909,16635,40923,14121,37755,641,1962,12049,31734,12690,33696
330230,201909,1642,3785,1153,3161,106,302,771,2087,877,2389
330240,201909,22443,59388,18095,52283,2625,8254,11310,31781,13935,40035
330245,201909,1647,4148,937,2891,199,647,321,999,520,1646
330250,201909,35081,92223,29229,83359,5664,16441,16893,48397,22557,64838
330260,201909,3855,9878,2920,8568,377,1237,1869,5278,2246,6515
330270,201909,24873,52556,15003,38096,2635,7250,6498,16092,9133,23342
330280,201909,2334,6212,1718,5122,187,619,1006,2869,1193,3488
330285,201909,21219,52128,16726,45563,1519,4779,11979,31582,13498,36361
330290,201909,3560,8902,2849,7928,351,1097,1905,5128,2256,6225
330300,201909,5586,13460,3927,10959,350,1108,2610,7124,2960,8232
330310,201909,2328,5921,1718,4896,104,268,1169,3324,1273,3592
330320,201909,15362,37491,11939,33088,1484,4148,8522,23674,10006,27822
330330,201909,33445,75670,25888,65203,2576,7107,18465,45460,21041,52567
330340,201909,13876,34866,9948,28520,1695,5386,5002,13682,6697,19068
330350,201909,116494,279695,96028,254162,6825,18967,77201,203410,84026,222377
330360,201909,7404,18062,6310,16707,250,706,5312,13943,5562,14649
330370,201909,4634,13415,3387,11206,775,2647,1399,4776,2174,7423
330380,201909,4981,13622,3716,11377,730,2542,1773,5181,2503,7723
330385,201909,3835,11268,3114,10191,761,2701,1451,4752,2212,7453
330390,201909,24329,67517,18545,57049,2821,9805,10194,29749,13015,39554
330395,201909,3105,7837,2543,7067,172,532,1805,4911,1977,5443
330400,201909,3044,8267,2614,7548,162,595,1938,5280,2100,5875
330410,201909,2821,7819,2101,6507,415,1433,957,2797,1372,4230
330411,201909,2699,7329,2091,6151,154,529,1472,4156,1626,4685
330412,201909,1431,4166,1161,3702,135,490,690,2057,825,2547
330414,201909,22252,56997,17821,50836,1738,5056,12760,36138,14498,41194
330415,201909,3770,10378,2902,8861,335,1046,1708,5247,2043,6293
330420,201909,10020,25002,6702,19470,876,2839,3245,8871,4121,11710
330430,201909,9019,22069,7648,20101,410,1310,5896,14973,6306,16283
330440,201909,2237,6134,1646,5140,320,1182,882,2610,1202,3792
330450,201909,1273,3729,1007,3251,140,484,520,1655,660,2139
330452,201909,15298,39651,12016,34527,1711,5473,7432,20694,9143,26167
330455,201909,529208,1274017,399259,1081580,61037,175703,246514,656181,307551,831884
330460,201909,1169,3231,856,2741,161,549,445,1395,606,1944
330470,201909,4661,11865,3373,9849,1040,3100,1119,3331,2159,6431
330475,201909,8878,23524,7124,21165,1214,4086,4446,12906,5660,16992
330480,201909,5788,15183,4865,13810,422,1314,3304,9117,3726,10431
330490,201909,108711,254009,88619,226332,10027,27011,63398,159857,73425,186868
330500,201909,6596,16780,5520,15273,632,1955,3942,10722,4574,12677
330510,201909,37297,94714,28141,81579,5523,16877,16262,46654,21785,63531
330513,201909,1235,3235,959,2821,204,654,490,1439,694,2093
330515,201909,2404,6493,1929,5773,426,1352,984,2864,1410,4216
330520,201909,10532,28470,8555,25233,1200,3960,5119,14604,6319,18564
330530,201909,1631,4064,1164,3304,255,776,520,1441,775,2217
330540,201909,2819,7543,2128,6302,546,1674,865,2508,1411,4182
330550,201909,8214,22547,6428,19972,1984,6614,2379,7307,4363,13921
330555,201909,15639,34615,12939,31299,975,2698,10103,24406,11078,27104
330560,201909,4176,11249,3345,9818,524,1590,1971,5624,2495,7214
330570,201909,2723,7561,2230,6754,355,1170,1413,4216,1768,5386
330575,201909,5289,13887,4559,12606,303,969,3579,9548,3882,10517
330580,201909,15097,41252,11385,34342,2282,7419,5255,15161,7537,22580
330590,201909,1409,3893,1192,3603,213,647,766,2336,979,2983
330600,201909,11247,30101,8847,26148,1102,3642,5307,15290,6409,18932
330610,201909,9018,24376,7280,21567,649,2263,4982,14330,5631,16593
330615,201909,2026,5604,1537,4908,299,1007,947,3055,1246,4062
330620,201909,3837,11195,3024,9738,725,2543,1253,3768,1978,6311
330630,201909,23588,60032,18323,51525,1548,5165,12798,34553,14346,39718
350010,201909,2039,5292,968,2938,211,675,139,300,350,975
350020,201909,665,1713,348,1068,46,134,137,379,183,513
350030,201909,3621,10283,2620,8426,659,2271,985,3022,1644,5293
350040,201909,657,1910,373,1287,55,215,120,335,175,550
350050,201909,1079,2789,707,2091,168,562,228,549,396,1111
350055,201909,905,2369,668,1983,76,250,379,1046,455,1296
350060,201909,97,250,65,198,10,35,36,109,46,144
350070,201909,3430,9072,2075,6508,419,1472,613,1709,1032,3181
350075,201909,564,1696,406,1377,174,626,35,110,209,736
350080,201909,649,1692,386,1198,57,193,155,438,212,631
350090,201909,611,1456,340,962,69,217,131,335,200,552
350100,201909,2052,5554,1357,4268,122,465,792,2352,914,2817
350110,201909,463,1200,309,914,19,70,175,506,194,576
350115,201909,1254,3663,1004,3109,180,630,532,1498,712,2128
350120,201909,629,1474,314,867,42,130,146,357,188,487
350130,201909,2940,7922,2299,6736,415,1274,1120,3117,1535,4391
350140,201909,737,2134,463,1555,51,222,231,701,282,923
350150,201909,471,1454,379,1280,92,296,99,315,191,611
350160,201909,10572,26187,6783,19391,850,2835,4105,11063,4955,13898
350170,201909,1915,5666,1478,4663,285,932,604,1798,889,2730
350180,201909,1024,2535,497,1487,109,323,108,299,217,622
350190,201909,2759,7872,1886,6029,369,1370,784,2093,1153,3463
350200,201909,418,1176,325,1004,19,66,217,634,236,700
350210,201909,5204,12048,3411,9315,523,1523,1986,5234,2509,6757
350220,201909,2760,7511,1810,5652,423,1396,612,1713,1035,3109
350230,201909,939,2489,770,2223,157,490,406,1142,563,1632
350240,201909,656,1925,404,1329,80,259,121,381,201,640
350250,201909,2282,6806,1669,5711,600,2222,275,996,875,3218
350260,201909,756,1837,467,1317,49,151,288,788,337,939
350270,201909,4473,12233,3488,10321,559,1798,1791,4937,2350,6735
350275,201909,2286,6243,1808,5423,318,1086,1020,2849,1338,3935
350280,201909,18189,40889,10234,27764,1855,5343,3776,9878,5631,15221
350290,201909,3070,8493,2009,6291,386,1341,798,2331,1184,3672
350300,201909,636,1745,454,1381,79,267,216,596,295,863
350310,201909,802,2358,570,1848,104,411,223,630,327,1041
350315,201909,537,1404,346,1056,25,97,165,460,190,557
350320,201909,13035,34064,9653,28032,2228,7083,3387,9258,5615,16341
350330,201909,13455,33343,9383,25401,1142,3403,5772,14711,6914,18114
350335,201909,348,993,257,814,25,95,141,422,166,517
350340,201909,1077,2800,614,1949,113,381,220,666,333,1047
350350,201909,746,1932,575,1740,76,278,323,946,399,1224
350360,201909,1066,3198,808,2640,222,731,228,744,450,1475
350370,201909,594,1494,404,1148,147,401,104,305,251,706
350380,201909,4187,11320,2723,8427,768,2383,642,2064,1410,4447
350390,201909,9246,25131,7118,21362,1760,5470,2961,8702,4721,14172
350395,201909,413,1058,199,640,21,63,65,185,86,248
350400,201909,7704,19268,5174,14968,1282,3981,1460,4064,2742,8045
350410,201909,8965,25374,6345,20128,1422,5019,2242,6544,3664,11563
350420,201909,656,1768,450,1357,84,283,109,303,193,586
350430,201909,636,1744,506,1521,66,239,311,838,377,1077
350440,201909,1815,4685,1447,4119,108,369,960,2650,1068,3019
350450,201909,6448,17922,4959,15280,1095,3676,2051,5900,3146,9576
350460,201909,1620,4208,776,2435,123,415,157,418,280,833
350470,201909,266,679,196,554,9,34,132,356,141,390
350480,201909,878,2302,530,1646,116,409,82,218,198,627
350490,201909,1813,4839,1255,3886,307,984,374,1069,681,2053
350500,201909,663,1800,492,1464,79,248,234,652,313,900
350510,201909,1068,2802,761,2224,97,327,426,1183,523,1510
350520,201909,2023,6277,1538,5265,251,978,688,2131,939,3109
350530,201909,2612,6611,1856,5152,227,712,1074,2777,1301,3489
350535,201909,1368,3810,1169,3513,177,600,722,2080,899,2680
350540,201909,1723,4393,1236,3623,182,567,722,2057,904,2624
350550,201909,8150,20216,5544,15804,605,2037,3189,8455,3794,10492
350560,201909,3792,10800,2964,9248,297,960,1812,5485,2109,6445
350570,201909,22733,64186,17993,54705,3608,11980,8753,25302,12361,37282
350580,201909,1847,5090,945,3064,258,904,142,373,400,1277
350590,201909,4602,12723,3297,9733,479,1598,1899,5171,2378,6769
350600,201909,35562,82847,21302,57468,3126,9339,10222,25279,13348,34618
350610,201909,6353,17596,4468,13754,851,2825,1992,5868,2843,8693
350620,201909,380,945,218,692,23,85,122,365,145,450
350630,201909,1410,3722,1011,2981,68,266,636,1737,704,2003
350635,201909,7557,19298,5675,16297,985,3150,3209,8726,4194,11876
350640,201909,906,2453,468,1443,66,209,151,389,217,598
350650,201909,7671,20806,5030,15386,1031,3402,1718,4851,2749,8253
350660,201909,4414,11712,3339,9884,595,1774,1698,5032,2293,6806
350670,201909,1792,4811,1453,4306,153,496,971,2854,1124,3350
350680,201909,1091,2944,697,2198,150,478,274,833,424,1311
350690,201909,1208,3218,852,2584,146,487,460,1332,606,1819
350700,201909,4651,11876,3098,9420,532,1847,1402,3984,1934,5831
350710,201909,2665,7433,2207,6612,338,1185,1228,3466,1566,4651
350715,201909,828,2385,663,2061,72,292,335,934,407,1226
350720,201909,170,439,117,340,18,51,37,89,55,140
350730,201909,577,1607,463,1394,29,118,332,937,361,1055
350740,201909,1570,4304,1019,3138,191,614,303,865,494,1479
350745,201909,526,1379,296,905,29,106,147,414,176,520
350750,201909,9428,24886,7018,20592,1277,4279,3076,8063,4353,12342
350760,201909,12923,32762,8880,25643,2141,6755,3040,7913,5181,14668
350770,201909,931,2353,567,1707,45,148,344,1014,389,1162
350775,201909,651,1587,429,1229,44,129,204,568,248,697
350780,201909,1919,4872,1326,3971,242,817,466,1561,708,2378
350790,201909,1653,4468,996,3220,196,695,237,617,433,1312
350800,201909,3174,9403,2695,8537,325,1141,1700,5229,2025,6370
350810,201909,2492,6279,1944,5483,246,729,1110,3130,1356,3859
350820,201909,893,2084,481,1350,51,161,220,573,271,734
350830,201909,825,2302,439,1439,83,267,129,355,212,622
350840,201909,2853,8571,2047,6942,510,1891,787,2421,1297,4312
350850,201909,6387,18164,4806,15160,1095,3727,1912,5825,3007,9552
350860,201909,3394,9303,2931,8620,140,536,2204,6368,2344,6904
350870,201909,2571,7377,1858,6185,272,1044,979,3141,1251,4185
350880,201909,1179,3463,906,2891,217,705,285,883,502,1588
350890,201909,530,1369,329,953,52,168,126,334,178,502
350900,201909,6455,17811,3937,12252,1021,3450,1031,2913,2052,6363
350910,201909,848,2177,713,1949,100,304,487,1292,587,1596
350920,201909,11335,28617,9496,25507,477,1567,7591,19620,8068,21187
350925,201909,4263,11826,2999,9429,579,1936,1374,3973,1953,5909
350930,201909,1412,3643,932,2733,114,349,527,1501,641,1850
350940,201909,2112,5739,1640,4922,198,648,1008,2932,1206,3580
350945,201909,809,2293,595,1871,99,379,303,857,402,1236
350950,201909,79993,209449,60592,171755,8301,25977,36370,98140,44671,124117
350960,201909,5876,16203,4489,13547,581,2022,2673,7635,3254,9657
350970,201909,3339,9621,2421,7742,746,2631,425,1187,1171,3818
350980,201909,594,1648,465,1410,140,449,192,570,332,1019
350990,201909,1711,4907,1241,4108,298,1116,436,1340,734,2456
350995,201909,739,2319,657,2151,53,207,458,1437,511,1644
351000,201909,2724,7121,1889,5609,360,1152,672,1888,1032,3040
351010,201909,305,754,193,553,19,62,107,297,126,359
351015,201909,747,2247,589,1920,91,341,278,804,369,1145
351020,201909,8824,24384,6553,20422,1372,4433,3150,9538,4522,13971
351030,201909,2523,7609,2015,6564,298,1085,1095,3455,1393,4540
351040,201909,4704,11878,3913,10649,209,703,3174,8362,3383,9065
351050,201909,16752,41141,11276,32291,2355,7152,4694,13149,7049,20301
351060,201909,45660,116218,34500,96852,3934,12107,22613,61442,26547,73549
351070,201909,1434,3623,766,2417,193,652,122,380,315,1032
351080,201909,2621,6554,1860,5605,247,893,1173,3335,1420,4228
351090,201909,313,924,213,730,50,173,50,177,100,350
351100,201909,2289,6218,1428,4480,322,1066,389,1289,711,2355
351110,201909,5810,14911,3638,10814,665,2155,1486,4126,2151,6281
351120,201909,742,1930,490,1481,65,196,195,570,260,766
351130,201909,1042,2692,431,1377,91,299,85,255,176,554
351140,201909,1836,5312,1287,4195,287,1045,462,1348,749,2393
351150,201909,2023,5937,1281,4268,253,919,483,1454,736,2373
351160,201909,1068,3378,803,2738,181,653,246,746,427,1399
351170,201909,1324,3725,1146,3390,105,331,779,2219,884,2550
351190,201909,998,2767,602,1926,114,371,207,593,321,964
351200,201909,1545,3743,1133,3120,91,288,777,2023,868,2311
351210,201909,1495,3727,870,2471,81,266,518,1370,599,1636
351220,201909,3103,8896,2637,8097,342,1084,1707,5205,2049,6289
351230,201909,1734,4798,1253,3933,249,902,551,1542,800,2444
351240,201909,2090,5416,1320,3783,268,815,558,1441,826,2256
351250,201909,1054,2809,595,1864,72,231,225,708,297,939
351260,201909,888,2287,625,1800,145,404,212,616,357,1020
351270,201909,384,1081,313,960,34,116,189,517,223,633
351280,201909,3666,9789,2735,8028,505,1578,1282,3598,1787,5176
351290,201909,1105,2832,736,2162,122,373,388,1101,510,1474
351300,201909,15296,42367,10184,32289,1962,6682,4149,12781,6111,19463
351310,201909,3113,7894,2317,6580,199,695,1602,4286,1801,4981
351320,201909,894,2620,624,2011,125,446,225,649,350,1095
351330,201909,471,1090,386,937,34,99,281,614,315,713
351340,201909,6148,17841,4842,15500,1197,3947,2052,6570,3249,10517
351350,201909,11113,28419,9196,25230,1052,3108,6657,17685,7709,20793
351360,201909,3682,10017,3013,8953,764,2449,1087,2986,1851,5435
351370,201909,2060,5838,1339,4303,343,1161,427,1236,770,2397
351380,201909,45364,111946,31678,87246,4456,13115,17451,45917,21907,59032
351385,201909,275,716,140,427,25,74,41,114,66,188
351390,201909,1349,3334,789,2477,129,476,445,1300,574,1776
351400,201909,905,2535,716,2140,138,414,421,1225,559,1639
351410,201909,2525,7130,1761,5603,312,1004,678,2112,990,3116
351420,201909,348,840,175,526,33,86,87,259,120,345
351430,201909,908,2545,700,2188,67,217,466,1423,533,1640
351440,201909,3217,8576,2020,6015,377,1211,544,1367,921,2578
351450,201909,1694,4533,1073,3311,224,762,184,460,408,1222
351460,201909,785,2081,593,1743,151,430,311,913,462,1343
351470,201909,1152,2985,859,2478,89,299,529,1437,618,1736
351480,201909,2488,7399,1947,6429,366,1322,814,2517,1180,3839
351490,201909,1849,5367,1564,4816,85,341,1205,3534,1290,3875
351492,201909,331,913,266,768,11,40,179,501,190,541
351495,201909,182,474,127,361,13,34,66,178,79,212
351500,201909,34738,87641,25425,71205,4211,12685,14419,38423,18630,51108
351510,201909,12274,30965,8767,24668,1139,3643,5373,14416,6512,18059
351512,201909,468,1269,307,915,57,172,97,258,154,430
351515,201909,3118,7012,1774,4845,340,1031,502,1422,842,2453
351518,201909,2309,5869,1441,4295,203,688,773,2085,976,2773
351519,201909,710,1964,400,1313,76,250,58,183,134,433
351520,201909,1140,2847,430,1339,53,179,176,484,229,663
351530,201909,330,901,183,571,28,86,67,160,95,246
351535,201909,1933,4683,1349,3689,204,616,706,1814,910,2430
351540,201909,2206,5584,1378,4099,325,1116,409,1031,734,2147
351550,201909,6193,15664,4101,11720,432,1468,2303,6075,2735,7543
351560,201909,422,1220,329,1036,82,290,93,270,175,560
351565,201909,183,538,144,468,32,118,40,120,72,238
351570,201909,18808,51528,13860,41020,1624,5262,8495,24013,10119,29275
351580,201909,254,652,145,436,15,49,61,188,76,237
351590,201909,494,1121,249,684,24,83,135,329,159,412
351600,201909,1307,3409,985,2823,98,319,618,1651,716,1970
351610,201909,741,1742,446,1211,31,102,245,610,276,712
351620,201909,20865,56715,15056,46041,2583,8920,6622,18166,9205,27086
351630,201909,24628,66358,19533,57314,3211,9906,11821,33689,15032,43595
351640,201909,15734,42387,11932,35076,1268,4221,7934,22374,9202,26595
351650,201909,377,999,157,520,18,66,38,103,56,169
351660,201909,739,2127,441,1410,83,271,68,186,151,457
351670,201909,5168,14138,3562,10628,769,2314,1599,4471,2368,6785
351680,201909,410,1201,247,791,47,145,55,148,102,293
351685,201909,418,1216,329,1059,94,297,110,322,204,619
351690,201909,1007,2581,566,1661,88,287,231,610,319,897
351700,201909,1277,3258,907,2580,116,335,520,1401,636,1736
351710,201909,747,2003,498,1536,41,143,259,713,300,856
351720,201909,1371,3599,868,2684,149,502,315,920,464,1422
351730,201909,871,2302,715,2041,65,232,478,1305,543,1537
351740,201909,3465,8774,2652,7197,470,1376,1314,3293,1784,4669
351750,201909,1235,3294,740,2386,142,482,268,856,410,1338
351760,201909,3213,9120,2250,7081,480,1685,796,2258,1276,3943
351770,201909,1724,5177,1395,4508,298,997,685,2166,983,3163
351780,201909,1322,3412,716,2182,117,409,229,653,346,1062
351790,201909,1288,3079,997,2689,163,437,592,1615,755,2052
351800,201909,510,1187,244,692,31,92,84,201,115,293
351810,201909,977,2586,775,2254,41,134,560,1552,601,1686
351820,201909,2430,6878,1648,5319,429,1513,351,1061,780,2574
351830,201909,4272,11638,3227,9773,330,1200,1961,5622,2291,6822
351840,201909,7882,22326,5875,18491,919,3224,2903,8564,3822,11788
351850,201909,1643,4430,1014,3176,196,705,314,840,510,1545
351860,201909,2725,8020,2094,6800,373,1287,1128,3666,1501,4953
351870,201909,22298,57910,16680,48409,4791,14204,6374,19049,11165,33253
351880,201909,111548,297561,81825,244036,21425,69414,31858,90482,53283,159896
351885,201909,867,2390,671,2027,82,284,412,1183,494,1467
351890,201909,654,1821,466,1492,113,363,73,198,186,561
351900,201909,1047,2858,802,2475,124,380,432,1333,556,1713
351905,201909,377,1045,242,766,18,65,93,250,111,315
351907,201909,20725,54839,15732,45673,1842,5824,10057,28168,11899,33992
351910,201909,1245,3280,857,2474,80,252,474,1248,554,1500
351920,201909,802,2134,576,1690,79,282,280,752,359,1034
351925,201909,850,2358,644,1949,96,318,312,870,408,1188
351930,201909,3064,8738,2748,8136,494,1480,1890,5507,2384,6987
351940,201909,1074,2817,757,2273,114,367,382,1120,496,1487
351950,201909,1556,3671,1111,2994,70,202,737,1931,807,2133
351960,201909,5045,12990,3622,10426,801,2468,1583,4242,2384,6710
351970,201909,6411,19637,5173,17382,846,3173,2842,9250,3688,12423
351980,201909,1022,2397,623,1736,76,249,368,953,444,1202
351990,201909,1392,3326,952,2638,67,251,440,1087,507,1338
352000,201909,2471,7178,2089,6374,265,941,1345,3832,1610,4773
352010,201909,2105,5797,1675,5041,436,1427,331,1040,767,2467
352020,201909,1391,3843,1063,3267,177,580,506,1468,683,2048
352030,201909,5299,14244,4157,12384,828,2715,2129,6152,2957,8867
352040,201909,2633,7206,1665,5176,278,915,533,1437,811,2352
352042,201909,3018,7486,1826,5439,367,1206,741,2134,1108,3340
352044,201909,2057,5562,1094,3656,192,726,225,674,417,1400
352050,201909,11391,30603,6976,21710,1791,6287,1171,3090,2962,9377
352060,201909,690,1870,483,1469,74,248,218,614,292,862
352070,201909,854,1749,533,1316,57,157,252,529,309,686
352080,201909,445,1124,263,762,33,106,100,256,133,362
352090,201909,1400,4171,1120,3567,149,566,500,1422,649,1988
352100,201909,2920,8267,2397,7277,568,1873,1124,3238,1692,5111
352110,201909,560,1673,424,1389,98,333,165,502,263,835
352115,201909,480,1334,391,1193,53,179,226,684,279,863
352120,201909,839,2567,660,2184,74,275,387,1191,461,1466
352130,201909,1845,5227,1182,3572,213,667,469,1321,682,1988
352140,201909,1223,3264,787,2392,135,439,368,1079,503,1518
352150,201909,797,2159,594,1797,105,338,354,1041,459,1379
352160,201909,970,2413,694,1995,86,300,376,1021,462,1321
352170,201909,2883,7867,2235,6542,360,1188,1241,3304,1601,4492
352180,201909,2463,6734,1885,5634,466,1540,575,1505,1041,3045
352190,201909,1142,3107,865,2666,150,454,414,1319,564,1773
352200,201909,353,1068,245,846,36,140,90,302,126,442
352210,201909,18403,44437,14255,38732,1127,3359,10775,28798,11902,32157
352215,201909,549,1469,473,1366,53,179,329,912,382,1091
352220,201909,17041,43106,11025,32106,2735,8363,3878,10740,6613,19103
352230,201909,12440,36895,9326,30832,2278,8407,3327,10163,5605,18570
352240,201909,10043,26375,7582,22087,1717,5653,3196,8485,4913,14138
352250,201909,22351,63144,17678,54700,3242,10619,10140,30768,13382,41387
352260,201909,4669,11915,3141,8880,452,1504,1811,4646,2263,6150
352265,201909,882,2505,776,2343,53,210,575,1673,628,1883
352270,201909,1421,4318,1032,3452,222,811,352,1098,574,1909
352280,201909,2351,6081,1774,5196,182,665,1021,2741,1203,3406
352290,201909,1101,3260,879,2798,139,505,445,1255,584,1760
352300,201909,878,2392,574,1745,88,312,294,812,382,1124
352310,201909,43930,117443,31705,95283,8056,24722,13536,40815,21592,65537
352320,201909,6149,16549,4621,13432,709,2302,2390,6295,3099,8597
352330,201909,2108,5678,1581,4917,319,1161,769,2225,1088,3386
352340,201909,5135,13659,3631,10921,625,2152,1775,4911,2400,7063
352350,201909,2080,6036,1608,4955,195,737,867,2370,1062,3107
352360,201909,1203,3242,1012,2897,93,326,750,2048,843,2374
352370,201909,1038,2996,892,2730,22,98,694,2072,716,2170
352380,201909,772,2151,578,1789,129,421,202,593,331,1014
352390,201909,15110,37253,9972,28171,1617,4995,5512,14696,7129,19691
352400,201909,3354,9350,2772,8234,489,1712,1643,4552,2132,6264
352410,201909,3061,7996,2272,6626,220,766,1377,3818,1597,4584
352420,201909,812,1987,557,1592,99,303,203,545,302,848
352430,201909,7328,18646,5137,14723,1259,4014,2202,5920,3461,9934
352440,201909,16798,46120,12398,37475,3029,9560,4815,14043,7844,23603
352450,201909,788,2019,373,1227,51,185,115,345,166,530
352460,201909,2849,7950,1892,6140,400,1438,699,2101,1099,3539
352470,201909,3226,8096,2298,6574,278,911,1287,3426,1565,4337
352480,201909,3444,8291,2206,6066,359,1115,1038,2609,1397,3724
352490,201909,683,2066,534,1768,106,377,239,746,345,1123
352500,201909,9924,25799,6500,19288,2887,9358,761,1335,3648,10693
352510,201909,3375,9212,2460,7604,565,1899,1048,3060,1613,4959
352520,201909,2496,6777,1912,5738,392,1327,1010,2751,1402,4078
352530,201909,9236,24586,5691,17382,1151,3951,1259,3130,2410,7081
352540,201909,527,1606,375,1241,71,252,106,318,177,570
352550,201909,965,2765,671,2175,132,478,200,574,332,1052
352560,201909,567,1580,418,1276,70,233,188,523,258,756
352570,201909,1943,5663,1215,4133,319,1156,154,460,473,1616
352580,201909,626,1625,508,1411,65,218,314,831,379,1049
352585,201909,240,703,178,573,15,65,99,283,114,348
352590,201909,12346,32605,8486,25112,2362,7593,3585,9827,5947,17420
352600,201909,1875,5112,1425,4243,198,654,809,2237,1007,2891
352610,201909,2936,8307,2157,6887,463,1657,869,2602,1332,4259
352620,201909,5533,14466,4210,12447,1291,3863,1578,4710,2869,8573
352630,201909,814,2031,602,1704,105,341,273,696,378,1037
352640,201909,2892,7553,2028,6018,221,693,1168,3318,1389,4011
352650,201909,557,1594,379,1175,60,215,138,401,198,616
352660,201909,1005,3021,796,2562,166,558,353,1099,519,1657
352670,201909,8466,23225,5257,16672,1461,4901,889,2764,2350,7665
352680,201909,3235,9762,2244,7387,362,1395,1092,3290,1454,4685
352690,201909,25916,65878,19359,54149,1602,5272,13020,34733,14622,40005
352700,201909,539,1342,381,1112,142,471,84,223,226,694
352710,201909,4790,12522,3322,9782,787,2559,1410,3849,2197,6408
352720,201909,7485,20904,5690,17376,2722,8454,803,2172,3525,10626
352725,201909,524,1324,267,799,18,56,125,358,143,414
352730,201909,2654,7584,2195,6510,322,1080,1299,3517,1621,4597
352740,201909,2178,5205,1587,4316,184,578,925,2389,1109,2967
352750,201909,386,968,209,647,35,119,82,218,117,337
352760,201909,1566,4378,1153,3523,150,485,577,1733,727,2218
352770,201909,875,2349,566,1737,118,378,225,657,343,1035
352780,201909,612,1774,416,1373,76,256,123,401,199,657
352790,201909,433,1179,283,858,31,102,110,297,141,399
352800,201909,1230,3809,858,2930,242,864,127,379,369,1243
352810,201909,1075,2582,657,1815,85,247,380,995,465,1242
352820,201909,492,1296,310,980,70,228,68,231,138,459
352830,201909,567,1445,241,745,24,80,48,116,72,196
352840,201909,3707,10757,3001,9460,1044,3595,948,2851,1992,6446
352850,201909,10087,25045,6586,19261,1875,5918,2007,5339,3882,11257
352860,201909,990,2727,685,2146,144,482,221,651,365,1133
352870,201909,871,2200,590,1605,39,130,390,1004,429,1134
352880,201909,1703,4052,1175,3121,168,481,714,1789,882,2270
352885,201909,290,829,212,687,26,92,119,356,145,448
352890,201909,682,1613,422,1087,50,144,235,535,285,679
352900,201909,17251,45298,11179,33196,1860,5896,5012,13922,6872,19818
352910,201909,422,1113,204,640,22,69,57,162,79,231
352920,201909,2590,6730,1841,5365,154,490,1209,3384,1363,3874
352930,201909,5479,14941,3932,11845,715,2345,1792,5000,2507,7345
352940,201909,21000,58659,14989,45575,3423,11370,5556,15924,8979,27294
352950,201909,472,1251,260,837,71,238,33,95,104,333
352960,201909,703,1918,361,1178,58,206,80,238,138,444
352965,201909,255,681,140,457,41,138,29,84,70,222
352970,201909,2886,6930,2172,5769,256,721,1393,3663,1649,4384
352980,201909,1365,3681,1046,3171,261,830,516,1528,777,2358
352990,201909,3973,11250,3117,9819,618,2149,1571,4747,2189,6896
353000,201909,445,1232,224,697,34,106,54,146,88,252
353010,201909,2426,6060,1548,4497,371,1200,590,1558,961,2758
353020,201909,3575,9316,1978,5939,286,967,700,1955,986,2922
353030,201909,4084,10574,2684,8002,678,2167,659,1906,1337,4073
353040,201909,602,1429,429,1166,57,168,250,632,307,800
353050,201909,4950,14461,3522,11445,727,2563,1556,4828,2283,7391
353060,201909,46569,119833,37721,105484,2811,9513,27935,75050,30746,84563
353070,201909,8898,25469,6097,19466,1271,4400,2267,6683,3538,11083
353080,201909,3850,10828,2576,8294,511,1859,996,2812,1507,4671
353090,201909,542,1663,395,1341,35,126,230,757,265,883
353100,201909,292,798,120,395,25,85,31,88,56,173
353110,201909,7297,20099,5842,17938,1098,3444,3282,10302,4380,13746
353120,201909,384,973,267,765,38,127,113,295,151,422
353130,201909,2266,5450,1425,4060,389,1231,460,1196,849,2427
353140,201909,2582,6495,1837,5135,140,462,1219,3196,1359,3658
353150,201909,1426,3558,991,2841,194,584,433,1159,627,1743
353160,201909,555,1441,382,1150,69,233,164,451,233,684
353170,201909,484,1357,368,1185,80,289,158,480,238,769
353180,201909,9293,23150,7178,19669,725,2245,5265,14003,5990,16248
353190,201909,3139,8527,2461,7173,277,892,1531,4175,1808,5067
353200,201909,1986,5317,903,2959,147,511,212,636,359,1147
353205,201909,328,1012,273,880,56,197,127,402,183,599
353210,201909,952,2244,584,1620,30,95,375,1019,405,1114
353215,201909,376,1068,287,886,47,154,133,361,180,515
353220,201909,738,2008,423,1318,99,289,54,158,153,447
353230,201909,757,2117,597,1864,162,559,243,686,405,1245
353240,201909,2207,6080,1756,5265,251,858,1021,2922,1272,3780
353250,201909,1247,2827,739,1965,101,289,396,1002,497,1291
353260,201909,1065,2497,573,1669,95,313,257,702,352,1015
353270,201909,667,1737,549,1522,42,137,380,1000,422,1137
353280,201909,691,1856,467,1436,94,299,147,411,241,710
353282,201909,1730,4951,1450,4409,176,620,868,2470,1044,3090
353284,201909,343,812,169,471,21,80,71,167,92,247
353286,201909,158,399,92,289,20,65,36,114,56,179
353290,201909,1506,3990,900,2749,114,374,363,1027,477,1401
353300,201909,1725,4698,1235,3703,206,706,552,1472,758,2178
353310,201909,387,960,265,737,21,75,176,466,197,541
353320,201909,630,1584,530,1426,13,44,458,1230,471,1274
353325,201909,622,1834,408,1353,94,309,143,452,237,761
353330,201909,500,1290,315,919,43,129,164,451,207,580
353340,201909,2681,7313,1834,5649,421,1427,784,2263,1205,3690
353350,201909,3179,8469,2123,6259,480,1561,532,1336,1012,2897
353360,201909,565,1609,435,1372,54,172,231,722,285,894
353370,201909,537,1574,433,1399,32,103,304,944,336,1047
353380,201909,261,798,206,681,31,118,97,294,128,412
353390,201909,5490,13762,3931,11032,503,1582,2161,5721,2664,7303
353400,201909,399,1113,292,900,45,164,96,240,141,404
353410,201909,495,1344,374,1121,61,202,217,642,278,844
353420,201909,425,1140,250,754,56,155,18,42,74,197
353430,201909,2136,5986,1540,4863,360,1259,624,1816,984,3075
353440,201909,61174,167929,42733,131134,7539,24960,21902,63622,29441,88582
353450,201909,373,970,245,744,41,147,109,299,150,446
353460,201909,3194,8707,2257,6820,163,603,1080,3142,1243,3745
353470,201909,7426,19727,5133,15372,922,3127,2083,5676,3005,8803
353475,201909,1366,3562,941,2687,137,440,473,1245,610,1685
353480,201909,1605,4327,1245,3675,70,255,834,2353,904,2608
353490,201909,1048,2790,652,1995,103,336,271,783,374,1119
353500,201909,974,2293,726,1916,166,448,403,1071,569,1519
353510,201909,771,2344,536,1746,124,424,139,403,263,827
353520,201909,1067,2815,661,2055,92,321,289,839,381,1160
353530,201909,2365,6344,1794,5279,232,770,922,2520,1154,3290
353540,201909,1964,5406,1591,4791,276,857,891,2611,1167,3468
353550,201909,5644,14786,4415,12740,790,2412,2387,6642,3177,9054
353560,201909,1945,5435,1408,4551,450,1576,344,1034,794,2610
353570,201909,549,1411,406,1182,56,170,245,668,301,838
353580,201909,1958,5145,1510,4337,352,984,695,1957,1047,2941
353590,201909,685,1850,431,1327,110,373,147,445,257,818
353600,201909,1726,4305,1280,3505,155,419,688,1840,843,2259
353610,201909,532,1605,373,1281,87,348,103,329,190,677
353620,201909,2562,6937,1751,5449,354,1246,567,1583,921,2829
353625,201909,473,1162,296,852,20,65,193,547,213,612
353630,201909,1198,3796,962,3240,228,873,301,913,529,1786
353640,201909,1335,3482,1056,3051,137,412,615,1757,752,2169
353650,201909,8166,22076,5801,17315,655,2203,3349,9332,4004,11535
353657,201909,379,994,258,779,32,98,108,302,140,400
353660,201909,1215,2655,819,2098,322,824,238,587,560,1411
353670,201909,3912,11018,2972,9135,608,2069,1468,4164,2076,6233
353680,201909,638,1716,464,1455,87,287,257,779,344,1066
353690,201909,411,1037,147,459,9,25,15,40,24,65
353700,201909,1892,5101,1552,4484,125,402,1116,3118,1241,3520
353710,201909,4357,9720,2415,6278,224,614,1494,3543,1718,4157
353715,201909,430,1140,237,750,15,60,66,190,81,250
353720,201909,1830,5027,1408,4392,175,615,872,2660,1047,3275
353730,201909,4148,11233,3035,9100,479,1611,1447,3987,1926,5598
353740,201909,1907,5113,1283,3958,316,1087,419,1181,735,2268
353750,201909,780,2385,535,1893,136,508,90,352,226,860
353760,201909,12032,28708,9173,24659,1694,4734,5194,13571,6888,18305
353770,201909,706,2141,360,1231,63,228,54,157,117,385
353780,201909,4969,14184,3763,11681,814,2819,1659,4692,2473,7511
353790,201909,2465,7611,1770,6122,490,1906,380,1162,870,3068
353800,201909,16689,44781,12660,37989,1995,6413,6787,20253,8782,26666
353810,201909,1058,2877,690,2112,109,375,292,836,401,1211
353820,201909,1648,4590,1114,3473,254,841,362,1091,616,1932
353830,201909,620,1554,431,1235,73,209,189,520,262,729
353850,201909,1570,4464,1179,3687,289,922,398,1239,687,2161
353860,201909,2478,7006,1907,5923,468,1624,831,2344,1299,3968
353870,201909,27504,73321,18912,56130,2645,8861,9655,26120,12300,34981
353880,201909,2865,8145,2215,6843,189,694,1333,3966,1522,4660
353890,201909,2366,5281,1531,4079,141,396,1019,2592,1160,2988
353900,201909,701,1960,484,1515,89,312,188,544,277,856
353910,201909,1910,5510,1550,4902,203,785,1006,3074,1209,3859
353920,201909,1832,5099,1238,3902,274,990,320,844,594,1834
353930,201909,4029,10810,2629,8222,531,1884,977,2709,1508,4593
353940,201909,1055,3053,700,2308,140,470,236,733,376,1203
353950,201909,2914,8030,2270,6859,418,1400,1268,3547,1686,4947
353960,201909,705,1856,452,1363,93,300,171,490,264,790
353970,201909,689,1671,501,1391,45,138,321,858,366,996
353980,201909,14365,37097,10832,30605,929,2958,7476,20342,8405,23300
353990,201909,881,2161,510,1465,83,259,242,654,325,913
354000,201909,2410,5872,1267,3652,282,848,203,566,485,1414
354010,201909,328,854,233,697,34,111,135,388,169,499
354020,201909,3255,9192,2518,7592,668,2181,979,2684,1647,4865
354025,201909,709,1959,437,1420,77,286,83,238,160,524
354030,201909,486,1073,241,661,49,140,107,288,156,428
354040,201909,786,1887,486,1362,28,95,341,919,369,1014
354050,201909,919,2642,622,2086,159,554,171,583,330,1137
354060,201909,3290,9407,2171,6989,516,1746,712,2112,1228,3858
354070,201909,3328,9057,2238,6899,438,1531,824,2154,1262,3685
354075,201909,2409,7166,1811,6010,234,924,1005,3236,1239,4160
354080,201909,1352,3716,868,2756,174,602,208,604,382,1206
354085,201909,403,858,311,740,1,3,225,500,226,503
354090,201909,1469,4175,1273,3775,92,300,965,2804,1057,3104
354100,201909,17964,50310,12259,39888,2783,9738,4701,15186,7484,24924
354105,201909,1507,3784,969,2774,128,370,440,1185,568,1555
354110,201909,472,1309,308,1000,56,195,92,295,148,490
354120,201909,1433,3873,922,2765,179,584,327,856,506,1440
354130,201909,5476,14541,3459,10579,942,3080,214,410,1156,3490
354140,201909,18361,45008,11719,32908,2168,6640,4786,12402,6954,19042
354150,201909,2984,7219,2171,5870,487,1334,843,2255,1330,3589
354160,201909,2893,8465,2081,6779,620,2176,578,1733,1198,3909
354165,201909,587,1780,435,1463,75,300,224,695,299,995
354170,201909,1525,4308,1250,3748,79,284,795,2280,874,2564
354180,201909,402,1105,280,840,55,167,115,312,170,479
354190,201909,1395,3947,951,3015,76,276,391,1215,467,1491
354200,201909,839,2104,646,1793,84,244,390,1033,474,1277
354210,201909,695,1873,550,1620,43,153,392,1073,435,1226
354220,201909,2937,8027,2088,6286,410,1320,967,2753,1377,4073
354230,201909,693,1754,535,1553,39,151,376,1022,415,1173
354240,201909,1535,4284,977,3100,179,632,294,795,473,1427
354250,201909,495,1262,305,962,85,268,82,276,167,544
354260,201909,7807,21112,5830,17544,1303,4088,2330,6814,3633,10902
354270,201909,1001,3044,776,2586,186,597,283,933,469,1530
354280,201909,744,1919,620,1733,59,217,387,994,446,1211
354290,201909,860,2736,709,2407,122,418,352,1228,474,1646
354300,201909,3477,10333,2936,9310,899,2863,1000,3155,1899,6018
354310,201909,597,1813,474,1549,119,429,158,467,277,896
354320,201909,871,2161,535,1566,72,258,217,559,289,817
354323,201909,454,1115,297,828,36,84,123,331,159,415
354325,201909,1185,3539,822,2743,148,503,322,1050,470,1553
354330,201909,8671,22251,5442,15481,707,2390,3127,8214,3834,10604
354340,201909,28330,72886,18749,55578,3445,11307,8846,24922,12291,36229
354350,201909,1155,2996,908,2553,97,296,611,1644,708,1940
354360,201909,579,1507,300,1014,51,179,55,180,106,359
354370,201909,954,2839,769,2521,131,459,420,1343,551,1802
354380,201909,710,1893,490,1522,87,330,118,301,205,631
354390,201909,12820,31344,7772,22276,1495,4550,2837,7729,4332,12279
354400,201909,1505,4867,1136,3976,195,731,406,1390,601,2121
354410,201909,5305,14718,3873,11736,905,2928,1615,4678,2520,7606
354420,201909,1416,3757,1014,2976,133,413,613,1726,746,2139
354425,201909,2581,6413,1784,4982,433,1238,725,2034,1158,3272
354430,201909,1517,4085,1159,3458,137,482,659,1819,796,2301
354440,201909,550,1484,333,1016,44,159,156,431,200,590
354450,201909,395,1042,203,669,37,131,49,135,86,266
354460,201909,873,2211,552,1634,83,259,291,831,374,1090
354470,201909,478,1204,289,811,17,54,146,366,163,420
354480,201909,1050,2372,684,1804,59,165,481,1224,540,1389
354490,201909,769,2306,546,1802,112,379,227,707,339,1086
354500,201909,1935,5540,1581,4988,486,1652,375,1199,861,2851
354510,201909,717,2012,564,1689,60,186,301,822,361,1008
354515,201909,308,933,221,741,39,151,82,257,121,408
354520,201909,6232,17399,4118,12693,624,2177,2232,6397,2856,8574
354530,201909,3996,11651,3018,9648,721,2375,1190,3764,1911,6139
354540,201909,1281,3447,917,2789,234,750,310,950,544,1700
354550,201909,506,1344,378,1086,52,157,217,586,269,743
354560,201909,2014,4997,1045,3041,145,440,521,1430,666,1870
354570,201909,1130,2853,438,1283,87,276,60,166,147,442
354580,201909,8660,22690,5445,16557,862,2868,2645,7645,3507,10513
354600,201909,1713,4754,1283,3903,154,542,800,2307,954,2849
354610,201909,393,1029,212,646,26,85,89,258,115,343
354620,201909,408,1192,251,870,44,163,91,285,135,448
354625,201909,315,874,168,556,27,103,40,106,67,209
354630,201909,1794,5431,1415,4641,518,1767,233,733,751,2500
354640,201909,3038,8838,2143,6946,371,1364,718,2153,1089,3517
354650,201909,857,2252,671,1932,59,170,421,1206,480,1376
354660,201909,3627,8580,1846,5514,173,618,888,2458,1061,3076
354670,201909,1024,2888,689,2180,148,517,253,724,401,1241
354680,201909,4690,12694,3622,10899,890,2750,1786,5500,2676,8250
354690,201909,520,1663,346,1244,80,301,100,352,180,653
354700,201909,871,2307,601,1769,91,300,303,828,394,1128
354710,201909,463,1266,314,959,47,158,134,372,181,530
354720,201909,314,761,127,380,42,130,25,77,67,207
354730,201909,9317,26425,6806,21490,978,3402,3764,11461,4742,14863
354740,201909,311,862,119,422,21,86,17,58,38,144
354750,201909,2364,6254,1450,4463,276,912,589,1612,865,2524
354760,201909,1877,5215,1270,4020,326,1105,371,1092,697,2197
354765,201909,349,938,128,424,20,68,24,69,44,137
354770,201909,2250,5587,1603,4486,314,950,735,1920,1049,2870
354780,201909,51463,132620,38004,105237,4670,14520,22739,58924,27409,73444
354790,201909,969,2735,755,2364,92,313,441,1322,533,1635
354800,201909,2478,6532,1893,5540,490,1455,786,2190,1276,3645
354805,201909,1294,3005,850,2305,98,270,461,1130,559,1400
354810,201909,634,1852,339,1207,45,184,73,231,118,415
354820,201909,914,2664,644,2107,131,477,154,420,285,897
354830,201909,454,1131,273,793,58,172,88,240,146,412
354840,201909,879,2189,469,1378,43,131,260,731,303,862
354850,201909,19958,52642,13570,40796,1735,6063,7954,22432,9689,28495
354860,201909,1609,4561,1003,3256,197,708,314,894,511,1602
354870,201909,53442,136297,40679,112140,4868,14753,24380,63446,29248,78199
354880,201909,5553,13862,2478,7130,317,1045,869,2018,1186,3063
354890,201909,16360,41214,12397,34370,1728,5397,7245,19280,8973,24677
354900,201909,395,1016,246,747,39,128,62,168,101,296
354910,201909,4992,13408,2852,9330,664,2311,405,1255,1069,3566
354920,201909,430,1147,177,609,23,92,37,124,60,216
354925,201909,273,793,157,532,22,79,33,104,55,183
354930,201909,392,922,207,606,14,49,94,244,108,293
354940,201909,2114,6498,1445,4946,491,1812,236,743,727,2555
354950,201909,1392,3716,1091,3264,65,282,784,2191,849,2473
354960,201909,878,2361,664,2036,63,238,385,1102,448,1340
354970,201909,3978,11349,3043,9646,408,1416,1821,5592,2229,7008
354980,201909,30139,72268,19284,53143,2249,7344,11076,28260,13325,35604
354990,201909,58931,151564,42851,121592,4069,13218,26854,71929,30923,85147
354995,201909,2666,6215,1984,5287,195,637,1408,3539,1603,4176
355000,201909,1475,3795,1110,3244,179,602,501,1352,680,1954
355010,201909,3567,9777,2023,6465,678,2238,188,637,866,2875
355020,201909,3425,9781,2431,7954,673,2392,735,2252,1408,4644
355030,201909,1286277,3186234,896776,2409952,145672,428884,439075,1086015,584747,1514899
355040,201909,2720,7101,2137,6293,337,1006,1394,4140,1731,5146
355050,201909,931,2231,654,1788,186,533,240,617,426,1150
355060,201909,5662,15639,4090,12584,708,2503,1990,5533,2698,8036
355070,201909,8009,21070,6302,18241,736,2490,3957,10779,4693,13269
355080,201909,862,2494,504,1762,105,396,65,176,170,572
355090,201909,1098,3228,801,2684,215,697,214,758,429,1455
355100,201909,21345,56444,16269,48715,2785,8782,9747,28906,12532,37688
355110,201909,837,2361,597,1955,181,649,107,333,288,982
355120,201909,672,1784,460,1444,42,149,165,482,207,631
355130,201909,855,1886,380,1020,28,86,205,514,233,600
355140,201909,1700,4009,1441,3629,106,340,1169,2830,1275,3170
355150,201909,4163,11159,3247,9484,373,1191,2026,5683,2399,6874
355160,201909,1804,5042,1264,4054,316,1137,290,893,606,2030
355170,201909,9301,24257,7089,20424,1513,4647,3591,10011,5104,14658
355180,201909,2662,7250,1839,5806,402,1410,651,1859,1053,3269
355190,201909,1833,4838,1422,4188,322,986,753,2317,1075,3303
355200,201909,813,2546,681,2329,188,716,275,862,463,1578
355210,201909,2692,7507,2116,6268,361,1235,1120,3103,1481,4338
355220,201909,42014,113472,32399,94550,8094,25035,12943,34854,21037,59889
355230,201909,1089,2734,564,1689,109,321,186,524,295,845
355240,201909,22459,59699,15182,45022,2203,7123,7887,22197,10090,29320
355250,201909,34995,94947,24964,75160,6407,20456,9103,25937,15510,46393
355255,201909,707,1784,367,1129,65,206,128,374,193,580
355260,201909,1370,3531,975,2823,131,460,571,1533,702,1993
355270,201909,1166,3453,868,2802,212,721,278,825,490,1546
355280,201909,27354,71498,18636,54346,2973,9309,8712,24019,11685,33328
355290,201909,843,2371,614,1934,141,419,246,747,387,1166
355300,201909,1186,3493,900,2893,159,530,287,889,446,1419
355310,201909,987,2694,719,2235,88,267,416,1305,504,1572
355320,201909,511,1356,372,1095,67,231,158,387,225,618
355330,201909,2400,6400,1808,5325,139,515,1300,3651,1439,4166
355340,201909,3819,8488,2927,7271,387,879,1825,4613,2212,5492
355350,201909,1275,3770,924,3042,209,712,319,1030,528,1742
355360,201909,1142,2972,857,2524,108,339,521,1521,629,1860
355365,201909,367,991,183,641,44,141,27,96,71,237
355370,201909,5292,13500,3963,11445,935,2557,1787,5610,2722,8167
355380,201909,2852,7760,2078,6232,385,1247,718,1853,1103,3100
355385,201909,1376,3673,1110,3265,116,421,683,1847,799,2268
355390,201909,785,2176,543,1626,115,369,221,614,336,983
355395,201909,1897,5278,1263,3967,207,685,435,1218,642,1903
355400,201909,8675,25458,6764,21495,1757,6279,2312,6540,4069,12819
355410,201909,20611,56620,12964,41763,2999,10657,3148,9967,6147,20624
355420,201909,620,2023,493,1757,132,543,126,418,258,961
355430,201909,3589,9137,2657,7478,694,1906,1166,3298,1860,5204
355440,201909,804,2206,462,1456,77,255,141,407,218,662
355450,201909,3095,8105,1908,5719,378,1202,738,2010,1116,3212
355460,201909,507,1253,305,903,41,141,151,411,192,552
355465,201909,375,1030,276,853,45,142,122,374,167,516
355470,201909,1080,2807,570,1761,168,562,167,466,335,1028
355475,201909,352,836,274,719,18,45,197,503,215,548
355480,201909,3584,10194,2925,9178,457,1632,1845,5586,2302,7218
355490,201909,920,2487,484,1522,37,126,249,730,286,856
355495,201909,745,2120,528,1723,72,267,194,592,266,859
355500,201909,6527,17073,3640,11144,583,1953,1164,3252,1747,5205
355510,201909,1263,3178,764,2278,112,381,311,829,423,1210
355520,201909,368,816,166,480,30,87,48,122,78,209
355530,201909,403,917,134,390,20,74,50,122,70,196
355535,201909,488,1337,359,1123,80,305,151,421,231,726
355540,201909,9816,25562,7942,22736,1370,4246,4811,13329,6181,17575
355550,201909,630,1891,513,1665,71,252,266,822,337,1074
355560,201909,1091,2819,562,1779,117,408,38,121,155,529
355570,201909,235,671,121,399,22,77,29,85,51,162
355580,201909,1177,2920,765,2215,134,433,347,933,481,1366
355590,201909,178,440,134,368,17,49,79,202,96,251
355600,201909,1437,3531,934,2663,196,591,402,1120,598,1711
355610,201909,1677,4213,1093,3153,134,415,539,1486,673,1901
355620,201909,4281,11713,3070,9258,378,1394,1641,4514,2019,5908
355630,201909,2199,6129,1476,4709,256,858,727,2283,983,3141
355635,201909,868,2573,626,2087,121,444,197,611,318,1055
355640,201909,2645,7594,1743,5711,355,1263,458,1443,813,2706
355645,201909,4138,11776,3017,9766,411,1439,1690,5368,2101,6807
355650,201909,6226,16986,4889,14482,1429,4391,1831,4924,3260,9315
355660,201909,1263,3326,847,2528,131,471,289,848,420,1319
355670,201909,3266,8937,2082,6211,268,985,1056,2747,1324,3732
355680,201909,2833,7823,1113,3693,302,1042,123,420,425,1462
355690,201909,751,2253,461,1658,113,419,12,22,125,441
355695,201909,234,677,133,445,11,53,22,48,33,101
355700,201909,6813,19735,5416,16532,982,3130,2821,8119,3803,11249
355710,201909,8158,19341,4920,13341,813,2398,2149,5235,2962,7633
355715,201909,456,1200,231,722,52,179,40,99,92,278
355720,201909,1428,4122,1106,3516,185,631,581,1713,766,2344
355730,201909,897,2544,703,2148,148,491,295,820,443,1311
410010,201909,1199,3318,886,2660,198,663,180,509,378,1172
410020,201909,926,2940,718,2430,264,832,183,641,447,1473
410030,201909,1452,4122,1220,3744,186,635,635,1949,821,2584
410040,201909,11121,31451,8003,25361,1754,5953,2578,7605,4332,13558
410045,201909,852,2276,569,1750,84,292,194,557,278,849
410050,201909,2367,5990,1494,4396,311,1008,434,1178,745,2186
410060,201909,2005,5845,1501,4755,353,1145,441,1357,794,2502
410070,201909,1747,4530,1217,3496,208,679,447,1191,655,1870
410080,201909,1325,3555,930,2797,157,494,371,1115,528,1609
410090,201909,1014,2725,885,2507,83,229,547,1621,630,1850
410100,201909,1779,5203,1177,3723,175,648,184,540,359,1188
410105,201909,464,1198,235,716,35,123,63,178,98,301
410110,201909,2975,7693,1999,5751,289,921,835,2262,1124,3183
410115,201909,535,1380,368,1083,57,190,129,361,186,551
410120,201909,2258,6708,1949,6184,533,1860,823,2512,1356,4372
410130,201909,1111,3041,956,2741,226,724,440,1154,666,1878
410140,201909,13691,33435,7977,22888,1580,4910,1847,4767,3427,9677
410150,201909,15652,37210,7131,20175,1250,3853,1590,4198,2840,8051
410160,201909,2817,7938,2238,6888,490,1671,809,2478,1299,4149
410165,201909,701,1926,587,1683,55,190,344,925,399,1115
410170,201909,2464,6455,1594,4557,377,1159,146,433,523,1592
410180,201909,13936,39386,10572,32189,1552,5161,5581,15885,7133,21046
410185,201909,401,1131,287,879,52,171,95,266,147,437
410190,201909,2168,5486,1546,4346,325,931,430,1184,755,2115
410200,201909,4809,11384,2510,7282,419,1426,500,1425,919,2851
410210,201909,2900,7434,1761,5281,294,1004,601,1581,895,2585
410220,201909,491,1257,306,906,45,144,54,158,99,302
410230,201909,1563,4256,1183,3441,155,540,661,1794,816,2334
410240,201909,4550,12381,3103,9532,835,2845,217,602,1052,3447
410250,201909,2512,6094,1798,4879,134,470,873,2306,1007,2776
410260,201909,1746,4436,1084,3190,205,636,456,1308,661,1944
410270,201909,449,1196,309,932,48,161,110,314,158,475
410275,201909,605,1731,385,1243,51,178,186,552,237,730
410280,201909,2222,6005,1439,4400,215,724,572,1643,787,2367
410290,201909,3017,8622,2020,6411,506,1625,567,1792,1073,3417
410300,201909,610,1548,481,1327,40,123,230,598,270,721
410302,201909,382,954,182,564,30,98,92,266,122,364
410304,201909,1142,3043,950,2686,123,342,546,1520,669,1862
410305,201909,1669,4091,1120,3274,148,473,656,1855,804,2328
410310,201909,2489,7253,1914,6046,370,1256,781,2443,1151,3699
410315,201909,690,1656,342,1066,124,387,72,220,196,607
410320,201909,1067,3007,694,2196,114,411,110,333,224,744
410322,201909,546,1476,270,829,28,100,126,353,154,453
410330,201909,1450,3638,991,2730,162,496,289,788,451,1284
410335,201909,803,2217,625,1865,93,298,285,791,378,1089
410337,201909,774,1881,523,1385,50,134,222,550,272,684
410340,201909,447,1246,298,878,27,91,145,357,172,448
410345,201909,2268,5826,1159,3415,239,743,347,923,586,1666
410347,201909,674,1713,470,1330,49,176,142,386,191,562
410350,201909,1256,3213,872,2555,106,326,371,1036,477,1362
410360,201909,4106,10027,3162,8414,292,891,1951,4951,2243,5842
410370,201909,11820,32047,7550,22045,971,3164,3080,7963,4051,11127
410380,201909,1371,3566,986,2808,133,416,392,1036,525,1452
410390,201909,2515,6596,1564,4766,394,1327,409,1132,803,2459
410395,201909,826,2423,667,2078,130,448,294,892,424,1340
410400,201909,5274,14231,3877,11544,644,2037,1738,4941,2382,6978
410405,201909,765,1877,577,1602,126,398,239,607,365,1005
410410,201909,1154,3161,1085,3059,165,567,676,1949,841,2516
410420,201909,8102,23165,6058,18943,1099,3806,2068,5815,3167,9621
410425,201909,2834,8155,1973,6353,361,1273,719,2094,1080,3367
410430,201909,12378,31607,8216,23705,1372,4337,2816,7705,4188,12042
410440,201909,2282,6964,1921,6250,310,1135,995,3176,1305,4311
410442,201909,2104,6567,1732,5706,508,1680,521,1690,1029,3370
410445,201909,2199,6495,1653,5406,329,1216,425,1453,754,2669
410450,201909,1384,3536,966,2783,187,617,330,868,517,1485
410460,201909,1839,4615,1425,3984,155,462,700,1894,855,2356
410465,201909,2513,7471,1912,6216,371,1239,633,1946,1004,3185
410470,201909,1898,5369,1304,4176,352,1281,229,755,581,2036
410480,201909,35199,83820,17988,52812,3004,9901,3908,9847,6912,19748
410490,201909,10425,29344,7178,22359,1400,4721,2650,7786,4050,12507
410500,201909,1646,4514,1107,3411,240,869,315,831,555,1700
410510,201909,1880,4708,1209,3405,227,625,353,1013,580,1638
410520,201909,2988,9540,2664,8869,859,2923,1011,3419,1870,6342
410530,201909,1567,3940,722,2111,105,300,163,391,268,691
410540,201909,2441,6687,1715,5220,293,984,837,2481,1130,3465
410550,201909,6816,18440,4266,12667,762,2474,1137,2970,1899,5444
410560,201909,1394,3667,1017,2903,218,666,376,948,594,1614
410570,201909,2410,6741,1748,5499,504,1876,158,538,662,2414
410580,201909,23339,61556,16826,49377,3475,10805,7112,19485,10587,30290
410590,201909,1477,4239,938,2874,160,521,261,695,421,1216
410600,201909,1744,4750,1303,3874,283,796,475,1459,758,2255
410610,201909,701,1868,496,1461,54,188,224,644,278,832
410620,201909,2088,6276,1302,4345,289,1040,216,695,505,1735
410630,201909,2270,6124,1419,4303,283,947,255,638,538,1585
410640,201909,4477,10663,2803,7724,664,2098,380,1046,1044,3144
410645,201909,991,2929,810,2680,260,889,337,1128,597,2017
410650,201909,2002,5624,1313,4143,292,1013,439,1257,731,2270
410655,201909,891,2177,609,1657,27,91,312,799,339,890
410657,201909,593,1594,373,1139,58,212,145,375,203,587
410660,201909,3083,8073,1646,4854,285,879,398,1118,683,1997
410670,201909,1018,2560,584,1686,121,357,242,642,363,999
410680,201909,2592,7936,1819,5964,478,1561,379,1267,857,2828
410685,201909,540,1392,404,1147,94,304,162,408,256,712
410690,201909,116697,290850,73790,209232,12588,40613,26448,65773,39036,106386
410700,201909,2341,6028,1960,5436,272,795,1064,2858,1336,3653
410710,201909,767,1950,494,1456,61,184,241,684,302,868
410712,201909,600,1803,501,1584,124,432,184,548,308,980
410715,201909,799,2356,472,1582,76,259,154,504,230,763
410720,201909,3012,7785,2221,6201,314,1042,496,1293,810,2335
410725,201909,1048,2627,582,1731,115,364,93,227,208,591
410730,201909,589,1589,439,1295,90,314,96,272,186,586
410740,201909,923,2601,663,2111,97,329,264,831,361,1160
410750,201909,1681,4341,1315,3674,209,643,562,1492,771,2135
410752,201909,349,885,156,474,17,57,68,193,85,250
410753,201909,238,730,167,572,26,104,37,112,63,216
410754,201909,1077,2827,872,2505,56,157,600,1817,656,1974
410755,201909,558,1460,384,1106,58,188,169,429,227,617
410760,201909,3253,8500,2268,6708,600,2007,490,1337,1090,3344
410765,201909,11885,34044,8995,28146,1530,5298,1697,4835,3227,10133
410770,201909,993,2402,665,1832,73,218,350,948,423,1166
410773,201909,1250,3363,1073,3078,119,382,665,1841,784,2223
410775,201909,1395,3584,1206,3303,71,223,756,2043,827,2266
410780,201909,605,1520,374,1046,57,162,95,269,152,431
410785,201909,698,1905,524,1580,91,304,189,550,280,854
410790,201909,658,1890,520,1607,152,516,60,134,212,650
410800,201909,3237,7287,2543,6213,57,195,1627,3860,1684,4055
410810,201909,359,971,267,784,26,82,129,357,155,439
410820,201909,763,2200,383,1204,89,276,72,204,161,480
410830,201909,30648,76006,20105,57855,4424,14477,6745,18273,11169,32750
410832,201909,931,2463,735,2111,90,297,417,1119,507,1416
410840,201909,7448,19331,4269,13045,848,2850,1075,2944,1923,5794
410845,201909,1098,2852,837,2418,169,505,342,967,511,1472
410850,201909,2177,6401,1870,5819,307,1042,912,2750,1219,3792
410855,201909,746,1882,475,1355,41,123,225,597,266,720
410860,201909,4029,10227,3180,8757,401,1267,1640,4246,2041,5513
410865,201909,1305,3956,1141,3622,147,542,677,2158,824,2700
410870,201909,1258,3424,1058,3094,67,214,735,2118,802,2332
410880,201909,4118,11465,2856,9002,505,1782,437,1529,942,3311
410890,201909,937,2655,666,2107,156,541,186,581,342,1122
410895,201909,942,3093,773,2693,261,983,139,461,400,1444
410900,201909,834,2222,538,1623,101,308,103,255,204,563
410910,201909,354,833,203,543,11,39,132,327,143,366
410920,201909,812,1957,534,1499,76,244,249,688,325,932
410930,201909,1498,4000,1057,3183,271,952,226,657,497,1609
410940,201909,21045,58731,14894,47146,3173,11045,4440,13912,7613,24957
410950,201909,1893,5570,1677,5226,58,211,1379,4228,1437,4439
410960,201909,6790,17462,4285,13006,996,3373,1564,4629,2560,8002
410965,201909,949,2497,671,1957,88,280,373,1070,461,1350
410970,201909,3711,10158,2556,7872,595,2198,344,903,939,3101
410975,201909,1246,3198,915,2634,116,354,389,1126,505,1480
410980,201909,6670,16981,4101,12180,528,1744,1701,4681,2229,6425
410990,201909,1261,3174,814,2432,238,820,211,569,449,1389
411000,201909,562,1542,366,1141,51,183,108,291,159,474
411005,201909,395,1069,235,713,48,156,52,149,100,305
411007,201909,2146,6137,1739,5391,401,1311,600,1866,1001,3177
411010,201909,4070,12351,3150,10362,824,2925,348,1055,1172,3980
411020,201909,2190,6391,1772,5630,523,1746,489,1496,1012,3242
411030,201909,705,1757,467,1260,39,147,257,608,296,755
411040,201909,901,2278,418,1199,46,142,139,338,185,480
411050,201909,1762,5641,1430,4842,402,1451,219,639,621,2090
411060,201909,1718,4518,1067,3231,258,921,154,414,412,1335
411065,201909,348,941,233,716,40,130,97,281,137,411
411070,201909,6436,16860,5059,14455,735,2401,2443,6704,3178,9105
411080,201909,2061,5500,1603,4659,445,1457,315,855,760,2312
411090,201909,797,2100,499,1511,40,149,135,386,175,535
411095,201909,1506,3564,993,2734,109,339,359,933,468,1272
411100,201909,1069,2787,704,2124,80,280,221,676,301,956
411110,201909,626,1627,255,794,37,103,20,44,57,147
411120,201909,1154,3314,914,2807,319,1110,211,558,530,1668
411125,201909,4868,14460,4262,13252,896,2817,2087,6700,2983,9517
411130,201909,661,1809,460,1404,83,242,179,573,262,815
411140,201909,2199,6844,1806,5944,534,1883,492,1578,1026,3461
411150,201909,3655,9583,2419,6979,506,1670,230,508,736,2178
411155,201909,937,2401,531,1609,66,196,227,643,293,839
411160,201909,342,798,218,612,31,100,45,129,76,229
411170,201909,689,2094,496,1627,106,326,166,543,272,869
411180,201909,5082,13719,3822,11380,625,2032,1730,4844,2355,6876
411190,201909,1496,3925,1095,3187,182,561,417,1140,599,1701
411200,201909,4765,13018,3189,9948,864,2912,578,1587,1442,4499
411210,201909,2771,6179,1765,4604,326,991,539,1279,865,2270
411220,201909,810,2146,581,1686,135,418,173,492,308,910
411230,201909,781,2116,538,1629,106,339,208,619,314,958
411240,201909,1526,3721,909,2514,95,313,448,1133,543,1446
411250,201909,2094,5664,1534,4622,325,1142,468,1347,793,2489
411260,201909,318,866,200,617,23,68,77,210,100,278
411270,201909,1899,5219,1428,4253,228,700,664,1843,892,2543
411275,201909,1315,3087,869,2327,149,471,380,942,529,1413
411280,201909,1273,3474,821,2581,222,729,110,331,332,1060
411290,201909,747,2008,477,1464,47,136,239,745,286,881
411295,201909,1155,2904,834,2266,95,269,390,1016,485,1285
411300,201909,994,2486,593,1688,57,180,244,621,301,801
411310,201909,846,2004,629,1678,45,121,280,734,325,855
411320,201909,5174,13668,3671,10877,690,2134,1476,3987,2166,6121
411325,201909,1402,3997,1171,3579,201,595,657,2074,858,2669
411330,201909,3224,8797,2310,7084,539,1800,709,2193,1248,3993
411340,201909,813,2231,467,1439,72,244,162,474,234,718
411342,201909,963,2336,556,1533,89,256,243,653,332,909
411345,201909,1038,2729,764,2269,71,226,534,1591,605,1817
411350,201909,2483,6928,1565,4989,421,1457,194,577,615,2034
411360,201909,642,1576,453,1277,57,166,155,429,212,595
411370,201909,49475,123103,34625,97389,2709,9297,20490,53957,23199,63254
411373,201909,1319,3359,1060,2955,90,300,578,1623,668,1923
411375,201909,1047,2682,737,2082,124,361,270,715,394,1076
411380,201909,1104,2597,710,1833,43,131,409,959,452,1090
411390,201909,1502,4150,1132,3308,186,601,454,1147,640,1748
411400,201909,2151,5471,1633,4477,196,644,816,2113,1012,2757
411410,201909,2176,6107,1553,4720,345,1167,346,1010,691,2177
411420,201909,3890,9707,2024,6036,315,1077,362,834,677,1911
411430,201909,3272,8971,2466,7393,545,1790,896,2451,1441,4241
411435,201909,417,1193,255,831,45,138,86,236,131,374
411440,201909,2360,6819,1900,5901,409,1394,661,2008,1070,3402
411450,201909,2459,6595,1851,5568,254,742,996,3033,1250,3775
411460,201909,3594,9504,2041,6349,385,1378,371,1074,756,2452
411470,201909,710,1882,505,1463,89,273,180,469,269,742
411480,201909,4308,11885,3035,9393,654,2369,946,2640,1600,5009
411490,201909,1571,4133,1185,3453,156,535,464,1207,620,1742
411500,201909,1272,3461,823,2483,140,476,177,471,317,947
411510,201909,2194,5737,1717,4871,382,1251,384,1110,766,2361
411520,201909,28891,70716,15707,44727,2039,6593,5793,14743,7832,21336
411530,201909,882,2319,524,1609,107,365,89,234,196,599
411535,201909,450,1322,225,757,28,101,43,113,71,214
411540,201909,2724,6767,1784,4961,230,745,824,2187,1054,2932
411545,201909,893,2620,737,2335,72,225,480,1540,552,1765
411550,201909,659,1716,458,1311,71,231,86,255,157,486
411560,201909,1836,4933,1026,3176,162,573,81,217,243,790
411570,201909,6684,15932,4269,12075,916,2835,853,2385,1769,5220
411573,201909,734,2026,618,1838,87,276,333,969,420,1245
411575,201909,1791,5005,1314,4003,262,855,314,938,576,1793
411580,201909,4292,9906,2365,6881,346,1220,414,1081,760,2301
411585,201909,624,1838,267,902,68,236,45,137,113,373
411590,201909,369,1053,251,781,22,78,137,372,159,450
411600,201909,271,691,161,509,37,116,54,167,91,283
411605,201909,1509,3514,888,2463,123,424,463,1255,586,1679
411610,201909,2319,5749,1614,4400,84,292,1038,2633,1122,2925
411620,201909,2743,7391,2318,6708,408,1255,1283,3658,1691,4913
411630,201909,713,1871,465,1395,67,229,153,416,220,645
411640,201909,454,1210,305,880,43,140,117,304,160,444
411650,201909,217,634,136,451,30,106,23,60,53,166
411660,201909,878,2220,614,1738,45,136,298,815,343,951
411670,201909,1265,3187,842,2317,94,278,387,979,481,1257
411680,201909,1438,3899,1072,3174,144,494,519,1499,663,1993
411690,201909,3451,9003,2560,7449,536,1625,777,2349,1313,3974
411695,201909,657,2020,403,1327,42,145,164,520,206,665
411700,201909,1557,4096,985,2978,228,758,132,365,360,1123
411705,201909,1831,5757,1535,5244,314,1050,833,3048,1147,4098
411710,201909,1744,4486,1150,3319,298,883,181,512,479,1395
411720,201909,1056,2517,734,1930,128,356,308,756,436,1112
411721,201909,886,2314,649,1858,127,360,154,446,281,806
411722,201909,736,2010,382,1131,60,211,134,312,194,523
411725,201909,1110,3195,746,2446,168,588,167,561,335,1149
411727,201909,1432,4049,904,2879,218,725,143,420,361,1145
411729,201909,692,1706,428,1193,55,201,157,383,212,584
411730,201909,5060,13673,3752,11047,863,2669,1515,4350,2378,7019
411740,201909,525,1368,259,783,54,159,58,157,112,316
411745,201909,716,2045,448,1409,62,208,84,204,146,412
411750,201909,4771,12685,3306,9726,427,1361,1613,4446,2040,5807
411760,201909,6545,17712,4963,14907,1712,5300,981,3268,2693,8568
411770,201909,2884,8432,2028,6492,508,1738,283,829,791,2567
411780,201909,2775,8006,2321,7069,637,2060,782,2375,1419,4435
411790,201909,2750,6684,1389,4143,305,1019,184,448,489,1467
411800,201909,944,2660,644,1971,102,330,136,402,238,732
411810,201909,1495,3948,1083,3103,167,487,534,1456,701,1943
411820,201909,10329,30310,8328,26534,2247,7674,3375,10448,5622,18122
411830,201909,582,1424,391,1098,71,205,93,288,164,493
411840,201909,11248,30233,7228,21646,1302,4231,1950,5365,3252,9596
411845,201909,469,1339,229,732,33,124,44,129,77,253
411850,201909,7084,18306,4686,13982,1247,4143,716,1908,1963,6051
411860,201909,683,1975,496,1574,81,279,132,372,213,651
411870,201909,612,1850,422,1387,89,324,94,274,183,598
411880,201909,2047,5271,1465,4281,247,819,430,1203,677,2022
411885,201909,1008,2608,691,2022,80,265,252,709,332,974
411890,201909,1125,3016,718,2219,139,474,64,166,203,640
411900,201909,788,2234,451,1463,107,369,58,181,165,550
411910,201909,882,2649,614,2052,150,547,197,606,347,1153
411915,201909,14821,36670,9213,26324,1493,4755,3329,8510,4822,13265
411920,201909,1018,3111,844,2724,203,745,278,835,481,1580
411925,201909,464,1228,310,938,71,235,119,340,190,575
411930,201909,4865,15341,4069,13720,1782,6545,232,913,2014,7458
411940,201909,3187,9636,2414,7852,601,2055,720,2083,1321,4138
411950,201909,12758,34954,10267,30722,1663,5499,5618,16209,7281,21708
411960,201909,5578,15307,4454,12973,889,2857,1621,4426,2510,7283
411965,201909,402,1116,277,864,35,118,107,296,142,414
411970,201909,1027,2454,772,2095,165,427,312,963,477,1390
411980,201909,1412,3606,997,2874,260,772,339,924,599,1696
411990,201909,36344,96556,22568,70329,4410,15071,7693,22786,12103,37857
411995,201909,2820,7192,2058,5975,590,1897,590,1614,1180,3511
412000,201909,1923,4417,1344,3429,39,117,945,2269,984,2386
412010,201909,571,1795,399,1400,59,219,102,293,161,512
412015,201909,535,1510,437,1329,55,187,261,793,316,980
412020,201909,428,1193,248,805,35,141,111,337,146,478
412030,201909,597,1676,398,1287,68,226,109,349,177,575
412033,201909,818,2185,555,1617,63,186,193,493,256,679
412035,201909,753,2025,467,1490,55,214,251,749,306,963
412040,201909,563,1535,341,1061,56,177,69,211,125,388
412050,201909,1657,4205,1099,3157,213,690,273,784,486,1474
412060,201909,6886,20803,5662,18282,1633,5901,1469,4483,3102,10384
412065,201909,600,1681,415,1265,86,278,116,356,202,634
412070,201909,1090,2819,822,2290,119,350,325,857,444,1207
412080,201909,1925,5479,1152,3746,184,637,167,472,351,1109
412085,201909,278,685,85,272,10,25,12,31,22,56
412090,201909,5588,14687,4173,12023,1192,3589,1440,4216,2632,7805
412100,201909,1511,4246,1112,3488,324,1109,243,817,567,1926
412110,201909,820,2175,562,1638,78,236,203,567,281,803
412120,201909,1843,5439,1400,4514,273,1000,408,1147,681,2147
412125,201909,617,1750,432,1361,94,305,120,352,214,657
412130,201909,698,1821,474,1382,74,228,112,340,186,568
412135,201909,597,1592,254,764,36,110,90,249,126,359
412140,201909,1538,3821,961,2765,194,667,191,504,385,1171
412150,201909,2679,7167,2226,6344,313,1011,1342,3624,1655,4635
412160,201909,934,2917,553,1902,109,405,91,279,200,684
412170,201909,4062,11458,3378,10292,714,2348,1390,3920,2104,6268
412175,201909,1220,3630,1002,3242,221,724,431,1419,652,2143
412180,201909,1605,4476,1136,3566,146,543,502,1424,648,1967
412190,201909,3279,8286,2402,6714,308,941,1116,3103,1424,4044
412200,201909,1671,5083,1193,3917,325,1146,202,602,527,1748
412210,201909,609,1518,343,1004,53,172,103,273,156,445
412215,201909,3256,8863,2587,7577,697,1974,1083,3587,1780,5561
412217,201909,919,2439,769,2184,61,189,507,1399,568,1588
412220,201909,5648,15962,4470,13686,1117,3428,1443,4649,2560,8077
412230,201909,2496,7495,1964,6398,356,1327,551,1526,907,2853
412240,201909,6534,16837,4035,11920,701,2283,1237,3368,1938,5651
412250,201909,1929,4979,1428,4048,347,1023,343,925,690,1948
412260,201909,1165,3157,802,2367,140,409,234,666,374,1075
412265,201909,832,2342,674,2063,135,448,283,827,418,1275
412270,201909,824,2317,533,1664,70,251,209,567,279,818
412280,201909,414,1167,319,999,67,224,92,258,159,482
412290,201909,949,2454,625,1843,95,296,197,559,292,855
412300,201909,1387,3794,1067,3164,246,767,266,805,512,1572
412310,201909,721,1988,594,1752,41,175,333,936,374,1111
412320,201909,798,2071,526,1527,70,266,185,532,255,798
412330,201909,1437,3946,954,2968,191,642,320,1022,511,1664
412340,201909,1103,3121,654,2096,110,389,116,344,226,733
412350,201909,2729,7181,1652,5018,344,1067,330,954,674,2021
412360,201909,238,660,153,468,5,22,85,245,90,267
412370,201909,785,2261,508,1660,106,396,34,118,140,514
412380,201909,1511,4137,1020,3108,286,923,144,482,430,1405
412382,201909,489,1229,307,903,46,159,116,292,162,451
412385,201909,2091,5797,1686,5030,541,1540,520,1708,1061,3248
412390,201909,2315,5771,1851,5039,326,880,738,2038,1064,2918
412395,201909,672,1921,445,1402,51,157,188,576,239,733
412400,201909,847,2276,591,1757,120,383,150,463,270,846
412402,201909,1802,4527,1204,3504,280,855,144,426,424,1281
412405,201909,2926,7835,1856,5701,487,1786,46,128,533,1914
412410,201909,5485,14642,3901,11842,768,2690,1187,3374,1955,6064
412420,201909,489,1283,304,897,24,86,135,344,159,430
412430,201909,514,1320,326,956,29,96,153,429,182,525
412440,201909,2611,7332,1701,5479,453,1564,274,886,727,2450
412450,201909,372,1100,239,753,45,133,22,51,67,184
412460,201909,971,2621,758,2247,133,441,351,1022,484,1463
412470,201909,1505,4931,1213,4236,313,1155,285,1001,598,2156
412480,201909,916,2495,572,1719,108,345,163,455,271,800
412490,201909,1197,3073,924,2552,104,293,509,1340,613,1633
412500,201909,1846,4757,1359,3796,305,839,378,996,683,1835
412510,201909,1877,5815,1265,4189,292,1039,116,328,408,1367
412520,201909,1224,3211,620,1850,154,471,48,129,202,600
412530,201909,626,1663,443,1282,69,225,110,312,179,537
412535,201909,767,2008,508,1502,92,293,108,276,200,569
412540,201909,1176,3103,801,2336,86,314,264,799,350,1113
412545,201909,661,1697,437,1220,74,219,140,362,214,581
412550,201909,28696,78010,19240,58387,3402,11150,7269,20379,10671,31529
412555,201909,257,693,164,479,16,47,49,111,65,158
412560,201909,4601,13584,3328,10547,553,1917,1024,3235,1577,5152
412570,201909,4048,10447,2177,6704,520,1784,279,935,799,2719
412575,201909,944,2439,742,2063,79,243,423,1106,502,1349
412580,201909,1373,3656,934,2768,106,366,470,1324,576,1690
412590,201909,404,1077,206,660,31,115,18,47,49,162
412600,201909,1370,3832,999,3056,169,597,396,1135,565,1732
412610,201909,751,1998,515,1488,54,171,260,667,314,838
412620,201909,1200,3245,883,2710,176,624,283,794,459,1418
412625,201909,8353,22388,4951,15380,722,2526,306,854,1028,3380
412627,201909,1080,3068,648,2123,131,453,173,558,304,1011
412630,201909,2778,8154,1940,6275,400,1303,613,1818,1013,3121
412635,201909,345,923,234,681,34,118,79,186,113,304
412640,201909,989,2646,523,1603,69,229,142,403,211,632
412650,201909,1528,4266,1188,3536,220,722,440,1136,660,1858
412660,201909,2308,5988,1552,4495,255,778,466,1222,721,2000
412665,201909,365,959,270,769,50,153,113,304,163,457
412667,201909,1656,4386,1211,3491,173,548,506,1380,679,1928
412670,201909,769,1882,497,1396,89,302,157,387,246,689
412680,201909,1640,4506,1079,3347,150,519,407,1141,557,1660
412690,201909,900,2440,660,1939,105,329,259,715,364,1044
412700,201909,1959,5246,1588,4634,204,694,849,2394,1053,3088
412710,201909,5635,16764,4193,13585,863,3116,1174,3454,2037,6570
412720,201909,1156,3431,853,2729,133,461,174,470,307,931
412730,201909,2121,5786,1272,3938,234,811,383,1113,617,1924
412740,201909,1725,4839,1133,3564,217,760,162,526,379,1286
412750,201909,3718,9912,3090,8966,322,1126,2031,5580,2353,6706
412760,201909,2796,7682,2284,6787,415,1369,1196,3346,1611,4715
412770,201909,9855,25058,5005,15282,733,2368,1103,2905,1836,5273
412780,201909,1153,3085,844,2519,184,591,327,952,511,1543
412785,201909,1927,4878,1319,3770,164,483,778,2182,942,2665
412788,201909,1267,3647,1027,3183,279,851,439,1341,718,2192
412790,201909,1237,3288,632,1984,101,372,199,548,300,920
412795,201909,1265,3312,646,1976,108,372,128,365,236,737
412796,201909,2184,6430,1779,5582,380,1272,585,1708,965,2980
412800,201909,3281,8077,2178,5965,269,834,950,2320,1219,3154
412810,201909,10556,26935,6321,18189,820,2724,2317,5911,3137,8635
412820,201909,6154,17088,4307,13309,1027,3351,1275,3904,2302,7255
412830,201909,323,930,211,673,30,95,49,153,79,248
412840,201909,1743,4480,1217,3425,149,462,470,1248,619,1710
412850,201909,2760,7358,1958,5902,317,1028,772,2261,1089,3289
412853,201909,1533,3891,1261,3359,178,528,639,1527,817,2055
412855,201909,1174,3149,734,2182,145,484,220,615,365,1099
412860,201909,768,1919,519,1516,75,243,269,738,344,981
412862,201909,674,1645,438,1246,72,209,191,528,263,737
412863,201909,1196,3693,1104,3537,158,525,744,2364,902,2889
412865,201909,707,1949,507,1554,112,354,164,512,276,866
412870,201909,848,2206,606,1808,172,579,130,397,302,976
412880,201909,782,2154,494,1543,96,326,74,200,170,526
420005,201909,432,1295,228,812,32,120,106,375,138,495
420010,201909,3218,7910,2067,5924,145,446,1512,4349,1657,4795
420020,201909,454,1419,275,967,49,198,52,151,101,349
420030,201909,83,274,57,217,18,76,16,58,34,134
420040,201909,502,1563,286,1062,47,190,25,78,72,268
420050,201909,679,1603,430,1150,41,135,279,675,320,810
420055,201909,173,509,91,311,20,81,34,99,54,180
420060,201909,103,296,54,169,12,44,14,29,26,73
420070,201909,673,2132,500,1725,119,437,180,601,299,1038
420075,201909,74,195,32,98,7,24,8,13,15,37
420080,201909,315,932,245,776,73,256,86,265,159,521
420090,201909,390,1233,227,827,59,238,50,168,109,406
420100,201909,1159,3126,961,2816,49,170,774,2237,823,2407
420110,201909,237,771,212,718,44,174,93,287,137,461
420120,201909,454,1278,291,913,60,212,117,319,177,531
420125,201909,296,931,210,735,53,198,90,292,143,490
420127,201909,267,744,92,318,20,74,22,76,42,150
420130,201909,2587,7364,1897,6113,281,1128,991,3005,1272,4133
420140,201909,3324,9102,2332,7350,645,2306,319,998,964,3304
420150,201909,580,1506,379,1159,47,159,218,645,265,804
420160,201909,211,520,84,266,12,36,24,72,36,108
420165,201909,148,419,80,258,21,72,26,74,47,146
420170,201909,255,768,162,547,21,62,36,100,57,162
420180,201909,169,527,94,344,15,56,28,101,43,157
420190,201909,168,548,98,362,35,142,20,66,55,208
420195,201909,1280,3400,906,2763,278,981,112,277,390,1258
420200,201909,3574,8989,1988,5953,307,1128,758,1927,1065,3055
420205,201909,1483,4011,1013,3134,154,494,559,1745,713,2239
420207,201909,1645,4372,996,3092,190,683,406,1185,596,1868
420208,201909,301,861,179,635,30,121,77,263,107,384
420209,201909,134,450,83,292,22,86,26,90,48,176
420210,201909,2546,6632,1608,5093,337,1178,729,2253,1066,3431
420213,201909,734,2321,604,2046,133,494,299,986,432,1480
420215,201909,192,577,122,424,33,128,14,41,47,169
420220,201909,228,690,138,475,26,101,64,199,90,300
420230,201909,4412,12283,3278,10118,502,1669,1724,5153,2226,6822
420240,201909,11531,31753,6828,21108,910,3240,3421,9371,4331,12611
420243,201909,365,1058,292,912,43,148,172,508,215,656
420245,201909,1250,3300,859,2600,70,272,503,1442,573,1714
420250,201909,427,1246,361,1127,69,249,176,495,245,744
420253,201909,472,1169,334,970,31,91,193,571,224,662
420257,201909,158,417,102,314,22,78,52,153,74,231
420260,201909,1039,2812,735,2348,126,447,440,1391,566,1838
420270,201909,460,1236,213,656,34,113,78,238,112,351
420280,201909,1083,3219,782,2605,159,590,246,808,405,1398
420285,201909,75,196,41,125,7,33,11,28,18,61
420287,201909,438,1027,296,810,81,221,105,297,186,518
420290,201909,3911,11167,2893,8842,434,1570,1643,4549,2077,6119
420300,201909,6468,18355,3579,11581,713,2542,919,2655,1632,5197
420310,201909,801,1884,384,1074,52,152,198,505,250,657
420315,201909,751,2161,498,1667,110,404,211,706,321,1110
420320,201909,4207,11971,3122,10035,960,3389,712,2099,1672,5488
420325,201909,248,733,183,620,34,113,70,234,104,347
420330,201909,847,2565,543,1885,102,405,167,507,269,912
420340,201909,888,2557,636,2064,160,531,63,195,223,726
420350,201909,1217,3255,857,2579,81,289,574,1687,655,1976
420360,201909,2413,6885,1242,4202,250,919,126,409,376,1328
420370,201909,954,2637,745,2276,89,323,480,1399,569,1722
420380,201909,4191,11340,2750,8635,610,2081,956,2847,1566,4928
420390,201909,1034,2548,676,1785,112,368,318,608,430,976
420395,201909,907,2651,568,1918,96,361,69,184,165,545
420400,201909,849,2481,556,1823,101,375,185,579,286,954
420410,201909,480,1332,363,1093,35,120,235,678,270,798
420415,201909,274,844,204,686,52,193,76,255,128,448
420417,201909,602,1801,468,1519,126,411,166,556,292,967
420419,201909,134,479,95,370,37,152,6,20,43,172
420420,201909,9947,26234,6385,19606,1924,6602,1661,4653,3585,11255
420425,201909,622,1641,410,1226,39,137,190,547,229,684
420430,201909,2871,7944,1672,5268,399,1354,523,1477,922,2831
420435,201909,250,636,108,358,15,49,51,166,66,215
420440,201909,651,1857,407,1316,107,386,163,470,270,856
420445,201909,259,654,157,450,32,102,63,166,95,268
420450,201909,623,1852,439,1436,83,342,158,452,241,794
420455,201909,1883,4782,1351,3933,181,664,683,1848,864,2512
420460,201909,8133,22055,5968,17989,943,3198,2957,8548,3900,11746
420470,201909,581,1546,308,1001,63,241,67,178,130,419
420475,201909,55,141,23,72,6,17,2,7,8,24
420480,201909,5361,13401,3140,9546,665,2192,936,2854,1601,5046
420490,201909,335,991,239,790,58,224,89,294,147,518
420500,201909,1336,3844,866,2908,153,558,357,1194,510,1752
420510,201909,160,457,80,262,10,40,22,67,32,107
420515,201909,42,113,28,82,1,1,13,43,14,44
420517,201909,716,2024,620,1849,42,127,475,1417,517,1544
420519,201909,280,666,188,530,21,63,105,308,126,371
420520,201909,306,822,139,475,24,81,14,47,38,128
420530,201909,749,2193,502,1657,92,356,172,494,264,850
420535,201909,208,608,79,270,16,67,28,89,44,156
420540,201909,30478,73031,18438,52103,2982,9488,6541,15676,9523,25164
420543,201909,208,628,156,499,22,71,84,262,106,333
420545,201909,1003,2983,748,2413,146,514,298,881,444,1395
420550,201909,3276,8994,2016,6747,380,1438,828,2784,1208,4222
420555,201909,280,811,190,620,29,109,101,310,130,419
420560,201909,393,983,256,774,60,189,133,396,193,585
420570,201909,2003,5678,1500,4686,295,1028,598,1765,893,2793
420580,201909,1706,4412,1148,3521,280,906,407,1265,687,2171
420590,201909,2747,7365,1516,4640,291,1052,382,859,673,1911
420600,201909,907,2682,685,2233,115,427,346,1086,461,1513
420610,201909,336,985,183,633,45,157,61,221,106,378
420620,201909,617,1545,389,1167,93,287,156,463,249,750
420630,201909,839,2517,594,1904,86,308,332,993,418,1301
420640,201909,478,1345,216,766,61,218,24,74,85,292
420650,201909,3125,8525,1807,5583,279,924,699,1894,978,2818
420660,201909,335,872,204,604,42,130,57,158,99,288
420665,201909,532,1408,325,1037,62,219,137,393,199,612
420670,201909,1282,3510,818,2604,127,488,322,896,449,1384
420675,201909,141,394,74,260,23,100,26,74,49,174
420680,201909,319,730,147,483,26,104,67,209,93,313
420690,201909,781,2390,450,1557,63,266,110,295,173,561
420700,201909,2637,7034,1953,5845,260,869,1036,2988,1296,3857
420710,201909,747,2231,549,1779,61,246,321,964,382,1210
420720,201909,1213,3374,847,2736,194,626,387,1227,581,1853
420730,201909,2581,6875,1933,5815,325,1050,1081,3147,1406,4197
420740,201909,526,1628,322,1154,101,384,31,120,132,504
420750,201909,1729,5147,1094,3617,186,720,432,1314,618,2034
420757,201909,68,170,33,108,3,7,17,53,20,60
420760,201909,336,992,143,450,36,130,30,70,66,200
420765,201909,388,1168,198,676,23,94,93,311,116,405
420768,201909,1199,3523,1028,3225,142,438,733,2281,875,2719
420770,201909,413,1130,188,669,32,123,81,273,113,396
420775,201909,268,815,184,619,42,163,42,115,84,278
420780,201909,828,2303,479,1544,116,404,86,239,202,643
420785,201909,177,475,121,357,16,52,55,131,71,183
420790,201909,972,3047,711,2490,138,569,363,1195,501,1764
420800,201909,661,1665,297,922,81,279,67,199,148,478
420810,201909,1381,4424,1098,3824,326,1285,342,1010,668,2295
420820,201909,10441,26460,7248,21121,1436,4768,3305,8702,4741,13470
420830,201909,3134,8443,2250,6831,454,1509,911,2684,1365,4193
420840,201909,487,1447,222,815,73,287,26,84,99,371
420845,201909,2099,5485,1218,3870,230,855,476,1445,706,2300
420850,201909,993,3251,595,2170,122,487,99,331,221,818
420860,201909,279,733,150,499,35,128,37,111,72,239
420870,201909,747,2058,561,1710,150,550,248,686,398,1236
420880,201909,897,2775,695,2367,145,583,262,824,407,1407
420890,201909,7391,20170,4235,13554,675,2393,1391,3863,2066,6256
420895,201909,147,436,94,307,21,70,28,94,49,164
420900,201909,1303,3298,758,2317,102,382,330,881,432,1263
420910,201909,25482,67551,15182,47267,2414,8569,5864,16357,8278,24926
420915,201909,525,1895,375,1457,59,236,188,735,247,971
420917,201909,317,801,160,451,24,76,77,215,101,291
420920,201909,67,187,21,79,0,0,4,10,4,10
420930,201909,16118,42283,11076,33289,2012,6692,4913,13978,6925,20670
420940,201909,2448,6050,1375,4155,349,1198,223,531,572,1729
420945,201909,126,370,96,298,22,81,38,101,60,182
420950,201909,310,900,163,548,29,120,37,102,66,222
420960,201909,950,2386,642,1836,109,373,273,680,382,1053
420970,201909,2259,6483,1475,4897,433,1487,248,854,681,2341
420980,201909,250,841,223,786,114,393,66,259,180,652
420985,201909,295,875,140,513,32,119,43,138,75,257
420990,201909,315,987,164,601,31,113,28,80,59,193
421000,201909,471,1482,307,1091,69,275,80,253,149,528
421003,201909,456,1059,139,407,11,35,25,59,36,94
421005,201909,53,153,45,142,10,30,22,69,32,99
421010,201909,3030,8387,2130,6710,455,1622,573,1599,1028,3221
421020,201909,364,1139,280,984,44,183,139,465,183,648
421030,201909,727,2258,554,1882,164,625,172,531,336,1156
421040,201909,670,1568,389,1141,35,116,237,687,272,803
421050,201909,943,2627,577,1773,110,370,190,511,300,881
421055,201909,161,442,76,241,11,43,33,88,44,131
421060,201909,532,1576,327,1069,63,230,136,393,199,623
421070,201909,509,1554,274,971,74,270,56,199,130,469
421080,201909,445,1307,376,1167,46,162,237,733,283,895
421085,201909,360,1053,124,456,25,91,17,50,42,141
421090,201909,246,631,144,430,15,52,52,140,67,192
421100,201909,837,1867,322,962,93,316,65,163,158,479
421105,201909,1456,4035,994,3097,170,530,426,1268,596,1798
421110,201909,968,2717,799,2468,28,78,587,1911,615,1989
421120,201909,838,2598,590,2013,91,345,197,625,288,970
421125,201909,238,619,186,541,70,226,66,155,136,381
421130,201909,4182,12535,3412,10996,786,2891,1785,5433,2571,8324
421140,201909,272,737,167,522,29,98,65,186,94,284
421145,201909,428,1217,269,868,58,209,123,365,181,574
421150,201909,526,1426,281,901,58,202,95,283,153,485
421160,201909,497,1345,350,1073,43,144,226,680,269,824
421165,201909,182,546,111,373,23,77,45,148,68,225
421170,201909,1029,2741,779,2348,136,394,466,1447,602,1841
421175,201909,1009,2555,605,1916,121,436,253,759,374,1195
421180,201909,349,899,183,565,34,129,68,191,102,320
421185,201909,299,806,190,573,28,94,106,315,134,409
421187,201909,275,840,163,546,29,98,52,162,81,260
421189,201909,347,1018,262,840,46,147,95,288,141,435
421190,201909,9243,25166,5913,18799,1194,4173,1817,5356,3011,9529
421200,201909,612,1838,489,1584,62,218,287,902,349,1120
421205,201909,168,460,125,387,25,86,64,188,89,274
421210,201909,1021,2680,595,1922,139,447,200,659,339,1106
421220,201909,1240,3848,956,3201,223,822,280,843,503,1665
421223,201909,330,943,201,681,51,176,87,295,138,471
421225,201909,853,2604,732,2375,128,462,426,1385,554,1847
421227,201909,886,2333,503,1565,83,284,223,705,306,989
421230,201909,563,1507,341,1094,75,251,111,365,186,616
421240,201909,259,801,107,411,15,72,17,64,32,136
421250,201909,1615,4164,1066,3256,160,538,529,1569,689,2107
421260,201909,159,476,43,166,11,48,10,37,21,85
421265,201909,545,1500,506,1445,11,36,469,1348,480,1384
421270,201909,380,994,160,561,24,82,54,177,78,259
421280,201909,1515,4386,1111,3624,196,782,565,1693,761,2475
421290,201909,766,2097,401,1243,75,250,89,253,164,503
421300,201909,238,637,120,390,19,69,30,100,49,169
421310,201909,171,496,120,397,25,88,62,208,87,296
421315,201909,207,576,126,383,38,112,34,105,72,217
421320,201909,593,1750,270,909,38,139,43,102,81,241
421330,201909,568,1705,410,1369,82,311,119,377,201,688
421335,201909,335,1030,272,913,63,237,109,359,172,596
421340,201909,1234,3579,884,2880,181,663,343,1042,524,1705
421350,201909,1223,3270,798,2512,172,648,325,930,497,1578
421360,201909,2148,5925,1241,4042,247,977,448,1259,695,2236
421370,201909,477,1588,278,1037,59,235,71,228,130,463
421380,201909,740,2020,633,1835,86,289,388,1085,474,1374
421390,201909,166,455,58,200,13,43,18,51,31,94
421400,201909,261,841,177,643,33,132,84,282,117,414
421410,201909,210,559,83,287,14,54,22,70,36,124
421415,201909,187,579,97,333,26,87,21,64,47,151
421420,201909,463,1317,379,1153,37,126,237,692,274,818
421430,201909,115,356,89,298,10,34,31,97,41,131
421440,201909,581,1560,348,1122,74,229,146,468,220,697
421450,201909,369,1107,220,743,29,118,37,136,66,254
421460,201909,324,946,181,642,25,87,31,90,56,177
421470,201909,242,704,131,449,26,94,49,168,75,262
421480,201909,2572,6961,1626,5129,360,1344,608,1722,968,3066
421490,201909,108,348,66,234,6,24,20,49,26,73
421500,201909,1986,5924,1345,4563,377,1483,304,926,681,2409
421505,201909,278,816,237,749,34,119,153,465,187,584
421507,201909,390,1136,207,712,56,202,63,205,119,407
421510,201909,257,749,146,470,26,98,72,208,98,306
421520,201909,453,1197,270,781,30,103,164,442,194,545
421530,201909,296,921,167,606,36,160,42,125,78,285
421535,201909,376,1017,227,736,36,141,117,352,153,493
421540,201909,251,607,122,385,16,53,41,122,57,175
421545,201909,667,1989,490,1648,108,432,228,708,336,1140
421550,201909,1786,5001,1425,4437,271,899,759,2327,1030,3226
421555,201909,189,591,69,257,15,64,11,29,26,93
421560,201909,79,267,49,191,14,55,12,42,26,97
421565,201909,873,2302,591,1842,146,514,173,530,319,1044
421567,201909,426,1459,266,980,107,408,59,197,166,605
421568,201909,308,945,227,747,35,134,105,327,140,461
421569,201909,179,506,73,245,18,61,33,107,51,168
421570,201909,908,2500,634,1961,167,567,172,504,339,1071
421575,201909,254,767,188,596,32,117,78,211,110,328
421580,201909,3074,8712,1964,6323,370,1405,733,2017,1103,3422
421590,201909,131,420,100,340,35,127,25,73,60,200
421600,201909,503,1385,331,1028,78,260,92,244,170,504
421605,201909,692,1830,476,1464,90,249,218,704,308,953
421610,201909,965,2676,591,1932,116,406,164,529,280,935
421620,201909,3750,10062,2076,6873,485,1763,513,1633,998,3396
421625,201909,163,460,61,202,13,42,14,46,27,88
421630,201909,2201,5888,1259,3960,226,845,391,1051,617,1896
421635,201909,228,629,147,449,22,74,85,243,107,317
421640,201909,645,1786,454,1470,93,322,163,532,256,854
421650,201909,2078,5786,1270,4219,308,1179,328,913,636,2092
421660,201909,8143,23026,5733,18361,906,3309,2411,7060,3317,10369
421670,201909,713,2073,487,1543,85,304,245,753,330,1057
421680,201909,934,2656,706,2222,190,648,313,886,503,1534
421690,201909,1191,3489,805,2650,149,554,295,977,444,1531
421700,201909,447,1371,240,854,44,172,72,232,116,404
421710,201909,208,654,85,287,21,75,24,76,45,151
421715,201909,96,274,73,219,16,44,48,138,64,182
421720,201909,1817,5006,1004,3230,266,949,273,750,539,1699
421725,201909,204,501,96,311,19,66,36,88,55,154
421730,201909,362,1041,189,556,19,63,99,274,118,337
421740,201909,596,1684,402,1261,115,371,92,260,207,631
421750,201909,816,1919,356,1054,79,263,143,393,222,656
421755,201909,155,416,85,252,13,53,41,103,54,156
421760,201909,827,2254,508,1647,97,351,164,461,261,812
421770,201909,2176,5903,1563,4809,397,1261,549,1808,946,3069
421775,201909,202,529,127,376,21,69,61,163,82,232
421780,201909,758,2293,490,1702,107,420,199,642,306,1062
421790,201909,723,1868,401,1288,92,309,188,588,280,897
421795,201909,192,544,125,382,25,90,43,115,68,205
421800,201909,2245,6248,1619,5062,236,857,882,2596,1118,3453
421810,201909,582,1621,390,1253,52,191,228,710,280,901
421820,201909,872,2589,460,1571,89,347,134,369,223,716
421825,201909,1269,3595,1124,3364,125,404,776,2259,901,2663
421830,201909,1858,5700,1541,5094,316,1135,680,2179,996,3314
421835,201909,192,491,101,323,19,66,28,80,47,146
421840,201909,207,672,133,488,29,113,31,108,60,221
421850,201909,351,1004,185,646,42,164,60,162,102,326
421860,201909,294,852,165,583,20,84,54,172,74,256
421870,201909,3583,9158,2457,6990,450,1485,1170,3017,1620,4502
421875,201909,208,609,95,331,15,55,26,71,41,126
421880,201909,498,1403,323,1034,90,337,64,213,154,550
421885,201909,183,513,111,351,30,100,31,85,61,185
421890,201909,738,2327,548,1929,115,463,243,795,358,1258
421895,201909,379,1002,306,903,40,132,203,616,243,748
421900,201909,908,2353,602,1732,93,315,276,724,369,1039
421910,201909,279,833,188,633,40,153,51,152,91,305
421915,201909,366,1050,194,634,40,130,26,77,66,207
421917,201909,550,1317,302,978,112,389,69,227,181,616
421920,201909,369,1148,260,926,118,446,72,252,190,698
421930,201909,2261,5843,1035,3379,278,997,213,633,491,1630
421935,201909,388,1250,305,1053,57,213,170,553,227,766
421940,201909,306,910,117,391,17,70,36,103,53,173
421950,201909,2857,7158,1394,4352,295,1028,332,901,627,1929
421960,201909,164,421,87,281,18,68,20,55,38,123
421970,201909,1743,4556,978,2987,210,740,331,873,541,1613
421985,201909,233,621,138,440,15,51,51,154,66,205
422000,201909,1665,4474,1333,3905,149,497,899,2609,1048,3106
430003,201909,505,1407,325,1068,63,225,134,431,197,656
430005,201909,261,697,162,515,35,118,76,230,111,348
430010,201909,1615,4076,1299,3551,140,429,923,2426,1063,2855
430020,201909,555,1291,415,1098,49,156,270,684,319,840
430030,201909,963,2296,523,1514,147,458,162,431,309,889
430040,201909,9155,22518,5233,15386,1400,4506,507,1616,1907,6122
430045,201909,504,1273,334,954,25,86,211,583,236,669
430047,201909,237,507,85,242,18,59,23,64,41,123
430050,201909,840,2174,466,1396,109,342,115,332,224,674
430055,201909,232,589,105,312,10,43,62,165,72,208
430057,201909,81,178,26,72,6,21,8,21,14,42
430060,201909,15275,41769,11652,35918,2547,8319,5301,16331,7848,24650
430063,201909,827,2333,644,1935,125,376,356,1061,481,1437
430064,201909,934,2637,702,2137,202,651,257,747,459,1398
430066,201909,97,212,70,171,4,9,55,126,59,135
430070,201909,692,1756,83,285,9,34,12,32,21,66
430080,201909,745,1864,446,1273,73,247,220,535,293,782
430085,201909,826,1918,499,1379,91,264,221,583,312,847
430087,201909,455,1207,365,1074,62,181,221,666,283,847
430090,201909,530,1361,160,509,13,53,53,161,66,214
430100,201909,630,1542,332,960,66,219,130,329,196,548
430105,201909,1010,2722,624,2050,122,455,295,956,417,1411
430107,201909,167,494,97,313,17,62,28,70,45,132
430110,201909,2045,5127,1465,4261,220,697,818,2335,1038,3032
430120,201909,1237,3715,759,2488,141,488,334,1102,475,1590
430130,201909,3171,7548,2324,6332,924,2528,439,1424,1363,3952
430140,201909,856,2412,584,1875,135,431,270,856,405,1287
430150,201909,538,1390,277,850,65,212,91,275,156,487
430155,201909,246,623,108,327,19,54,19,48,38,102
430160,201909,17265,42411,13413,36645,1950,5770,7328,19965,9278,25735
430163,201909,2521,6283,1692,4902,95,290,1170,3404,1265,3694
430165,201909,323,788,81,267,16,40,14,39,30,79
430170,201909,890,2366,309,1076,58,207,49,162,107,369
430175,201909,634,1938,518,1680,138,444,245,774,383,1218
430180,201909,602,1503,473,1280,57,162,331,876,388,1038
430185,201909,436,1034,254,709,57,153,74,189,131,342
430187,201909,636,1510,442,1247,75,236,220,642,295,878
430190,201909,1330,3595,1052,3130,241,775,463,1308,704,2083
430192,201909,130,350,47,137,7,20,11,26,18,46
430195,201909,386,1154,43,160,6,16,5,20,11,36
430200,201909,1038,3167,834,2786,266,918,251,865,517,1783
430205,201909,455,1216,387,1083,13,45,329,895,342,940
430210,201909,4393,11328,2919,8291,603,1828,927,2161,1530,3989
430215,201909,293,764,178,530,39,124,73,219,112,343
430220,201909,623,1545,159,542,31,130,35,89,66,219
430222,201909,168,487,118,371,11,41,48,145,59,186
430223,201909,226,605,180,523,22,72,116,325,138,397
430225,201909,15,28,10,20,1,2,9,18,10,20
430230,201909,1702,4850,1464,4480,139,442,1083,3299,1222,3741
430235,201909,268,793,178,579,41,149,59,168,100,317
430237,201909,501,1232,344,967,18,67,238,639,256,706
430240,201909,1079,2418,586,1594,73,249,328,817,401,1066
430245,201909,645,1922,496,1630,158,519,226,757,384,1276
430250,201909,837,2141,612,1780,220,704,31,71,251,775
430258,201909,110,295,83,242,6,14,44,134,50,148
430260,201909,594,1608,414,1254,66,204,227,685,293,889
430265,201909,199,570,134,440,27,94,40,119,67,213
430270,201909,2588,6611,2047,5726,368,1116,1217,3300,1585,4416
430280,201909,4765,11520,3267,8835,716,1976,1378,3671,2094,5647
430290,201909,2068,4896,1730,4487,53,172,1478,3756,1531,3928
430300,201909,8675,22769,6593,19009,1130,3550,3416,9645,4546,13195
430310,201909,10095,25577,6509,18623,893,2914,3076,8159,3969,11073
430320,201909,930,2487,488,1555,63,185,270,881,333,1066
430330,201909,615,1545,371,1040,64,187,175,440,239,627
430340,201909,693,1544,356,1017,50,156,210,575,260,731
430350,201909,6563,17407,4771,13989,907,2820,2372,6691,3279,9511
430355,201909,311,791,97,317,19,55,15,41,34,96
430360,201909,792,1917,511,1424,117,364,200,513,317,877
430367,201909,304,734,155,451,37,113,68,199,105,312
430370,201909,450,1216,193,601,39,129,49,132,88,261
430380,201909,648,1621,304,971,68,256,80,243,148,499
430390,201909,2823,6927,1489,4387,263,874,164,337,427,1211
430400,201909,1033,2229,794,1878,57,151,595,1350,652,1501
430410,201909,521,1266,346,971,50,162,209,565,259,727
430420,201909,2533,7080,1902,5648,524,1627,755,2139,1279,3766
430430,201909,590,1516,274,846,63,191,63,194,126,385
430435,201909,1410,3634,1045,3026,211,649,501,1456,712,2105
430440,201909,3454,9807,2575,8098,355,1275,1490,4594,1845,5869
430450,201909,6415,16514,5012,13978,672,2110,2834,7626,3506,9736
430460,201909,27575,71594,19350,57712,3776,12401,8968,25539,12744,37940
430461,201909,314,817,90,287,10,33,30,82,40,115
430462,201909,228,602,123,397,18,56,45,156,63,212
430463,201909,4753,13108,3545,10911,720,2461,1658,4939,2378,7400
430465,201909,415,1095,338,952,47,151,217,582,264,733
430466,201909,3736,9574,2894,8135,738,2139,1351,3626,2089,5765
430467,201909,473,1156,320,910,47,160,164,434,211,594
430468,201909,1233,3049,954,2629,100,293,588,1579,688,1872
430469,201909,624,1740,73,254,11,38,11,15,22,53
430470,201909,5159,13474,3371,10244,1044,3403,862,2463,1906,5866
430471,201909,480,1422,396,1259,68,231,210,639,278,870
430480,201909,730,1946,367,1148,53,182,81,229,134,411
430485,201909,162,438,60,197,15,44,8,26,23,70
430490,201909,385,996,203,599,25,89,101,267,126,356
430495,201909,346,949,190,619,27,92,69,206,96,298
430500,201909,955,2500,645,1960,200,649,189,515,389,1164
430510,201909,22438,59225,15525,45334,2899,9641,6673,17769,9572,27410
430511,201909,317,942,114,396,13,51,16,45,29,96
430512,201909,886,2041,678,1730,171,432,245,640,416,1072
430513,201909,767,1934,350,1015,52,157,175,490,227,647
430515,201909,359,1017,249,784,34,96,125,397,159,493
430517,201909,1005,3154,756,2554,138,461,382,1324,520,1785
430520,201909,1217,3202,594,1830,106,340,132,369,238,709
430530,201909,976,2499,358,1120,64,194,88,269,152,463
430535,201909,2960,7823,2090,6195,308,954,1064,3060,1372,4014
430537,201909,309,1098,283,1013,24,76,223,801,247,877
430540,201909,548,1356,321,973,46,140,161,482,207,622
430543,201909,665,1244,378,906,62,123,179,469,241,592
430544,201909,617,1813,423,1358,98,325,186,588,284,913
430545,201909,2001,5314,1461,4473,300,936,710,2223,1010,3159
430550,201909,360,1016,224,718,41,128,78,246,119,374
430558,201909,105,236,41,112,4,7,12,33,16,40
430560,201909,326,725,132,395,13,43,41,119,54,162
430570,201909,704,1660,508,1360,97,299,271,675,368,974
430580,201909,827,2086,580,1693,143,455,254,707,397,1162
430583,201909,196,488,35,114,3,11,6,18,9,29
430585,201909,220,539,109,297,16,46,49,119,65,165
430587,201909,195,556,133,420,23,72,57,184,80,256
430590,201909,1353,3255,1122,2896,53,161,945,2396,998,2557
430593,201909,18,63,12,41,1,3,6,19,7,22
430595,201909,405,966,86,278,4,15,24,61,28,76
430597,201909,392,1037,202,604,22,72,73,165,95,237
430600,201909,1773,4573,765,2266,148,472,219,607,367,1079
430605,201909,1071,2990,765,2370,110,411,333,974,443,1385
430607,201909,509,1212,401,1034,26,76,290,740,316,816
430610,201909,5281,12816,3447,9936,1000,3130,682,2026,1682,5156
430613,201909,245,567,62,174,9,28,16,36,25,64
430620,201909,545,1379,403,1105,52,162,234,598,286,760
430630,201909,402,1123,115,374,20,69,23,65,43,134
430632,201909,504,1362,213,674,24,80,100,303,124,383
430635,201909,501,1239,362,997,47,135,256,703,303,838
430637,201909,439,1103,342,952,41,131,209,558,250,689
430640,201909,981,2533,539,1624,78,241,193,567,271,808
430642,201909,330,913,239,697,47,133,131,361,178,494
430645,201909,164,385,54,150,14,42,14,40,28,82
430650,201909,1484,4447,1209,3984,311,1024,585,2005,896,3029
430655,201909,258,636,145,410,22,67,68,167,90,234
430660,201909,4704,12417,3505,10302,814,2553,1553,4517,2367,7070
430670,201909,613,1506,462,1241,24,72,299,803,323,875
430673,201909,533,1224,198,588,40,126,74,206,114,332
430675,201909,196,560,45,163,13,50,18,63,31,113
430676,201909,4347,11111,3362,9543,441,1406,2106,5814,2547,7220
430680,201909,878,2387,519,1615,154,498,128,385,282,883
430690,201909,2736,7534,2148,6439,714,2243,594,1724,1308,3967
430692,201909,204,632,150,537,11,47,106,379,117,426
430693,201909,945,2495,537,1652,108,393,134,370,242,763
430695,201909,452,1169,243,722,32,90,133,379,165,469
430697,201909,378,955,282,797,70,179,131,406,201,585
430700,201909,6228,15632,3294,10070,768,2490,487,1449,1255,3939
430705,201909,387,945,179,539,26,92,75,201,101,293
430710,201909,1601,3539,1109,2831,152,435,641,1597,793,2032
430720,201909,698,1675,347,1043,58,170,164,496,222,666
430730,201909,975,2705,669,2104,99,295,349,1098,448,1393
430740,201909,568,1580,284,958,49,173,78,278,127,451
430745,201909,394,1077,214,661,34,120,71,189,105,309
430750,201909,1253,3275,875,2603,180,556,471,1346,651,1902
430755,201909,443,1074,267,717,15,49,156,385,171,434
430760,201909,1821,4631,1417,3982,338,1007,619,1675,957,2682
430770,201909,5713,14488,4332,12382,580,1842,2709,7517,3289,9359
430780,201909,1844,4558,1026,3127,215,694,364,1081,579,1775
430781,201909,430,1203,229,716,35,106,63,170,98,276
430783,201909,386,871,219,605,24,80,134,353,158,433
430786,201909,31,105,20,79,4,15,4,20,8,35
430790,201909,4074,10085,2711,7651,355,1170,1616,4244,1971,5414
430800,201909,729,1735,528,1407,39,114,353,938,392,1052
430805,201909,373,1008,224,672,22,80,143,396,165,476
430807,201909,369,843,175,484,14,44,92,234,106,278
430810,201909,728,1739,243,779,31,116,83,253,114,369
430820,201909,1248,3287,643,2080,144,483,156,510,300,993
430825,201909,249,623,78,202,13,33,23,55,36,88
430830,201909,1587,4637,1272,4021,57,217,910,2832,967,3049
430840,201909,896,2343,667,1930,85,268,455,1279,540,1547
430843,201909,116,278,40,115,4,12,20,52,24,64
430845,201909,380,912,238,664,63,188,82,216,145,404
430850,201909,2167,5723,1475,4372,229,746,655,1920,884,2666
430860,201909,816,1837,388,1095,53,184,190,460,243,644
430865,201909,476,1212,358,1009,63,192,195,533,258,725
430870,201909,608,1584,243,774,39,142,80,225,119,367
430880,201909,1264,2974,841,2305,158,457,435,1154,593,1611
430885,201909,168,441,82,272,9,33,48,154,57,187
430890,201909,928,2398,605,1807,58,248,108,297,166,545
430900,201909,2831,6302,1900,4921,177,536,1221,2970,1398,3506
430905,201909,722,1857,439,1303,81,271,165,466,246,737
430910,201909,1401,3761,960,2848,152,536,463,1219,615,1755
430912,201909,479,1325,310,990,28,84,208,680,236,764
430915,201909,480,1490,341,1214,115,413,107,381,222,794
430920,201909,21758,55659,16342,46506,2361,7426,9719,26813,12080,34239
430925,201909,106,242,40,122,7,23,16,50,23,73
430930,201909,9659,22994,5884,17055,1183,3545,2383,7163,3566,10708
430940,201909,982,2621,540,1629,163,508,109,260,272,768
430950,201909,693,1687,434,1217,39,141,263,661,302,802
430955,201909,221,585,67,216,16,48,20,57,36,105
430957,201909,177,606,163,573,27,98,99,343,126,441
430960,201909,1284,3064,724,2034,154,472,320,869,474,1341
430965,201909,1544,3703,1172,3120,65,191,915,2450,980,2641
430970,201909,360,890,170,497,26,79,84,222,110,301
430975,201909,462,1432,347,1152,76,260,161,521,237,781
430980,201909,366,854,195,562,30,97,83,216,113,313
430990,201909,548,1585,321,1025,39,134,164,518,203,652
430995,201909,545,1414,389,1153,53,171,199,567,252,738
431000,201909,1268,3015,483,1445,86,280,33,81,119,361
431010,201909,1925,4954,1094,3492,212,732,164,443,376,1175
431020,201909,7856,17190,4446,11891,1043,3107,1497,3539,2540,6646
431030,201909,319,862,140,471,26,94,24,71,50,165
431033,201909,3292,7930,1990,5809,478,1442,683,2016,1161,3458
431036,201909,331,708,67,187,8,18,20,48,28,66
431040,201909,871,2249,552,1654,93,318,232,639,325,957
431041,201909,444,1036,319,854,26,65,191,508,217,573
431043,201909,367,882,176,555,39,133,77,241,116,374
431046,201909,108,279,43,130,3,8,12,35,15,43
431050,201909,1311,3244,920,2618,147,431,490,1409,637,1840
431053,201909,565,1560,289,951,60,219,89,275,149,494
431055,201909,561,1383,462,1238,48,118,342,914,390,1032
431057,201909,245,702,108,365,19,65,34,106,53,171
431060,201909,4824,12891,3225,10035,850,2869,754,2360,1604,5229
431065,201909,400,1025,280,827,55,170,110,313,165,483
431070,201909,406,1169,215,721,53,193,39,126,92,319
431075,201909,215,644,130,441,22,76,38,128,60,204
431080,201909,568,1591,373,1170,75,266,131,389,206,655
431085,201909,679,1817,428,1216,69,198,216,596,285,794
431087,201909,426,1196,337,1012,23,62,234,722,257,784
431090,201909,400,938,140,446,22,70,43,135,65,205
431100,201909,3110,7017,2146,5694,316,892,1068,2860,1384,3752
431110,201909,1322,3097,894,2353,256,685,363,906,619,1591
431112,201909,483,1427,396,1252,74,260,208,623,282,883
431113,201909,335,944,287,851,48,156,175,507,223,663
431115,201909,961,2755,734,2323,108,403,423,1255,531,1658
431120,201909,2174,6232,1469,4758,500,1800,334,970,834,2770
431123,201909,367,1036,227,731,42,116,126,426,168,542
431125,201909,965,2894,728,2391,279,892,229,804,508,1696
431127,201909,224,578,52,168,7,23,8,23,15,46
431130,201909,2818,7407,2017,5978,345,1165,1037,2961,1382,4126
431140,201909,4730,11268,2589,7171,336,994,1136,2815,1472,3809
431142,201909,472,1277,340,1030,53,165,198,601,251,766
431150,201909,987,2680,679,2085,135,445,279,843,414,1288
431160,201909,674,1923,446,1425,83,301,146,449,229,750
431162,201909,497,1199,249,743,22,77,139,385,161,462
431164,201909,176,403,35,113,8,23,4,12,12,35
431170,201909,480,1350,329,1024,98,300,90,273,188,573
431171,201909,594,1416,479,1265,85,205,302,814,387,1019
431173,201909,395,1044,284,868,87,297,108,304,195,601
431175,201909,1078,2608,639,1838,120,358,220,603,340,961
431177,201909,686,1988,508,1679,136,491,264,848,400,1339
431179,201909,321,696,75,220,12,36,16,40,28,76
431180,201909,2111,5356,1222,3597,338,965,298,888,636,1853
431190,201909,418,1138,202,649,26,80,60,163,86,243
431198,201909,311,955,262,863,98,340,72,259,170,599
431200,201909,360,908,68,204,13,36,5,16,18,52
431205,201909,175,494,78,269,20,77,27,95,47,172
431210,201909,573,1484,457,1317,111,313,228,684,339,997
431213,201909,236,629,169,500,10,32,85,263,95,295
431215,201909,534,1261,218,633,23,74,102,271,125,345
431217,201909,153,410,100,309,7,27,60,167,67,194
431220,201909,561,1468,314,969,39,147,173,494,212,641
431225,201909,1466,3552,1089,2899,114,325,746,1986,860,2311
431230,201909,633,1837,465,1431,59,206,285,834,344,1040
431235,201909,147,371,21,69,2,5,4,17,6,22
431237,201909,298,962,249,842,49,181,125,405,174,586
431238,201909,25,64,19,50,6,14,5,12,11,26
431240,201909,3761,9630,2850,8136,516,1614,1443,3987,1959,5601
431242,201909,258,711,213,630,52,163,106,307,158,470
431244,201909,317,758,145,409,20,74,57,127,77,201
431245,201909,1227,2898,756,2055,88,255,383,986,471,1241
431247,201909,216,590,107,343,23,82,27,68,50,150
431250,201909,1510,3975,1103,3382,243,762,560,1769,803,2531
431260,201909,220,615,129,424,18,74,48,146,66,220
431261,201909,219,696,178,623,18,75,94,309,112,384
431262,201909,369,1008,165,530,11,37,110,354,121,391
431265,201909,1452,3412,535,1569,65,230,187,458,252,688
431267,201909,253,690,139,415,4,18,99,267,103,285
431270,201909,2560,5936,1337,3821,335,1032,385,1116,720,2148
431275,201909,125,364,66,213,21,70,9,24,30,94
431280,201909,216,575,58,190,7,25,7,13,14,38
431290,201909,284,812,181,564,30,99,47,120,77,219
431295,201909,66,177,17,57,1,4,6,17,7,21
431300,201909,303,776,51,165,5,18,13,36,18,54
431301,201909,298,852,60,198,9,23,4,9,13,32
431303,201909,552,1471,307,937,25,90,133,373,158,463
431306,201909,2021,4794,1128,3250,179,566,433,1108,612,1674
431308,201909,21,66,19,62,10,35,7,21,17,56
431310,201909,501,1443,351,1095,40,140,167,488,207,628
431320,201909,561,1558,256,872,38,124,41,129,79,253
431330,201909,1573,3738,698,2073,171,576,221,582,392,1158
431333,201909,213,584,98,292,17,51,36,100,53,151
431335,201909,39,111,22,75,5,10,3,6,8,16
431337,201909,2426,6566,1718,5345,371,1306,794,2358,1165,3664
431339,201909,375,990,269,789,74,221,115,332,189,553
431340,201909,18278,44796,12177,34281,2306,7143,5087,13388,7393,20531
431342,201909,426,943,313,780,14,38,280,693,294,731
431344,201909,388,997,218,650,9,32,133,381,142,413
431346,201909,243,603,86,277,15,53,28,92,43,145
431349,201909,642,1683,333,995,82,247,123,351,205,598
431350,201909,3724,9849,2689,8011,406,1332,1361,3969,1767,5301
431360,201909,555,1337,279,798,75,228,86,242,161,470
431365,201909,1751,4294,1402,3801,126,394,1037,2791,1163,3185
431370,201909,3967,10032,2813,8063,702,2131,1231,3618,1933,5749
431380,201909,760,2103,630,1887,38,128,432,1286,470,1414
431390,201909,2345,5745,1351,3930,170,580,598,1512,768,2092
431395,201909,1169,3027,812,2460,187,594,355,1088,542,1682
431400,201909,312,881,155,497,32,95,31,95,63,190
431402,201909,803,1846,568,1477,74,207,369,925,443,1132
431403,201909,177,487,137,410,22,77,71,174,93,251
431405,201909,4136,11072,3155,9475,624,2119,1453,4085,2077,6204
431406,201909,486,1411,347,1107,83,251,169,552,252,803
431407,201909,450,1251,292,908,60,212,139,412,199,624
431410,201909,15438,39678,9671,28936,1560,5356,4587,12772,6147,18128
431413,201909,223,572,52,165,5,14,8,24,13,38
431415,201909,644,1589,388,1168,74,256,167,441,241,697
431417,201909,521,1169,350,914,50,146,199,514,249,660
431420,201909,1431,3363,1068,2836,175,480,546,1453,721,1933
431430,201909,516,1327,228,745,35,136,69,184,104,320
431440,201909,26884,64225,18680,50943,3473,10216,7097,18339,10570,28555
431442,201909,105,296,47,161,6,18,9,23,15,41
431445,201909,408,1154,122,417,16,48,13,44,29,92
431446,201909,274,801,189,625,44,159,83,260,127,419
431447,201909,619,1672,383,1172,81,265,144,444,225,709
431449,201909,705,1862,410,1212,79,217,170,497,249,714
431450,201909,2063,4388,1638,3783,87,214,1264,2828,1351,3042
431454,201909,35,109,31,100,6,19,11,38,17,57
431455,201909,578,1396,274,754,36,107,137,336,173,443
431460,201909,2691,6770,1902,5320,525,1548,548,1548,1073,3096
431470,201909,1368,3890,967,3022,180,571,430,1362,610,1933
431475,201909,247,705,35,145,3,14,5,20,8,34
431477,201909,396,1032,225,672,35,102,93,244,128,346
431478,201909,273,712,50,159,14,40,6,16,20,56
431480,201909,2905,7397,2194,6257,511,1496,1111,3185,1622,4681
431490,201909,100212,240988,77345,205322,6213,19447,56625,144717,62838,164164
431500,201909,470,1196,334,939,63,173,177,483,240,656
431505,201909,286,703,190,548,15,42,126,365,141,407
431507,201909,334,786,132,384,39,121,41,111,80,232
431510,201909,1447,3811,970,2859,217,704,374,1083,591,1787
431513,201909,215,491,115,316,8,21,79,215,87,236
431514,201909,89,235,56,174,3,9,40,119,43,128
431515,201909,449,1141,310,881,63,182,159,442,222,624
431517,201909,67,191,52,155,11,31,22,64,33,95
431520,201909,413,1015,149,485,26,94,56,154,82,248
431530,201909,3715,7837,2125,5631,554,1496,457,1200,1011,2696
431531,201909,195,502,115,339,10,34,52,142,62,176
431532,201909,524,1243,303,845,73,220,123,329,196,549
431535,201909,236,627,93,303,20,71,18,47,38,118
431540,201909,1747,5632,1632,5465,59,252,1333,4454,1392,4706
431545,201909,340,887,57,180,9,25,12,38,21,63
431550,201909,1888,4914,1468,4120,243,740,764,2063,1007,2803
431555,201909,656,1493,404,1070,24,80,253,654,277,734
431560,201909,20235,50294,13105,38754,2731,8624,4230,13163,6961,21787
431570,201909,4477,10939,3441,9452,427,1353,2321,6110,2748,7463
431575,201909,216,562,161,460,34,89,42,110,76,199
431580,201909,537,1376,306,899,40,147,167,457,207,604
431590,201909,579,1606,425,1286,89,281,179,556,268,837
431595,201909,331,907,205,629,45,139,84,240,129,379
431600,201909,1218,2836,859,2339,232,685,319,896,551,1581
431610,201909,1302,3419,875,2593,134,379,455,1384,589,1763
431620,201909,475,1251,205,623,35,115,82,230,117,345
431630,201909,1256,3172,543,1659,100,341,195,541,295,882
431640,201909,5789,14580,5006,13525,555,1580,3591,9765,4146,11345
431642,201909,487,1174,303,824,22,60,170,425,192,485
431643,201909,343,853,140,414,17,47,48,134,65,181
431645,201909,1721,4018,1341,3467,80,255,1030,2616,1110,2871
431647,201909,222,564,80,229,9,29,16,36,25,65
431650,201909,124,331,79,249,10,36,40,112,50,148
431660,201909,843,2281,425,1389,74,279,113,342,187,621
431670,201909,1072,2585,669,1857,100,288,354,942,454,1230
431673,201909,226,568,80,270,15,46,16,52,31,98
431675,201909,535,1301,93,292,9,36,22,54,31,90
431680,201909,6815,17832,4866,14089,1209,3655,2038,5768,3247,9423
431690,201909,20572,51214,13344,38181,2990,9085,5006,14466,7996,23551
431695,201909,132,319,81,238,14,54,44,102,58,156
431697,201909,437,1049,321,862,52,129,179,496,231,625
431700,201909,1334,3507,1111,3092,152,404,665,1823,817,2227
431710,201909,11272,28315,7981,23432,1648,5125,3677,11085,5325,16210
431720,201909,5440,13991,3190,9405,838,2623,495,1288,1333,3911
431725,201909,21,52,15,42,5,14,5,12,10,26
431730,201909,3458,8626,2159,6448,513,1662,692,2179,1205,3841
431740,201909,4736,11505,3023,8494,891,2844,676,1591,1567,4435
431750,201909,6826,17813,5366,15486,1130,3536,2497,7097,3627,10633
431755,201909,297,804,59,212,6,22,12,45,18,67
431760,201909,5162,11638,3297,8722,330,1050,2008,4964,2338,6014
431770,201909,1744,4243,1369,3743,89,302,1028,2728,1117,3030
431775,201909,197,515,92,285,22,60,15,41,37,101
431780,201909,1837,4616,1175,3404,215,704,495,1377,710,2081
431790,201909,768,2093,544,1645,99,301,244,710,343,1011
431795,201909,224,577,97,295,20,63,30,87,50,150
431800,201909,7077,17685,4504,13418,1293,4368,566,1770,1859,6138
431805,201909,295,697,78,260,5,17,31,99,36,116
431810,201909,3152,7616,1960,5374,359,1058,844,2204,1203,3262
431820,201909,2023,5614,1601,4916,463,1501,564,1796,1027,3297
431830,201909,8283,18389,5991,15189,1544,4470,1968,4966,3512,9436
431840,201909,2380,6470,1926,5684,335,1003,1129,3354,1464,4357
431842,201909,624,1553,200,627,28,102,61,171,89,273
431843,201909,292,791,223,651,29,93,111,302,140,395
431844,201909,213,546,58,195,16,57,18,64,34,121
431845,201909,507,1340,349,1020,25,75,206,595,231,670
431846,201909,266,709,225,646,14,42,192,549,206,591
431848,201909,107,273,62,186,7,25,8,19,15,44
431849,201909,403,974,58,172,4,9,6,20,10,29
431850,201909,3807,10493,2903,8644,686,2221,919,2694,1605,4915
431860,201909,633,1574,355,1019,60,182,186,508,246,690
431861,201909,97,265,48,151,12,38,13,34,25,72
431862,201909,407,1292,329,1158,72,289,163,550,235,839
431870,201909,16549,43471,13297,38096,1841,5907,7820,21622,9661,27529
431880,201909,3809,9900,2640,7763,452,1534,1176,3281,1628,4815
431890,201909,3909,10057,2350,6998,724,2338,381,1237,1105,3575
431900,201909,945,2414,578,1706,87,294,299,826,386,1120
431910,201909,752,1823,240,693,45,128,70,161,115,289
431912,201909,432,1238,337,1065,67,222,204,640,271,862
431915,201909,997,2550,791,2201,25,86,601,1627,626,1713
431920,201909,1112,2755,927,2495,32,94,788,2105,820,2199
431930,201909,628,1698,421,1319,117,329,206,673,323,1002
431935,201909,81,227,47,152,15,53,10,35,25,88
431936,201909,287,853,154,511,31,109,55,174,86,283
431937,201909,168,417,101,271,21,70,44,92,65,162
431940,201909,2799,6725,1588,4467,191,609,792,2128,983,2737
431950,201909,1678,4530,1362,4011,433,1280,527,1559,960,2839
431960,201909,2688,6758,1947,5384,565,1600,515,1411,1080,3011
431970,201909,408,1044,140,431,36,107,37,102,73,209
431971,201909,57,141,31,94,5,20,6,11,11,31
431973,201909,459,1484,375,1320,39,153,273,953,312,1106
431975,201909,103,218,18,65,4,17,3,7,7,24
431980,201909,987,2617,751,2209,173,538,334,942,507,1480
431990,201909,5479,13289,3504,10293,528,1793,1569,4368,2097,6161
432000,201909,9911,24201,7019,19561,1754,4982,3030,8542,4784,13524
432010,201909,1905,4917,1406,3985,217,692,799,2137,1016,2829
432020,201909,1627,4031,1056,2998,224,670,496,1331,720,2001
432023,201909,499,1208,246,701,43,138,116,295,159,433
432026,201909,986,2764,690,2190,180,568,245,761,425,1329
432030,201909,319,816,175,525,25,70,90,271,115,341
432032,201909,339,879,228,667,24,86,126,336,150,422
432035,201909,612,1742,527,1595,186,573,192,604,378,1177
432040,201909,1030,2294,327,1019,57,204,104,283,161,487
432045,201909,172,463,99,315,22,72,37,122,59,194
432050,201909,448,1178,331,960,79,233,135,397,214,630
432055,201909,617,1646,390,1200,133,438,89,246,222,684
432057,201909,234,613,166,446,31,76,77,195,108,271
432060,201909,441,1070,134,427,29,102,44,117,73,219
432065,201909,208,586,140,435,27,79,54,159,81,238
432067,201909,681,2001,576,1756,53,177,406,1195,459,1372
432070,201909,1638,4373,1025,3138,229,789,304,839,533,1628
432080,201909,3995,9900,3011,8228,554,1750,1402,3654,1956,5404
432085,201909,347,884,231,701,74,219,91,295,165,514
432090,201909,1193,3053,813,2351,160,508,406,1112,566,1620
432100,201909,922,2410,406,1300,82,286,69,170,151,456
432110,201909,1988,5402,1308,4129,326,1177,111,334,437,1511
432120,201909,2581,7213,2017,6188,452,1541,711,2111,1163,3652
432130,201909,2324,6144,1935,5586,635,1857,799,2372,1434,4229
432132,201909,170,476,100,329,20,68,43,118,63,186
432135,201909,961,2327,607,1680,37,122,436,1185,473,1307
432140,201909,1470,4490,1098,3741,154,559,674,2296,828,2855
432143,201909,1315,3507,1011,3027,73,241,672,1989,745,2230
432145,201909,1271,3374,707,2158,112,374,221,568,333,942
432146,201909,96,271,57,201,18,71,18,54,36,125
432147,201909,464,1367,276,936,89,323,63,184,152,507
432149,201909,404,1032,191,578,12,36,92,268,104,304
432150,201909,2710,7079,1966,5712,452,1487,693,1929,1145,3416
432160,201909,4792,13033,3514,10860,951,3191,1187,3515,2138,6706
432162,201909,261,575,32,93,4,9,5,14,9,23
432163,201909,125,317,25,72,0,0,3,6,3,6
432166,201909,542,1534,400,1230,68,229,147,403,215,632
432170,201909,1234,3348,743,2402,144,521,267,805,411,1326
432180,201909,2457,6040,1260,3713,242,767,423,1112,665,1879
432183,201909,343,1011,216,706,53,200,73,224,126,424
432185,201909,777,1999,437,1332,34,117,237,679,271,796
432190,201909,1731,4265,1054,3100,216,714,484,1336,700,2050
432195,201909,904,2254,564,1630,157,427,209,637,366,1064
432200,201909,2973,7883,2075,6369,383,1193,1086,3406,1469,4599
432210,201909,338,900,194,607,34,131,90,240,124,371
432215,201909,607,1784,541,1683,46,135,401,1257,447,1392
432218,201909,249,626,103,299,16,53,48,126,64,179
432220,201909,3433,8198,2531,6778,431,1230,1409,3709,1840,4939
432225,201909,83,245,59,191,13,44,31,102,44,146
432230,201909,671,1620,358,1034,52,156,153,406,205,562
432232,201909,476,1176,285,836,69,224,102,274,171,498
432234,201909,264,671,108,322,22,54,14,39,36,93
432235,201909,71,194,20,60,5,15,5,19,10,34
432237,201909,329,850,280,766,10,24,226,599,236,623
432240,201909,13778,35897,10139,30726,753,2650,6464,20303,7217,22953
432250,201909,4202,12778,3420,11230,992,3325,1324,4394,2316,7719
432252,201909,411,1001,246,698,37,114,122,331,159,445
432253,201909,942,2937,549,1911,146,541,30,98,176,639
432254,201909,666,1587,132,428,30,96,16,41,46,137
432255,201909,104,266,54,165,6,21,27,70,33,91
432260,201909,4404,11516,3157,9113,904,2693,916,2586,1820,5279
432270,201909,1680,4808,1309,4047,402,1330,252,747,654,2077
432280,201909,1079,2780,556,1694,90,315,219,570,309,885
432285,201909,167,496,21,68,0,0,3,6,3,6
432290,201909,324,934,162,534,55,179,29,66,84,245
432300,201909,24029,62375,17826,52082,2705,8830,10320,29102,13025,37932
432310,201909,751,2085,536,1680,55,178,355,1117,410,1295
432320,201909,206,477,66,193,9,33,24,62,33,95
432330,201909,206,487,60,187,8,22,17,48,25,70
432335,201909,194,551,60,221,7,31,11,33,18,64
432340,201909,313,746,126,398,14,49,42,117,56,166
432345,201909,616,1445,543,1353,19,52,431,1057,450,1109
432350,201909,329,878,169,558,31,105,62,200,93,305
432360,201909,222,657,42,144,4,15,16,51,20,66
432370,201909,293,727,185,538,15,49,126,357,141,406
432375,201909,458,1161,338,928,64,160,170,479,234,639
432377,201909,174,546,31,112,5,20,3,6,8,26
432380,201909,1494,4053,943,3010,175,624,458,1401,633,2025
500020,201909,2328,6109,1602,4819,210,732,912,2650,1122,3382
500025,201909,1208,2882,738,2044,68,204,414,1099,482,1303
500060,201909,6739,19133,4739,15269,626,2075,2841,9469,3467,11544
500070,201909,3875,10185,2671,8125,506,1589,1183,3701,1689,5290
500080,201909,1308,3304,835,2470,161,530,359,960,520,1490
500085,201909,1921,4789,1264,3715,293,917,623,1748,916,2665
500090,201909,1834,4974,1227,3895,238,785,469,1538,707,2323
500100,201909,3376,8673,2533,7276,453,1438,1216,3323,1669,4761
500110,201909,7046,18455,4398,14165,1016,3613,1306,4843,2322,8456
500124,201909,1906,5787,1513,5072,268,839,824,2906,1092,3745
500150,201909,1243,2858,748,2101,169,489,256,698,425,1187
500190,201909,4021,9974,2667,7807,646,1916,775,2274,1421,4190
500200,201909,2069,4947,1486,3976,177,503,906,2309,1083,2812
500210,201909,4301,10910,3092,9253,807,2459,1363,4169,2170,6628
500215,201909,1305,3740,905,2971,89,332,470,1547,559,1879
500220,201909,2354,6701,1505,5099,263,949,434,1419,697,2368
500230,201909,1995,4727,1464,3955,194,509,952,2551,1146,3060
500240,201909,3338,10082,2283,7884,373,1422,874,3122,1247,4544
500260,201909,2977,6388,1776,4698,241,648,920,2361,1161,3009
500270,201909,128354,303691,72838,207279,13272,41278,25954,69715,39226,110993
500280,201909,1185,3014,793,2387,98,322,469,1364,567,1686
500290,201909,3413,8032,1815,5398,340,1167,589,1580,929,2747
500295,201909,3079,7599,1806,5250,311,999,676,1711,987,2710
500310,201909,869,1852,578,1478,97,202,297,798,394,1000
500315,201909,3313,9619,2637,8544,243,775,1838,6150,2081,6925
500320,201909,17029,47571,11768,38738,3104,10682,4086,14295,7190,24977
500325,201909,4009,9099,2713,7324,246,697,1761,4808,2007,5505
500330,201909,6456,14910,4096,11326,321,989,2322,6537,2643,7526
500345,201909,1903,4695,1195,3550,295,908,404,1167,699,2075
500348,201909,2299,5944,1751,5021,256,759,990,2895,1246,3654
500350,201909,1229,3362,642,2050,68,217,282,888,350,1105
500370,201909,22844,59850,15429,47385,2285,7935,7793,23900,10078,31835
500375,201909,2257,6021,1490,4442,310,1002,496,1403,806,2405
500380,201909,3311,8347,2207,6450,614,1895,641,1888,1255,3783
500390,201909,491,1061,298,812,54,167,168,453,222,620
500400,201909,1212,3156,767,2267,151,498,264,724,415,1222
500410,201909,2268,5751,1587,4701,177,518,942,2854,1119,3372
500430,201909,2446,6141,1595,4825,229,805,671,2122,900,2927
500440,201909,1073,2601,628,1883,87,279,240,776,327,1055
500450,201909,1328,3351,711,2178,151,500,153,454,304,954
500460,201909,3417,9320,2031,6586,383,1405,662,2144,1045,3549
500470,201909,2294,6283,1366,4340,417,1482,268,718,685,2200
500480,201909,2012,6158,1708,5668,153,536,1224,4171,1377,4707
500490,201909,952,2240,522,1587,121,439,143,432,264,871
500500,201909,4092,11124,2574,8591,932,3620,462,1553,1394,5173
500510,201909,656,1697,415,1226,30,105,251,723,281,828
500515,201909,1740,4389,1334,3757,137,417,879,2404,1016,2821
500520,201909,2852,9360,2267,8205,630,2330,951,3581,1581,5911
500525,201909,819,2475,668,2241,62,228,408,1386,470,1614
500540,201909,4053,10642,2396,7682,689,2697,235,661,924,3358
500560,201909,5018,14252,4056,12960,294,1035,3168,10214,3462,11249
500568,201909,4153,9126,2408,6543,582,1741,809,2186,1391,3927
500570,201909,7071,16641,4007,11293,805,2492,1261,3293,2066,5785
500580,201909,2849,7738,2103,6428,449,1463,1023,3101,1472,4564
500600,201909,2919,7330,2025,5979,427,1283,895,2734,1322,4017
500620,201909,6983,18802,4577,14139,1065,3434,1596,4836,2661,8270
500625,201909,461,1252,253,789,47,162,92,255,139,417
500627,201909,699,1823,409,1278,63,203,143,443,206,646
500630,201909,5979,14082,3332,9597,702,2187,1030,3005,1732,5192
500635,201909,2797,8981,2159,8115,167,680,1537,6199,1704,6879
500640,201909,1612,3566,1053,2801,33,111,729,1882,762,1993
500660,201909,15522,42019,10586,34366,3574,12920,2616,8683,6190,21603
500690,201909,2029,5628,1364,4582,550,2115,88,196,638,2311
500710,201909,2761,7613,2087,6389,640,2057,613,1763,1253,3820
500720,201909,4689,11997,2917,9028,679,2243,837,2628,1516,4871
500730,201909,872,2235,525,1597,70,192,191,590,261,782
500740,201909,4384,10521,2970,8229,379,1122,1630,4535,2009,5657
500750,201909,901,2330,580,1734,90,272,216,571,306,843
500755,201909,828,2229,443,1476,93,327,75,227,168,554
500769,201909,4608,11469,2349,7082,465,1556,367,859,832,2415
500770,201909,1429,3907,890,2916,167,612,288,942,455,1554
500780,201909,1173,2903,734,2151,163,515,212,595,375,1110
500790,201909,7046,18726,5454,16115,1067,3409,2891,8587,3958,11996
500793,201909,1796,4607,1193,3546,357,1145,317,855,674,2000
500795,201909,2413,6308,1980,5752,91,258,1685,5011,1776,5269
500797,201909,652,1662,429,1261,117,357,155,459,272,816
500800,201909,2705,6351,1675,4825,545,1822,211,684,756,2506
500830,201909,16496,41991,10972,31756,2257,7134,4320,11752,6577,18886
500840,201909,1325,3265,739,2125,87,255,309,850,396,1105
510010,201909,1783,4051,1140,3188,110,316,791,2229,901,2545
510020,201909,3362,8644,1714,5273,381,1259,359,1003,740,2262
510025,201909,6407,15995,3837,11585,612,2065,1503,4346,2115,6411
510030,201909,2213,5027,1432,3900,332,905,515,1414,847,2319
510035,201909,1151,2995,697,2261,85,304,413,1399,498,1703
510040,201909,2105,4808,1513,4018,147,378,969,2656,1116,3034
510050,201909,1897,4200,1239,3289,163,512,821,2093,984,2605
510060,201909,1297,3299,932,2709,190,609,287,787,477,1396
510080,201909,1153,3067,740,2342,229,766,221,610,450,1376
510100,201909,637,1516,425,1170,51,145,222,589,273,734
510120,201909,250,478,139,347,3,12,109,276,112,288
510125,201909,1953,4914,1529,4281,172,646,780,2037,952,2683
510130,201909,1390,3503,951,2798,203,653,294,874,497,1527
510140,201909,2830,7513,1925,6339,719,2767,646,1939,1365,4706
510160,201909,1653,4294,1186,3675,194,588,808,2542,1002,3130
510170,201909,4291,11421,3088,9457,762,2408,1244,3934,2006,6342
510180,201909,13024,30312,7693,22097,1792,5579,2247,7352,4039,12931
510185,201909,1608,4297,1044,3475,429,1423,282,1168,711,2591
510190,201909,1892,5467,1219,4268,356,1378,225,823,581,2201
510250,201909,14427,37945,11268,33407,2174,6711,6111,18781,8285,25492
510260,201909,1960,8140,1575,7423,275,1404,938,4810,1213,6214
510263,201909,2800,7931,1639,5490,267,1005,211,637,478,1642
510267,201909,4435,12855,2570,8700,556,2011,300,969,856,2980
510268,201909,1181,2951,866,2451,104,295,564,1571,668,1866
510269,201909,979,2718,594,1969,159,577,183,565,342,1142
510270,201909,2773,8032,1872,6352,358,1321,736,2452,1094,3773
510279,201909,1657,4372,1065,3331,212,738,455,1348,667,2086
510285,201909,1048,2833,718,2267,224,782,155,443,379,1225
510300,201909,3540,9066,2575,7727,404,1211,1486,4689,1890,5900
510305,201909,1403,3919,819,2769,171,598,195,736,366,1334
510310,201909,872,2196,588,1711,178,543,163,489,341,1032
510320,201909,3479,8922,2374,6969,533,1688,641,1915,1174,3603
510325,201909,4161,12464,3141,10639,926,3276,1053,3669,1979,6945
510330,201909,2627,8060,1733,6424,333,1256,648,2740,981,3996
510335,201909,4221,12423,3168,10769,499,1818,1775,6203,2274,8021
510336,201909,421,1212,300,1013,61,193,138,513,199,706
510337,201909,1505,4514,989,3548,394,1534,180,662,574,2196
510340,201909,85716,191672,50367,138995,13030,42320,14032,35824,27062,78144
510343,201909,982,2720,654,2075,119,411,282,863,401,1274
510345,201909,1181,3392,860,2754,162,526,375,1159,537,1685
510350,201909,2663,7043,1670,5331,366,1214,656,2077,1022,3291
510360,201909,1781,3745,1106,2947,60,130,810,2281,870,2411
510370,201909,1637,4879,1166,4015,166,646,686,2382,852,3028
510380,201909,533,1342,279,876,60,219,98,294,158,513
510385,201909,1172,3978,838,3328,94,419,514,2113,608,2532
510390,201909,1109,3154,758,2666,212,725,322,1240,534,1965
510395,201909,696,1561,456,1209,31,92,266,759,297,851
510410,201909,4436,12620,3219,10369,621,2064,1738,5762,2359,7826
510420,201909,2158,4687,1461,3750,114,342,957,2432,1071,2774
510450,201909,470,1159,255,753,68,200,40,134,108,334
510452,201909,664,1888,448,1466,69,235,224,727,293,962
510454,201909,840,2372,635,2011,63,175,414,1387,477,1562
510455,201909,863,2441,607,1904,100,372,236,666,336,1038
510460,201909,1691,4213,1180,3444,95,342,775,2154,870,2496
510480,201909,4410,10767,2853,7825,564,1747,1126,2948,1690,4695
510490,201909,1622,4306,1187,3728,195,623,711,2272,906,2895
510500,201909,1513,3829,883,2744,170,557,313,979,483,1536
510510,201909,3215,9620,2352,7985,637,2398,703,2505,1340,4903
510515,201909,5048,13248,3142,9645,765,2607,764,2111,1529,4718
510517,201909,992,2905,750,2475,235,874,130,369,365,1243
510520,201909,2028,4126,1136,3026,74,212,612,1738,686,1950
510523,201909,980,2581,713,2124,154,442,380,1160,534,1602
510525,201909,5967,16702,4384,13559,760,2655,1995,5800,2755,8455
510530,201909,513,1320,368,1114,34,110,221,650,255,760
510550,201909,2321,6877,1637,5650,408,1474,683,2377,1091,3851
510558,201909,2083,5618,1487,4671,165,501,748,2504,913,3005
510560,201909,1567,4532,900,3177,199,781,236,890,435,1671
510562,201909,4939,13323,3443,10469,904,3000,1125,3493,2029,6493
510590,201909,2972,7479,2117,6368,185,612,1494,4539,1679,5151
510600,201909,1415,3240,885,2433,181,504,362,1016,543,1520
510610,201909,2679,6543,1781,5287,174,599,1100,3275,1274,3874
510615,201909,2391,6180,1539,4732,287,885,793,2533,1080,3418
510617,201909,913,2721,672,2320,110,440,393,1400,503,1840
510618,201909,1179,3158,786,2449,162,570,384,1158,546,1728
510619,201909,693,1778,425,1305,68,223,96,276,164,499
510620,201909,1320,2992,586,1818,152,563,34,75,186,638
510621,201909,1412,3812,841,2722,189,679,257,787,446,1466
510622,201909,4129,11744,2817,8866,1019,3440,413,1170,1432,4610
510623,201909,2494,6272,1683,4972,395,1404,466,1310,861,2714
510624,201909,1584,4015,654,2220,82,304,150,431,232,735
510625,201909,2580,6362,1351,4149,260,928,302,914,562,1842
510626,201909,1400,3419,850,2545,249,856,205,613,454,1469
510627,201909,576,1498,314,975,86,288,76,247,162,535
510628,201909,1475,3395,940,2664,187,553,385,1088,572,1641
510629,201909,1493,4346,1087,3587,241,861,391,1282,632,2143
510630,201909,3127,8845,1784,6213,417,1564,316,1193,733,2757
510631,201909,557,1340,389,1098,13,39,299,861,312,900
510637,201909,3151,7744,2213,6333,595,1895,618,1754,1213,3649
510642,201909,5017,14771,3867,12996,1022,3677,1592,5547,2614,9224
510645,201909,799,1703,467,1259,107,308,207,516,314,824
510650,201909,6788,17788,5404,16261,632,1735,3763,12329,4395,14064
510665,201909,1723,3864,986,2668,140,404,426,1190,566,1594
510670,201909,407,877,228,611,25,72,130,358,155,430
510675,201909,5480,15435,3679,11993,1136,4020,603,1943,1739,5963
510677,201909,1986,5150,1336,4160,194,668,697,2148,891,2816
510680,201909,643,1709,356,1146,78,270,71,215,149,485
510682,201909,1510,4524,1089,3789,364,1395,228,766,592,2161
510685,201909,547,1592,391,1271,58,201,195,631,253,832
510700,201909,3775,9357,2637,7710,311,1045,1840,5310,2151,6355
510704,201909,9922,23617,6255,17184,1318,3930,1745,4561,3063,8491
510706,201909,1874,5628,1307,4725,238,860,705,2758,943,3618
510710,201909,2462,6348,1576,4633,353,1090,550,1543,903,2633
510715,201909,561,1278,413,1074,39,116,197,522,236,638
510718,201909,2192,4960,1240,3720,449,1324,334,1290,783,2614
510719,201909,412,872,243,650,29,75,140,357,169,432
510720,201909,896,2149,568,1642,112,362,247,671,359,1033
510724,201909,718,1970,470,1511,81,286,222,689,303,975
510726,201909,1077,1954,540,1289,58,147,277,661,335,808
510729,201909,591,1403,252,776,38,135,58,186,96,321
510730,201909,2762,6808,1832,5318,278,908,850,2414,1128,3322
510735,201909,990,2889,741,2530,77,305,537,1823,614,2128
510740,201909,847,2105,517,1481,79,228,248,709,327,937
510757,201909,526,1670,419,1493,144,563,140,471,284,1034
510760,201909,39828,88102,22575,61346,4989,15599,7016,17398,12005,32997
510770,201909,4144,9463,2818,7823,263,705,1903,5516,2166,6221
510774,201909,330,880,223,682,38,120,110,344,148,464
510775,201909,567,1551,386,1253,92,340,83,253,175,593
510776,201909,421,1062,286,801,75,213,86,254,161,467
510777,201909,1493,4022,1057,3446,141,541,679,2171,820,2712
510779,201909,584,1585,441,1360,48,144,268,866,316,1010
510780,201909,3492,9183,2533,7777,606,1850,1116,3830,1722,5680
510785,201909,1928,5156,1086,3557,288,1015,172,637,460,1652
510787,201909,2426,6969,1555,5102,573,1972,150,477,723,2449
510788,201909,606,1444,409,1144,63,177,179,577,242,754
510790,201909,15981,41833,9208,28803,2046,7185,1406,3797,3452,10982
510792,201909,8107,22001,4840,15638,1024,3696,937,2757,1961,6453
510794,201909,1158,3131,748,2419,238,851,160,448,398,1299
510795,201909,7574,20268,4796,15128,1109,3848,1227,3851,2336,7699
510800,201909,1638,4296,1031,3234,374,1168,122,359,496,1527
510805,201909,1474,4099,967,3123,217,772,305,862,522,1634
510810,201909,624,1296,384,962,103,272,163,406,266,678
510820,201909,742,1427,394,980,27,88,203,510,230,598
510830,201909,809,1999,563,1669,56,150,391,1222,447,1372
510835,201909,540,1319,349,1037,47,153,193,560,240,713
510840,201909,47937,104805,32714,85862,6024,15005,17302,49407,23326,64412
510850,201909,1767,4236,962,2937,313,1069,90,213,403,1282
510860,201909,2216,5978,1374,4537,434,1659,131,427,565,2086
510880,201909,649,1887,483,1559,121,405,189,619,310,1024
510885,201909,522,1273,351,1022,64,217,123,346,187,563
510890,201909,606,1786,450,1513,104,369,205,687,309,1056
510895,201909,1198,3129,780,2435,179,666,318,900,497,1566
520005,201909,2248,5940,1743,5316,487,1491,772,2653,1259,4144
520010,201909,2098,6122,1481,4874,384,1407,418,1202,802,2609
520013,201909,2622,6904,1737,5233,397,1227,487,1594,884,2821
520015,201909,501,1281,356,1068,83,266,125,391,208,657
520017,201909,1044,2743,774,2320,97,316,495,1455,592,1771
520020,201909,376,873,282,749,29,101,202,508,231,609
520025,201909,31695,89321,27238,83042,2734,9075,19693,59678,22427,68753
520030,201909,5168,13553,4110,12039,353,1156,2834,8250,3187,9406
520050,201909,400,933,251,673,13,34,149,417,162,451
520055,201909,1492,3752,1002,2809,70,190,574,1555,644,1745
520060,201909,1351,3842,986,3153,272,935,243,783,515,1718
520080,201909,1776,4591,1316,3968,246,752,612,2028,858,2780
520082,201909,860,2240,684,1936,69,187,383,1127,452,1314
520085,201909,773,2107,594,1808,118,378,265,764,383,1142
520090,201909,794,1581,547,1306,53,95,429,1065,482,1160
520110,201909,36161,98143,24768,79224,8107,29302,1997,5792,10104,35094
520120,201909,180,424,101,301,14,49,37,107,51,156
520130,201909,3483,8671,2710,7429,515,1458,1189,3285,1704,4743
520140,201909,37506,102184,26054,82207,9670,32968,3323,10843,12993,43811
520145,201909,528,1240,358,990,65,201,189,478,254,679
520150,201909,582,1325,414,1104,75,197,230,634,305,831
520160,201909,762,1743,540,1402,98,234,260,708,358,942
520170,201909,4875,9942,3239,8040,185,514,2474,6002,2659,6516
520180,201909,2006,5590,1647,5049,334,1126,865,2612,1199,3738
520215,201909,1752,4228,1226,3402,301,911,459,1225,760,2136
520235,201909,571,1338,329,954,35,121,129,360,164,481
520250,201909,1422,3702,1024,3064,335,1109,199,604,534,1713
520260,201909,797,1855,483,1327,98,270,197,551,295,821
520280,201909,656,1666,494,1409,107,309,228,689,335,998
520310,201909,1082,2383,676,1776,160,470,254,699,414,1169
520320,201909,1570,4277,1183,3641,142,490,646,1948,788,2438
520330,201909,3644,10038,2619,8322,419,1603,1312,4038,1731,5641
520340,201909,2302,5173,1431,3938,183,467,831,2387,1014,2854
520350,201909,2731,6651,1960,5434,593,1744,758,2086,1351,3830
520355,201909,1718,4738,1219,3728,343,1146,365,1033,708,2179
520357,201909,706,1726,524,1452,39,102,389,1107,428,1209
520360,201909,663,1744,489,1445,154,476,132,426,286,902
520380,201909,1246,3123,720,2148,78,258,367,1028,445,1286
520390,201909,967,2112,548,1583,161,511,170,522,331,1033
520393,201909,500,1207,328,934,43,147,152,389,195,536
520396,201909,745,1980,621,1775,51,174,435,1193,486,1367
520400,201909,1549,3858,1184,3357,164,501,767,2202,931,2703
520410,201909,1836,4092,1058,2918,173,514,461,1213,634,1727
520420,201909,356,819,273,680,30,83,203,476,233,559
520425,201909,1370,3337,825,2373,214,642,251,700,465,1342
520430,201909,2152,4928,1133,3361,221,778,41,111,262,889
520440,201909,2874,6943,1702,4886,418,1310,456,1255,874,2565
520450,201909,11337,27434,7346,21173,2361,7421,1149,3392,3510,10813
520455,201909,634,1759,452,1476,122,437,129,423,251,860
520460,201909,933,2240,734,1977,83,196,569,1570,652,1766
520465,201909,750,1951,595,1729,93,301,388,1077,481,1378
520470,201909,1858,5045,1486,4564,365,1105,742,2443,1107,3548
520480,201909,869,2430,581,1937,191,639,125,452,316,1091
520485,201909,1509,4248,1258,3897,195,623,851,2611,1046,3234
520490,201909,3815,10583,2833,9045,919,2976,1107,3688,2026,6664
520495,201909,1509,3335,1133,2827,52,144,905,2241,957,2385
520500,201909,1252,3327,834,2523,191,631,326,1000,517,1631
520505,201909,696,1601,475,1309,66,185,286,787,352,972
520510,201909,7165,18080,4619,14043,1096,3740,1241,4047,2337,7787
520520,201909,1109,2872,816,2397,198,615,259,765,457,1380
520530,201909,1870,5570,1379,4726,463,1658,405,1524,868,3182
520540,201909,2694,7197,1609,4985,298,982,360,1069,658,2051
520545,201909,869,2301,656,1962,139,400,261,804,400,1204
520547,201909,731,2009,577,1740,157,491,259,780,416,1271
520549,201909,12193,33567,9967,30159,1536,4932,6417,19305,7953,24237
520551,201909,4262,11715,3562,10691,407,1469,2497,7260,2904,8729
520552,201909,794,2074,656,1901,120,342,402,1226,522,1568
520570,201909,530,1194,347,938,92,225,127,384,219,609
520580,201909,2093,4936,1593,4323,113,361,1159,3096,1272,3457
520590,201909,1094,2844,752,2263,222,691,174,534,396,1225
520620,201909,7790,21252,6075,18719,1557,4925,2718,8621,4275,13546
520630,201909,680,1764,422,1297,70,220,91,283,161,503
520640,201909,2309,5733,1744,4757,434,1181,721,2047,1155,3228
520650,201909,829,1988,587,1629,103,283,289,847,392,1130
520660,201909,507,1212,237,722,45,156,59,170,104,326
520670,201909,888,2486,754,2300,70,224,498,1470,568,1694
520680,201909,683,1697,492,1399,83,221,249,733,332,954
520690,201909,337,790,224,625,67,174,68,211,135,385
520710,201909,394,949,270,730,8,19,193,511,201,530
520725,201909,1509,3592,1040,2828,119,359,653,1703,772,2062
520735,201909,706,1752,459,1347,100,280,167,536,267,816
520740,201909,1978,4555,1485,3950,260,652,820,2319,1080,2971
520750,201909,639,1579,446,1265,80,222,217,631,297,853
520753,201909,1280,3424,968,2828,188,582,391,1070,579,1652
520760,201909,1101,2464,967,2295,45,84,864,2092,909,2176
520780,201909,1444,3423,1027,2833,107,312,509,1352,616,1664
520790,201909,3292,7824,2272,6218,277,751,1278,3692,1555,4443
520800,201909,14916,39148,11590,34313,1970,5997,6725,20479,8695,26476
520810,201909,1247,2669,893,2259,159,440,541,1419,700,1859
520815,201909,566,1675,400,1338,74,254,113,393,187,647
520830,201909,1781,3823,1240,3200,47,125,1005,2551,1052,2676
520840,201909,2376,6469,1907,5858,824,2698,519,1710,1343,4408
520850,201909,627,1638,437,1355,156,552,98,314,254,866
520860,201909,5862,15946,4336,13491,1102,3698,1629,5020,2731,8718
520870,201909,93462,219210,61684,171624,15009,45222,20851,56644,35860,101866
520880,201909,6149,17640,4713,15123,1144,3788,1719,5594,2863,9382
520890,201909,3633,8948,2440,7076,530,1648,1039,3033,1569,4681
520910,201909,4439,11299,2768,8332,710,2332,594,1799,1304,4131
520915,201909,651,1795,375,1175,63,209,114,347,177,556
520920,201909,4263,9747,2871,7913,366,1036,1622,4590,1988,5626
520929,201909,689,1614,477,1275,87,210,224,655,311,865
520940,201909,951,2552,738,2248,46,163,545,1623,591,1786
520945,201909,463,1049,374,918,25,59,269,643,294,702
520960,201909,959,2443,752,2098,110,307,485,1331,595,1638
520970,201909,2328,6540,1841,5733,494,1692,486,1600,980,3292
520980,201909,760,1881,549,1579,115,361,215,582,330,943
520990,201909,2903,7900,2324,7131,331,1006,1488,4644,1819,5650
520993,201909,1023,2424,676,1861,85,263,399,1055,484,1318
520995,201909,2187,5605,1632,4841,277,845,660,2005,937,2850
521000,201909,7994,20925,5306,16203,1177,3750,1601,4891,2778,8641
521010,201909,3579,9227,2634,7609,272,793,1534,4386,1806,5179
521015,201909,760,1896,524,1467,48,149,320,846,368,995
521020,201909,2943,7595,1689,5137,493,1609,151,489,644,2098
521030,201909,456,983,302,766,43,89,143,400,186,489
521040,201909,7287,17720,5333,14683,1117,3234,2317,6480,3434,9714
521056,201909,853,2270,662,1992,211,627,199,664,410,1291
521060,201909,931,2443,684,2004,52,152,361,1071,413,1223
521080,201909,1070,2349,531,1476,72,223,224,539,296,762
521090,201909,3126,8346,2081,6339,598,1937,260,837,858,2774
521100,201909,1700,3964,1194,3246,199,538,684,1881,883,2419
521120,201909,4537,10630,3167,8922,211,533,1605,5166,1816,5699
521130,201909,920,2087,535,1447,22,64,291,828,313,892
521140,201909,1185,3046,843,2443,120,364,398,1147,518,1511
521150,201909,11823,26035,7200,19499,1286,4040,3352,9143,4638,13183
521160,201909,587,1241,411,976,46,111,272,623,318,734
521170,201909,1003,2358,719,1923,63,183,490,1277,553,1460
521180,201909,6679,18832,5472,16701,984,3271,2730,8043,3714,11314
521190,201909,9966,25236,5577,17616,1426,4762,1128,3772,2554,8534
521200,201909,706,1750,476,1359,55,160,263,743,318,903
521205,201909,597,1493,450,1256,14,39,332,891,346,930
521210,201909,681,1730,381,1127,99,319,66,149,165,468
521220,201909,3573,8874,2275,6744,496,1652,649,1826,1145,3478
521225,201909,324,725,240,630,34,95,149,382,183,477
521230,201909,1211,3229,1090,3076,380,1078,531,1585,911,2663
521250,201909,28687,78388,22194,68855,8359,27100,6674,22019,15033,49119
521260,201909,561,1311,402,1052,56,153,230,584,286,737
521270,201909,1753,4462,1505,4158,84,218,1162,3228,1246,3446
521280,201909,1759,4757,1301,3979,334,1113,506,1561,840,2674
521290,201909,451,1071,309,887,43,148,182,504,225,652
521295,201909,1023,2249,797,2003,59,135,626,1641,685,1776
521300,201909,1802,4499,1411,3958,272,713,868,2507,1140,3220
521305,201909,677,1651,454,1298,57,156,266,765,323,921
521308,201909,4563,12324,3211,9732,341,1038,1822,5427,2163,6465
521310,201909,7907,20322,5288,15864,1211,3945,2063,5923,3274,9868
521340,201909,406,951,287,771,23,69,202,520,225,589
521350,201909,1970,5092,1486,4349,156,546,1007,2829,1163,3375
521370,201909,1165,3006,690,2165,199,714,95,321,294,1035
521375,201909,1269,3165,859,2559,197,568,278,912,475,1480
521377,201909,1426,3074,1025,2574,72,135,839,2195,911,2330
521380,201909,5902,15825,3816,11879,422,1471,961,3167,1383,4638
521385,201909,613,1479,465,1290,63,167,266,797,329,964
521390,201909,663,1646,459,1333,145,459,161,483,306,942
521400,201909,2435,5645,1861,4945,205,542,1324,3612,1529,4154
521405,201909,1214,3113,891,2573,188,553,403,1160,591,1713
521410,201909,754,2020,575,1721,106,297,296,949,402,1246
521440,201909,1173,2989,822,2436,272,892,234,687,506,1579
521450,201909,3690,11071,2683,9076,693,2397,722,2555,1415,4952
521460,201909,5465,14591,3872,11734,1379,4334,839,2582,2218,6916
521470,201909,617,1682,360,1132,48,142,123,375,171,517
521480,201909,330,822,187,547,34,101,52,135,86,236
521483,201909,2369,5718,1607,4494,371,1104,596,1627,967,2731
521486,201909,1671,3963,1240,3359,72,208,924,2479,996,2687
521487,201909,415,1014,291,837,53,160,135,402,188,562
521490,201909,864,2351,629,1958,41,157,452,1364,493,1521
521500,201909,2049,5155,1495,4244,108,382,1045,2881,1153,3263
521520,201909,702,1628,486,1307,78,227,207,553,285,780
521523,201909,11015,34688,9158,31564,2563,9618,2478,8745,5041,18363
521525,201909,1024,2352,749,1964,74,202,532,1381,606,1583
521530,201909,2235,5796,1266,3787,275,871,312,961,587,1832
521540,201909,806,2037,512,1543,71,251,232,725,303,976
521550,201909,1270,3250,737,2197,143,476,202,632,345,1108
521560,201909,4248,11414,2909,9597,493,1910,1466,5014,1959,6924
521565,201909,604,1471,467,1279,75,195,290,782,365,977
521570,201909,3329,8924,2134,6649,445,1595,246,819,691,2414
521580,201909,493,1198,276,819,40,131,81,203,121,334
521590,201909,601,1452,446,1227,93,281,241,640,334,921
521600,201909,363,997,219,692,39,104,79,251,118,355
521630,201909,1637,3613,973,2611,199,562,333,857,532,1419
521640,201909,1752,4137,1185,3306,266,817,396,1066,662,1883
521645,201909,537,1403,338,1037,80,220,111,347,191,567
521680,201909,1077,3283,814,2748,242,887,111,393,353,1280
521690,201909,498,1279,430,1171,60,179,257,685,317,864
521710,201909,2968,7558,1869,5678,345,1189,431,1245,776,2434
521720,201909,2132,5024,1396,3890,161,495,793,2201,954,2696
521730,201909,3419,9806,2592,8342,785,2852,594,1616,1379,4468
521740,201909,3702,9754,2759,8371,729,2386,989,3136,1718,5522
521760,201909,14165,39478,10937,34447,3058,10590,3902,12685,6960,23275
521770,201909,2824,6889,1854,5252,579,1765,455,1291,1034,3056
521800,201909,5854,16090,4313,13501,1087,3529,1548,5282,2635,8811
521805,201909,485,1164,348,965,120,317,139,398,259,715
521810,201909,620,1474,425,1200,63,178,233,670,296,848
521830,201909,5197,14542,4160,12968,322,1201,2949,9044,3271,10245
521839,201909,642,1617,466,1312,84,263,230,579,314,842
521850,201909,5065,12292,3090,9090,525,1711,293,779,818,2490
521860,201909,1567,4140,1066,3247,179,587,350,1049,529,1636
521870,201909,659,1838,454,1439,99,338,120,337,219,675
521878,201909,620,1592,438,1250,65,217,227,593,292,810
521880,201909,17533,42534,11535,33381,2971,9101,3855,11414,6826,20515
521890,201909,2917,7638,1887,5751,523,1712,323,906,846,2618
521900,201909,1520,3601,893,2652,288,836,143,447,431,1283
521910,201909,1165,2512,739,1987,70,185,428,1209,498,1394
521920,201909,444,1254,320,1023,60,212,139,432,199,644
521925,201909,699,1859,516,1581,91,283,263,792,354,1075
521930,201909,5050,12386,3294,9649,887,2473,1217,3921,2104,6394
521935,201909,950,2308,629,1718,71,205,355,911,426,1116
521940,201909,1212,2740,785,2151,185,555,317,847,502,1402
521945,201909,507,1417,394,1214,88,271,201,637,289,908
521950,201909,720,1758,511,1438,126,373,229,599,355,972
521960,201909,692,1838,446,1351,55,183,236,671,291,854
521970,201909,2456,6158,1991,5601,148,421,1547,4395,1695,4816
521971,201909,709,1688,486,1363,131,360,136,384,267,744
521973,201909,1200,3181,925,2739,48,179,663,1915,711,2094
521975,201909,11411,30315,9405,27514,1477,4538,5973,17482,7450,22020
521980,201909,2475,5869,1882,5075,153,385,1417,3889,1570,4274
521990,201909,1057,2945,829,2547,155,487,378,1174,533,1661
522000,201909,2419,6601,1938,5973,226,684,1310,4151,1536,4835
522005,201909,326,787,241,664,48,124,118,339,166,463
522010,201909,3766,9276,2615,7410,664,2005,843,2355,1507,4360
522015,201909,910,2410,646,1985,159,492,246,774,405,1266
522020,201909,5195,12465,3394,9616,708,2118,1381,3969,2089,6087
522026,201909,637,1812,457,1459,75,253,152,471,227,724
522028,201909,425,1099,304,879,56,168,134,372,190,540
522040,201909,2947,6720,2071,5547,251,728,1378,3607,1629,4335
522045,201909,16249,45640,11831,37586,2901,9891,3148,9678,6049,19569
522050,201909,927,2418,629,1937,161,545,234,681,395,1226
522060,201909,2420,6595,1848,5712,171,535,1115,3566,1286,4101
522068,201909,1754,4611,1375,4143,146,388,1016,3151,1162,3539
522070,201909,595,1491,479,1312,19,61,395,1056,414,1117
522100,201909,640,1679,436,1338,50,164,234,701,284,865
522108,201909,894,2415,704,2127,53,231,555,1600,608,1831
522119,201909,1445,3700,1087,3209,174,538,584,1777,758,2315
522130,201909,363,904,250,748,45,133,137,442,182,575
522140,201909,16024,42984,11226,34460,3018,9916,2886,8501,5904,18417
522145,201909,784,1936,531,1553,133,375,224,670,357,1045
522150,201909,1019,2519,709,2005,197,554,208,617,405,1171
522155,201909,874,2214,669,1895,122,338,397,1138,519,1476
522157,201909,518,1304,435,1187,25,86,338,923,363,1009
522160,201909,5692,14874,3655,11123,1024,3389,288,945,1312,4334
522170,201909,2563,6593,1866,5552,314,969,1015,3025,1329,3994
522180,201909,434,1040,274,771,58,167,28,95,86,262
522185,201909,16655,41946,11884,35355,4964,15828,2642,8550,7606,24378
522190,201909,738,1779,498,1357,101,277,185,502,286,779
522200,201909,1576,4543,1011,3375,207,752,133,398,340,1150
522205,201909,1567,3678,1190,3166,114,330,847,2233,961,2563
522220,201909,1258,3208,921,2679,161,468,468,1397,629,1865
522230,201909,1104,2872,892,2565,209,729,449,1199,658,1928
530010,201909,158948,435674,128976,389379,21307,70253,73147,217275,94454,287528
110001,201910,3793,10750,2495,8251,603,2124,971,3245,1574,5369
110002,201910,11343,30049,7797,23863,2244,7279,2205,6804,4449,14083
110003,201910,612,1809,421,1405,107,388,102,322,209,710
110004,201910,10283,27437,6673,20773,1552,5193,1826,5831,3378,11024
110005,201910,2466,6442,1552,4825,358,1208,428,1428,786,2636
110006,201910,1710,4805,1022,3345,211,774,179,538,390,1312
110007,201910,1319,3367,810,2526,269,896,206,756,475,1652
110008,201910,3202,9103,2323,7729,266,862,1544,5419,1810,6281
110009,201910,4132,11778,2620,8919,636,2252,984,3406,1620,5658
110010,201910,6937,22967,5132,19371,1142,4271,2437,10067,3579,14338
110011,201910,6403,17379,4381,13639,1611,5219,622,2036,2233,7255
110012,201910,14084,35788,8120,25020,2073,6722,789,2639,2862,9361
110013,201910,5136,15097,3717,12186,1585,5420,494,1773,2079,7193
110014,201910,3609,9745,2379,7388,633,2044,876,2686,1509,4730
110015,201910,5032,13283,2798,8789,698,2369,508,1474,1206,3843
110018,201910,3514,8971,1993,6246,412,1469,577,1742,989,3211
110020,201910,71960,175398,49863,144404,11201,33330,20677,64911,31878,98241
110025,201910,4830,11869,3080,8817,679,2091,1334,3797,2013,5888
110026,201910,477,1267,334,1053,91,298,136,447,227,745
110028,201910,6336,16382,3792,11704,1027,3420,569,1739,1596,5159
110029,201910,1393,3402,777,2331,180,549,299,942,479,1491
110030,201910,12415,28984,7579,21849,1651,5499,1723,5275,3374,10774
110032,201910,2896,8384,1832,6081,584,1937,414,1437,998,3374
110033,201910,3513,11235,2718,9712,1004,3672,663,2660,1667,6332
110034,201910,3340,8012,2135,6319,672,2153,777,2420,1449,4573
110037,201910,1568,4757,1188,4055,279,950,557,1953,836,2903
110040,201910,2931,8310,2057,6661,609,2122,588,1820,1197,3942
110045,201910,4948,14419,3706,12129,1009,3561,1336,4385,2345,7946
110050,201910,1729,4805,1201,3849,487,1672,232,762,719,2434
110060,201910,738,2220,505,1700,202,728,74,245,276,973
110070,201910,1634,5199,1216,4248,395,1483,241,761,636,2244
110080,201910,6051,14293,4376,12301,531,1387,3050,9046,3581,10433
110090,201910,533,1440,369,1148,85,294,164,490,249,784
110092,201910,1129,3368,817,2762,140,485,425,1526,565,2011
110094,201910,2740,8234,2042,6915,872,3125,344,1206,1216,4331
110100,201910,1656,4995,1322,4314,351,1200,589,1929,940,3129
110110,201910,1698,4782,1144,3783,379,1316,249,868,628,2184
110120,201910,1238,3705,905,3045,236,837,290,966,526,1803
110130,201910,2536,6545,1599,4838,342,1155,577,1732,919,2887
110140,201910,1964,5936,1335,4613,348,1231,343,1234,691,2465
110143,201910,1285,3522,859,2664,286,872,161,511,447,1383
110145,201910,810,2183,514,1645,129,423,174,579,303,1002
110146,201910,431,1155,300,957,62,188,139,480,201,668
110147,201910,749,1955,448,1338,70,227,172,442,242,669
110148,201910,771,2203,442,1517,107,412,51,173,158,585
110149,201910,2988,8311,2052,6796,749,2554,438,1570,1187,4124
110150,201910,2589,6402,1683,5120,532,1749,463,1637,995,3386
110155,201910,668,2013,489,1595,117,397,171,530,288,927
110160,201910,1439,4537,1031,3608,318,1120,242,894,560,2014
110170,201910,2168,5669,1304,3949,256,808,657,1921,913,2729
110175,201910,1625,4660,1132,3786,208,744,486,1712,694,2456
110180,201910,1327,3721,881,2814,154,500,442,1403,596,1903
120001,201910,3073,9228,2538,8434,416,1432,1617,5508,2033,6940
120005,201910,1947,7490,1761,7216,166,753,1371,5710,1537,6463
120010,201910,5190,15832,4361,14527,466,1509,3113,10687,3579,12196
120013,201910,2156,7803,1949,7535,458,1702,1179,4865,1637,6567
120017,201910,2422,8974,2159,8562,346,1347,1416,6002,1762,7349
120020,201910,14871,59025,13689,56673,1159,5436,10665,44446,11824,49882
120025,201910,3022,8793,2431,8050,410,1343,1646,5619,2056,6962
120030,201910,6506,25715,6064,24894,421,2347,4739,19460,5160,21807
120032,201910,1646,7465,1560,7292,105,686,1279,5871,1384,6557
120033,201910,4041,15031,3786,14573,135,760,3279,12497,3414,13257
120034,201910,2610,9543,2214,8820,117,719,1821,7082,1938,7801
120035,201910,3559,14559,3367,14201,307,1466,2694,11440,3001,12906
120038,201910,2693,8746,2310,8119,546,1997,1224,4381,1770,6378
120039,201910,1998,8702,1860,8392,151,897,1462,6547,1613,7444
120040,201910,42778,137046,36830,127053,5524,20152,22933,80024,28457,100176
120042,201910,3327,12558,3032,11963,146,797,2501,9784,2647,10581
120043,201910,1383,5608,1257,5404,42,248,1134,4891,1176,5139
120045,201910,6048,15930,5264,15046,122,503,4815,13602,4937,14105
120050,201910,9264,33541,8444,32260,433,2261,6972,26649,7405,28910
120060,201910,9612,37108,8824,35901,410,2413,7647,30900,8057,33313
120070,201910,3113,10143,2694,9551,260,940,1916,7064,2176,8004
120080,201910,4201,13854,3749,13133,494,1847,2668,9508,3162,11355
130002,201910,3057,12190,2736,11703,193,884,2315,10021,2508,10905
130006,201910,2385,9004,1957,8210,195,887,1452,6105,1647,6992
130008,201910,2601,9154,2307,8704,74,399,1973,7416,2047,7815
130010,201910,3940,11473,3292,10730,83,274,3019,9938,3102,10212
130014,201910,2968,8986,2292,7836,428,1493,1385,4839,1813,6332
130020,201910,2699,10686,2446,10281,150,882,1954,8157,2104,9039
130030,201910,9863,32329,8968,31263,289,1023,7975,28227,8264,29250
130040,201910,3752,11380,3119,10509,179,637,2558,8693,2737,9330
130050,201910,7613,27781,6360,26159,175,931,5769,23902,5944,24833
130060,201910,7520,29947,6455,28530,478,2709,5271,23159,5749,25868
130063,201910,6293,20674,5617,19918,224,1004,5078,18066,5302,19070
130068,201910,3707,13408,3133,12483,244,1362,2316,9058,2560,10420
130070,201910,7501,21336,6167,19853,308,1000,5150,16982,5458,17982
130080,201910,6783,25356,5945,24357,262,1539,4980,20707,5242,22246
130083,201910,2727,9074,2436,8713,181,756,2056,7354,2237,8110
130090,201910,3400,10625,3015,10128,62,286,2619,8956,2681,9242
130100,201910,7943,23931,6789,22716,61,147,6371,21886,6432,22033
130110,201910,8489,24376,6961,22456,1007,2661,5076,17560,6083,20221
130115,201910,5345,16744,4612,15901,106,376,4079,14285,4185,14661
130120,201910,14234,50666,12627,48537,1128,4832,10284,39804,11412,44636
130130,201910,5208,16911,4030,15365,400,1692,2975,11339,3375,13031
130140,201910,7108,25132,6373,24301,202,1115,5614,21472,5816,22587
130150,201910,3670,13692,3447,13431,86,552,3143,12250,3229,12802
130160,201910,5017,18055,4322,17170,280,1293,3658,14671,3938,15964
130165,201910,3238,12336,3051,12091,129,583,2740,10930,2869,11513
130170,201910,11741,34781,9372,31999,751,2978,7485,25689,8236,28667
130180,201910,4493,14382,4249,14105,44,250,4096,13542,4140,13792
130185,201910,18331,45450,14981,41851,961,1760,12729,37432,13690,39192
130190,201910,18931,62862,15279,57353,1843,7193,10698,41340,12541,48533
130195,201910,2446,8936,2002,8374,73,399,1771,7430,1844,7829
130200,201910,2561,7298,2122,6708,113,450,1746,5474,1859,5924
130210,201910,1285,4880,1151,4722,102,599,916,3656,1018,4255
130220,201910,2287,8043,1998,7649,67,347,1743,6695,1810,7042
130230,201910,4489,18811,3917,17974,263,1609,3322,15213,3585,16822
130240,201910,11981,36132,9716,33078,201,1169,8663,29408,8864,30577
130250,201910,26005,78491,22347,74337,1773,5506,17893,61769,19666,67275
130255,201910,4302,14566,3759,13601,172,800,3036,10984,3208,11784
130260,201910,258769,731240,210673,659970,57878,192722,96777,309831,154655,502553
130270,201910,8704,32035,7350,29886,1130,4616,4954,20914,6084,25530
130280,201910,3522,14218,3229,13891,101,511,2986,13006,3087,13517
130290,201910,13104,44586,11416,42469,685,2785,9649,36536,10334,39321
130300,201910,4706,16535,4268,15919,162,903,3683,13663,3845,14566
130310,201910,6052,20834,5292,19797,320,1481,4411,16485,4731,17966
130320,201910,3471,11233,2919,10536,363,1299,2162,8035,2525,9334
130330,201910,4616,14827,3735,13716,212,957,3195,11702,3407,12659
130340,201910,23189,73851,19981,70133,1489,4767,16617,60259,18106,65026
130350,201910,3912,14378,3531,13883,149,857,3092,12039,3241,12896
130353,201910,7185,19853,5793,18049,866,2605,4019,12997,4885,15602
130356,201910,5083,16517,4259,15197,735,2597,2643,9906,3378,12503
130360,201910,3052,9561,2629,9046,85,309,2395,8254,2480,8563
130370,201910,5666,22262,4968,21279,296,1619,4093,17420,4389,19039
130380,201910,7053,29481,6546,28749,399,2302,5521,23980,5920,26282
130390,201910,5905,24899,5195,23679,581,3090,3730,16997,4311,20087
130395,201910,2316,7412,1977,6843,199,730,1493,5144,1692,5874
130400,201910,2721,8627,2340,8123,95,331,2081,7338,2176,7669
130406,201910,10986,38931,9322,36810,1690,6716,6338,25900,8028,32616
130410,201910,4168,14951,3543,13866,1088,4451,1587,6423,2675,10874
130420,201910,13436,47540,11244,44837,951,4880,8795,35144,9746,40024
130423,201910,4242,13548,3722,12952,179,868,3267,11200,3446,12068
130426,201910,2822,11103,2646,10875,77,427,2432,10029,2509,10456
130430,201910,4177,11963,3626,11220,287,1052,2955,8989,3242,10041
130440,201910,4804,15141,4145,14356,121,512,3798,13237,3919,13749
140002,201910,2204,6577,1907,6201,94,364,1593,5186,1687,5550
140005,201910,3254,9053,2892,8640,145,384,2503,7633,2648,8017
140010,201910,54095,143156,42335,125544,10924,33992,17463,53066,28387,87058
140015,201910,3678,11208,3127,10532,206,695,2725,9313,2931,10008
140017,201910,4049,11785,3531,11124,266,815,2830,9182,3096,9997
140020,201910,5202,15420,4454,14404,256,1097,3596,11526,3852,12623
140023,201910,2406,7227,1964,6605,212,725,1452,4982,1664,5707
140028,201910,2069,5343,1749,4931,103,337,1396,3909,1499,4246
140030,201910,5188,13410,4590,12719,367,754,3924,11271,4291,12025
140040,201910,2471,9870,2265,9575,100,601,2017,8421,2117,9022
140045,201910,2529,9204,2118,8630,351,1260,1450,6336,1801,7596
140047,201910,6114,17536,5125,16080,633,2031,3625,11525,4258,13556
140050,201910,1405,4139,1173,3805,127,421,865,2858,992,3279
140060,201910,1638,4367,1374,3978,123,337,1070,3168,1193,3505
140070,201910,1847,9612,1782,9464,123,829,1476,7751,1599,8580
150010,201910,45397,113287,41103,107769,956,2416,36759,96070,37715,98486
150013,201910,1960,5054,1604,4665,147,309,1247,3846,1394,4155
150020,201910,14287,43112,13266,41764,1235,3144,11103,35980,12338,39124
150030,201910,8623,32567,7849,31604,432,1976,6820,27608,7252,29584
150034,201910,4224,10565,3488,9614,226,566,2913,8194,3139,8760
150040,201910,16440,42457,14394,40188,1307,2107,11865,36088,13172,38195
150050,201910,6928,24405,6340,23600,146,667,5776,21720,5922,22387
150060,201910,21519,59137,17386,52904,2902,9037,10877,33879,13779,42916
150070,201910,6619,25050,5825,24091,221,1127,5193,21697,5414,22824
150080,201910,93801,209824,78380,188867,18851,49494,23893,70370,42744,119864
150085,201910,7405,21810,6723,20982,144,510,6278,19661,6422,20171
150090,201910,9788,36694,9199,35516,657,2703,7426,28808,8083,31511
150095,201910,5559,16553,4877,15680,270,652,4091,13698,4361,14350
150100,201910,2892,10226,2554,9638,202,715,1991,7639,2193,8354
150110,201910,4363,18210,4095,17891,215,1013,3718,16334,3933,17347
150120,201910,7842,24864,7490,24434,270,730,6679,22455,6949,23185
150125,201910,735,2012,545,1748,106,398,314,985,420,1383
150130,201910,22399,65206,19379,60643,3064,8628,13137,43073,16201,51701
150140,201910,242133,565801,204796,513638,31859,77978,119680,313055,151539,391033
150145,201910,4324,13223,3651,12216,913,2749,2059,7566,2972,10315
150150,201910,15784,40960,13813,38428,657,1965,11451,31865,12108,33830
150157,201910,3449,9554,2797,8703,301,983,1976,6384,2277,7367
150160,201910,2975,8959,2765,8634,571,1702,1692,5479,2263,7181
150170,201910,24422,80436,21223,75010,4062,13529,12868,48359,16930,61888
150172,201910,4701,13033,3781,11733,262,758,2866,9163,3128,9921
150175,201910,1595,5075,1335,4571,239,863,778,2678,1017,3541
150178,201910,10448,28528,8653,26416,231,646,7663,23724,7894,24370
150180,201910,21935,78794,20058,76573,1054,3745,17579,68525,18633,72270
150190,201910,6677,22687,6219,22086,290,1278,5422,19152,5712,20430
150195,201910,5182,16788,4928,16402,83,454,4578,15075,4661,15529
150200,201910,5787,17046,5301,16510,63,165,5007,15729,5070,15894
150210,201910,25530,90390,23848,88050,1794,6675,19701,74424,21495,81099
150215,201910,7517,21432,6406,19789,1223,3695,3729,12049,4952,15744
150220,201910,11990,34446,10514,32309,1103,3326,7245,22689,8348,26015
150230,201910,12393,35350,10762,33186,1190,3328,7427,23863,8617,27191
150240,201910,31954,89295,26244,79305,7564,23257,8801,27135,16365,50392
150250,201910,4161,16210,3920,15908,608,2411,2981,12412,3589,14823
150260,201910,2709,8986,2457,8586,179,612,1908,6755,2087,7367
150270,201910,8688,25068,6062,20486,2011,7102,1720,6174,3731,13276
150275,201910,6779,21842,6233,21068,228,915,5430,18241,5658,19156
150276,201910,2272,6136,1940,5738,253,682,1340,4341,1593,5023
150277,201910,5205,13750,4198,12584,326,897,3238,10314,3564,11211
150280,201910,6701,27295,6485,26911,501,2065,5420,22760,5921,24825
150285,201910,3284,11567,2886,10933,246,991,2084,8001,2330,8992
150290,201910,10576,28850,9586,27775,325,714,8654,25683,8979,26397
150293,201910,9374,23330,6984,20141,1077,3091,4149,12617,5226,15708
150295,201910,7865,21110,5615,18080,1952,6832,1847,6619,3799,13451
150300,201910,2354,7101,2107,6778,48,187,1904,6133,1952,6320
150304,201910,4063,12185,3315,10991,610,1921,2016,6976,2626,8897
150307,201910,6097,19704,5636,18955,357,1183,4608,15683,4965,16866
150309,201910,6189,18873,4951,16690,924,3051,2738,9627,3662,12678
150310,201910,7310,28844,6952,28403,225,1268,6159,25362,6384,26630
150320,201910,9398,25684,8567,24504,421,1319,6643,18902,7064,20221
150330,201910,13920,45182,12845,43422,1354,4324,9665,33561,11019,37885
150340,201910,2545,7433,2257,7006,351,1019,1554,4958,1905,5977
150345,201910,7992,23640,7216,22607,429,1409,6153,19367,6582,20776
150350,201910,8910,22848,8169,21880,744,1445,6679,18486,7423,19931
150360,201910,23936,66831,19128,60617,2025,5577,13349,44765,15374,50342
150370,201910,10481,32516,8661,30035,974,2970,6352,23461,7326,26431
150375,201910,3448,14108,3114,13608,254,1227,2586,11398,2840,12625
150380,201910,11025,28393,9072,25798,149,547,7962,22674,8111,23221
150390,201910,7969,32049,7170,30764,1118,4265,5014,22763,6132,27028
150400,201910,6415,23317,6146,22799,276,1107,5337,19851,5613,20958
150405,201910,9224,24504,8100,23133,494,1143,6514,19258,7008,20401
150410,201910,1909,6137,1612,5613,200,631,1059,3771,1259,4402
150420,201910,40436,113414,30866,98935,8853,29690,10342,38378,19195,68068
150430,201910,8414,24759,7681,23790,848,2032,6013,19433,6861,21465
150440,201910,5532,18076,5081,17404,736,2266,3603,12840,4339,15106
150442,201910,25317,61551,20842,55758,2297,6055,14379,39296,16676,45351
150445,201910,6284,19433,5539,18281,211,756,4743,15680,4954,16436
150450,201910,5031,21752,4695,21283,357,1818,4020,18183,4377,20001
150460,201910,8428,27699,7720,26787,258,1060,6597,23664,6855,24724
150470,201910,21536,55826,19178,53133,407,1063,17982,49926,18389,50989
150475,201910,4796,15378,4180,14420,173,658,3460,12057,3633,12715
150480,201910,13575,44329,12181,42216,2254,7178,8023,29616,10277,36794
150490,201910,8261,28816,7637,28029,264,1155,6797,25059,7061,26214
150495,201910,5215,18111,5009,17798,119,607,4562,16093,4681,16700
150497,201910,2909,9271,2334,8244,548,1970,1183,4478,1731,6448
150500,201910,3287,8498,2915,7962,250,601,2279,6259,2529,6860
150503,201910,4726,12417,3252,10430,996,3395,1036,3778,2032,7173
150506,201910,10134,30734,8552,28553,1828,5371,5357,19682,7185,25053
150510,201910,9723,35643,8431,33195,1144,4320,5695,23460,6839,27780
150520,201910,7111,27456,6798,27060,234,1382,6117,24235,6351,25617
150530,201910,12395,42293,10736,39877,1580,4730,7661,30410,9241,35140
150540,201910,4964,13686,4219,12550,207,582,3547,10576,3754,11158
150543,201910,7217,19478,5877,17772,527,1638,4443,13985,4970,15623
150548,201910,10161,31797,9167,30454,304,1127,8053,26830,8357,27957
150549,201910,1984,5975,1706,5592,44,188,1477,4839,1521,5027
150550,201910,19543,57906,16339,52630,3902,12811,7350,25255,11252,38066
150553,201910,25410,75443,20010,65815,6247,21028,6836,24287,13083,45315
150555,201910,1879,5003,1446,4317,133,320,1009,3134,1142,3454
150560,201910,1813,5558,1602,5142,268,833,938,3131,1206,3964
150563,201910,2406,7444,2028,6778,445,1557,1102,3683,1547,5240
150565,201910,4324,13931,3813,13101,112,517,3132,10841,3244,11358
150570,201910,6193,20019,5811,19470,257,1001,5064,16906,5321,17907
150580,201910,10278,41164,9071,39800,643,3261,7384,33381,8027,36642
150590,201910,7900,27598,6865,26330,202,1176,6179,23575,6381,24751
150600,201910,9654,32072,8986,31228,234,900,8276,28940,8510,29840
150610,201910,2843,8455,2543,7962,98,372,2122,6585,2220,6957
150611,201910,3164,9006,2802,8480,90,355,2471,7398,2561,7753
150613,201910,13390,37083,10031,31292,1874,6259,4934,15326,6808,21585
150616,201910,3337,9199,2397,7624,596,1971,985,3095,1581,5066
150618,201910,6829,19971,5498,17883,527,1649,3538,12105,4065,13754
150619,201910,6244,17785,5178,16244,162,620,4322,13585,4484,14205
150620,201910,6581,21796,5651,20235,681,2347,3924,14451,4605,16798
150630,201910,6089,16695,5563,16026,443,1196,4572,13361,5015,14557
150635,201910,4605,12792,3863,11583,534,1537,2508,7717,3042,9254
150640,201910,2204,6488,2012,6257,31,99,1875,5918,1906,6017
150650,201910,11502,32225,10058,29829,3083,8623,4411,14250,7494,22873
150655,201910,5843,16640,5264,15788,214,649,4545,13622,4759,14271
150658,201910,4422,12584,3474,11137,555,1883,2102,7067,2657,8950
150660,201910,5707,16409,5078,15492,464,1336,3561,11110,4025,12446
150670,201910,8295,19411,6479,17339,651,1463,5086,14273,5737,15736
150680,201910,67080,198208,50915,172538,12459,41489,22999,87241,35458,128730
150690,201910,3001,8160,2631,7712,109,258,2334,7007,2443,7265
150700,201910,6162,18290,5508,17442,349,963,4388,14269,4737,15232
150710,201910,3775,12588,3432,12024,264,944,2624,9351,2888,10295
150715,201910,4979,14447,4107,13091,316,980,3229,10440,3545,11420
150720,201910,6803,24495,6319,23699,440,1837,5243,19755,5683,21592
150730,201910,11706,36137,10213,33955,1184,4080,7654,26026,8838,30106
150740,201910,3944,11111,3467,10349,315,815,2613,7956,2928,8771
150745,201910,5096,14500,4071,12972,819,2769,2627,8412,3446,11181
150746,201910,1624,5001,1475,4774,80,262,1210,3920,1290,4182
150747,201910,4763,15399,4201,14433,745,2286,2775,9998,3520,12284
150750,201910,3655,11526,3064,10598,227,831,2349,8321,2576,9152
150760,201910,11928,35074,10843,33639,1555,4416,7657,24477,9212,28893
150770,201910,6298,22801,5969,22410,200,654,5445,21024,5645,21678
150775,201910,890,2554,693,2272,129,469,375,1229,504,1698
150780,201910,4584,13727,4071,13118,135,387,3695,12151,3830,12538
150790,201910,5596,16096,4831,15266,210,521,3968,13688,4178,14209
150795,201910,13457,42508,11888,39960,3115,9897,6616,23748,9731,33645
150796,201910,3724,9292,3235,8701,178,442,2746,7486,2924,7928
150797,201910,3984,12422,3409,11562,142,407,2894,9954,3036,10361
150800,201910,13275,41738,12044,40143,1487,4570,9169,31583,10656,36153
150803,201910,7014,22723,6587,22066,352,1183,5619,18949,5971,20132
150805,201910,3503,10867,2962,10049,245,846,2276,7829,2521,8675
150808,201910,6054,17230,4354,14380,1696,6117,599,2233,2295,8350
150810,201910,20711,55033,15584,48762,3369,10818,7901,26951,11270,37769
150812,201910,5397,15300,4722,14126,441,1390,3465,10172,3906,11562
150815,201910,9299,27804,7825,25967,620,2073,6389,21523,7009,23596
150820,201910,11972,32844,10059,30448,1038,2696,7730,24401,8768,27097
150830,201910,11428,42672,10742,41818,408,1941,9364,37122,9772,39063
150835,201910,2312,7778,1992,7186,368,1314,1102,4015,1470,5329
150840,201910,7349,21132,5796,18526,985,3357,3161,10022,4146,13379
160005,201910,1169,3247,1042,3067,60,219,881,2586,941,2805
160010,201910,2441,6373,2293,6212,20,106,2228,5968,2248,6074
160015,201910,2645,7913,2387,7575,74,252,2184,6948,2258,7200
160020,201910,2022,6643,1786,6336,178,620,1402,5087,1580,5707
160021,201910,1074,4196,986,4082,68,395,803,3252,871,3647
160023,201910,1240,4428,1086,4165,112,388,766,3093,878,3481
160025,201910,1860,5525,1785,5437,10,38,1750,5335,1760,5373
160027,201910,8904,24786,7957,23605,626,1748,6430,19440,7056,21188
160030,201910,68160,195868,54790,177742,11947,36606,29765,105996,41712,142602
160040,201910,5608,19352,5065,18643,86,409,4706,17423,4792,17832
160050,201910,4783,14813,3750,13358,1439,4894,1317,5766,2756,10660
160053,201910,3704,11653,3387,11265,242,706,2819,9652,3061,10358
160055,201910,896,2633,865,2597,29,90,806,2421,835,2511
160060,201910,24167,65516,19718,60372,988,3171,15770,50234,16758,53405
160070,201910,2780,10528,2495,10065,210,829,1955,8149,2165,8978
160080,201910,3290,10586,2976,10220,44,222,2748,9507,2792,9729
170025,201910,608,1628,438,1371,80,251,227,720,307,971
170030,201910,1193,3630,901,3081,149,502,440,1534,589,2036
170035,201910,1455,3790,1038,3107,99,336,617,1853,716,2189
170040,201910,1850,5331,1450,4761,97,387,882,3010,979,3397
170070,201910,1793,4201,1249,3514,78,271,738,2119,816,2390
170100,201910,2438,7019,1994,6275,187,559,1282,4122,1469,4681
170105,201910,715,2095,474,1557,117,343,171,572,288,915
170110,201910,882,2751,672,2343,126,469,284,991,410,1460
170130,201910,1308,3941,918,3186,176,651,440,1565,616,2216
170190,201910,1339,3836,901,3099,313,1094,167,760,480,1854
170200,201910,1859,4560,1135,3324,219,670,379,1119,598,1789
170210,201910,24170,66071,18136,55861,6457,21631,1980,7163,8437,28794
170215,201910,1313,3539,1065,3207,46,190,836,2512,882,2702
170220,201910,5805,18190,4841,16395,1293,4164,2058,7573,3351,11737
170230,201910,1219,3670,902,3033,270,920,173,635,443,1555
170240,201910,2632,7414,1991,6371,147,566,1369,4253,1516,4819
170255,201910,3997,11642,2778,9337,505,1736,1243,4285,1748,6021
170270,201910,965,2335,622,1853,30,87,387,1141,417,1228
170290,201910,2905,8599,2461,8031,110,383,1953,6555,2063,6938
170300,201910,1957,5362,1570,4781,182,568,1047,3236,1229,3804
170305,201910,653,1796,520,1567,64,227,263,770,327,997
170307,201910,919,3177,729,2787,106,441,400,1541,506,1982
170310,201910,1572,3978,1066,3130,171,542,493,1453,664,1995
170320,201910,1026,2651,761,2227,68,212,478,1410,546,1622
170330,201910,910,2803,820,2658,47,215,676,2140,723,2355
170360,201910,482,1317,329,1048,24,77,214,646,238,723
170370,201910,1270,3437,908,2830,292,885,220,808,512,1693
170380,201910,1744,5083,1275,4333,116,455,720,2531,836,2986
170382,201910,532,1602,426,1407,38,170,303,949,341,1119
170384,201910,1572,5665,1273,5061,254,1048,635,2564,889,3612
170386,201910,866,2401,527,1726,78,306,182,554,260,860
170388,201910,606,1728,421,1397,64,244,185,614,249,858
170389,201910,1007,3173,838,2882,41,162,630,2207,671,2369
170390,201910,1677,3891,1222,3326,63,164,978,2739,1041,2903
170410,201910,552,1640,391,1330,22,96,251,847,273,943
170460,201910,371,969,286,826,44,123,173,517,217,640
170510,201910,893,2641,637,2158,41,176,405,1325,446,1501
170550,201910,6479,17454,4640,14390,1218,4075,1083,3625,2301,7700
170555,201910,1346,3736,1030,3232,58,195,544,1759,602,1954
170560,201910,1022,2896,751,2505,66,262,466,1654,532,1916
170600,201910,1304,3507,1048,3130,219,517,594,1939,813,2456
170610,201910,1672,4484,1189,3741,72,254,747,2344,819,2598
170625,201910,421,1159,251,793,38,113,82,258,120,371
170650,201910,1250,3756,961,3255,151,530,515,1812,666,2342
170700,201910,3313,9796,2441,8136,501,1729,1074,3661,1575,5390
170710,201910,1522,4055,1137,3398,156,511,697,2075,853,2586
170720,201910,1767,4478,1381,3903,77,167,1009,2971,1086,3138
170730,201910,1007,2797,742,2356,146,428,350,1187,496,1615
170740,201910,2059,6900,1744,6287,195,755,1212,4349,1407,5104
170755,201910,887,2495,602,1963,53,212,297,921,350,1133
170765,201910,1179,3036,801,2436,157,481,352,1122,509,1603
170770,201910,1780,5227,1454,4712,175,545,952,3168,1127,3713
170820,201910,3308,10081,2662,8863,490,1727,1319,4466,1809,6193
170825,201910,929,2239,745,1978,79,214,530,1400,609,1614
170830,201910,1373,3729,1135,3355,36,114,894,2653,930,2767
170900,201910,2635,8489,2216,7865,188,717,1732,6224,1920,6941
170930,201910,3614,10089,2736,8426,625,2028,959,2930,1584,4958
170950,201910,10928,30372,7306,23700,2128,7797,898,3140,3026,10937
170980,201910,436,1186,346,1040,15,67,249,706,264,773
171050,201910,1584,5093,1369,4698,55,271,1133,3854,1188,4125
171070,201910,1336,3874,1129,3566,290,941,519,1842,809,2783
171090,201910,1038,2576,829,2270,78,211,562,1540,640,1751
171110,201910,562,1524,391,1205,60,195,183,505,243,700
171150,201910,1081,2710,624,1912,71,254,374,1123,445,1377
171180,201910,759,2108,494,1589,76,224,208,678,284,902
171190,201910,1731,5898,1477,5441,245,975,861,3280,1106,4255
171195,201910,803,2619,652,2332,91,386,394,1373,485,1759
171200,201910,522,1496,392,1258,75,258,179,572,254,830
171215,201910,354,1000,279,872,42,147,181,546,223,693
171240,201910,748,2513,605,2225,36,183,403,1464,439,1647
171245,201910,650,1968,494,1626,49,187,298,933,347,1120
171250,201910,1024,2690,730,2238,137,448,354,1093,491,1541
171270,201910,422,1568,327,1349,72,330,128,556,200,886
171280,201910,849,2600,654,2247,69,224,372,1340,441,1564
171320,201910,3985,11288,3056,9639,634,2000,1176,3886,1810,5886
171330,201910,2674,7335,2027,6215,398,1185,975,3082,1373,4267
171360,201910,1389,4058,1097,3626,81,310,794,2663,875,2973
171370,201910,663,1703,507,1473,50,143,344,1019,394,1162
171380,201910,1457,4384,1207,4016,105,322,862,2997,967,3319
171395,201910,946,2651,636,2050,62,231,377,1180,439,1411
171420,201910,1877,5637,1344,4556,238,891,595,2008,833,2899
171430,201910,1027,3077,841,2712,60,223,568,1777,628,2000
171488,201910,2298,6855,1766,5947,300,1038,889,3097,1189,4135
171500,201910,988,2473,744,2093,41,120,557,1564,598,1684
171510,201910,773,2579,669,2370,43,189,465,1636,508,1825
171515,201910,453,1193,314,955,29,111,191,551,220,662
171525,201910,672,1962,517,1696,31,134,305,943,336,1077
171550,201910,330,966,235,798,30,121,137,451,167,572
171570,201910,1100,3367,909,3020,142,474,525,1792,667,2266
171575,201910,1788,4792,1124,3574,137,465,497,1558,634,2023
171610,201910,5673,15981,4161,13338,910,3244,1169,3966,2079,7210
171620,201910,2625,7465,2199,6843,119,468,1751,5429,1870,5897
171630,201910,957,2592,758,2310,109,343,504,1576,613,1919
171650,201910,2053,5937,1542,5016,390,1375,469,1655,859,3030
171660,201910,2305,5895,1549,4605,235,659,802,2429,1037,3088
171665,201910,1304,3663,980,3126,167,612,467,1501,634,2113
171670,201910,1842,4978,1398,4240,217,726,775,2323,992,3049
171700,201910,1210,3489,873,2872,101,311,493,1642,594,1953
171720,201910,793,2052,607,1757,53,188,433,1219,486,1407
171750,201910,1247,3553,853,2830,219,746,108,459,327,1205
171780,201910,1224,3112,868,2594,77,256,602,1758,679,2014
171790,201910,1386,4645,1114,4067,225,835,505,1926,730,2761
171800,201910,723,2003,531,1708,68,266,301,962,369,1228
171820,201910,10914,30884,7966,25700,1981,6613,2554,8802,4535,15415
171830,201910,1478,4878,1233,4418,115,517,784,2779,899,3296
171840,201910,744,1998,582,1735,25,71,394,1178,419,1249
171845,201910,589,1513,423,1263,53,198,253,743,306,941
171850,201910,856,2926,722,2618,71,348,508,1766,579,2114
171855,201910,1013,3098,846,2796,75,255,524,1700,599,1955
171865,201910,374,1194,297,1054,52,205,144,477,196,682
171870,201910,795,2264,554,1805,66,234,287,935,353,1169
171875,201910,1243,3717,992,3304,48,213,749,2469,797,2682
171880,201910,1152,3576,1008,3378,37,134,801,2722,838,2856
171884,201910,813,2309,590,1929,110,414,214,746,324,1160
171886,201910,1404,3921,978,3181,288,1033,190,624,478,1657
171888,201910,720,2048,491,1608,35,136,311,986,346,1122
171889,201910,397,1232,320,1083,77,286,127,423,204,709
171890,201910,1115,3097,821,2629,187,557,444,1486,631,2043
171900,201910,527,1834,363,1406,78,296,146,587,224,883
172000,201910,554,1698,459,1515,44,158,263,843,307,1001
172010,201910,1035,3616,869,3263,82,347,513,1876,595,2223
172015,201910,365,1300,268,1093,67,278,107,463,174,741
172020,201910,2530,7419,2237,7023,157,579,1681,5388,1838,5967
172025,201910,723,2003,522,1668,38,144,361,1151,399,1295
172030,201910,1223,3638,1035,3339,48,194,808,2594,856,2788
172049,201910,1278,3116,845,2493,171,482,466,1472,637,1954
172065,201910,1447,3609,1113,3195,104,220,891,2727,995,2947
172080,201910,2310,6852,1855,6034,104,403,1226,3954,1330,4357
172085,201910,461,1271,298,917,57,165,106,311,163,476
172090,201910,3934,10039,3000,8803,131,437,2273,6682,2404,7119
172093,201910,462,1365,325,1120,26,115,179,588,205,703
172097,201910,624,1655,436,1329,55,170,211,652,266,822
172100,201910,48025,119724,32407,94315,6137,19804,11077,33030,17214,52834
172110,201910,1580,5761,1352,5389,149,603,971,4083,1120,4686
172120,201910,4883,14489,3804,12739,504,1756,2144,7418,2648,9174
172125,201910,302,830,223,700,21,67,117,362,138,429
172130,201910,640,1591,506,1377,23,84,356,898,379,982
172208,201910,2468,6188,1972,5532,179,446,1413,4063,1592,4509
172210,201910,2656,6917,2011,6083,377,1196,1095,3433,1472,4629
210005,201910,18955,54898,14461,47387,4311,14700,5438,18651,9749,33351
210010,201910,1930,5977,1740,5725,71,319,1501,4943,1572,5262
210015,201910,3292,9912,2934,9438,112,326,2554,8309,2666,8635
210020,201910,7452,17297,6396,16066,84,250,5936,14928,6020,15178
210030,201910,4773,15808,4437,15317,205,930,3822,13142,4027,14072
210040,201910,1816,4375,1638,4159,27,47,1531,3928,1558,3975
210043,201910,6278,17832,5220,16415,492,1481,3903,12596,4395,14077
210047,201910,6701,20936,5454,19221,157,790,4695,16494,4852,17284
210050,201910,2231,7582,1735,6658,170,755,1208,4608,1378,5363
210055,201910,1855,5999,1674,5711,68,278,1413,4809,1481,5087
210060,201910,7108,26295,6304,24816,747,3084,4407,17796,5154,20880
210070,201910,7163,20366,6733,19808,41,170,6413,18876,6454,19046
210080,201910,4087,14069,3887,13830,41,247,3656,13075,3697,13322
210083,201910,5618,15969,4611,14894,47,246,4358,14064,4405,14310
210087,201910,3041,8303,2642,7787,111,266,2270,6851,2381,7117
210090,201910,9339,29269,8678,28094,495,1395,7379,24095,7874,25490
210095,201910,6280,20476,5786,19881,213,929,4929,17342,5142,18271
210100,201910,6775,20687,6074,19574,320,1119,4959,16025,5279,17144
210110,201910,3032,10264,2802,9979,65,406,2560,9017,2625,9423
210120,201910,22697,62801,18827,57676,2063,5297,12709,41318,14772,46615
210125,201910,4325,11740,3784,11083,791,1825,2677,8442,3468,10267
210130,201910,4331,11519,3566,10542,168,386,3022,9036,3190,9422
210135,201910,1467,4441,1263,4111,65,204,1017,3358,1082,3562
210140,201910,17932,48263,13767,42812,2658,8105,7726,25182,10384,33287
210150,201910,4382,10589,3861,9863,129,360,3361,8463,3490,8823
210160,201910,16365,48388,14186,45548,1294,4386,10087,33402,11381,37788
210170,201910,14959,47050,13931,45702,722,2285,12253,40351,12975,42636
210173,201910,2293,8699,2104,8350,65,405,1865,7399,1930,7804
210177,201910,3423,9384,3004,8878,112,197,2693,8244,2805,8441
210180,201910,1426,3886,1254,3666,30,89,1138,3317,1168,3406
210190,201910,5180,14455,4441,13383,79,386,3813,11269,3892,11655
210193,201910,1271,3760,1125,3532,35,144,891,2841,926,2985
210197,201910,2042,6522,1882,6291,153,525,1532,5200,1685,5725
210200,201910,7507,24425,6725,23121,485,1820,5379,18515,5864,20335
210203,201910,6899,20684,5964,19420,444,1502,4838,15996,5282,17498
210207,201910,3671,9453,2968,8669,137,329,2474,7406,2611,7735
210210,201910,8169,26564,7506,25654,128,778,6809,23141,6937,23919
210215,201910,2268,7474,2044,7144,51,269,1828,6376,1879,6645
210220,201910,6177,21275,5851,20766,193,1238,5114,17718,5307,18956
210230,201910,5209,15839,4684,15053,376,997,3927,12892,4303,13889
210232,201910,11329,35762,9297,32710,1565,5541,5807,21774,7372,27315
210235,201910,3357,10041,2931,9465,68,312,2597,8384,2665,8696
210237,201910,2683,9020,2356,8626,34,206,2185,7989,2219,8195
210240,201910,2609,8283,2386,7885,82,343,2071,6756,2153,7099
210250,201910,5587,17114,5084,16479,74,423,4566,14770,4640,15193
210255,201910,2454,7605,2070,6896,306,1027,1292,4279,1598,5306
210260,201910,5480,16442,4813,15458,228,845,4132,13229,4360,14074
210270,201910,4735,13238,4238,12603,107,496,3769,11112,3876,11608
210275,201910,3569,9001,3144,8482,49,111,2875,7838,2924,7949
210280,201910,5475,15814,4371,14063,276,1143,3134,9914,3410,11057
210290,201910,7167,19542,6421,18598,135,417,5881,17035,6016,17452
210300,201910,32802,89412,26824,80985,1800,5684,19784,61635,21584,67319
210310,201910,3049,7891,2678,7341,126,293,2327,6419,2453,6712
210312,201910,2692,6974,2362,6602,42,183,2181,6018,2223,6201
210315,201910,2940,8265,2494,7758,62,169,2278,7228,2340,7397
210317,201910,4119,13081,3734,12625,114,612,3344,11218,3458,11830
210320,201910,18935,57842,17256,55627,436,2168,15255,48782,15691,50950
210325,201910,3515,10165,3044,9556,81,262,2730,8695,2811,8957
210330,201910,24074,69164,19830,63456,5962,17319,9427,34811,15389,52130
210340,201910,9997,29801,8913,28276,723,2295,6838,22237,7561,24532
210350,201910,9309,26959,8130,25499,160,577,7198,22691,7358,23268
210355,201910,4264,14465,3749,13656,101,512,3201,11736,3302,12248
210360,201910,13376,42073,11958,39974,587,2677,9317,30653,9904,33330
210370,201910,10711,24210,8316,21663,241,446,7609,20253,7850,20699
210375,201910,3293,8757,2454,7638,644,2032,1142,3912,1786,5944
210380,201910,5494,14228,4751,13336,225,557,4063,11482,4288,12039
210390,201910,2515,9061,2337,8736,135,640,1933,7192,2068,7832
210400,201910,4475,13785,3949,13123,148,483,3505,11801,3653,12284
210405,201910,6894,18735,5519,16754,1052,2982,3101,10017,4153,12999
210407,201910,1962,6540,1630,5916,88,396,1308,4679,1396,5075
210408,201910,2478,9374,2314,9115,146,718,1871,7379,2017,8097
210409,201910,3781,13116,3445,12640,105,614,2857,10495,2962,11109
210410,201910,3395,10426,2861,9543,168,653,2147,7127,2315,7780
210420,201910,3895,12438,3504,11765,208,598,2943,10012,3151,10610
210430,201910,2253,6607,2020,6315,83,238,1786,5624,1869,5862
210440,201910,4265,11723,3781,11083,69,264,3483,10141,3552,10405
210450,201910,2430,7214,2090,6692,93,315,1720,5494,1813,5809
210455,201910,4256,11275,3195,9926,948,2974,1509,4901,2457,7875
210460,201910,3634,10502,3099,9805,79,340,2712,8516,2791,8856
210462,201910,1589,4918,1357,4529,37,160,1102,3673,1139,3833
210465,201910,2618,7716,2284,7243,55,225,1990,6302,2045,6527
210467,201910,5721,18682,5087,17850,309,1266,4249,15015,4558,16281
210470,201910,2078,5417,1417,4473,79,181,1083,3556,1162,3737
210480,201910,16159,47724,13353,44257,1200,3609,9834,34860,11034,38469
210490,201910,3707,9391,2980,8363,68,200,2586,7266,2654,7466
210500,201910,6211,24191,5739,23352,373,1840,4693,18963,5066,20803
210510,201910,5999,19929,5277,19132,119,536,4715,17363,4834,17899
210515,201910,3713,10896,3232,10361,108,386,2830,9181,2938,9567
210520,201910,2531,7279,2267,6945,77,278,1994,6054,2071,6332
210530,201910,52815,128075,40836,110361,6589,22337,11161,38581,17750,60918
210535,201910,3082,10509,2862,10166,121,465,2405,8630,2526,9095
210540,201910,14495,42208,12066,38811,1412,4263,8515,28487,9927,32750
210542,201910,6452,15143,5201,13761,315,538,4336,12211,4651,12749
210545,201910,2202,6907,2073,6690,46,196,1822,5798,1868,5994
210547,201910,3507,12724,3076,11859,313,1190,2216,8808,2529,9998
210550,201910,6195,18684,4903,16675,329,1290,3638,12639,3967,13929
210560,201910,3509,10789,3142,10195,126,415,2625,8475,2751,8890
210565,201910,1456,4850,1208,4475,61,333,952,3544,1013,3877
210570,201910,10522,28757,9318,27295,300,890,8265,24557,8565,25447
210580,201910,2918,7944,2470,7404,166,322,2002,6307,2168,6629
210590,201910,4270,12845,3714,12115,76,410,3296,10700,3372,11110
210592,201910,2583,7677,2382,7338,27,134,2129,6491,2156,6625
210594,201910,2510,6784,1915,5857,94,265,1418,4487,1512,4752
210596,201910,2499,8961,2230,8412,124,528,1785,6775,1909,7303
210598,201910,1840,5380,1684,5144,35,153,1516,4586,1551,4739
210600,201910,3041,8119,2433,7251,87,214,1975,6010,2062,6224
210610,201910,2625,7522,2278,7097,61,301,1949,6030,2010,6331
210620,201910,2677,7333,2236,6800,51,150,2042,6321,2093,6471
210630,201910,3031,10242,2758,9804,122,620,2281,7979,2403,8599
210632,201910,4376,14254,3886,13533,232,1030,3063,10566,3295,11596
210635,201910,1762,6255,1653,6065,127,443,1352,5073,1479,5516
210637,201910,2334,7867,2052,7447,153,673,1536,5636,1689,6309
210640,201910,4640,16600,4392,16303,62,308,4138,15350,4200,15658
210650,201910,7392,21136,6716,20258,61,299,6241,18843,6302,19142
210660,201910,8173,24243,7207,22687,264,1042,6232,19370,6496,20412
210663,201910,2544,7538,2349,7306,127,323,2030,6463,2157,6786
210667,201910,1879,6186,1743,5988,42,170,1578,5467,1620,5637
210670,201910,4437,15189,4054,14587,127,637,3517,12567,3644,13204
210675,201910,5049,13758,4334,12813,208,507,3639,10993,3847,11500
210680,201910,4281,10830,3604,9992,118,207,3225,9146,3343,9353
210690,201910,7657,23702,6562,22466,251,1157,5764,19796,6015,20953
210700,201910,2679,7434,2143,6703,139,408,1629,5296,1768,5704
210710,201910,4955,15571,4345,14698,112,605,3804,12739,3916,13344
210720,201910,2870,9508,2610,9183,57,342,2348,8187,2405,8529
210725,201910,1328,4483,1138,4180,46,196,816,3116,862,3312
210730,201910,1179,3163,985,2892,55,149,812,2391,867,2540
210735,201910,4630,13731,3933,12784,201,650,3350,11115,3551,11765
210740,201910,5165,13993,4513,13260,108,377,3767,11025,3875,11402
210745,201910,4397,12032,4055,11576,118,347,3695,10534,3813,10881
210750,201910,22642,57872,19638,54117,1557,4079,13885,40207,15442,44286
210760,201910,5895,15660,5039,14741,30,72,4797,14150,4827,14222
210770,201910,6116,15799,5273,14830,51,229,4948,13839,4999,14068
210780,201910,7149,23015,6305,21598,546,1725,4923,17198,5469,18923
210790,201910,4370,13685,3932,13089,219,590,3154,11129,3373,11719
210800,201910,4898,12997,4177,12034,63,251,3782,10768,3845,11019
210805,201910,3910,14356,3740,14105,112,633,3329,12437,3441,13070
210810,201910,4889,14255,4450,13688,245,534,3789,11996,4034,12530
210820,201910,6889,19673,5742,17824,693,2225,3481,11117,4174,13342
210825,201910,6733,20880,6104,20045,245,840,5297,17585,5542,18425
210830,201910,7663,21764,7045,20993,407,929,6063,18557,6470,19486
210840,201910,3218,8570,2865,8080,63,220,2544,7052,2607,7272
210845,201910,6484,17618,5838,16907,22,82,5654,16418,5676,16500
210850,201910,5842,20059,4927,18660,254,1252,3860,14668,4114,15920
210860,201910,20735,53949,17301,49602,773,1984,14017,42109,14790,44093
210870,201910,7107,18891,5746,17315,204,601,5020,15199,5224,15800
210880,201910,4312,13271,3903,12791,189,717,3229,10597,3418,11314
210890,201910,3948,11677,3534,11186,234,611,2896,9467,3130,10078
210900,201910,4419,13014,3348,11006,1350,4735,527,1943,1877,6678
210905,201910,1962,5467,1639,5038,44,76,1497,4708,1541,4784
210910,201910,7168,21748,5994,19865,858,2892,3869,12929,4727,15821
210920,201910,3250,10693,2815,10109,77,449,2515,8936,2592,9385
210923,201910,1432,4441,1247,4127,55,202,943,3130,998,3332
210927,201910,5259,16541,4602,15776,201,730,3898,13593,4099,14323
210930,201910,2456,8493,2165,7933,171,718,1625,5911,1796,6629
210940,201910,4025,11411,3751,11081,111,447,3433,10014,3544,10461
210945,201910,6186,18131,5572,17393,231,701,4753,15104,4984,15805
210950,201910,5096,14454,3910,12770,595,1566,2588,9134,3183,10700
210955,201910,1550,4955,1336,4578,136,474,950,3316,1086,3790
210960,201910,8871,26710,7645,24866,1263,3799,4871,16647,6134,20446
210970,201910,1272,3941,1012,3495,51,217,791,2661,842,2878
210975,201910,1660,5321,1485,5039,79,286,1182,4014,1261,4300
210980,201910,9998,23022,8693,21673,97,217,8208,20567,8305,20784
210990,201910,15627,44805,12381,40487,736,2676,9393,31177,10129,33853
211000,201910,14319,42477,12011,39712,636,2362,9775,33229,10411,35591
211003,201910,5551,16748,4665,15669,130,521,4043,13859,4173,14380
211010,201910,6449,23315,5823,22527,95,499,5273,20679,5368,21178
211020,201910,8067,23873,7090,22723,230,943,6055,19712,6285,20655
211023,201910,1942,6453,1843,6317,89,362,1563,5309,1652,5671
211027,201910,2950,9563,2828,9362,162,523,2472,8140,2634,8663
211030,201910,3902,10825,3472,10297,256,581,2811,8602,3067,9183
211040,201910,4541,16487,4220,15915,123,727,3747,14006,3870,14733
211050,201910,9101,23592,8261,22510,124,376,7622,20759,7746,21135
211060,201910,6905,21008,6323,20231,135,549,5813,18590,5948,19139
211065,201910,2139,6048,1769,5570,81,257,1463,4715,1544,4972
211070,201910,7262,23663,6254,22095,498,1802,4899,17481,5397,19283
211080,201910,1257,3531,996,3119,33,177,759,2234,792,2411
211085,201910,1989,5743,1703,5353,72,173,1494,4815,1566,4988
211090,201910,3173,8807,2849,8400,38,189,2630,7694,2668,7883
211100,201910,6723,17116,6205,16477,41,129,5713,15237,5754,15366
211102,201910,2950,10304,2719,9963,128,619,2365,8566,2493,9185
211105,201910,2330,7468,1941,6734,185,658,1377,4755,1562,5413
211107,201910,4515,14432,3849,13433,144,650,3150,11215,3294,11865
211110,201910,5857,16211,4515,14146,390,1154,3297,10539,3687,11693
211120,201910,43180,107654,36682,100144,4902,12392,23630,68911,28532,81303
211125,201910,2077,6139,1739,5618,40,164,1462,4734,1502,4898
211130,201910,193036,461209,170157,431563,24718,62096,75281,218370,99999,280466
211140,201910,4911,14715,4312,13908,203,616,3663,11862,3866,12478
211150,201910,9294,25541,7889,23688,341,988,6641,20050,6982,21038
211153,201910,2479,7278,1981,6662,284,1019,1294,4564,1578,5583
211157,201910,1068,3426,887,3102,33,172,652,2247,685,2419
211160,201910,3955,11406,3134,10183,160,622,2337,7487,2497,8109
211163,201910,1674,5279,1532,5077,26,136,1379,4621,1405,4757
211167,201910,1536,4913,1437,4751,29,141,1324,4341,1353,4482
211170,201910,6398,15781,5970,15290,43,148,5689,14504,5732,14652
211172,201910,2410,6652,2062,6124,99,322,1685,4847,1784,5169
211174,201910,2834,8264,2573,7965,48,247,2368,7287,2416,7534
211176,201910,4239,12159,3260,10709,162,677,2589,8471,2751,9148
211178,201910,4655,10863,3977,10120,38,167,3760,9471,3798,9638
211180,201910,3908,13071,3626,12646,198,768,3089,10779,3287,11547
211190,201910,3017,8998,2570,8315,32,182,2238,7173,2270,7355
211195,201910,1323,3834,1133,3543,46,117,965,3079,1011,3196
211200,201910,2050,5931,1643,5397,206,661,1150,3858,1356,4519
211210,201910,6331,19297,5729,18495,265,1056,4939,15835,5204,16891
211220,201910,35821,91277,29223,83145,2730,7466,21606,62985,24336,70451
211223,201910,5065,13520,4257,12426,395,1161,3178,9311,3573,10472
211227,201910,1733,5818,1565,5574,36,174,1394,5032,1430,5206
211230,201910,7249,21507,6358,20125,398,1141,5111,16443,5509,17584
211240,201910,8134,25954,7678,25357,150,807,7089,23139,7239,23946
211245,201910,6850,17484,6207,16820,73,207,6011,16299,6084,16506
211250,201910,13163,40775,11880,39116,565,2334,9899,32234,10464,34568
211260,201910,7803,25587,7052,24558,201,910,6357,22212,6558,23122
211270,201910,10439,33383,8964,31347,384,1766,7322,25694,7706,27460
211280,201910,12573,35151,11154,33372,944,2303,8899,27770,9843,30073
211285,201910,1727,5777,1509,5458,167,670,1014,3764,1181,4434
211290,201910,7358,22336,6679,21399,179,753,5780,18399,5959,19152
211300,201910,7899,22407,7023,21196,166,581,6232,18702,6398,19283
211400,201910,11263,32553,9190,29640,1084,3493,6192,20901,7276,24394
220005,201910,1806,4829,1637,4584,38,153,1378,3781,1416,3934
220010,201910,1471,4213,1215,3756,30,122,931,2853,961,2975
220020,201910,3444,9835,2989,9155,168,604,2411,7282,2579,7886
220025,201910,2228,5097,1894,4587,24,67,1581,3702,1605,3769
220027,201910,1234,3171,1064,2951,19,64,903,2450,922,2514
220030,201910,3248,8353,3040,8063,80,249,2683,7006,2763,7255
220040,201910,6942,21138,6094,19494,1377,4078,3341,11192,4718,15270
220045,201910,1453,4484,1200,4044,38,194,963,3185,1001,3379
220050,201910,4616,12772,3915,11808,75,372,3562,10571,3637,10943
220060,201910,2408,5076,2029,4637,26,63,1913,4348,1939,4411
220070,201910,2491,6308,2120,5772,75,160,1743,4748,1818,4908
220080,201910,692,1967,589,1817,28,115,508,1529,536,1644
220090,201910,1781,4305,1474,3877,20,69,1218,3323,1238,3392
220095,201910,636,1632,604,1598,23,35,548,1462,571,1497
220100,201910,1363,3765,1092,3325,49,177,869,2575,918,2752
220105,201910,1970,6182,1717,5672,141,488,1266,4196,1407,4684
220110,201910,3385,9356,3153,8934,44,219,2819,7860,2863,8079
220115,201910,2635,7754,2428,7457,64,252,2207,6691,2271,6943
220117,201910,1352,3277,1039,2834,14,62,872,2327,886,2389
220120,201910,12582,34192,11483,32782,88,317,10812,30811,10900,31128
220130,201910,1083,2966,909,2722,18,96,814,2396,832,2492
220140,201910,2032,4307,1733,3947,120,318,1488,3311,1608,3629
220150,201910,6322,18881,5834,18080,129,648,4917,14893,5046,15541
220155,201910,1119,3262,889,2832,27,104,638,1993,665,2097
220157,201910,1038,2559,880,2314,19,82,713,1800,732,1882
220160,201910,2763,7760,2378,7069,34,168,1979,5768,2013,5936
220170,201910,1528,4051,1276,3674,11,60,1148,3260,1159,3320
220173,201910,2071,5817,1594,4935,40,178,1320,3958,1360,4136
220177,201910,1971,5625,1869,5506,11,39,1838,5419,1849,5458
220180,201910,1105,2748,893,2379,3,15,694,1726,697,1741
220190,201910,6567,16887,5492,15389,363,1149,4153,11626,4516,12775
220191,201910,1441,4497,1313,4267,70,268,973,3060,1043,3328
220192,201910,1847,4989,1429,4239,32,116,1169,3398,1201,3514
220194,201910,1675,4836,1483,4508,63,243,1206,3592,1269,3835
220196,201910,1923,5086,1734,4788,28,127,1479,3991,1507,4118
220198,201910,1279,3539,1068,3267,8,34,983,3034,991,3068
220200,201910,5073,14655,4384,13747,143,551,3685,11550,3828,12101
220202,201910,2151,6064,1841,5555,32,161,1578,4673,1610,4834
220205,201910,2505,7138,2226,6659,51,226,1879,5502,1930,5728
220207,201910,772,2319,633,2079,64,229,398,1308,462,1537
220208,201910,1643,5124,1338,4513,172,625,766,2533,938,3158
220209,201910,1577,4504,1361,4138,28,124,1099,3301,1127,3425
220210,201910,1634,4112,1387,3722,22,84,1170,3077,1192,3161
220211,201910,1569,4074,1448,3906,20,76,1261,3420,1281,3496
220213,201910,1746,4695,1495,4231,31,117,1215,3333,1246,3450
220217,201910,2064,6264,1949,6141,29,89,1827,5814,1856,5903
220220,201910,10241,26925,8388,24026,506,1320,5860,17390,6366,18710
220225,201910,1043,2731,840,2474,8,43,771,2239,779,2282
220230,201910,5749,14184,4912,13029,179,440,4210,11196,4389,11636
220240,201910,2871,8451,2619,7995,108,352,2122,6486,2230,6838
220245,201910,1663,4033,1296,3571,10,53,1179,3273,1189,3326
220250,201910,2992,8339,2619,7859,19,106,2434,7259,2453,7365
220253,201910,1596,4360,1379,3985,73,245,1139,3183,1212,3428
220255,201910,1842,4487,1541,4037,40,183,1294,3242,1334,3425
220260,201910,4257,13125,3692,12115,170,649,2954,9654,3124,10303
220265,201910,1231,4002,1106,3812,40,185,927,3121,967,3306
220270,201910,6305,19827,5887,19060,216,1029,4929,15400,5145,16429
220271,201910,1461,3750,1263,3476,28,103,1116,3060,1144,3163
220272,201910,1755,5035,1553,4663,72,227,1148,3349,1220,3576
220273,201910,1208,3464,998,3074,42,168,763,2300,805,2468
220275,201910,2273,5464,1753,4732,34,115,1536,4152,1570,4267
220277,201910,2116,5375,1812,4910,30,95,1539,4073,1569,4168
220280,201910,1619,3841,1330,3448,30,110,1139,2899,1169,3009
220285,201910,1426,3632,1200,3360,13,60,1090,3015,1103,3075
220290,201910,6169,17845,4849,15963,347,1274,3550,11892,3897,13166
220300,201910,1951,5692,1575,5188,40,245,1304,4210,1344,4455
220310,201910,3037,8168,2342,7345,41,200,1957,6096,1998,6296
220320,201910,2996,8873,2297,7537,99,445,1762,5594,1861,6039
220323,201910,1611,4755,1273,4197,59,242,1048,3395,1107,3637
220325,201910,1259,3717,1066,3389,26,134,875,2722,901,2856
220327,201910,1468,4204,1280,3889,55,232,1056,3115,1111,3347
220330,201910,4312,10457,3577,9552,68,207,3194,8455,3262,8662
220335,201910,1703,5099,1512,4861,29,109,1364,4374,1393,4483
220340,201910,1831,4829,1407,4125,55,189,969,2733,1024,2922
220342,201910,1129,3348,997,3143,45,212,785,2426,830,2638
220345,201910,3092,6995,2403,6005,15,54,2177,5404,2192,5458
220350,201910,3298,8489,2632,7473,138,423,1871,5290,2009,5713
220360,201910,1211,3105,951,2676,18,63,773,2150,791,2213
220370,201910,8668,24995,7832,23655,178,781,6862,20406,7040,21187
220375,201910,1584,4520,1406,4303,7,31,1331,4096,1338,4127
220380,201910,1501,3572,1201,3135,13,39,1054,2708,1067,2747
220385,201910,831,1985,661,1676,10,29,575,1442,585,1471
220390,201910,9578,25335,7300,21704,1891,5497,2851,9290,4742,14787
220400,201910,1480,3540,1117,2990,22,60,864,2258,886,2318
220410,201910,1150,3169,914,2761,54,164,738,2186,792,2350
220415,201910,801,2065,669,1847,19,56,535,1455,554,1511
220420,201910,1957,5403,1565,4662,47,137,1220,3581,1267,3718
220430,201910,2480,6716,2337,6508,82,269,2008,5516,2090,5785
220435,201910,1719,4454,1469,4087,44,154,1201,3267,1245,3421
220440,201910,2372,7482,2042,6950,113,478,1682,5606,1795,6084
220450,201910,2455,6395,1988,5809,76,269,1665,4873,1741,5142
220455,201910,1322,4047,1250,3951,20,95,1109,3489,1129,3584
220460,201910,945,2338,875,2253,26,77,761,1929,787,2006
220465,201910,2321,7216,2047,6781,179,605,1515,5100,1694,5705
220470,201910,3432,9565,3046,8950,83,234,2472,7166,2555,7400
220480,201910,2598,6827,2067,5947,163,419,1426,4082,1589,4501
220490,201910,2435,6192,2104,5756,28,142,1848,4969,1876,5111
220500,201910,2607,6875,2346,6459,45,177,1951,5175,1996,5352
220510,201910,2529,7165,1977,6168,84,257,1549,4841,1633,5098
220515,201910,1624,3934,1477,3726,33,62,1296,3253,1329,3315
220520,201910,4882,12709,4388,11999,102,296,3834,10412,3936,10708
220525,201910,1272,3235,1102,3015,11,54,1009,2720,1020,2774
220527,201910,1323,3697,1129,3410,14,53,967,2974,981,3027
220530,201910,1406,3516,1202,3251,33,110,1108,2950,1141,3060
220535,201910,788,2217,732,2143,38,134,591,1700,629,1834
220540,201910,3218,10290,3030,9939,117,428,2568,8366,2685,8794
220545,201910,1357,4167,1251,3994,67,268,1035,3252,1102,3520
220550,201910,8466,25944,7512,24356,493,1740,5670,18207,6163,19947
220551,201910,1391,3989,1207,3665,27,119,991,2946,1018,3065
220552,201910,1575,4569,1279,4033,37,181,1013,3070,1050,3251
220553,201910,1630,4366,1389,4028,52,119,1120,3337,1172,3456
220554,201910,861,2297,620,1883,51,121,400,1220,451,1341
220555,201910,2199,6662,1986,6355,47,224,1623,5282,1670,5506
220556,201910,1196,3496,1029,3152,63,258,724,2102,787,2360
220557,201910,1598,4888,1343,4371,67,255,981,3096,1048,3351
220558,201910,1387,3590,1073,3149,22,90,925,2683,947,2773
220559,201910,1650,4233,1394,3833,6,23,1120,3109,1126,3132
220560,201910,1751,3946,1400,3492,33,67,1267,3177,1300,3244
220570,201910,7156,21377,6487,20433,449,1454,5125,16191,5574,17645
220580,201910,6906,19038,6325,18085,89,323,5717,16203,5806,16526
220585,201910,1978,6276,1680,5731,47,163,1373,4716,1420,4879
220590,201910,1310,3600,1070,3231,80,244,768,2312,848,2556
220595,201910,2487,6800,2241,6465,23,104,2008,5736,2031,5840
220600,201910,1378,3078,1148,2782,97,131,950,2381,1047,2512
220605,201910,1625,4713,1370,4258,21,125,1101,3317,1122,3442
220610,201910,2710,8030,2541,7796,28,124,2370,7258,2398,7382
220620,201910,7906,24428,7248,23540,203,1043,6546,20947,6749,21990
220630,201910,358,1067,271,903,25,85,173,585,198,670
220635,201910,1595,5094,1409,4686,51,247,1061,3425,1112,3672
220640,201910,2503,6868,2120,6302,83,325,1713,5013,1796,5338
220650,201910,2026,5583,1728,5104,30,110,1404,4132,1434,4242
220660,201910,2642,8234,2253,7566,94,473,1845,6025,1939,6498
220665,201910,1234,3757,1041,3431,35,186,847,2717,882,2903
220667,201910,1585,4981,1412,4650,65,263,1138,3711,1203,3974
220669,201910,1652,5026,1579,4909,62,285,1365,4142,1427,4427
220670,201910,2188,5733,1726,5071,22,91,1487,4353,1509,4444
220672,201910,3185,7828,2558,7074,118,365,2223,6094,2341,6459
220675,201910,1202,3301,1088,3095,40,121,893,2519,933,2640
220680,201910,2650,7286,2520,7094,101,238,2297,6498,2398,6736
220690,201910,1508,4026,1333,3761,84,247,1046,2943,1130,3190
220695,201910,856,2387,793,2265,22,69,685,1952,707,2021
220700,201910,9561,23753,7606,21012,346,1025,5870,16050,6216,17075
220710,201910,887,2463,658,2024,27,99,499,1495,526,1594
220720,201910,2123,5006,1903,4705,17,69,1647,4012,1664,4081
220730,201910,1296,3626,1085,3272,18,98,928,2726,946,2824
220735,201910,951,2234,723,1873,12,44,617,1547,629,1591
220740,201910,1372,3619,1084,3246,34,96,911,2759,945,2855
220750,201910,3830,9754,3336,9034,210,493,2873,7824,3083,8317
220755,201910,1249,3117,1028,2771,32,116,817,2130,849,2246
220760,201910,3027,8546,2642,8021,92,311,2326,7125,2418,7436
220770,201910,21428,64935,17971,58834,5777,19823,6320,21295,12097,41118
220775,201910,1108,2872,1016,2758,12,52,977,2633,989,2685
220777,201910,1625,4131,1227,3506,32,78,930,2653,962,2731
220779,201910,1308,3253,1128,3000,21,66,983,2598,1004,2664
220780,201910,5471,13988,4776,12912,219,721,3915,10298,4134,11019
220785,201910,1470,3243,1293,3012,9,20,1249,2895,1258,2915
220790,201910,9939,28488,8942,27036,237,1109,7496,22326,7733,23435
220793,201910,903,2376,713,2038,16,40,586,1701,602,1741
220795,201910,1364,3561,1213,3364,14,53,1082,2998,1096,3051
220800,201910,17424,39474,14594,35621,645,1566,11232,27170,11877,28736
220810,201910,2912,8185,2462,7358,49,166,2032,5997,2081,6163
220820,201910,5058,13176,4331,12123,327,792,3214,9002,3541,9794
220830,201910,7187,19112,6437,18055,239,784,5400,14948,5639,15732
220840,201910,12061,37108,10023,32850,2364,7386,4653,15937,7017,23323
220850,201910,3127,9684,2776,9240,68,366,2450,8123,2518,8489
220855,201910,668,1713,578,1576,13,58,517,1384,530,1442
220860,201910,1003,2511,858,2275,19,74,760,1979,779,2053
220865,201910,2496,6594,1928,5617,90,310,1431,4055,1521,4365
220870,201910,2902,8196,2400,7535,40,196,2200,6863,2240,7059
220880,201910,5272,12487,4541,11583,81,308,4158,10464,4239,10772
220885,201910,1382,4262,1136,3853,59,255,905,3071,964,3326
220887,201910,1519,3335,1246,2975,8,28,1166,2753,1174,2781
220890,201910,1401,4341,1204,4017,50,176,987,3326,1037,3502
220900,201910,2017,4848,1672,4386,29,73,1469,3820,1498,3893
220910,201910,1499,4146,1261,3792,60,185,1032,3095,1092,3280
220915,201910,951,2569,736,2155,7,28,567,1594,574,1622
220920,201910,1340,4407,1145,4134,69,322,933,3350,1002,3672
220930,201910,1638,4518,1403,4164,25,89,1291,3800,1316,3889
220935,201910,1053,3021,838,2575,26,105,565,1633,591,1738
220937,201910,1365,3644,1162,3320,24,82,945,2672,969,2754
220940,201910,1494,4239,1183,3661,41,151,894,2725,935,2876
220945,201910,432,1512,370,1366,19,103,271,968,290,1071
220950,201910,1413,3276,894,2444,15,54,714,1879,729,1933
220955,201910,1577,4105,1319,3652,40,126,1096,2982,1136,3108
220960,201910,821,2092,616,1750,12,45,464,1261,476,1306
220965,201910,1757,4844,1531,4511,23,144,1322,3791,1345,3935
220970,201910,1866,4544,1365,3784,37,93,1132,3101,1169,3194
220975,201910,685,2030,586,1904,17,101,518,1612,535,1713
220980,201910,1148,3226,1016,3045,32,126,856,2533,888,2659
220985,201910,1191,3182,1041,2952,44,149,834,2280,878,2429
220987,201910,1435,4280,1235,3913,54,235,993,3089,1047,3324
220990,201910,1685,4656,1479,4348,20,112,1243,3587,1263,3699
220995,201910,1063,3242,847,2845,40,150,625,2084,665,2234
220997,201910,2396,7087,2196,6772,48,225,1975,6004,2023,6229
221000,201910,4332,11991,3857,11264,99,473,3284,9397,3383,9870
221005,201910,1461,3875,1330,3654,29,138,1150,3030,1179,3168
221010,201910,1192,2773,954,2476,26,63,828,2102,854,2165
221020,201910,1490,4548,1379,4335,20,88,1069,3313,1089,3401
221030,201910,1590,4017,1357,3725,28,89,1186,3271,1214,3360
221035,201910,1485,3875,1275,3590,21,33,1117,3237,1138,3270
221037,201910,644,1822,539,1633,9,34,372,1082,381,1116
221038,201910,515,1459,402,1240,16,58,277,845,293,903
221039,201910,854,2332,731,2113,16,67,603,1674,619,1741
221040,201910,3994,12013,3488,11102,151,552,2775,8792,2926,9344
221050,201910,3833,10150,3357,9538,63,253,3022,8516,3085,8769
221060,201910,8351,23118,6874,20805,234,685,5612,17071,5846,17756
221062,201910,1139,3734,969,3433,40,196,784,2723,824,2919
221063,201910,1031,2909,862,2655,69,239,647,1962,716,2201
221065,201910,2578,6670,2273,6123,24,107,1991,5253,2015,5360
221070,201910,3211,10127,2651,8966,301,1011,1665,5735,1966,6746
221080,201910,3517,8589,2829,7555,58,222,2332,6112,2390,6334
221090,201910,1393,3629,1124,3155,11,46,970,2660,981,2706
221093,201910,1331,3768,1224,3549,119,343,846,2406,965,2749
221095,201910,891,2317,740,2078,8,25,613,1688,621,1713
221097,201910,814,2142,622,1790,21,67,462,1270,483,1337
221100,201910,108163,290587,90315,260353,10478,32104,58804,165184,69282,197288
221110,201910,9732,29070,8929,28038,160,827,8013,24844,8173,25671
221120,201910,4683,13032,4154,12158,181,574,3577,10407,3758,10981
221130,201910,5130,13554,3771,10863,757,2066,1817,5290,2574,7356
221135,201910,1582,4256,1419,4034,39,144,1254,3540,1293,3684
221140,201910,1303,3112,1099,2842,10,37,980,2474,990,2511
221150,201910,1073,2661,832,2234,20,93,653,1628,673,1721
221160,201910,743,1834,641,1698,18,33,526,1397,544,1430
221170,201910,964,2796,884,2653,22,69,754,2259,776,2328
230010,201910,3111,8120,2476,7016,48,160,1957,5432,2005,5592
230015,201910,2943,9613,2586,8883,179,729,1800,6123,1979,6852
230020,201910,12793,40504,11981,39231,353,1530,10117,32786,10470,34316
230030,201910,12791,32234,10732,29495,200,619,9418,25837,9618,26456
230040,201910,4462,11557,3692,10297,64,301,3053,8358,3117,8659
230050,201910,2763,8643,2051,6915,323,1043,902,2966,1225,4009
230060,201910,2300,6274,1831,5439,41,184,1462,4254,1503,4438
230070,201910,3818,10266,3057,8777,150,458,2128,6036,2278,6494
230075,201910,9050,29306,8260,27903,453,1988,6607,21911,7060,23899
230080,201910,3066,6389,2312,5452,5,19,2104,4971,2109,4990
230090,201910,4253,10557,3560,9421,146,404,2857,7495,3003,7899
230100,201910,17784,46787,15725,43899,1242,3599,11128,31151,12370,34750
230110,201910,12613,37483,10653,33556,1732,5365,5724,18119,7456,23484
230120,201910,7236,19763,6363,18308,511,1335,4688,13688,5199,15023
230125,201910,3128,8296,2507,7278,72,272,1935,5539,2007,5811
230130,201910,5620,17408,4542,15009,313,1119,3070,9952,3383,11071
230140,201910,3400,10207,2878,9127,106,429,2196,6776,2302,7205
230150,201910,1570,4710,1297,4085,202,541,763,2487,965,3028
230160,201910,6448,16861,5521,15404,207,745,4448,12124,4655,12869
230170,201910,6106,17436,5005,15165,306,926,3618,10780,3924,11706
230180,201910,1636,4526,1376,4030,24,105,1107,3133,1131,3238
230185,201910,4235,12196,3575,11085,239,824,2659,8210,2898,9034
230190,201910,12886,37696,10859,33920,1551,5046,6067,18835,7618,23881
230195,201910,5211,15403,4718,14486,342,1059,3604,11002,3946,12061
230200,201910,4933,13614,4140,12085,140,469,3169,9054,3309,9523
230205,201910,3987,12129,3529,11394,164,637,2662,8480,2826,9117
230210,201910,10283,24837,8624,22550,353,1155,6768,17342,7121,18497
230220,201910,13496,34117,11870,31745,516,1475,9899,26140,10415,27615
230230,201910,6769,20477,6041,18946,381,1213,4465,13925,4846,15138
230240,201910,12604,33865,11015,31180,282,1137,9116,25290,9398,26427
230250,201910,8785,24966,8283,24170,245,878,6604,18711,6849,19589
230260,201910,14405,43450,12479,39943,1573,4981,7279,23676,8852,28657
230270,201910,7375,20167,5637,16861,464,1376,3765,11287,4229,12663
230280,201910,20323,54252,16436,47639,506,2129,12980,36205,13486,38334
230290,201910,4743,13227,3968,11750,281,746,2981,8845,3262,9591
230300,201910,4751,12793,4318,12172,90,307,3773,10522,3863,10829
230310,201910,4596,13100,3861,11791,140,606,2788,8266,2928,8872
230320,201910,7660,22080,6464,19864,270,1095,4918,14773,5188,15868
230330,201910,4617,12640,3714,10895,163,532,2769,7958,2932,8490
230340,201910,3565,11122,3025,10024,279,953,2019,6633,2298,7586
230350,201910,17448,48481,15374,45324,905,3119,10213,30295,11118,33414
230360,201910,2784,7598,2219,6577,140,410,1487,4365,1627,4775
230365,201910,3034,7552,2495,6729,45,238,2107,5600,2152,5838
230370,201910,56995,159984,48282,146539,7590,23312,28115,86799,35705,110111
230380,201910,6383,17763,4998,15145,132,528,3666,10878,3798,11406
230390,201910,3314,9874,2866,9144,105,457,2204,6951,2309,7408
230393,201910,3099,9368,2484,8115,85,461,1898,5938,1983,6399
230395,201910,5828,15882,5061,14557,348,946,3520,10149,3868,11095
230400,201910,5549,15377,4902,14291,113,569,3906,11032,4019,11601
230410,201910,14297,42272,11668,37320,951,3290,7834,24945,8785,28235
230420,201910,27907,77397,22603,67824,2826,8814,12627,37645,15453,46459
230423,201910,4665,13838,4048,12589,87,374,3261,9964,3348,10338
230425,201910,5509,17067,4994,15984,398,1365,3566,11338,3964,12703
230426,201910,2705,7168,1955,5681,34,123,1463,4169,1497,4292
230427,201910,1869,5270,1297,4036,67,233,875,2603,942,2836
230428,201910,9457,25442,8170,23475,1112,3237,4841,13735,5953,16972
230430,201910,4829,13706,3816,11939,152,555,2892,8886,3044,9441
230435,201910,5619,14896,4703,13304,538,1482,2980,8437,3518,9919
230440,201910,403344,1008457,332635,901577,36249,104023,209321,560671,245570,664694
230445,201910,4253,11310,3411,9825,185,523,2329,6583,2514,7106
230450,201910,3581,10379,3098,9641,253,989,2228,6715,2481,7704
230460,201910,2126,5923,1837,5459,66,262,1518,4492,1584,4754
230465,201910,3952,11122,3345,9975,98,406,2493,7134,2591,7540
230470,201910,10928,36435,9818,34314,834,3444,7021,24101,7855,27545
230480,201910,1407,4096,1167,3651,85,340,831,2494,916,2834
230490,201910,2455,6859,2061,6124,165,537,1305,3676,1470,4213
230495,201910,5759,17112,5034,15789,373,1424,3306,10243,3679,11667
230500,201910,9154,29584,8263,27946,275,1141,6712,22592,6987,23733
230510,201910,1609,4976,1213,4085,189,685,572,1898,761,2583
230520,201910,4504,12789,3874,11633,315,895,2707,8123,3022,9018
230523,201910,14690,43590,11640,36955,2701,8526,3148,10576,5849,19102
230526,201910,3798,10792,3185,9699,172,536,2348,7157,2520,7693
230530,201910,5328,16611,4465,14908,308,1153,3211,10622,3519,11775
230533,201910,4213,10438,3548,9347,90,265,2936,7631,3026,7896
230535,201910,5205,14547,4398,13166,216,680,3135,9461,3351,10141
230540,201910,16075,43791,13806,40385,269,1080,11456,33109,11725,34189
230550,201910,20359,54475,16291,47412,1496,4482,10311,29765,11807,34247
230560,201910,8001,19606,6311,16878,54,237,5498,14537,5552,14774
230565,201910,2998,8395,2493,7452,85,359,1877,5502,1962,5861
230570,201910,3472,8846,2949,8148,69,228,2457,6748,2526,6976
230580,201910,10624,27821,9105,25636,324,997,7588,21170,7912,22167
230590,201910,8867,25367,7293,22433,418,1523,5336,15843,5754,17366
230600,201910,3648,9551,2816,8035,91,296,1939,5558,2030,5854
230610,201910,6535,18080,5767,16789,450,1297,4528,13125,4978,14422
230620,201910,2087,5650,1564,4608,119,374,960,2747,1079,3121
230625,201910,7646,21978,6381,19610,1936,6194,1737,5702,3673,11896
230630,201910,10579,31639,9149,28706,1594,4730,5051,16332,6645,21062
230640,201910,27474,83202,24693,78689,1375,5416,19430,60978,20805,66394
230650,201910,5146,14077,4342,12644,145,623,3474,9827,3619,10450
230655,201910,9270,31492,8707,30473,632,2342,6879,24256,7511,26598
230660,201910,6042,17961,4897,15884,162,846,3960,12571,4122,13417
230670,201910,6094,14620,4440,11913,126,425,3586,9377,3712,9802
230680,201910,2570,7085,2178,6382,131,383,1558,4595,1689,4978
230690,201910,7010,20878,6075,18975,406,1421,3838,11748,4244,13169
230700,201910,9651,24866,8032,21921,316,899,6053,16138,6369,17037
230710,201910,6624,20996,5748,19136,595,2065,3899,12774,4494,14839
230720,201910,1926,5663,1532,4841,125,382,1015,3127,1140,3509
230725,201910,3853,11747,3416,10900,397,1397,1911,6008,2308,7405
230730,201910,55341,151311,43201,132075,9745,32136,14351,45903,24096,78039
230740,201910,6021,16765,5119,15295,126,490,4123,12229,4249,12719
230750,201910,8380,22457,6923,20011,175,687,5451,15262,5626,15949
230760,201910,10960,29159,9581,27018,550,1808,7167,19727,7717,21535
230763,201910,4680,12989,3918,11544,136,606,3124,8890,3260,9496
230765,201910,39619,108472,32718,97014,5350,16483,15894,46839,21244,63322
230770,201910,25083,62565,20961,56988,2231,6225,13748,37405,15979,43630
230780,201910,6052,21526,5562,20388,786,2954,3301,12358,4087,15312
230790,201910,2928,8550,2607,8010,113,496,1950,5817,2063,6313
230800,201910,7866,25109,6932,23175,802,2937,4218,13826,5020,16763
230810,201910,11540,34412,10226,32260,411,1564,7831,24208,8242,25772
230820,201910,3286,10791,2729,9500,261,1086,1646,5445,1907,6531
230830,201910,7547,20590,6374,18586,151,658,5235,14874,5386,15532
230835,201910,4214,10099,3176,8414,76,225,2626,6840,2702,7065
230837,201910,3109,9580,2658,8746,111,528,2127,6776,2238,7304
230840,201910,8758,25905,7540,23877,690,2136,5481,17515,6171,19651
230850,201910,9391,27427,7863,24343,366,1324,5628,17179,5994,18503
230860,201910,5066,13062,4237,11828,72,264,3716,10286,3788,10550
230870,201910,16368,40127,13974,36143,411,1144,11380,29079,11791,30223
230880,201910,2075,6381,1880,6043,51,282,1481,4614,1532,4896
230890,201910,4521,14534,4109,13698,336,1251,2943,9612,3279,10863
230900,201910,2969,8604,2524,7723,187,665,1693,5033,1880,5698
230910,201910,2993,8115,2421,7189,66,317,1964,5760,2030,6077
230920,201910,4501,12822,3785,11654,147,604,2936,8796,3083,9400
230930,201910,6404,18036,5338,16059,302,915,3732,11214,4034,12129
230940,201910,7725,20112,6717,18561,194,538,5649,15480,5843,16018
230945,201910,6490,18719,5536,16833,334,1163,3887,11651,4221,12814
230950,201910,6286,15787,5558,14814,117,282,4880,13106,4997,13388
230960,201910,12723,37388,11255,34597,1721,5339,5834,18120,7555,23459
230970,201910,13155,35214,10928,31676,1776,5167,5926,17401,7702,22568
230980,201910,2671,7838,2322,7208,389,1158,1410,4506,1799,5664
230990,201910,1661,4716,1379,4141,68,284,949,2717,1017,3001
231000,201910,2443,6539,2008,5681,77,202,1468,4064,1545,4266
231010,201910,3380,8027,2689,6827,46,166,2320,5729,2366,5895
231020,201910,7981,25470,7089,23609,1313,4072,3993,13830,5306,17902
231025,201910,7396,20676,6431,19075,779,2265,4399,13169,5178,15434
231030,201910,7256,21662,5647,18216,900,2839,2977,9615,3877,12454
231040,201910,2929,8526,2545,7817,111,353,1985,6009,2096,6362
231050,201910,11628,30246,9232,25912,669,1863,6778,18544,7447,20407
231060,201910,2760,7881,2413,7306,63,241,1970,5919,2033,6160
231070,201910,7815,22781,6574,20574,757,2429,4118,12805,4875,15234
231080,201910,3939,11302,3365,10346,132,589,2543,7653,2675,8242
231085,201910,6590,16222,5228,14560,212,566,4060,11274,4272,11840
231090,201910,4384,11496,3197,9157,102,400,2225,6135,2327,6535
231095,201910,2234,6695,1753,5623,138,461,1178,3766,1316,4227
231100,201910,3033,8867,2497,7855,127,461,1876,5852,2003,6313
231110,201910,3458,10313,3159,9747,123,467,2393,7245,2516,7712
231120,201910,2206,6513,1834,5853,82,320,1290,4057,1372,4377
231123,201910,1882,4876,1550,4297,75,184,1141,3155,1216,3339
231126,201910,5387,14963,4278,12822,237,736,3140,9258,3377,9994
231130,201910,20671,53678,17189,49181,1047,3855,12578,35227,13625,39082
231135,201910,4092,11515,3380,10126,145,508,2444,7172,2589,7680
231140,201910,16535,46686,13170,40591,603,2540,9181,27504,9784,30044
231150,201910,5574,15395,4291,12891,695,2127,1951,5972,2646,8099
231160,201910,6057,18519,5324,17141,816,2496,3034,10051,3850,12547
231170,201910,4337,12799,3531,11199,195,707,2431,7442,2626,8149
231180,201910,14046,40197,11383,34453,3102,9109,3929,12273,7031,21382
231190,201910,3802,10760,3140,9532,74,333,2430,7168,2504,7501
231195,201910,4763,14495,3956,12834,211,807,2914,9287,3125,10094
231200,201910,7733,24339,6667,22107,231,1141,5219,16736,5450,17877
231210,201910,4780,14123,4044,12855,195,723,3024,9407,3219,10130
231220,201910,11769,30868,9042,25623,438,1365,6661,18184,7099,19549
231230,201910,9198,29382,8102,27416,452,1843,6004,20255,6456,22098
231240,201910,11219,33003,9839,30343,1537,4638,5899,18372,7436,23010
231250,201910,2087,5409,1342,3744,99,283,811,2199,910,2482
231260,201910,3177,9075,2739,8373,270,804,1868,5847,2138,6651
231270,201910,6390,16731,5200,14763,149,578,3940,10947,4089,11525
231280,201910,1662,5238,1535,4997,90,305,1158,3735,1248,4040
231290,201910,36923,110727,30673,97674,5226,16538,14278,45177,19504,61715
231300,201910,3983,11094,3112,9315,227,731,2032,5962,2259,6693
231310,201910,7160,18755,5690,16009,492,1406,3835,10580,4327,11986
231320,201910,7698,21236,5957,18101,96,461,4662,13947,4758,14408
231325,201910,2477,6614,1990,5846,166,432,1325,3960,1491,4392
231330,201910,9472,28612,7753,25116,1425,4430,4103,13813,5528,18243
231335,201910,5771,15096,4844,13608,78,354,4256,11788,4334,12142
231340,201910,17015,53194,15149,49830,1350,4513,10857,36067,12207,40580
231350,201910,15667,42651,14198,40575,322,1138,12678,35825,13000,36963
231355,201910,4362,13064,3889,12191,242,829,2971,9213,3213,10042
231360,201910,7258,21999,6263,20234,293,1084,4903,15777,5196,16861
231370,201910,2181,5959,1717,5122,35,117,1326,3917,1361,4034
231375,201910,4385,13623,3984,12945,140,624,3302,10600,3442,11224
231380,201910,5911,16035,5340,15247,179,488,4363,12605,4542,13093
231390,201910,3335,9728,2981,9137,149,558,2172,6463,2321,7021
231395,201910,3875,11487,3204,10411,463,1471,1837,6077,2300,7548
231400,201910,9358,27030,7912,24328,285,1184,6018,18105,6303,19289
231410,201910,14565,45475,13108,43009,639,2448,10498,33954,11137,36402
240010,201910,2483,6650,1912,5575,194,620,1161,3290,1355,3910
240020,201910,12079,34246,10148,30768,676,2515,6722,19974,7398,22489
240030,201910,2800,7000,2546,6609,99,312,2196,5601,2295,5913
240040,201910,799,2283,648,1995,31,114,461,1357,492,1471
240050,201910,3138,8448,2584,7424,48,140,2023,5719,2071,5859
240060,201910,1370,3688,1136,3258,25,83,922,2596,947,2679
240070,201910,2102,6161,1924,5801,185,597,1421,4170,1606,4767
240080,201910,2853,7753,2359,6823,55,215,1830,5180,1885,5395
240090,201910,2239,5531,1806,4776,18,55,1517,3963,1535,4018
240100,201910,9813,24425,7785,20664,231,744,6096,15586,6327,16330
240110,201910,4366,12503,3704,11277,194,708,2685,8010,2879,8718
240120,201910,3328,9135,2537,8203,207,755,1763,5824,1970,6579
240130,201910,3595,7528,3000,6753,33,109,2743,6064,2776,6173
240140,201910,1811,5410,1535,4880,166,565,1032,3249,1198,3814
240145,201910,6529,18287,5332,16167,821,2548,3017,9191,3838,11739
240150,201910,880,2605,788,2410,55,200,605,1785,660,1985
240160,201910,1421,4306,1196,3869,46,226,885,2858,931,3084
240165,201910,957,2627,791,2297,44,135,628,1799,672,1934
240170,201910,2385,6544,2000,5842,203,664,1344,3805,1547,4469
240180,201910,2957,8769,2330,7503,541,1665,1084,3680,1625,5345
240185,201910,1198,3844,1085,3659,55,229,893,2969,948,3198
240190,201910,1012,3000,882,2773,23,102,743,2344,766,2446
240200,201910,10545,27382,8453,23712,889,2699,4845,13308,5734,16007
240210,201910,2961,7485,2547,6859,31,152,2153,5610,2184,5762
240220,201910,7268,21832,6488,20599,366,1625,5025,15566,5391,17191
240230,201910,5792,14819,4650,12867,201,572,3696,10205,3897,10777
240240,201910,1843,5314,1113,3508,120,401,420,1166,540,1567
240250,201910,2844,7606,2527,7145,116,331,2086,5896,2202,6227
240260,201910,13884,41074,11948,37678,1689,5078,7408,24424,9097,29502
240270,201910,2207,6582,1925,6133,106,328,1436,4674,1542,5002
240280,201910,1658,4248,1404,3842,50,140,1131,3042,1181,3182
240290,201910,1176,3421,954,2921,28,118,668,1918,696,2036
240300,201910,2173,5604,1540,4403,73,230,1000,2780,1073,3010
240310,201910,8438,22358,6644,19101,864,2625,3504,9878,4368,12503
240320,201910,2039,5547,1458,4397,32,148,1110,3179,1142,3327
240325,201910,29572,80057,22896,68132,4382,13556,9515,28618,13897,42174
240330,201910,1698,4637,1276,3816,49,174,878,2507,927,2681
240340,201910,1954,4514,1593,3958,65,154,1301,3173,1366,3327
240350,201910,2085,5416,1901,5212,22,87,1721,4715,1743,4802
240360,201910,8292,23216,7377,21742,906,2666,5044,15155,5950,17821
240370,201910,1886,5045,1450,4133,79,233,999,2781,1078,3014
240375,201910,882,2238,730,1952,25,94,595,1534,620,1628
240380,201910,2241,6372,1623,4981,142,419,968,2907,1110,3326
240390,201910,979,2441,663,1825,28,71,425,1092,453,1163
240400,201910,1364,3437,1066,2899,37,142,747,1916,784,2058
240410,201910,570,1746,474,1534,51,214,294,895,345,1109
240420,201910,4548,16064,3982,14785,473,2138,2308,8326,2781,10464
240430,201910,3294,8710,2766,7710,192,606,2018,5431,2210,6037
240440,201910,2555,5613,2138,5028,148,314,1696,3963,1844,4277
240450,201910,4426,12076,3443,10209,353,1123,2021,5760,2374,6883
240460,201910,2851,8168,2587,7743,262,828,1990,5934,2252,6762
240470,201910,3535,10663,2691,8902,448,1408,1418,4877,1866,6285
240480,201910,535,1483,367,1116,27,82,173,513,200,595
240485,201910,2082,5916,1699,5173,139,437,1152,3523,1291,3960
240490,201910,1650,4210,1281,3532,73,178,964,2669,1037,2847
240500,201910,2122,5721,1843,5260,83,243,1520,4322,1603,4565
240510,201910,1659,4352,1460,4066,73,275,1207,3259,1280,3534
240520,201910,1359,3425,1062,3012,45,159,815,2276,860,2435
240530,201910,2079,6068,1878,5736,110,330,1510,4605,1620,4935
240540,201910,2252,5646,1949,5167,62,136,1694,4466,1756,4602
240550,201910,684,1955,622,1835,24,100,496,1405,520,1505
240560,201910,3228,8459,2739,7796,307,798,1973,5705,2280,6503
240570,201910,2747,7226,1794,5082,264,775,739,1938,1003,2713
240580,201910,7972,23268,7074,21608,556,1676,5656,17310,6212,18986
240590,201910,706,1866,607,1696,15,53,464,1270,479,1323
240600,201910,1772,4780,1288,3761,48,162,867,2443,915,2605
240610,201910,4178,11335,3509,10092,135,463,2660,7489,2795,7952
240615,201910,1160,3110,913,2626,59,202,631,1716,690,1918
240620,201910,1849,5203,1559,4676,89,256,1235,3669,1324,3925
240630,201910,2045,5891,1840,5529,131,319,1298,4022,1429,4341
240640,201910,916,2483,722,2147,28,116,539,1567,567,1683
240650,201910,3938,10888,3431,9952,197,599,2650,7596,2847,8195
240660,201910,3022,7789,2665,7319,54,169,2407,6609,2461,6778
240670,201910,2403,6753,1940,5812,146,458,1255,3655,1401,4113
240680,201910,1611,4307,1278,3730,54,174,976,2767,1030,2941
240690,201910,964,2439,757,2085,16,73,604,1589,620,1662
240700,201910,2364,6877,1938,6085,66,258,1523,4685,1589,4943
240710,201910,15937,41451,13263,36736,1881,5065,8016,22282,9897,27347
240720,201910,5102,12763,4412,11751,398,1128,3202,8407,3600,9535
240725,201910,1107,3167,848,2630,32,110,571,1717,603,1827
240730,201910,2121,6008,1770,5317,65,235,1349,3963,1414,4198
240740,201910,1804,4836,1458,4177,45,178,1075,2908,1120,3086
240750,201910,2135,7075,1779,6312,262,1018,944,3390,1206,4408
240760,201910,1542,3738,1077,3023,50,100,835,2388,885,2488
240770,201910,3177,8776,2669,8029,121,465,2146,6341,2267,6806
240780,201910,4937,13454,3929,11768,496,1500,2425,7402,2921,8902
240790,201910,841,2407,692,2115,12,51,521,1553,533,1604
240800,201910,44789,109603,34656,93888,4804,13457,17675,47794,22479,61251
240810,201910,84034,221141,71286,199467,10069,28569,43800,121272,53869,149841
240820,201910,5688,17099,4894,15657,663,2127,3046,9867,3709,11994
240830,201910,8620,24852,7727,23465,260,1164,6353,18963,6613,20127
240840,201910,1132,2837,890,2426,32,91,632,1651,664,1742
240850,201910,1257,3457,898,2688,38,125,524,1514,562,1639
240860,201910,1239,3361,929,2794,16,73,694,1982,710,2055
240870,201910,1116,2847,838,2349,126,365,467,1312,593,1677
240880,201910,1268,3992,1117,3686,79,328,878,2837,957,3165
240890,201910,4446,12163,3326,9984,473,1553,1667,4777,2140,6330
240895,201910,2599,8180,2361,7820,134,471,2056,6803,2190,7274
240910,201910,3220,8864,2741,7970,58,216,2263,6468,2321,6684
240920,201910,817,2300,687,2081,63,186,389,1220,452,1406
240930,201910,3668,8407,3028,7622,190,277,2304,6059,2494,6336
240933,201910,1759,4251,1424,3750,44,176,1227,3171,1271,3347
240940,201910,6089,15015,4735,12704,418,1154,3107,8081,3525,9235
240950,201910,970,2923,841,2675,31,136,685,2121,716,2257
240960,201910,674,2064,600,1913,30,112,467,1453,497,1565
240970,201910,1830,4707,1472,4108,58,221,1210,3254,1268,3475
240980,201910,3174,9550,2854,8957,133,557,2295,7039,2428,7596
240990,201910,2530,7202,2249,6644,264,873,1586,4488,1850,5361
241000,201910,914,2423,726,2065,34,82,528,1496,562,1578
241010,201910,2759,8850,2516,8316,169,683,1857,6002,2026,6685
241020,201910,2066,5560,1501,4405,157,458,947,2743,1104,3201
241025,201910,1716,4947,1348,4230,48,204,964,2966,1012,3170
241030,201910,2489,7778,1982,6697,225,781,1285,4326,1510,5107
241040,201910,2261,7174,2006,6738,99,446,1616,5371,1715,5817
241050,201910,1299,3592,1054,3134,37,130,800,2317,837,2447
241060,201910,717,2038,633,1853,28,95,448,1258,476,1353
241070,201910,645,1761,562,1618,14,49,436,1205,450,1254
241080,201910,1125,3182,839,2600,9,38,609,1863,618,1901
241090,201910,2014,5845,1616,5161,55,279,1277,4001,1332,4280
241100,201910,1146,3237,894,2689,64,206,595,1735,659,1941
241105,201910,994,3021,799,2633,255,830,256,875,511,1705
241110,201910,912,2610,685,2113,40,141,460,1354,500,1495
241120,201910,7531,21341,6364,19255,978,2907,3673,11419,4651,14326
241140,201910,3239,8593,2572,7256,166,474,1858,5111,2024,5585
241142,201910,759,2050,549,1633,26,96,322,891,348,987
241150,201910,5864,15357,5181,14210,153,531,4252,11428,4405,11959
241160,201910,1144,3064,927,2668,141,401,580,1618,721,2019
241170,201910,1295,3303,1114,2992,31,125,937,2399,968,2524
241180,201910,1009,2618,725,2073,91,256,384,1065,475,1321
241190,201910,1100,2899,898,2497,19,75,661,1761,680,1836
241200,201910,18574,48967,15955,44766,2555,7156,9339,26316,11894,33472
241210,201910,1376,3722,975,2909,122,400,564,1621,686,2021
241220,201910,8557,25563,7434,23626,1806,5694,3438,11399,5244,17093
241230,201910,2888,7665,2542,7109,92,319,2134,5839,2226,6158
241240,201910,1170,3297,689,2202,58,192,320,1028,378,1220
241250,201910,5217,15291,4207,13352,174,803,3097,9421,3271,10224
241255,201910,2106,6721,1827,6106,109,476,1352,4389,1461,4865
241260,201910,4811,12620,3747,10796,89,387,2956,8300,3045,8687
241270,201910,1747,5062,1434,4440,119,413,1001,3059,1120,3472
241280,201910,2158,5444,1856,4887,69,194,1555,4021,1624,4215
241290,201910,3389,8305,2523,6878,75,292,2006,5285,2081,5577
241300,201910,1415,3804,1107,3240,37,130,766,2173,803,2303
241310,201910,2068,5229,1757,4788,13,61,1479,4055,1492,4116
241320,201910,987,3170,813,2818,91,375,508,1736,599,2111
241330,201910,1749,4548,1356,4034,23,108,1163,3435,1186,3543
241335,201910,3115,8767,2754,8086,95,341,2306,6679,2401,7020
241340,201910,1536,4398,1175,3631,249,786,495,1515,744,2301
241350,201910,1986,5773,1751,5345,95,328,1341,4030,1436,4358
241355,201910,1282,3464,1051,3018,22,76,821,2322,843,2398
241360,201910,2081,5397,1541,4275,45,136,1122,2998,1167,3134
241370,201910,1332,3685,1024,3046,52,177,716,2032,768,2209
241380,201910,609,1724,471,1433,71,201,251,778,322,979
241390,201910,2701,8028,2400,7563,174,517,1858,5896,2032,6413
241400,201910,3477,9670,3100,9089,164,524,2521,7314,2685,7838
241410,201910,2347,7005,1882,6042,337,1112,955,3060,1292,4172
241415,201910,1631,4815,1331,4227,64,240,948,2933,1012,3173
241420,201910,2160,7040,1835,6454,443,1690,861,3017,1304,4707
241430,201910,581,1605,395,1166,25,88,251,706,276,794
241440,201910,7271,22847,6504,21482,359,1416,5156,16784,5515,18200
241445,201910,1067,2762,966,2633,22,54,875,2435,897,2489
241450,201910,2569,6471,2210,5893,381,852,1465,4021,1846,4873
241460,201910,3599,9812,2924,8374,178,561,2084,5815,2262,6376
241470,201910,1414,3703,1128,3285,25,93,927,2686,952,2779
241475,201910,1187,3371,903,2811,24,127,658,1938,682,2065
241480,201910,2797,8815,2302,7744,728,2415,755,2834,1483,5249
241490,201910,648,1548,516,1360,23,68,356,912,379,980
241500,201910,802,2297,712,2177,7,31,645,1976,652,2007
250010,201910,2544,7573,2091,6633,59,241,1527,4709,1586,4950
250020,201910,1582,4300,1104,3352,34,93,810,2421,844,2514
250030,201910,6826,18792,6031,17543,501,1542,4530,12968,5031,14510
250040,201910,4037,12414,3472,11360,205,792,2503,8025,2708,8817
250050,201910,3525,9556,3193,9072,104,409,2641,7422,2745,7831
250053,201910,1160,3325,1048,3146,68,234,765,2280,833,2514
250057,201910,653,2318,611,2251,7,32,549,2064,556,2096
250060,201910,5370,14182,4859,13535,324,865,3949,11074,4273,11939
250070,201910,3932,11044,3378,10066,47,201,2706,7848,2753,8049
250073,201910,749,1988,608,1771,5,24,499,1407,504,1431
250077,201910,2204,5957,1643,5013,66,229,1224,3700,1290,3929
250080,201910,4727,11996,4091,11155,69,313,3538,9488,3607,9801
250090,201910,3205,7941,2809,7405,56,164,2417,6254,2473,6418
250100,201910,3609,11083,3282,10466,174,644,2580,8030,2754,8674
250110,201910,4815,13518,4326,12799,288,1070,3367,9719,3655,10789
250115,201910,670,1769,479,1472,9,52,337,1021,346,1073
250120,201910,1808,5321,1511,4808,31,153,1193,3748,1224,3901
250130,201910,5409,14992,4574,13783,76,412,3818,11312,3894,11724
250135,201910,1158,3193,1034,2986,16,68,918,2625,934,2693
250140,201910,2204,6577,2056,6380,121,553,1735,5247,1856,5800
250150,201910,4790,15007,4302,14137,157,691,3446,11104,3603,11795
250153,201910,1417,3697,1171,3323,26,80,955,2669,981,2749
250157,201910,1695,5094,1514,4730,69,281,1202,3684,1271,3965
250160,201910,3873,9678,3104,8625,31,143,2762,7630,2793,7773
250170,201910,1817,4667,1613,4363,30,117,1389,3694,1419,3811
250180,201910,19477,47745,16685,44101,796,2512,12950,33341,13746,35853
250190,201910,4052,10899,3382,9860,361,1043,2252,6448,2613,7491
250200,201910,1907,5129,1617,4702,57,197,1362,3940,1419,4137
250205,201910,819,2556,700,2354,19,86,580,1935,599,2021
250210,201910,1558,4748,1404,4494,50,263,1119,3499,1169,3762
250215,201910,1501,4142,1242,3755,70,240,769,2309,839,2549
250220,201910,659,1860,537,1675,29,110,357,1073,386,1183
250230,201910,1562,3561,1120,2892,24,70,904,2262,928,2332
250240,201910,2241,6782,1974,6301,41,196,1665,5227,1706,5423
250250,201910,4539,12623,3918,11708,83,283,3318,9908,3401,10191
250260,201910,1685,4699,1402,4216,41,127,1112,3306,1153,3433
250270,201910,1201,3615,1070,3451,67,229,803,2669,870,2898
250280,201910,3202,9060,2825,8468,96,306,2254,6707,2350,7013
250290,201910,1601,4195,1345,3828,23,66,1063,3039,1086,3105
250300,201910,5442,14562,4939,13975,199,910,4087,11091,4286,12001
250310,201910,1121,3088,934,2771,35,115,724,2119,759,2234
250320,201910,11283,25867,9751,24072,270,779,8625,20972,8895,21751
250330,201910,2302,6476,1919,5972,109,365,1541,4763,1650,5128
250340,201910,1086,2770,958,2600,6,15,874,2350,880,2365
250350,201910,3979,11112,3548,10423,144,385,2856,8602,3000,8987
250355,201910,1968,5965,1756,5668,28,148,1573,5040,1601,5188
250360,201910,1756,4893,1572,4627,43,158,1295,3793,1338,3951
250370,201910,12933,33755,10671,30345,285,1088,8832,24705,9117,25793
250375,201910,1180,3063,944,2774,6,18,880,2615,886,2633
250380,201910,1583,4111,1446,3931,30,132,1251,3275,1281,3407
250390,201910,1751,4535,1479,4094,99,261,1155,3180,1254,3441
250400,201910,68991,168594,49037,137589,13386,39738,15272,44696,28658,84434
250403,201910,1688,4771,1513,4556,70,357,1167,3353,1237,3710
250407,201910,1198,3045,969,2705,59,132,705,2000,764,2132
250410,201910,603,1630,525,1502,5,13,438,1235,443,1248
250415,201910,1814,5158,1600,4802,35,158,1368,4074,1403,4232
250420,201910,1197,3379,1083,3230,20,88,987,2919,1007,3007
250430,201910,6214,15343,5258,14030,134,446,4350,11356,4484,11802
250435,201910,1507,4164,1212,3656,13,56,929,2762,942,2818
250440,201910,4550,12005,3892,11184,63,210,3439,9864,3502,10074
250450,201910,1784,4806,1489,4400,28,116,1233,3636,1261,3752
250460,201910,7336,19790,6472,18508,328,1006,5242,14912,5570,15918
250470,201910,1530,3947,1267,3551,53,169,980,2688,1033,2857
250480,201910,4096,11005,3504,10310,21,82,3162,9413,3183,9495
250485,201910,716,1629,521,1352,34,69,381,957,415,1026
250490,201910,5076,12157,4518,11503,184,579,3960,9871,4144,10450
250500,201910,1962,5421,1737,5033,69,231,1421,4096,1490,4327
250510,201910,5431,13633,4660,12610,84,245,4101,11161,4185,11406
250520,201910,1812,4914,1542,4522,131,422,1091,3168,1222,3590
250523,201910,2232,5465,1979,5143,74,310,1641,4117,1715,4427
250527,201910,1663,4302,1499,4110,26,74,1313,3635,1339,3709
250530,201910,603,1588,513,1466,7,20,451,1280,458,1300
250535,201910,1330,3919,1205,3674,25,123,984,2897,1009,3020
250540,201910,2986,6804,2449,6203,75,133,2149,5531,2224,5664
250550,201910,769,2473,669,2283,22,94,507,1694,529,1788
250560,201910,1673,4629,1473,4327,44,168,1229,3512,1273,3680
250570,201910,2614,7855,2232,7150,80,314,1751,5494,1831,5808
250580,201910,1056,2729,934,2559,45,165,781,2090,826,2255
250590,201910,820,2295,718,2143,24,101,595,1757,619,1858
250600,201910,8139,20709,6783,18949,308,929,5586,15486,5894,16415
250610,201910,3022,8402,2692,7915,122,459,2230,6435,2352,6894
250620,201910,741,1982,624,1767,11,46,473,1314,484,1360
250625,201910,2524,7277,2252,6833,46,239,1888,5549,1934,5788
250630,201910,9885,27581,7995,24163,858,2661,5144,15192,6002,17853
250640,201910,3290,9194,2999,8803,66,334,2590,7413,2656,7747
250650,201910,927,2263,772,2051,16,55,667,1731,683,1786
250660,201910,1553,3882,1308,3553,39,118,1094,2890,1133,3008
250670,201910,2318,7225,2114,6866,44,198,1837,5842,1881,6040
250680,201910,5890,13463,5214,12691,81,294,4772,11414,4853,11708
250690,201910,6783,15442,5802,14195,102,265,5151,12449,5253,12714
250700,201910,4270,12004,3706,11136,394,1195,2644,7858,3038,9053
250710,201910,4409,12629,3774,11751,282,987,2725,8448,3007,9435
250720,201910,2741,7264,2459,6864,36,179,2158,5930,2194,6109
250730,201910,4100,10872,3580,10181,106,418,2983,8229,3089,8647
250740,201910,1956,4919,1590,4432,98,261,1218,3388,1316,3649
250750,201910,99794,248290,84688,226925,7200,21009,61130,160386,68330,181395
250760,201910,2335,6021,2030,5529,96,287,1599,4231,1695,4518
250770,201910,3949,11980,3540,11425,368,1222,2559,8269,2927,9491
250780,201910,1705,4627,1415,4086,63,220,1068,3002,1131,3222
250790,201910,2427,7237,2097,6736,167,656,1401,4388,1568,5044
250800,201910,2442,6482,2104,5941,86,179,1724,4902,1810,5081
250810,201910,1255,3363,1007,2997,20,51,864,2586,884,2637
250820,201910,1940,5466,1799,5306,37,158,1639,4791,1676,4949
250830,201910,5680,16961,4705,15025,271,1058,3255,10071,3526,11129
250840,201910,772,2424,654,2190,15,58,485,1633,500,1691
250850,201910,1770,5342,1589,5021,33,166,1320,4052,1353,4218
250855,201910,940,2761,813,2543,59,206,615,1908,674,2114
250860,201910,3074,9153,2542,8225,444,1521,1455,4691,1899,6212
250870,201910,1028,2826,856,2531,36,129,699,2042,735,2171
250880,201910,1587,4081,1294,3656,93,285,965,2718,1058,3003
250890,201910,9901,26315,8823,24817,445,1895,6987,18622,7432,20517
250900,201910,2764,7793,2369,7055,60,244,2001,5814,2061,6058
250905,201910,2357,6746,2155,6443,53,219,1944,5785,1997,6004
250910,201910,5980,14823,4895,13567,91,329,4175,11635,4266,11964
250915,201910,2052,4886,1493,4278,18,43,1316,3851,1334,3894
250920,201910,3494,8883,3037,8173,330,786,2208,5925,2538,6711
250930,201910,2197,5908,1987,5625,60,233,1708,4736,1768,4969
250933,201910,1154,3437,1020,3189,22,117,774,2342,796,2459
250937,201910,691,1863,564,1648,22,80,427,1261,449,1341
250939,201910,1725,4635,1499,4333,62,204,1174,3361,1236,3565
250940,201910,3862,10457,3403,9835,30,115,2978,8589,3008,8704
250950,201910,1668,4280,1345,3870,21,88,1133,3211,1154,3299
250960,201910,1096,3216,957,2991,27,143,782,2349,809,2492
250970,201910,8241,21378,7189,19692,264,862,5844,15632,6108,16494
250980,201910,2472,6579,2213,6180,39,162,1876,5097,1915,5259
250990,201910,1985,6062,1654,5454,57,271,1238,4023,1295,4294
251000,201910,2032,5716,1643,5067,37,165,1340,4093,1377,4258
251010,201910,2595,7344,2356,6970,22,94,2139,6315,2161,6409
251020,201910,1653,4461,1485,4202,31,140,1293,3580,1324,3720
251030,201910,981,2612,810,2291,34,101,568,1578,602,1679
251040,201910,1822,5230,1536,4728,46,215,1215,3697,1261,3912
251050,201910,1063,2895,893,2564,48,154,646,1798,694,1952
251060,201910,1060,2283,794,1951,8,32,648,1544,656,1576
251065,201910,462,1261,363,1088,12,34,255,736,267,770
251070,201910,711,1855,607,1707,7,29,514,1419,521,1448
251080,201910,18314,47155,14956,42100,1758,5257,9803,27545,11561,32802
251090,201910,2676,7747,2261,6989,55,192,1831,5624,1886,5816
251100,201910,789,2514,704,2360,27,99,526,1694,553,1793
251110,201910,1685,4529,1419,4058,45,122,1095,3099,1140,3221
251120,201910,7068,20120,5968,18737,257,1011,4720,14685,4977,15696
251130,201910,3883,8737,3428,8225,129,312,3028,7237,3157,7549
251140,201910,4210,11757,3783,11155,73,315,3173,9224,3246,9539
251150,201910,2637,7640,2362,7204,110,465,1915,5673,2025,6138
251160,201910,2051,6059,1792,5688,71,281,1510,4718,1581,4999
251170,201910,1525,4193,1350,3963,38,134,1161,3387,1199,3521
251180,201910,2585,6985,2127,6348,168,501,1437,4248,1605,4749
251190,201910,4312,11285,3965,10879,43,230,3594,9660,3637,9890
251200,201910,4270,12597,3799,11981,83,345,3304,10449,3387,10794
251203,201910,928,3024,855,2867,25,108,646,2106,671,2214
251207,201910,1062,2931,817,2512,22,111,573,1708,595,1819
251210,201910,7351,18953,5919,17037,247,629,4539,13238,4786,13867
251220,201910,1175,2860,905,2489,51,124,709,1973,760,2097
251230,201910,4590,12716,3944,11616,127,487,3135,8986,3262,9473
251240,201910,3583,9840,2977,8846,145,436,2243,6525,2388,6961
251250,201910,9897,26777,8705,24795,806,2454,6372,17577,7178,20031
251260,201910,476,1382,436,1312,12,62,345,999,357,1061
251270,201910,4215,13133,3764,12515,110,458,3111,10522,3221,10980
251272,201910,1348,3665,1207,3466,43,171,1003,2792,1046,2963
251274,201910,900,2499,719,2178,61,207,483,1383,544,1590
251275,201910,1209,3371,1029,3089,39,185,783,2255,822,2440
251276,201910,1325,3561,1158,3345,33,174,935,2602,968,2776
251278,201910,575,1611,510,1509,41,109,372,1118,413,1227
251280,201910,2226,6116,1971,5710,50,196,1642,4667,1692,4863
251290,201910,5843,13890,5331,13244,148,514,4659,11142,4807,11656
251300,201910,828,2461,748,2339,7,35,643,2000,650,2035
251310,201910,2727,7818,2366,7242,52,263,1882,5617,1934,5880
251315,201910,1677,5290,1539,5046,72,239,1162,3747,1234,3986
251320,201910,1606,4256,1122,3409,31,108,834,2498,865,2606
251330,201910,2056,4792,1684,4349,22,81,1530,3967,1552,4048
251335,201910,1005,3052,915,2912,24,103,794,2469,818,2572
251340,201910,3642,8874,2895,7856,114,354,2196,5880,2310,6234
251350,201910,1059,3088,942,2895,30,132,778,2332,808,2464
251360,201910,1786,5051,1451,4582,19,87,1245,3936,1264,4023
251365,201910,688,1931,540,1623,8,26,418,1249,426,1275
251370,201910,22619,60650,19506,56224,2308,6901,12692,36888,15000,43789
251380,201910,1174,3376,1037,3134,17,98,870,2537,887,2635
251385,201910,725,1872,558,1575,16,55,419,1132,435,1187
251390,201910,6331,18598,5544,17320,492,1634,3620,11263,4112,12897
251392,201910,968,2650,799,2394,26,117,621,1812,647,1929
251394,201910,603,1783,493,1584,21,88,370,1162,391,1250
251396,201910,691,1855,585,1674,19,63,406,1136,425,1199
251398,201910,924,2368,654,1890,16,66,491,1380,507,1446
251400,201910,1197,2978,963,2647,27,96,757,2009,784,2105
251410,201910,1460,3453,1181,3045,19,85,1011,2519,1030,2604
251420,201910,1886,5025,1536,4615,40,151,1192,3544,1232,3695
251430,201910,1519,4656,1349,4368,33,160,1167,3750,1200,3910
251440,201910,1118,3145,903,2726,34,97,713,2171,747,2268
251445,201910,1510,4294,1392,4120,35,150,1174,3381,1209,3531
251450,201910,4354,12878,3890,12170,89,408,3250,10036,3339,10444
251455,201910,865,2628,783,2474,24,104,607,1880,631,1984
251460,201910,880,2525,766,2344,20,76,639,1946,659,2022
251465,201910,428,1274,362,1138,6,24,272,840,278,864
251470,201910,1154,3206,860,2596,67,230,515,1464,582,1694
251480,201910,980,2595,805,2285,20,88,622,1684,642,1772
251490,201910,1862,4930,1466,4380,51,165,1085,3226,1136,3391
251500,201910,1925,5436,1756,5202,33,133,1586,4667,1619,4800
251510,201910,2632,7934,2163,6963,128,482,1441,4522,1569,5004
251520,201910,936,2471,712,2050,62,166,473,1334,535,1500
251530,201910,14372,34611,11648,31188,109,606,10281,27003,10390,27609
251540,201910,2840,8333,2555,7792,94,343,2078,6217,2172,6560
251550,201910,3682,8817,2923,7850,86,197,2452,6595,2538,6792
251560,201910,567,1696,490,1575,62,211,335,1036,397,1247
251570,201910,910,2590,736,2233,20,90,575,1689,595,1779
251580,201910,1902,4512,1690,4197,49,190,1463,3490,1512,3680
251590,201910,1575,3991,1333,3702,59,183,1081,2905,1140,3088
251593,201910,861,2550,786,2423,80,262,517,1551,597,1813
251597,201910,2087,5857,1887,5588,22,99,1659,4850,1681,4949
251600,201910,6358,17247,5591,16050,167,558,4634,13093,4801,13651
251610,201910,3219,9127,2742,8241,248,681,1893,5784,2141,6465
251615,201910,1231,3089,989,2712,22,60,788,2111,810,2171
251620,201910,18424,42898,14249,37805,127,422,12043,32397,12170,32819
251630,201910,4643,10951,3714,9666,199,548,2856,7334,3055,7882
251640,201910,2081,5773,1853,5384,32,161,1598,4515,1630,4676
251650,201910,3989,10635,3464,9952,117,371,2972,8508,3089,8879
251660,201910,3448,10305,3029,9562,78,374,2507,7755,2585,8129
251670,201910,3999,11398,3544,10749,48,252,3144,9433,3192,9685
251675,201910,639,1844,569,1755,78,245,376,1161,454,1406
251680,201910,2520,6748,2082,6157,41,153,1694,5001,1735,5154
251690,201910,3117,8796,2614,7894,82,260,1973,5869,2055,6129
251700,201910,2004,5813,1707,5436,43,193,1444,4513,1487,4706
251710,201910,776,2027,516,1481,43,156,305,853,348,1009
251720,201910,1296,3687,1049,3242,22,98,802,2401,824,2499
251740,201910,599,1687,478,1457,38,147,337,977,375,1124
260005,201910,29579,62238,24107,55182,1641,3758,18570,41646,20211,45404
260010,201910,9964,26255,8194,23420,468,1435,4936,14165,5404,15600
260020,201910,6705,15849,5726,14430,116,514,4774,11828,4890,12342
260030,201910,6600,17081,5554,15520,159,514,4483,12418,4642,12932
260040,201910,7653,20194,6325,18144,497,1368,4346,12688,4843,14056
260050,201910,13674,35727,11379,33188,169,766,10392,30313,10561,31079
260060,201910,3953,10029,3373,9077,184,463,2682,7168,2866,7631
260070,201910,10301,26175,8841,24041,381,1305,7040,18664,7421,19969
260080,201910,6533,14908,5719,13798,116,389,4793,11292,4909,11681
260090,201910,4705,12155,4176,11442,528,1452,2883,7924,3411,9376
260100,201910,3016,8172,2533,7449,60,281,2053,5936,2113,6217
260105,201910,4970,13470,4430,12754,143,515,3695,10491,3838,11006
260110,201910,22206,61209,19726,57594,1035,3539,16137,46351,17172,49890
260120,201910,14398,38796,12002,35131,1549,4448,7446,22196,8995,26644
260130,201910,3002,7835,2687,7365,201,585,2013,5396,2214,5981
260140,201910,12830,29330,11011,27112,599,1645,9159,22201,9758,23846
260150,201910,3566,8327,3053,7699,97,317,2649,6568,2746,6885
260160,201910,6502,17041,5450,15713,88,346,4867,14140,4955,14486
260170,201910,19053,46101,16119,42061,1079,2786,12616,32618,13695,35404
260180,201910,3421,9209,2955,8567,82,315,2523,7185,2605,7500
260190,201910,18396,37016,15382,33472,168,473,13560,28854,13728,29327
260200,201910,11082,26595,9509,24595,447,1049,7966,20793,8413,21842
260210,201910,11745,33291,9921,30314,318,1277,7898,23926,8216,25203
260220,201910,10293,24920,9485,23878,164,577,8354,20640,8518,21217
260230,201910,10600,26208,9228,24351,204,678,7749,20064,7953,20742
260240,201910,2645,7937,2304,7287,130,461,1777,5559,1907,6020
260250,201910,2153,5715,1872,5283,121,294,1419,3994,1540,4288
260260,201910,12772,33544,11349,31301,413,1416,8962,24153,9375,25569
260270,201910,4082,10064,3572,9424,140,560,2953,7584,3093,8144
260280,201910,12656,38253,11344,36397,492,2098,9570,30246,10062,32344
260290,201910,39021,100238,33541,92027,3677,10280,22616,61730,26293,72010
260300,201910,9661,25982,8332,24141,228,988,6939,19993,7167,20981
260310,201910,4893,12791,4343,12069,288,774,3386,9485,3674,10259
260320,201910,7619,21932,6466,19963,262,832,5253,16198,5515,17030
260330,201910,2507,7737,2202,7096,70,275,1769,5553,1839,5828
260340,201910,2037,5442,1740,4981,31,144,1472,4108,1503,4252
260345,201910,24472,64446,20473,58461,3148,9610,10695,29888,13843,39498
260350,201910,5351,12744,4654,11916,94,254,4102,10457,4196,10711
260360,201910,2463,6432,2229,5999,38,174,1562,4135,1600,4309
260370,201910,5490,15807,4726,14495,237,856,3609,10957,3846,11813
260380,201910,4874,14548,4166,13364,167,623,3108,9823,3275,10446
260390,201910,4410,13284,3666,11729,210,712,2510,7848,2720,8560
260392,201910,3377,10795,3002,10313,127,746,2396,8206,2523,8952
260400,201910,17095,40172,14814,37176,497,1469,11630,28100,12127,29569
260410,201910,70956,173545,54352,149846,9786,28423,24792,69876,34578,98299
260415,201910,4471,12197,3848,11133,73,308,3111,8842,3184,9150
260420,201910,12710,26498,10756,24307,117,335,9873,22057,9990,22392
260430,201910,2755,8534,2347,7730,113,452,1655,5410,1768,5862
260440,201910,3630,9529,3190,8822,79,291,2659,7192,2738,7483
260450,201910,5670,14415,5085,13676,293,658,4153,11339,4446,11997
260460,201910,5159,15468,4384,14061,485,1743,2597,8154,3082,9897
260470,201910,4933,12933,4148,12013,90,225,3769,11089,3859,11314
260480,201910,3974,10551,3312,9595,218,783,2296,6657,2514,7440
260490,201910,5294,12234,4686,11313,43,161,4228,10017,4271,10178
260500,201910,6077,15331,5192,14053,436,1142,3655,9965,4091,11107
260510,201910,9545,23686,8007,21543,133,518,7031,18709,7164,19227
260515,201910,4159,11476,3203,9621,140,437,2133,6233,2273,6670
260520,201910,17104,39765,14928,36919,878,2157,12016,29341,12894,31498
260530,201910,9694,27763,8282,25574,176,813,7036,21411,7212,22224
260540,201910,7102,15442,6276,14382,189,436,5580,12685,5769,13121
260545,201910,46,137,17,66,2,7,4,10,6,17
260550,201910,3005,8395,2456,7458,117,492,1656,4892,1773,5384
260560,201910,6011,15311,5048,13921,132,535,4196,11311,4328,11846
260570,201910,7656,20907,6702,19607,427,1365,5230,15312,5657,16677
260580,201910,4446,10569,3965,9920,23,88,3631,9052,3654,9140
260590,201910,6670,15513,5571,14272,220,559,4643,11968,4863,12527
260600,201910,30043,78453,24412,69645,1185,3760,18282,51276,19467,55036
260610,201910,7079,18483,6366,17539,400,1227,4755,12930,5155,14157
260620,201910,15762,41412,13789,38520,1323,4187,9875,26959,11198,31146
260630,201910,2331,6318,1897,5616,37,157,1519,4384,1556,4541
260640,201910,20953,48116,17614,44212,866,2226,14059,34978,14925,37204
260650,201910,5891,15701,4739,14255,160,655,4024,11999,4184,12654
260660,201910,7123,18819,6090,17423,165,710,5160,14420,5325,15130
260670,201910,2158,5662,1781,5085,75,196,1336,3774,1411,3970
260680,201910,26896,64658,22530,58326,1674,4633,15679,39784,17353,44417
260690,201910,3572,9230,2913,8221,101,372,2286,6372,2387,6744
260700,201910,6000,17390,5646,16969,24,80,5469,16556,5493,16636
260710,201910,1315,3531,1152,3301,34,139,893,2559,927,2698
260720,201910,22312,57097,19496,53116,2145,6052,13627,36672,15772,42724
260730,201910,7408,21645,6508,20363,276,1042,5392,16597,5668,17639
260740,201910,1326,3722,1100,3359,11,60,873,2715,884,2775
260750,201910,6964,19325,5870,17919,115,399,5227,16165,5342,16564
260760,201910,5592,13303,4785,12324,194,559,3909,10082,4103,10641
260765,201910,7735,22611,6711,21168,448,1877,4700,14459,5148,16336
260770,201910,3820,9826,3204,8783,97,334,2544,6877,2641,7211
260775,201910,5194,13841,4569,12859,202,743,3540,9639,3742,10382
260780,201910,3571,10573,3169,9924,283,1083,2060,6230,2343,7313
260790,201910,116613,262939,96364,235909,14986,35690,59303,145220,74289,180910
260795,201910,2998,7778,2562,7179,100,339,1968,5521,2068,5860
260800,201910,5385,12602,4784,11741,141,460,4189,9917,4330,10377
260805,201910,3575,10189,2990,9137,171,625,2207,6602,2378,7227
260810,201910,6533,17664,5713,16081,520,1419,4065,11224,4585,12643
260820,201910,4340,10291,3825,9658,121,427,3151,7786,3272,8213
260825,201910,2898,8659,2506,7966,110,409,1859,5826,1969,6235
260830,201910,4246,12333,3533,11033,464,1298,2238,7186,2702,8484
260840,201910,4170,10902,3711,10247,210,562,3075,8485,3285,9047
260845,201910,4159,11069,3712,10272,242,669,2791,7654,3033,8323
260850,201910,4810,13348,4017,11794,344,1089,2626,7481,2970,8570
260860,201910,3464,9763,2912,8805,97,351,2331,6855,2428,7206
260870,201910,4488,10788,3852,10002,81,324,3420,8706,3501,9030
260875,201910,6780,16897,5510,14986,561,1549,3765,10184,4326,11733
260880,201910,9695,27113,8397,24829,503,1486,6556,19396,7059,20882
260890,201910,13030,33659,11277,30924,670,2054,8135,21711,8805,23765
260900,201910,5197,14782,4307,13439,305,1081,2870,8849,3175,9930
260910,201910,3157,8674,2725,7997,98,336,2148,6241,2246,6577
260915,201910,5139,15099,4508,14332,56,290,4111,13054,4167,13344
260920,201910,3296,8228,2786,7653,87,247,2363,6534,2450,6781
260930,201910,3639,11512,3117,10553,181,733,2315,7639,2496,8372
260940,201910,14443,34789,12535,32023,867,2309,9468,23739,10335,26048
260950,201910,6549,17703,5298,15491,371,1279,3369,9387,3740,10666
260960,201910,67404,152650,53912,134812,6176,16075,33901,83314,40077,99389
260970,201910,5369,14281,4770,13457,201,517,3648,10321,3849,10838
260980,201910,4499,13121,3984,12460,62,226,3609,11388,3671,11614
260990,201910,17902,49679,15069,45775,901,3078,11614,34918,12515,37996
261000,201910,16058,38186,13494,34790,425,1555,10759,27018,11184,28573
261010,201910,2386,6228,2084,5813,73,191,1811,5066,1884,5257
261020,201910,6065,16497,5147,14904,208,761,4140,11489,4348,12250
261030,201910,4046,11604,3474,10642,138,558,2744,8162,2882,8720
261040,201910,5151,15143,4127,13116,174,705,3057,9486,3231,10191
261050,201910,7688,20168,6967,18995,451,971,5191,14205,5642,15176
261060,201910,13840,34826,12085,32653,311,1041,10028,26777,10339,27818
261070,201910,61658,135062,50876,120663,2884,6821,38671,89822,41555,96643
261080,201910,6351,15579,5801,14862,136,339,5328,13625,5464,13964
261090,201910,18486,44441,16402,41731,322,1159,14193,35470,14515,36629
261100,201910,8205,22850,7060,21134,526,1695,5107,15302,5633,16997
261110,201910,61010,171381,50927,153551,7971,25156,28963,86794,36934,111950
261120,201910,3757,9323,3207,8577,89,230,2744,7351,2833,7581
261130,201910,7279,17777,6369,16533,134,376,5601,14434,5735,14810
261140,201910,3575,8277,3184,7761,167,448,2560,6116,2727,6564
261150,201910,5292,13844,4647,12872,83,324,4037,11027,4120,11351
261153,201910,1845,5552,1583,5044,59,220,1086,3454,1145,3674
261160,201910,204559,478598,165245,423288,40823,107641,68192,177251,109015,284892
261170,201910,5951,14915,5285,13900,358,887,4204,10974,4562,11861
261180,201910,9577,24046,8363,22427,452,1247,6072,16240,6524,17487
261190,201910,4547,13422,4061,12595,218,915,3120,9360,3338,10275
261200,201910,3346,7741,2975,7233,140,379,2477,5887,2617,6266
261210,201910,1921,4612,1612,4182,61,187,1350,3437,1411,3624
261220,201910,13605,38648,11227,34160,1440,4718,6381,19092,7821,23810
261230,201910,4063,11630,3399,10688,63,270,2809,8888,2872,9158
261240,201910,5227,13197,4562,12144,255,714,3759,9855,4014,10569
261245,201910,3534,10015,2971,9010,79,363,2348,6887,2427,7250
261247,201910,2877,8634,2381,7714,140,522,1646,5263,1786,5785
261250,201910,21578,49573,18546,45980,1629,3667,14156,35918,15785,39585
261255,201910,4035,11915,3287,10461,140,611,2415,7431,2555,8042
261260,201910,12761,34230,10987,31944,357,1510,9390,26847,9747,28357
261270,201910,4210,10712,3713,10046,171,547,3097,8207,3268,8754
261280,201910,2552,7116,2238,6569,73,276,1774,5074,1847,5350
261290,201910,2919,7618,2461,7076,78,317,1993,5741,2071,6058
261300,201910,11952,33753,10079,30537,599,2212,7234,21402,7833,23614
261310,201910,8700,22305,7387,20454,693,2161,5305,14261,5998,16422
261320,201910,5941,16792,5168,15481,86,390,4312,12680,4398,13070
261330,201910,5942,14591,5336,13783,125,457,4649,11770,4774,12227
261340,201910,4173,11902,3611,11140,153,577,2914,8879,3067,9456
261350,201910,8717,25347,7726,23681,121,576,6322,19021,6443,19597
261360,201910,8155,19781,6888,17972,232,738,5475,13817,5707,14555
261370,201910,22373,56531,18787,51505,2157,5896,12050,33178,14207,39074
261380,201910,3964,12042,3511,11235,465,1600,2280,7181,2745,8781
261390,201910,16245,46456,13607,42120,1209,4095,8920,27375,10129,31470
261400,201910,4587,14608,3960,13256,163,757,2951,9583,3114,10340
261410,201910,9405,23699,7728,21058,535,1495,5951,15890,6486,17385
261420,201910,7240,21866,6548,21003,784,2888,4576,14560,5360,17448
261430,201910,3413,9617,2853,8743,69,291,2364,7125,2433,7416
261440,201910,1452,4335,1215,3868,38,192,870,2638,908,2830
261450,201910,14993,40425,13271,37716,227,880,10966,31046,11193,31926
261460,201910,7431,20488,6569,19170,172,670,5467,15745,5639,16415
261470,201910,4187,10403,3668,9714,30,156,3131,8275,3161,8431
261480,201910,5029,15467,4319,14251,207,862,3337,10753,3544,11615
261485,201910,4984,14159,4239,12954,371,1235,2948,8858,3319,10093
261500,201910,5738,14860,4998,13839,387,962,3488,9970,3875,10932
261510,201910,1865,5590,1604,5142,63,238,1196,3876,1259,4114
261520,201910,2356,7230,2124,6744,87,314,1516,4819,1603,5133
261530,201910,11518,34095,9288,29865,996,3820,4631,14314,5627,18134
261540,201910,8024,23030,7180,21783,1072,3236,4078,12927,5150,16163
261550,201910,3603,9628,3115,8853,213,683,2234,6215,2447,6898
261560,201910,7783,23117,6711,21496,336,1264,5049,16181,5385,17445
261570,201910,3467,9332,2756,8172,202,729,1894,5464,2096,6193
261580,201910,6605,17434,5788,16344,124,570,5147,14311,5271,14881
261590,201910,2650,6802,2112,6032,71,232,1576,4457,1647,4689
261600,201910,5015,12881,4199,11642,375,942,2839,8143,3214,9085
261610,201910,2256,6282,1827,5548,92,346,1273,3824,1365,4170
261618,201910,2532,6367,2190,5864,70,211,1760,4647,1830,4858
261620,201910,4060,11538,3748,11079,860,2275,2289,7123,3149,9398
261630,201910,6303,17622,5328,15783,361,1304,3576,10133,3937,11437
261640,201910,36916,82932,31459,76118,1741,3546,23986,59443,25727,62989
261650,201910,4135,10269,3554,9501,155,506,2655,7021,2810,7527
270010,201910,4276,14436,3697,13435,168,948,2898,10241,3066,11189
270020,201910,3866,9735,3384,9116,148,513,2867,7529,3015,8042
270030,201910,32479,88970,27371,80784,3734,10786,18033,53476,21767,64262
270040,201910,10843,29176,9310,27349,370,1497,7689,22288,8059,23785
270050,201910,5521,12716,4691,11784,201,493,4120,10390,4321,10883
270060,201910,2046,5289,1706,4891,111,302,1387,4015,1498,4317
270070,201910,4617,13030,4003,12152,154,583,3337,9935,3491,10518
270080,201910,1418,3881,1177,3467,41,129,898,2536,939,2665
270090,201910,1816,5526,1613,5138,69,299,1302,4023,1371,4322
270100,201910,5493,14644,4753,13549,173,673,3877,10775,4050,11448
270110,201910,3236,7704,2586,6929,143,361,2043,5693,2186,6054
270120,201910,2828,7670,2450,7169,76,323,2062,5944,2138,6267
270130,201910,5091,13160,4399,12335,131,439,3766,10545,3897,10984
270135,201910,2005,4825,1699,4480,57,178,1513,3969,1570,4147
270140,201910,9713,22581,7758,19844,326,1191,6137,14858,6463,16049
270150,201910,2720,8118,2507,7809,5,27,2374,7381,2379,7408
270160,201910,6032,16598,5185,15605,63,381,4793,14284,4856,14665
270170,201910,3410,9937,2867,9177,189,883,2142,6580,2331,7463
270180,201910,2244,6913,2042,6650,41,200,1818,5861,1859,6061
270190,201910,1632,4880,1456,4655,40,205,1262,3986,1302,4191
270200,201910,2387,7236,2058,6777,115,448,1507,4887,1622,5335
270210,201910,5710,13494,4890,12567,89,369,4478,11309,4567,11678
270220,201910,1423,3766,1127,3349,202,622,633,1854,835,2476
270230,201910,9154,25532,7549,23021,667,2274,5293,15906,5960,18180
270235,201910,5756,17737,4964,16445,141,638,4010,13097,4151,13735
270240,201910,10579,28804,8498,25984,842,2840,6100,18553,6942,21393
270250,201910,2771,7032,2408,6518,197,523,1867,5063,2064,5586
270255,201910,4467,12803,3444,10908,119,487,2579,8019,2698,8506
270260,201910,5612,16508,5088,15640,108,548,4421,13228,4529,13776
270270,201910,1032,2697,863,2482,109,325,617,1748,726,2073
270280,201910,3931,9381,3116,8351,468,767,2181,6297,2649,7064
270290,201910,7497,23847,6714,22532,197,913,5741,19030,5938,19943
270300,201910,4154,10927,3240,9922,162,482,2478,7732,2640,8214
270310,201910,6941,19418,5968,17944,135,678,5030,14687,5165,15365
270320,201910,5473,15990,4751,14624,481,1550,3311,9948,3792,11498
270330,201910,3832,12567,3395,11900,265,1088,2581,8976,2846,10064
270340,201910,1608,4405,1392,4114,57,180,1150,3355,1207,3535
270350,201910,1812,4367,1484,3967,163,472,1015,2743,1178,3215
270360,201910,2542,6473,2262,6153,73,186,2067,5636,2140,5822
270370,201910,1356,4247,1227,3994,44,209,1000,3196,1044,3405
270375,201910,3090,7191,2573,6615,19,57,2414,6219,2433,6276
270380,201910,5469,15558,4584,14378,617,1913,2920,9492,3537,11405
270390,201910,1194,3010,979,2761,24,105,806,2258,830,2363
270400,201910,6192,16502,5179,14909,216,685,4060,11478,4276,12163
270410,201910,4554,13241,3948,12275,178,639,3250,10011,3428,10650
270420,201910,5452,16208,4930,15446,133,653,4237,12976,4370,13629
270430,201910,135787,326072,106625,288407,21536,60627,50101,137254,71637,197881
270440,201910,4737,12820,4081,12008,95,418,3507,10180,3602,10598
270450,201910,6783,18457,6003,17517,253,954,5057,14663,5310,15617
270460,201910,3760,8319,3255,7730,117,266,2949,6946,3066,7212
270470,201910,11010,30783,9531,28628,738,2433,7178,21506,7916,23939
270480,201910,2892,7706,2454,7071,109,441,1979,5538,2088,5979
270490,201910,952,2666,824,2509,48,168,659,1978,707,2146
270500,201910,4892,15005,4350,14131,273,1062,3378,10819,3651,11881
270510,201910,5526,14814,4683,13703,360,1435,3476,9680,3836,11115
270520,201910,3812,11002,2994,9552,640,2119,1218,4016,1858,6135
270530,201910,1197,3459,1026,3198,50,141,745,2344,795,2485
270540,201910,2148,6287,1867,5920,62,297,1607,4979,1669,5276
270550,201910,6645,17279,5347,15841,577,1423,4005,12321,4582,13744
270560,201910,2963,7780,2574,7254,153,474,2041,5682,2194,6156
270570,201910,4122,11609,3479,10619,110,404,2827,8519,2937,8923
270580,201910,2283,6476,2068,6159,97,295,1773,5241,1870,5536
270590,201910,1608,4799,1480,4633,17,91,1396,4346,1413,4437
270600,201910,2712,8386,2450,7979,52,281,2168,6948,2220,7229
270610,201910,3672,9569,3129,8849,80,296,2775,7757,2855,8053
270620,201910,1189,3684,1083,3476,37,160,924,2881,961,3041
270630,201910,17092,42041,14731,38746,604,1949,12303,31598,12907,33547
270640,201910,5313,15311,4601,14165,164,668,3746,11258,3910,11926
270642,201910,2473,7976,2182,7490,157,696,1661,5543,1818,6239
270644,201910,3534,8837,2870,7962,243,625,2162,6112,2405,6737
270650,201910,3079,9127,2709,8590,417,1389,1818,5716,2235,7105
270660,201910,2044,5151,1669,4616,83,311,1255,3392,1338,3703
270670,201910,15893,37101,13225,33818,435,1373,11167,27904,11602,29277
270680,201910,5374,13064,4779,12395,125,188,4467,11737,4592,11925
270690,201910,8907,22188,7331,20207,646,1718,5529,15252,6175,16970
270700,201910,524,1568,458,1457,30,124,340,1064,370,1188
270710,201910,5442,16449,4877,15594,239,1019,3946,12323,4185,13342
270720,201910,3427,10262,3020,9560,67,381,2659,8232,2726,8613
270730,201910,8086,18077,7103,16990,237,502,5644,14820,5881,15322
270740,201910,2344,6169,2073,5847,98,344,1715,4730,1813,5074
270750,201910,5592,14953,4884,14021,115,505,4244,12087,4359,12592
270760,201910,3275,9283,2844,8694,55,290,2393,7213,2448,7503
270770,201910,20626,50328,16280,44975,2573,6494,10140,29480,12713,35974
270780,201910,1724,4984,1588,4792,102,375,1278,3777,1380,4152
270790,201910,1529,4372,1278,3997,105,354,875,2703,980,3057
270800,201910,10679,29468,9545,27863,360,1357,8138,23274,8498,24631
270810,201910,3254,9309,2535,8065,175,695,1771,5507,1946,6202
270820,201910,1667,4976,1392,4509,54,243,1075,3399,1129,3642
270830,201910,5238,12472,4209,11195,172,567,3386,8877,3558,9444
270840,201910,8161,24286,7279,23050,191,1065,6380,19630,6571,20695
270850,201910,8954,21374,7962,20171,651,1908,6556,16230,7207,18138
270860,201910,12645,29638,10396,26991,379,1252,8646,21985,9025,23237
270870,201910,2113,5995,1750,5386,224,705,1162,3630,1386,4335
270880,201910,8075,24136,7208,22828,232,1001,5940,18453,6172,19454
270890,201910,2712,7416,2296,6822,184,592,1600,4709,1784,5301
270895,201910,3026,9509,2764,9157,81,431,2429,7883,2510,8314
270900,201910,1780,4597,1335,3875,41,123,1043,3009,1084,3132
270910,201910,3836,11225,3284,10311,106,418,2617,8080,2723,8498
270915,201910,9201,26613,7452,23643,684,2561,5014,15480,5698,18041
270920,201910,5119,15994,4612,15136,175,860,3755,11892,3930,12752
270930,201910,17011,39863,13183,35369,1853,4526,8927,24866,10780,29392
270940,201910,6389,17067,5491,15974,196,958,4429,12473,4625,13431
280010,201910,671,1837,532,1538,14,53,376,972,390,1025
280020,201910,4698,12095,4005,10997,496,1259,2661,7382,3157,8641
280030,201910,72948,172616,56594,149290,12601,33492,24808,67960,37409,101452
280040,201910,2946,8263,2561,7673,253,828,1713,5052,1966,5880
280050,201910,3853,10986,3310,10110,555,1763,1945,5938,2500,7701
280060,201910,5498,14666,4351,12872,793,2448,2153,6592,2946,9040
280067,201910,6835,17121,5799,15552,326,922,4231,11099,4557,12021
280070,201910,1890,5697,1759,5477,86,326,1471,4480,1557,4806
280100,201910,3892,10478,3254,9434,315,968,2271,6521,2586,7489
280110,201910,1363,3722,1190,3458,22,101,1037,2936,1059,3037
280120,201910,7414,21656,6607,20343,738,2115,4851,15226,5589,17341
280130,201910,9029,21257,7881,19606,444,1179,6358,15670,6802,16849
280140,201910,5493,13197,4819,12282,219,635,4053,10208,4272,10843
280150,201910,3991,9995,3445,9287,249,637,2766,7456,3015,8093
280160,201910,1234,3539,1024,3174,105,348,680,2054,785,2402
280170,201910,5154,13588,4577,12812,241,689,3631,10130,3872,10819
280190,201910,1205,2685,1020,2424,59,152,807,1873,866,2025
280200,201910,1264,3335,1036,2979,98,347,734,2046,832,2393
280210,201910,16081,40760,13947,37637,1588,4511,8887,23852,10475,28363
280220,201910,1755,4709,1490,4341,44,215,1223,3526,1267,3741
280230,201910,4074,10341,3466,9446,265,666,2507,6824,2772,7490
280240,201910,3343,8925,3001,8412,59,308,2547,6917,2606,7225
280250,201910,854,2155,679,1882,56,183,435,1154,491,1337
280260,201910,2099,5167,1864,4880,38,99,1721,4507,1759,4606
280270,201910,2297,6392,2027,5954,113,402,1702,4883,1815,5285
280280,201910,4138,12419,3681,11761,465,1345,2598,8596,3063,9941
280290,201910,17512,46579,14991,43001,1307,4089,10194,29351,11501,33440
280300,201910,11488,28377,9967,26725,280,854,7650,22020,7930,22874
280310,201910,1360,3504,1124,3098,32,115,842,2245,874,2360
280320,201910,8523,23109,7343,21315,850,2546,4918,14044,5768,16590
280330,201910,4589,11422,3848,10359,269,741,2827,7531,3096,8272
280340,201910,5486,11444,4590,10478,216,393,3981,9220,4197,9613
280350,201910,25299,59918,21982,55420,1212,3308,17146,42417,18358,45725
280360,201910,5755,16057,4993,14749,774,2316,2902,8645,3676,10961
280370,201910,2183,5379,1780,4694,60,165,1408,3625,1468,3790
280380,201910,967,2659,816,2450,73,228,542,1627,615,1855
280390,201910,3600,8988,2974,7959,130,339,2368,6284,2498,6623
280400,201910,3857,9868,3300,9086,483,1168,2041,5911,2524,7079
280410,201910,2202,6164,1741,5365,200,650,1023,3068,1223,3718
280420,201910,4329,11603,3932,11078,86,318,3563,9963,3649,10281
280430,201910,2025,4964,1768,4618,62,243,1434,3604,1496,3847
280440,201910,4236,11426,3690,10601,166,590,3080,8607,3246,9197
280445,201910,2280,5770,2012,5292,52,166,1530,3848,1582,4014
280450,201910,10257,23529,8913,21733,690,1346,6770,16879,7460,18225
280460,201910,6817,16278,6156,15334,394,956,5146,12681,5540,13637
280470,201910,1687,4817,1445,4379,55,214,1064,3139,1119,3353
280480,201910,40963,99970,35299,92017,2872,8169,25294,64495,28166,72664
280490,201910,3642,10358,3130,9472,86,379,2432,7129,2518,7508
280500,201910,986,2366,832,2154,33,128,699,1765,732,1893
280510,201910,2538,6554,2176,6015,82,312,1667,4488,1749,4800
280520,201910,1595,4089,1390,3811,71,189,1105,2995,1176,3184
280530,201910,2551,6319,2166,5793,312,713,1505,4118,1817,4831
280540,201910,8943,24088,8100,22839,242,893,7068,19577,7310,20470
280550,201910,6619,15485,5373,13694,227,782,4333,10616,4560,11398
280560,201910,6983,19756,6535,19069,134,520,5731,16504,5865,17024
280570,201910,6404,15641,5167,14037,207,712,3847,10300,4054,11012
280580,201910,5548,15050,4750,13820,512,1455,3332,9727,3844,11182
280590,201910,2916,6565,2458,6030,117,427,1913,4477,2030,4904
280600,201910,3548,9528,3112,8890,162,518,2219,6320,2381,6838
280610,201910,2475,6109,2224,5735,140,365,1810,4613,1950,4978
280620,201910,5342,13218,4513,12106,407,919,3188,8873,3595,9792
280630,201910,3802,10800,3447,10277,176,620,2778,8191,2954,8811
280640,201910,2389,6418,2103,6089,64,205,1865,5390,1929,5595
280650,201910,1193,3129,947,2754,98,323,681,1896,779,2219
280660,201910,3253,7461,2837,6954,122,305,2479,6021,2601,6326
280670,201910,19390,43807,16695,40330,862,2299,13403,31963,14265,34262
280680,201910,2747,6617,2331,6018,207,390,1690,4418,1897,4808
280690,201910,924,2313,761,2084,30,94,590,1583,620,1677
280700,201910,1139,2884,971,2620,21,94,772,2030,793,2124
280710,201910,15071,33992,12695,31274,481,985,10858,27250,11339,28235
280720,201910,2651,6018,2172,5451,75,235,1498,3937,1573,4172
280730,201910,1049,2705,931,2509,48,140,709,1857,757,1997
280740,201910,14083,34430,11913,31092,811,2262,8459,21562,9270,23824
280750,201910,3561,10005,3099,9178,175,603,2231,6477,2406,7080
280760,201910,6287,16989,5469,15719,552,1486,3663,10787,4215,12273
290010,201910,3170,6661,2063,4928,9,32,1680,3821,1689,3853
290020,201910,5416,14325,4896,13646,346,676,4107,11824,4453,12500
290030,201910,4408,10346,3601,9445,169,429,3042,8024,3211,8453
290035,201910,5177,11334,4203,10063,383,618,3299,8251,3682,8869
290040,201910,4199,10242,3562,9465,121,308,2829,7837,2950,8145
290050,201910,2029,6496,1694,5772,128,517,1127,3742,1255,4259
290060,201910,1304,3157,948,2575,67,226,637,1691,704,1917
290070,201910,36306,80195,31096,73580,1812,4530,23915,55880,25727,60410
290080,201910,5308,15668,4509,14456,461,1635,3122,10059,3583,11694
290090,201910,2174,4196,1547,3527,20,66,1407,3173,1427,3239
290100,201910,9755,25647,7879,22791,1270,3467,4350,13095,5620,16562
290110,201910,5158,13689,4567,12710,356,1042,3253,8962,3609,10004
290115,201910,3980,11520,3336,10382,230,785,2474,7620,2704,8405
290120,201910,6454,16069,5439,14675,127,458,4686,12441,4813,12899
290130,201910,4673,11307,3649,9991,167,533,2841,7700,3008,8233
290135,201910,4216,9904,3394,8545,216,564,2591,6346,2807,6910
290140,201910,4481,11904,3488,10557,101,407,2957,8853,3058,9260
290150,201910,2455,6428,2112,5993,145,420,1610,4553,1755,4973
290160,201910,3181,7501,2819,7007,327,704,2127,5356,2454,6060
290170,201910,3298,8498,2912,8064,110,312,2580,7191,2690,7503
290180,201910,2953,8071,2419,7180,82,301,1961,5759,2043,6060
290190,201910,4137,11862,3624,11165,160,688,2952,8923,3112,9611
290195,201910,2365,5858,1857,5155,30,154,1552,4261,1582,4415
290200,201910,4074,11345,3319,10084,219,752,2510,7548,2729,8300
290205,201910,3356,8632,2951,8035,137,499,2312,6074,2449,6573
290210,201910,13303,36854,11639,34308,937,2510,8855,26627,9792,29137
290220,201910,2819,7069,2462,6609,131,380,2006,5329,2137,5709
290225,201910,3317,7069,2566,6269,166,293,2147,5343,2313,5636
290230,201910,2498,6582,2257,6296,32,103,2023,5624,2055,5727
290240,201910,3641,9208,2919,8274,84,295,2461,6928,2545,7223
290250,201910,4024,11696,3395,10772,126,438,2743,8847,2869,9285
290260,201910,5331,13266,4354,11874,184,652,3562,9451,3746,10103
290265,201910,3468,10185,2782,8845,157,594,2044,6407,2201,7001
290270,201910,11143,37910,10439,36686,549,2441,8351,28967,8900,31408
290280,201910,5941,17822,5126,16219,308,1111,3689,11510,3997,12621
290290,201910,9830,28679,7931,25122,822,2851,5210,16205,6032,19056
290300,201910,4266,11551,3119,9360,164,548,2226,6643,2390,7191
290310,201910,1554,3900,1259,3533,70,292,950,2563,1020,2855
290320,201910,24089,63335,18997,55420,4262,12315,9019,27547,13281,39862
290323,201910,3741,10170,3229,9378,98,317,2575,7413,2673,7730
290327,201910,4143,12010,3495,10738,274,806,2463,7518,2737,8324
290330,201910,2177,4593,1696,4069,48,92,1497,3616,1545,3708
290340,201910,5626,14302,4348,12694,480,1458,3075,9110,3555,10568
290350,201910,4723,13118,3884,11692,283,882,2772,8363,3055,9245
290360,201910,5016,13221,4394,12398,127,385,3803,10744,3930,11129
290370,201910,5252,12727,3845,10879,165,382,2848,8216,3013,8598
290380,201910,5588,14867,4706,13642,111,298,4066,11960,4177,12258
290390,201910,14538,40826,12062,37043,1286,3824,8012,25056,9298,28880
290395,201910,2784,8137,2258,7216,73,352,1757,5498,1830,5850
290400,201910,3744,10030,2986,8775,84,362,2289,6531,2373,6893
290405,201910,4565,13396,3856,12140,273,924,2705,8640,2978,9564
290410,201910,5700,15661,4378,13464,125,598,3307,9826,3432,10424
290420,201910,2961,8324,2419,7451,71,268,1858,5666,1929,5934
290430,201910,3104,8585,2527,7678,251,803,1667,5024,1918,5827
290440,201910,2797,7066,1985,5790,40,126,1411,4192,1451,4318
290450,201910,3355,8738,2648,7674,147,457,1980,5714,2127,6171
290460,201910,11728,32900,9800,29227,1969,5993,4525,13374,6494,19367
290470,201910,4466,11107,3287,9458,382,1206,1868,5427,2250,6633
290475,201910,6471,18756,5418,16863,114,586,4350,13208,4464,13794
290480,201910,1748,4448,1443,4004,91,303,992,2625,1083,2928
290485,201910,4522,13216,3990,12445,120,612,3370,10278,3490,10890
290490,201910,9177,21564,8117,20111,525,1229,6361,15892,6886,17121
290500,201910,3919,11848,2982,9750,531,1809,1338,4266,1869,6075
290510,201910,3424,8545,2843,7791,75,264,2445,6630,2520,6894
290515,201910,3705,10103,3172,9382,48,145,2818,8508,2866,8653
290520,201910,11297,32305,8661,27120,508,1786,5419,16669,5927,18455
290530,201910,4942,14140,4170,12849,133,500,3499,10730,3632,11230
290540,201910,3424,9085,3050,8629,69,234,2795,7870,2864,8104
290550,201910,4297,11213,3707,10514,13,60,3418,9806,3431,9866
290560,201910,6473,16794,4901,14434,426,1549,3242,9178,3668,10727
290570,201910,43190,106675,38483,100624,2441,6599,30982,80396,33423,86995
290580,201910,7846,23056,6784,21503,631,2005,4892,15848,5523,17853
290590,201910,7008,21688,5926,19728,143,592,4811,16036,4954,16628
290600,201910,18570,51744,16398,48231,708,2272,13117,38438,13825,40710
290610,201910,2528,7940,1956,6748,94,405,1365,4640,1459,5045
290620,201910,6513,18203,5576,16631,211,625,4644,13796,4855,14421
290630,201910,9136,22246,7229,19711,599,1583,5547,15263,6146,16846
290640,201910,2731,7109,2085,6148,75,233,1541,4547,1616,4780
290650,201910,12691,32154,11277,30487,2713,7001,6641,18878,9354,25879
290660,201910,3663,9415,3047,8526,48,119,2287,6644,2335,6763
290670,201910,6638,18550,5617,16851,387,1121,4295,13016,4682,14137
290680,201910,10685,29806,9000,27310,194,1049,7395,21920,7589,22969
290682,201910,4706,12304,4081,11437,135,332,3444,9720,3579,10052
290685,201910,3357,7641,2399,6269,188,472,1525,4229,1713,4701
290687,201910,6611,17924,5333,15790,720,2038,3385,10281,4105,12319
290689,201910,2780,7833,2172,6730,121,371,1612,5008,1733,5379
290690,201910,5566,14321,4470,12766,349,1071,3220,9065,3569,10136
290700,201910,2597,7110,2276,6687,73,238,1884,5568,1957,5806
290710,201910,8318,23419,7063,21655,160,677,5989,18304,6149,18981
290720,201910,18723,51134,16916,48356,951,3112,13379,37647,14330,40759
290730,201910,7100,16995,6040,15749,297,633,4732,12480,5029,13113
290740,201910,1031,2795,775,2364,34,133,619,1884,653,2017
290750,201910,11011,27601,9489,25102,697,1995,6944,17789,7641,19784
290755,201910,2083,5852,1670,5086,96,315,1153,3506,1249,3821
290760,201910,3769,11025,3000,9545,202,609,2002,6513,2204,7122
290770,201910,2619,8449,2366,8138,52,275,1995,6889,2047,7164
290780,201910,8273,20430,7081,18826,282,643,5586,15083,5868,15726
290790,201910,4668,12757,4045,11896,155,461,3390,10091,3545,10552
290800,201910,7168,14855,5076,12391,319,749,3748,9218,4067,9967
290810,201910,5445,14306,4319,12629,118,385,3240,9630,3358,10015
290820,201910,4822,13040,4319,12289,178,542,3280,9448,3458,9990
290830,201910,4535,10279,4054,9664,37,106,3552,8347,3589,8453
290840,201910,16746,44780,14478,41215,1864,4464,9343,28076,11207,32540
290850,201910,6505,15878,5845,15157,272,677,4952,12972,5224,13649
290860,201910,6002,17450,5222,16519,219,739,4404,14155,4623,14894
290870,201910,4791,13224,3611,10995,119,409,2548,7668,2667,8077
290880,201910,1376,3463,1090,3086,65,184,768,2224,833,2408
290890,201910,9124,18556,8149,17439,168,380,7616,16205,7784,16585
290900,201910,2317,6084,1729,5092,100,280,1113,3245,1213,3525
290910,201910,5101,12252,3871,10384,43,144,3253,8638,3296,8782
290920,201910,5077,12708,4622,12167,52,114,4353,11543,4405,11657
290930,201910,7750,21649,6192,18927,196,899,4819,14265,5015,15164
290940,201910,3712,10394,3056,9452,173,666,2401,7429,2574,8095
290950,201910,1465,3700,1191,3293,64,181,846,2343,910,2524
290960,201910,5486,14456,4891,13701,161,433,4125,11550,4286,11983
290970,201910,3448,10035,2793,8871,114,420,2122,6729,2236,7149
290980,201910,12054,29115,10073,25983,826,2307,6237,15588,7063,17895
290990,201910,9398,25140,8206,23183,283,1135,6841,18665,7124,19800
291000,201910,3371,8851,2637,7922,134,402,2140,6512,2274,6914
291005,201910,15137,37275,13288,34812,1087,2755,10491,27449,11578,30204
291010,201910,2954,8974,2376,7749,117,443,1578,5006,1695,5449
291020,201910,1269,3148,1011,2664,21,75,742,1856,763,1931
291030,201910,2461,6024,1697,4686,97,262,1083,2904,1180,3166
291040,201910,5341,14817,4497,13612,174,715,3522,10587,3696,11302
291050,201910,7576,20038,6495,18480,717,2273,4591,12794,5308,15067
291060,201910,5859,18230,5041,17085,338,1433,3815,12810,4153,14243
291070,201910,15678,42453,13074,38275,463,1642,10574,30676,11037,32318
291072,201910,23952,61821,17122,49833,3268,9866,7322,21534,10590,31400
291075,201910,5279,13241,4700,12329,111,303,3886,9988,3997,10291
291077,201910,1575,4117,1217,3490,45,111,868,2484,913,2595
291080,201910,92470,237835,72832,209364,23517,69359,18637,57239,42154,126598
291085,201910,5613,14229,4718,12857,204,652,3942,10655,4146,11307
291090,201910,1970,3677,1428,3077,34,75,1184,2522,1218,2597
291100,201910,3165,6981,2186,5793,117,336,1668,4357,1785,4693
291110,201910,5959,17704,5036,16110,332,1351,3752,11522,4084,12873
291120,201910,7638,18725,6454,17207,324,947,4918,13051,5242,13998
291125,201910,2171,3834,1601,3198,124,183,1223,2528,1347,2711
291130,201910,3186,9148,2335,7440,89,408,1679,5149,1768,5557
291140,201910,4751,12939,3445,10490,423,1132,2150,6588,2573,7720
291150,201910,2384,5251,1877,4677,6,22,1767,4391,1773,4413
291160,201910,5126,14055,4199,12679,403,1265,2759,8271,3162,9536
291165,201910,2122,5815,1617,4861,44,192,1172,3379,1216,3571
291170,201910,20687,52433,17255,46595,970,2869,11329,30090,12299,32959
291180,201910,6100,14294,4469,12025,316,805,3396,9181,3712,9986
291185,201910,3082,8359,2703,7737,86,261,2075,5912,2161,6173
291190,201910,7551,18647,6232,16915,324,1026,4887,13195,5211,14221
291200,201910,2752,7620,2023,6223,97,326,1228,3660,1325,3986
291210,201910,6871,14990,5215,13050,155,514,3894,9758,4049,10272
291220,201910,3978,11407,3578,10779,195,723,2789,8285,2984,9008
291230,201910,4422,9583,3395,8449,46,107,3040,7643,3086,7750
291240,201910,4234,10866,3631,9874,65,219,3109,8327,3174,8546
291250,201910,3411,10050,2665,8684,166,533,1724,5637,1890,6170
291260,201910,1433,3358,1186,3037,35,106,970,2482,1005,2588
291270,201910,5299,13952,4151,12226,624,1819,2635,7917,3259,9736
291280,201910,2472,6184,1846,5242,125,428,1201,3282,1326,3710
291290,201910,5852,15501,4539,13421,340,1121,3137,9166,3477,10287
291300,201910,3829,10334,2920,8818,118,424,2209,6551,2327,6975
291310,201910,5079,13606,4302,12152,107,368,3614,10015,3721,10383
291320,201910,6105,17084,4684,14405,1096,3137,2264,7398,3360,10535
291330,201910,1777,4490,1466,3967,80,219,1090,2901,1170,3120
291340,201910,4206,10861,3413,9490,85,266,2595,7080,2680,7346
291345,201910,2929,8848,2662,8428,120,429,2214,6992,2334,7421
291350,201910,6815,17039,5287,15129,66,215,4529,13187,4595,13402
291360,201910,36607,84840,28838,75244,2913,7743,18630,49482,21543,57225
291370,201910,7815,21592,6937,20264,506,1628,5159,14811,5665,16439
291380,201910,3402,9379,3011,8820,106,422,2479,7187,2585,7609
291390,201910,13117,28373,10229,25169,409,1046,8492,20830,8901,21876
291400,201910,13606,35165,11210,31521,1560,3876,6644,20038,8204,23914
291410,201910,2861,7528,2183,6364,46,195,1603,4570,1649,4765
291420,201910,1930,4768,1498,4224,36,141,1288,3620,1324,3761
291430,201910,2813,7970,2417,7313,103,453,1894,5548,1997,6001
291440,201910,6301,18147,5387,16612,327,1088,4226,13015,4553,14103
291450,201910,8938,22588,7415,20823,88,158,6509,18877,6597,19035
291460,201910,15351,40929,13465,38094,655,2134,10202,28557,10857,30691
291465,201910,8989,22546,7099,20359,175,780,6042,17184,6217,17964
291470,201910,15887,36262,13268,33325,653,1524,9936,25596,10589,27120
291480,201910,40975,91485,29822,75962,3736,9920,15655,39754,19391,49674
291490,201910,5577,13954,4836,13075,147,470,4354,11701,4501,12171
291500,201910,4989,12209,4125,11058,74,316,3703,9853,3777,10169
291510,201910,4174,10439,3132,9115,61,317,2583,7460,2644,7777
291520,201910,4520,10332,3414,8869,171,485,2613,6730,2784,7215
291530,201910,2245,5221,1583,4341,299,744,913,2733,1212,3477
291535,201910,3327,9810,2970,9168,183,520,2272,7147,2455,7667
291540,201910,2254,5105,1561,4256,59,225,1299,3456,1358,3681
291550,201910,5546,12812,4329,11231,406,901,2951,7802,3357,8703
291560,201910,18769,43615,13259,36612,1202,3215,8394,24022,9596,27237
291570,201910,2409,5729,1891,5077,52,145,1567,4324,1619,4469
291580,201910,6210,16137,4857,14309,223,751,3634,10567,3857,11318
291590,201910,2048,5165,1773,4824,91,337,1515,4012,1606,4349
291600,201910,5101,12411,3798,10355,390,1164,2487,6564,2877,7728
291610,201910,5739,15183,5211,14582,93,344,4759,13289,4852,13633
291620,201910,3131,6988,2292,6054,111,293,1783,4776,1894,5069
291630,201910,3212,7267,2385,6191,218,644,1750,4456,1968,5100
291640,201910,15339,38340,11564,32793,1787,4901,5110,15194,6897,20095
291650,201910,9389,23633,8263,22276,553,1105,6920,19112,7473,20217
291660,201910,2057,5076,1487,4178,126,442,964,2532,1090,2974
291670,201910,2083,5454,1750,4984,102,247,1348,3897,1450,4144
291680,201910,4056,10045,3270,8871,290,810,2316,6230,2606,7040
291685,201910,4665,11111,3700,9874,220,449,2812,7799,3032,8248
291690,201910,4203,9282,2844,7321,207,435,2196,5680,2403,6115
291700,201910,8593,24950,7547,23076,346,1272,6119,18340,6465,19612
291710,201910,5222,12545,3878,10619,229,717,2808,7534,3037,8251
291720,201910,4335,13299,3609,11831,388,1385,2393,7646,2781,9031
291730,201910,6273,16196,5389,15019,278,855,4406,12206,4684,13061
291733,201910,2902,7383,2440,6755,69,192,1781,5166,1850,5358
291735,201910,2923,7637,2322,6594,79,221,1763,4972,1842,5193
291740,201910,3867,10000,2862,8188,99,299,2038,5691,2137,5990
291750,201910,19463,46557,15684,40945,1484,3832,10643,27907,12127,31739
291760,201910,10267,29791,7984,25991,2433,8952,2140,6952,4573,15904
291770,201910,6996,18947,5775,16777,390,1195,4234,11996,4624,13191
291780,201910,5069,13550,4556,12797,91,351,3965,10999,4056,11350
291790,201910,2642,7443,2406,7137,253,660,1788,5449,2041,6109
291800,201910,28776,72979,21426,61785,3362,9393,10802,32232,14164,41625
291810,201910,10674,25500,8830,23216,251,696,7571,19856,7822,20552
291820,201910,3807,10084,3301,9400,98,324,2625,7501,2723,7825
291830,201910,4313,10338,3602,9360,197,481,2857,7455,3054,7936
291835,201910,6411,19190,4957,16335,603,2082,3061,10226,3664,12308
291840,201910,47334,129597,40634,119299,4558,14334,28107,82112,32665,96446
291845,201910,2424,6381,1919,5749,107,350,1536,4644,1643,4994
291850,201910,3912,11185,3220,10009,270,790,2283,7285,2553,8075
291855,201910,2161,4312,1687,3772,42,104,1524,3402,1566,3506
291860,201910,2243,5856,1532,4464,47,141,1034,2890,1081,3031
291870,201910,1309,3292,865,2512,53,158,570,1616,623,1774
291875,201910,2793,8380,2407,7580,72,296,1783,5450,1855,5746
291880,201910,5552,15775,4741,14406,216,669,3588,10901,3804,11570
291890,201910,1574,3285,1017,2623,123,294,693,1787,816,2081
291900,201910,1152,2887,891,2465,21,86,698,1874,719,1960
291905,201910,2536,6420,2021,5579,84,285,1518,4039,1602,4324
291910,201910,2916,7401,2443,6832,60,219,2128,5963,2188,6182
291915,201910,7375,20960,5973,18527,246,907,4446,13802,4692,14709
291920,201910,25712,67769,21822,62201,2286,7071,14892,41583,17178,48654
291930,201910,2502,6812,2118,6258,257,777,1375,4067,1632,4844
291940,201910,3948,10105,2571,7729,194,583,1488,4411,1682,4994
291950,201910,9126,27484,7745,24779,324,1194,5356,16950,5680,18144
291955,201910,15169,38311,13495,36137,1148,3221,10491,28116,11639,31337
291960,201910,3053,8123,2508,7350,117,375,1958,5821,2075,6196
291970,201910,4425,11290,3716,10353,142,497,2811,7821,2953,8318
291980,201910,9815,27884,7712,24339,782,2353,4912,15769,5694,18122
291990,201910,2177,5710,1853,5337,22,93,1739,5014,1761,5107
291992,201910,3977,9640,3079,8443,239,570,2425,6761,2664,7331
291995,201910,2100,5678,1683,5046,49,217,1304,3803,1353,4020
292000,201910,2630,6215,2127,5595,91,369,1694,4400,1785,4769
292010,201910,5851,13531,4716,11910,195,594,3885,9594,4080,10188
292020,201910,4527,13142,3729,11699,204,776,2720,8265,2924,9041
292030,201910,1803,5520,1659,5263,79,286,1061,3301,1140,3587
292040,201910,4271,11115,3359,9757,231,619,2560,7601,2791,8220
292045,201910,3980,10467,2949,8938,42,118,2582,7991,2624,8109
292050,201910,6443,18176,5147,15812,252,916,3261,9824,3513,10740
292060,201910,11551,26770,10649,25649,549,1220,9197,21944,9746,23164
292070,201910,5801,15086,5099,14227,290,853,4388,12143,4678,12996
292080,201910,3184,7956,2596,7204,83,274,2291,6315,2374,6589
292090,201910,4524,9840,3226,8284,249,680,2451,6334,2700,7014
292100,201910,10593,25965,8979,23887,1045,2914,6045,15982,7090,18896
292105,201910,3437,8682,2989,8054,94,239,2425,6552,2519,6791
292110,201910,5942,14672,4160,11754,971,2766,1899,5384,2870,8150
292120,201910,6816,17540,5574,15422,351,1057,4229,11453,4580,12510
292130,201910,3369,8095,2753,7323,110,333,2156,5639,2266,5972
292140,201910,5109,12020,4230,10715,302,767,3369,8459,3671,9226
292145,201910,2314,6716,1939,6062,57,161,1488,4696,1545,4857
292150,201910,13669,37670,11969,34917,311,1260,9850,28294,10161,29554
292160,201910,3003,7346,2249,6377,53,150,1837,5384,1890,5534
292170,201910,8277,22073,6862,19697,393,1285,5092,14350,5485,15635
292180,201910,2814,7686,2026,6246,176,547,1267,3818,1443,4365
292190,201910,2899,7648,2444,6942,113,366,1873,5278,1986,5644
292200,201910,8076,20533,5985,17525,1016,3091,3201,9590,4217,12681
292205,201910,3904,10711,3334,9843,68,318,2924,8532,2992,8850
292210,201910,6414,15041,5151,13418,95,422,4609,11827,4704,12249
292220,201910,2118,5120,1862,4716,55,168,1473,3595,1528,3763
292225,201910,3188,9344,2789,8739,73,345,2355,7232,2428,7577
292230,201910,8588,20384,7647,19179,179,611,6541,16069,6720,16680
292240,201910,4711,13697,4059,12492,316,947,2804,8653,3120,9600
292250,201910,5359,14357,4790,13468,481,1311,3386,9577,3867,10888
292260,201910,3387,8874,3016,8390,114,308,2596,7222,2710,7530
292265,201910,3337,9129,2783,8273,73,337,2181,6324,2254,6661
292270,201910,4390,10014,3485,8935,139,335,2845,7302,2984,7637
292273,201910,2628,5710,2089,5038,61,110,1572,4000,1633,4110
292275,201910,1663,4317,1304,3818,58,159,983,2928,1041,3087
292280,201910,2613,6212,2102,5618,94,199,1767,4864,1861,5063
292285,201910,2570,6230,2022,5481,85,220,1613,4379,1698,4599
292290,201910,7351,19635,5848,17502,175,662,4759,14200,4934,14862
292300,201910,10155,25832,7882,22812,743,2347,5427,15638,6170,17985
292303,201910,2886,8296,2525,7720,75,209,2107,6468,2182,6677
292305,201910,2357,6310,2174,6049,46,219,1950,5315,1996,5534
292310,201910,6706,16939,5750,15760,156,533,4970,13458,5126,13991
292320,201910,6085,16569,4815,14212,242,786,3553,10227,3795,11013
292330,201910,2803,6080,2194,5396,103,229,1694,4313,1797,4542
292335,201910,4746,12209,4210,11440,242,586,3543,9691,3785,10277
292340,201910,5687,15792,4670,13837,222,667,3461,10157,3683,10824
292350,201910,2514,6729,2070,6128,77,280,1673,4951,1750,5231
292360,201910,4826,12984,3998,11556,237,796,2827,7928,3064,8724
292370,201910,10685,24590,9127,22505,139,481,8420,20411,8559,20892
292380,201910,6818,19040,6060,17684,427,1250,4577,13275,5004,14525
292390,201910,4414,8581,3217,7179,96,181,2831,6331,2927,6512
292400,201910,21983,63004,18975,58118,1735,5532,13140,40224,14875,45756
292405,201910,4129,10344,3480,9344,113,305,2844,7555,2957,7860
292410,201910,2154,5140,1841,4754,65,166,1632,4219,1697,4385
292420,201910,3551,10732,3220,10191,123,606,2739,8434,2862,9040
292430,201910,4824,14434,3655,12292,312,1117,2368,7914,2680,9031
292440,201910,8456,26852,7798,25836,139,714,6944,22882,7083,23596
292450,201910,3926,11308,3076,9618,99,394,2386,7414,2485,7808
292460,201910,4821,13274,3929,11744,369,1070,2805,8401,3174,9471
292465,201910,2586,6771,2162,6190,89,198,1498,4623,1587,4821
292467,201910,1852,5220,1644,4933,241,638,1124,3513,1365,4151
292470,201910,2997,7564,2306,6470,60,129,1799,5057,1859,5186
292480,201910,6358,15077,5059,13503,68,278,4559,12035,4627,12313
292490,201910,2075,5452,1718,4915,107,276,1282,3739,1389,4015
292500,201910,6493,17783,5196,15431,536,1669,3381,9925,3917,11594
292510,201910,12616,34005,9918,29887,497,1858,7150,21445,7647,23303
292520,201910,6887,17201,6057,15986,490,1374,4656,12154,5146,13528
292525,201910,5834,13828,4765,12618,106,292,4157,11109,4263,11401
292530,201910,26704,71406,20458,60838,5327,15946,7683,23506,13010,39452
292540,201910,4279,8026,3361,7031,114,191,2997,6295,3111,6486
292550,201910,8177,21482,6206,19055,462,1458,4499,14423,4961,15881
292560,201910,4258,10757,3654,9958,81,266,3016,8204,3097,8470
292570,201910,3659,9610,3073,8598,82,314,2578,7004,2660,7318
292575,201910,6979,19902,6373,19071,375,1101,5116,15443,5491,16544
292580,201910,7499,18877,6243,17018,132,441,5255,14163,5387,14604
292590,201910,7352,19557,6305,17773,241,798,5298,14617,5539,15415
292593,201910,2829,6959,2328,6120,72,174,1950,5098,2022,5272
292595,201910,5459,14531,4666,13553,162,539,3890,11207,4052,11746
292600,201910,11016,29841,9413,27380,328,931,7431,21673,7759,22604
292610,201910,4103,10718,3443,9551,201,477,2559,7203,2760,7680
292620,201910,6528,17683,5371,16299,121,305,4937,15221,5058,15526
292630,201910,8422,20612,6799,18015,635,1712,4501,11947,5136,13659
292640,201910,8128,24050,7085,22334,196,852,5011,15836,5207,16688
292650,201910,4522,11072,4045,10444,106,293,3680,9374,3786,9667
292660,201910,11287,30475,9572,27919,449,1446,7388,21468,7837,22914
292665,201910,2163,6424,1893,6072,67,199,1599,5202,1666,5401
292670,201910,3554,9547,2709,7964,122,400,1844,5325,1966,5725
292680,201910,3966,10501,3116,8975,210,559,2249,6354,2459,6913
292690,201910,2641,6815,1810,5431,203,577,1073,3379,1276,3956
292700,201910,9812,26647,8492,24619,753,2035,5805,17295,6558,19330
292710,201910,2458,7650,2265,7382,49,187,2032,6663,2081,6850
292720,201910,8985,21418,7569,19791,239,652,6012,15949,6251,16601
292730,201910,4461,10347,4191,10018,203,312,3700,9014,3903,9326
292740,201910,320294,779732,277331,716161,40283,104602,171914,441158,212197,545760
292750,201910,6182,16465,5378,15277,242,698,4122,11849,4364,12547
292760,201910,3904,11242,3388,10312,229,783,2481,7461,2710,8244
292770,201910,5969,15985,4772,14262,786,2443,2898,8889,3684,11332
292780,201910,2056,4198,1521,3517,41,139,1212,2654,1253,2793
292790,201910,4087,8708,3130,7665,159,420,2609,6396,2768,6816
292800,201910,11114,27895,9523,25478,321,929,7927,20906,8248,21835
292805,201910,3450,8372,2697,7359,114,339,2107,5696,2221,6035
292810,201910,10705,28135,8403,24538,222,937,6266,17729,6488,18666
292820,201910,7517,20545,5382,17022,488,1634,3648,11345,4136,12979
292830,201910,2905,6830,2465,6283,94,305,2097,5313,2191,5618
292840,201910,8788,22929,7446,21087,159,641,6460,17899,6619,18540
292850,201910,2481,6561,2077,5961,143,434,1459,4157,1602,4591
292860,201910,16969,37557,15165,35339,538,1320,12887,29641,13425,30961
292870,201910,17559,43856,15054,40258,955,2717,10172,26869,11127,29586
292880,201910,10992,29868,9376,27419,304,1267,7370,20823,7674,22090
292890,201910,6925,19286,6072,18015,215,886,5215,15290,5430,16176
292895,201910,2938,6350,2147,5158,88,222,1735,4111,1823,4333
292900,201910,2589,7020,2367,6662,63,252,1930,5256,1993,5508
292905,201910,4327,11269,3386,9875,152,519,2489,7156,2641,7675
292910,201910,4881,13269,4419,12602,237,703,3360,9494,3597,10197
292920,201910,9706,26642,8991,25599,266,1008,7767,21676,8033,22684
292925,201910,5398,15185,4500,13586,225,695,3285,9758,3510,10453
292930,201910,6465,19083,5479,17164,480,1729,3449,10456,3929,12185
292935,201910,2389,6078,1861,5486,29,143,1661,4916,1690,5059
292937,201910,2975,7243,2576,6728,60,185,2273,5904,2333,6089
292940,201910,2897,7344,2290,6427,184,438,1659,4813,1843,5251
292950,201910,9593,24362,8349,22449,533,1321,6275,16783,6808,18104
292960,201910,5211,12587,4360,11388,126,350,3493,8993,3619,9343
292970,201910,3781,10967,3320,10261,92,442,2767,8541,2859,8983
292975,201910,4544,9711,4010,9102,158,290,3610,8298,3768,8588
292980,201910,3307,7978,2649,6987,90,278,2137,5526,2227,5804
292990,201910,11412,31060,9477,27625,674,2112,6955,19946,7629,22058
293000,201910,2573,6155,2199,5588,38,143,1745,4428,1783,4571
293010,201910,18008,46141,14411,40369,1945,5666,8794,24516,10739,30182
293015,201910,8069,24779,6316,21342,424,1579,4273,14552,4697,16131
293020,201910,9827,28514,8813,27055,127,624,7892,24329,8019,24953
293030,201910,5302,14080,4003,12086,104,367,2771,8548,2875,8915
293040,201910,4014,10988,3393,10119,71,271,2936,8743,3007,9014
293050,201910,21774,54105,19259,50399,972,2760,14646,37704,15618,40464
293060,201910,3426,9058,2787,7908,246,740,1932,5370,2178,6110
293070,201910,24953,60503,21150,55494,2168,5970,14810,38860,16978,44830
293075,201910,3407,10817,2967,10077,175,740,2347,7957,2522,8697
293076,201910,3600,8800,3219,8333,69,189,2819,7349,2888,7538
293077,201910,6061,16835,4838,14892,444,1475,3113,9793,3557,11268
293080,201910,4733,13960,4044,12787,102,460,3241,10038,3343,10498
293090,201910,3207,9308,2439,8042,207,720,1619,5344,1826,6064
293100,201910,5622,15131,4597,13286,224,704,3578,10181,3802,10885
293105,201910,3652,11545,3209,10638,216,772,2303,7548,2519,8320
293110,201910,2380,5939,1980,5344,64,240,1632,4279,1696,4519
293120,201910,4358,11891,3852,11071,123,340,3200,9198,3323,9538
293130,201910,3748,10285,3275,9659,78,314,2813,8209,2891,8523
293135,201910,29710,70231,21685,59221,3353,9932,10250,28149,13603,38081
293140,201910,2368,5287,2037,4869,70,158,1699,4049,1769,4207
293150,201910,5289,15818,4393,14107,356,1214,3020,9705,3376,10919
293160,201910,3813,9286,3244,8660,240,418,2709,7570,2949,7988
293170,201910,4748,10112,4110,9303,125,276,3558,7999,3683,8275
293180,201910,4293,12053,3520,10672,104,433,2778,8186,2882,8619
293190,201910,13918,38115,12217,35677,172,739,10752,31208,10924,31947
293200,201910,8173,20376,6588,17891,206,784,5258,13941,5464,14725
293210,201910,5208,13779,4410,12527,303,849,3353,9519,3656,10368
293220,201910,4995,13012,3681,10759,868,2551,1448,4331,2316,6882
293230,201910,3928,10091,2907,8614,217,723,1991,5951,2208,6674
293240,201910,4432,11682,3539,10226,73,194,2711,8081,2784,8275
293245,201910,3801,10269,3408,9713,152,511,2873,8049,3025,8560
293250,201910,5771,13503,4767,12215,159,404,4003,10233,4162,10637
293260,201910,4422,12002,3603,10729,130,417,2529,7513,2659,7930
293270,201910,7087,15815,5635,14243,416,656,4388,11862,4804,12518
293280,201910,4572,11960,3975,11128,251,614,3089,8716,3340,9330
293290,201910,13911,41320,12269,38710,1914,6116,7689,24641,9603,30757
293300,201910,5783,13987,4944,12741,297,750,3616,9337,3913,10087
293305,201910,3955,9678,3448,9021,40,120,3098,8062,3138,8182
293310,201910,2156,5475,1775,4852,50,154,1396,3751,1446,3905
293315,201910,4055,9749,3307,8605,184,435,2710,7051,2894,7486
293317,201910,2551,6135,2242,5697,149,304,1761,4519,1910,4823
293320,201910,11574,28538,10399,27193,283,793,9217,23987,9500,24780
293325,201910,1740,4384,1358,3855,184,528,865,2467,1049,2995
293330,201910,48930,144536,39938,128187,8247,27035,17995,58796,26242,85831
293340,201910,2218,6231,1843,5575,98,327,1298,3875,1396,4202
293345,201910,3403,9304,2706,8265,340,811,1815,5991,2155,6802
293350,201910,6630,18865,5758,17851,64,306,5272,16530,5336,16836
293360,201910,15390,38322,12992,35179,321,1324,11383,30220,11704,31544
310010,201910,924,2104,583,1626,46,167,206,516,252,683
310020,201910,2251,6317,1597,5107,348,1233,294,887,642,2120
310030,201910,1898,5433,1469,4658,222,771,898,2745,1120,3516
310040,201910,924,2426,737,2099,36,144,497,1324,533,1468
310050,201910,1497,4538,1280,4190,149,605,808,2538,957,3143
310060,201910,3168,8990,2741,8428,101,418,2237,6794,2338,7212
310070,201910,341,773,234,615,5,12,179,469,184,481
310080,201910,743,1978,504,1525,81,285,216,603,297,888
310090,201910,4582,12331,3719,10898,301,961,2660,7649,2961,8610
310100,201910,3332,9411,2784,8470,88,395,2229,6581,2317,6976
310110,201910,4672,12394,3595,10479,775,2449,1523,4248,2298,6697
310120,201910,630,1549,400,1173,47,163,238,636,285,799
310130,201910,365,969,306,879,33,123,215,583,248,706
310140,201910,257,734,181,602,38,145,71,209,109,354
310150,201910,5146,13744,3765,11125,544,1857,1724,4789,2268,6646
310160,201910,7299,18476,5148,14912,1042,3278,1795,5202,2837,8480
310163,201910,1003,2999,796,2597,197,732,255,759,452,1491
310170,201910,8911,23036,7070,20105,607,1783,5004,14180,5611,15963
310180,201910,1725,4345,1254,3568,149,481,763,2077,912,2558
310190,201910,2569,7545,2007,6511,459,1667,297,872,756,2539
310200,201910,1795,5393,1281,4331,215,829,550,1829,765,2658
310205,201910,1104,3063,819,2599,157,554,345,1084,502,1638
310210,201910,2618,6991,2112,6104,114,360,1562,4396,1676,4756
310220,201910,1169,3198,899,2704,102,343,588,1704,690,2047
310230,201910,2193,6182,1751,5308,239,818,1054,2977,1293,3795
310240,201910,889,2804,747,2546,49,195,529,1773,578,1968
310250,201910,1016,2732,809,2394,20,80,580,1685,600,1765
310260,201910,2823,7334,1707,5343,496,1819,426,986,922,2805
310270,201910,2700,6749,2094,5914,101,370,1707,4783,1808,5153
310280,201910,2327,5492,1780,4686,293,818,971,2426,1264,3244
310285,201910,1845,5942,1536,5370,168,668,926,3199,1094,3867
310290,201910,1107,2913,897,2530,206,680,477,1190,683,1870
310300,201910,1426,4230,1214,3853,156,627,686,2006,842,2633
310310,201910,303,763,190,553,33,101,100,284,133,385
310320,201910,515,1334,337,1031,25,95,181,535,206,630
310330,201910,473,1115,280,767,40,133,116,278,156,411
310340,201910,7625,20898,6080,18235,909,2651,2999,9268,3908,11919
310350,201910,12176,29469,8094,22755,1623,4826,3389,9244,5012,14070
310360,201910,476,1102,350,938,9,30,254,667,263,697
310370,201910,1248,3918,1032,3494,220,814,322,1106,542,1920
310375,201910,824,2067,557,1669,87,275,280,831,367,1106
310380,201910,363,809,191,534,32,96,87,223,119,319
310390,201910,435,1310,341,1128,90,329,95,260,185,589
310400,201910,9433,23009,6540,18548,747,2467,3854,10607,4601,13074
310410,201910,844,2436,540,1859,96,352,184,591,280,943
310420,201910,4141,10623,2684,7770,384,1252,1031,2724,1415,3976
310430,201910,1459,3975,930,2963,198,718,321,904,519,1622
310440,201910,606,1566,414,1220,38,147,237,667,275,814
310445,201910,1317,3827,967,3129,46,169,697,2209,743,2378
310450,201910,4699,11828,3496,9898,161,607,2617,7161,2778,7768
310460,201910,1556,4104,1069,3192,188,603,345,979,533,1582
310470,201910,3776,8249,2913,7134,293,728,2078,5145,2371,5873
310480,201910,896,2366,684,1979,89,279,435,1229,524,1508
310490,201910,2795,7678,2153,6557,260,963,1161,3295,1421,4258
310500,201910,1363,3900,988,3233,177,664,497,1565,674,2229
310510,201910,1981,5227,1226,3780,243,840,441,1369,684,2209
310520,201910,1191,3083,853,2487,140,381,456,1327,596,1708
310530,201910,735,1876,412,1238,65,232,124,297,189,529
310540,201910,3038,8693,2493,7739,571,1866,1109,3301,1680,5167
310550,201910,1223,3159,831,2477,69,253,480,1349,549,1602
310560,201910,14168,37280,9955,29796,1660,5642,3938,10593,5598,16235
310570,201910,1049,2780,826,2463,62,228,583,1705,645,1933
310590,201910,4033,10803,3203,9276,221,747,1840,5029,2061,5776
310600,201910,1334,3949,1068,3409,154,561,550,1628,704,2189
310610,201910,477,1254,292,940,49,169,148,445,197,614
310620,201910,167019,427087,119024,339238,18874,62017,55805,142813,74679,204830
310630,201910,4322,11918,3429,10211,286,977,2184,6257,2470,7234
310640,201910,995,2986,810,2603,184,648,319,959,503,1607
310650,201910,2395,6926,1722,5621,186,655,964,3039,1150,3694
310660,201910,1252,3424,1037,3147,35,129,878,2630,913,2759
310665,201910,1359,3537,1074,3124,31,122,893,2583,924,2705
310670,201910,52996,138114,44244,122778,4490,14452,29904,78726,34394,93178
310680,201910,714,1740,583,1548,15,60,481,1232,496,1292
310690,201910,1786,4771,1282,3902,118,421,711,2051,829,2472
310700,201910,484,1075,378,950,30,95,283,684,313,779
310710,201910,5309,15298,3766,13017,882,3547,544,1726,1426,5273
310720,201910,950,2300,735,2017,39,135,533,1413,572,1548
310730,201910,9516,25989,8115,23703,378,1431,5999,17107,6377,18538
310740,201910,5662,15757,3749,11683,638,2173,1237,3551,1875,5724
310750,201910,1194,2865,848,2354,119,369,407,1049,526,1418
310760,201910,540,1416,386,1182,23,74,208,648,231,722
310770,201910,1067,2960,725,2410,80,317,361,1112,441,1429
310780,201910,4239,10280,3517,9225,79,240,2798,7318,2877,7558
310790,201910,1784,5675,1530,5125,375,1339,297,915,672,2254
310800,201910,2155,6423,1532,5132,364,1435,99,280,463,1715
310810,201910,1138,2925,912,2490,45,142,638,1686,683,1828
310820,201910,1155,3005,677,2160,152,522,157,498,309,1020
310825,201910,2440,7639,1953,6798,82,487,1536,5134,1618,5621
310830,201910,1601,4633,1083,3541,216,815,448,1358,664,2173
310840,201910,1852,5067,1299,4111,359,1260,310,854,669,2114
310850,201910,1472,4045,1233,3715,51,255,950,2720,1001,2975
310855,201910,3121,8288,2391,7101,179,612,1655,4786,1834,5398
310860,201910,6811,19789,5413,17004,532,1806,3324,10468,3856,12274
310870,201910,1003,2388,753,2013,58,149,553,1489,611,1638
310880,201910,984,2938,758,2476,99,337,456,1445,555,1782
310890,201910,2257,6454,1400,4699,275,998,204,590,479,1588
310900,201910,3847,10774,2552,7898,373,1202,1104,3153,1477,4355
310910,201910,1955,4907,1300,3793,111,397,245,633,356,1030
310920,201910,1858,4897,1401,4177,198,631,778,2266,976,2897
310925,201910,946,2626,752,2294,82,286,499,1450,581,1736
310930,201910,5634,14986,3976,12282,791,2527,1886,5990,2677,8517
310940,201910,6362,15528,5036,13532,210,743,3756,9734,3966,10477
310945,201910,1263,3318,984,2871,113,369,556,1586,669,1955
310950,201910,1865,5561,1185,4000,221,835,416,1240,637,2075
310960,201910,738,1965,404,1277,78,286,97,276,175,562
310970,201910,1119,3327,767,2555,198,706,148,450,346,1156
310980,201910,286,686,184,522,20,65,117,323,137,388
310990,201910,1228,3460,926,2914,165,538,450,1391,615,1929
311000,201910,3953,11113,2863,9239,703,2447,1164,3622,1867,6069
311010,201910,843,2516,668,2145,215,767,256,782,471,1549
311020,201910,986,2573,619,1898,43,143,323,970,366,1113
311030,201910,1550,3909,1046,3047,199,665,484,1299,683,1964
311040,201910,300,928,232,770,70,245,67,206,137,451
311050,201910,2645,6636,1962,5607,378,1216,954,2615,1332,3831
311060,201910,2932,7633,2049,5906,315,1051,806,2105,1121,3156
311070,201910,2215,5638,1567,4566,185,674,799,2186,984,2860
311080,201910,1047,2456,851,2137,44,156,653,1542,697,1698
311090,201910,1984,6357,1541,5523,349,1413,469,1645,818,3058
311100,201910,2111,6085,1246,4296,258,1008,206,629,464,1637
311110,201910,3640,7505,1982,5171,376,1039,739,1963,1115,3002
311115,201910,1317,3088,1076,2755,70,186,860,2159,930,2345
311120,201910,6317,16681,4655,13590,713,2362,1708,4391,2421,6753
311130,201910,1847,4837,1375,4169,119,462,760,2223,879,2685
311140,201910,1350,3346,1011,2872,79,259,652,1825,731,2084
311150,201910,1502,4752,1161,4073,190,752,613,2070,803,2822
311160,201910,3531,10192,2418,8090,611,2306,714,2316,1325,4622
311170,201910,870,2242,681,1977,40,110,431,1316,471,1426
311180,201910,1305,2934,799,2169,159,464,357,958,516,1422
311190,201910,926,2555,670,2045,118,405,259,694,377,1099
311200,201910,1876,5127,1298,3986,280,941,425,1168,705,2109
311205,201910,856,2605,699,2281,42,192,429,1334,471,1526
311210,201910,1008,2939,869,2760,115,333,635,2071,750,2404
311220,201910,731,2064,600,1829,53,178,362,1046,415,1224
311230,201910,7544,22810,5580,18763,998,3501,2088,7169,3086,10670
311240,201910,967,2565,731,2230,153,496,318,965,471,1461
311250,201910,925,2663,707,2254,173,525,291,902,464,1427
311260,201910,2482,6184,1532,4498,243,781,638,1730,881,2511
311265,201910,1288,3378,940,2785,43,173,657,1866,700,2039
311270,201910,2925,8744,2529,8068,162,706,1868,5684,2030,6390
311280,201910,1106,2847,484,1568,95,331,55,161,150,492
311290,201910,1814,5574,1659,5242,163,537,1121,3530,1284,4067
311300,201910,4629,13121,3770,11642,214,920,2943,8841,3157,9761
311310,201910,559,1566,466,1400,42,132,265,765,307,897
311320,201910,3054,9411,2575,8330,403,1511,1191,3526,1594,5037
311330,201910,4819,12925,3848,11298,434,1418,2153,6409,2587,7827
311340,201910,10007,28408,7781,24361,2180,7386,1996,5909,4176,13295
311350,201910,2248,5658,1541,4357,143,475,839,2119,982,2594
311360,201910,1106,2722,685,2037,207,698,213,574,420,1272
311370,201910,4497,11075,3272,9089,163,649,2118,5553,2281,6202
311380,201910,358,1110,265,917,68,240,105,373,173,613
311390,201910,1667,5155,1296,4625,563,2296,297,900,860,3196
311400,201910,1361,3785,977,3047,141,461,396,1117,537,1578
311410,201910,1546,4594,1266,4202,205,787,708,2353,913,3140
311420,201910,1431,4202,956,3185,177,652,208,562,385,1214
311430,201910,3612,9651,2299,7001,469,1469,687,2095,1156,3564
311440,201910,2491,7145,1762,5861,385,1513,558,1772,943,3285
311450,201910,1670,5057,1188,4122,303,1176,309,922,612,2098
311455,201910,968,2203,640,1715,166,451,243,671,409,1122
311460,201910,472,1472,311,1130,68,325,82,252,150,577
311470,201910,461,1461,301,1072,71,298,42,141,113,439
311480,201910,1072,2824,893,2557,55,151,689,1997,744,2148
311490,201910,223,659,170,553,34,134,80,229,114,363
311500,201910,417,1037,311,879,28,90,194,526,222,616
311510,201910,3025,8012,1986,6143,300,1042,802,2310,1102,3352
311520,201910,552,1612,496,1504,74,270,284,824,358,1094
311530,201910,8577,20051,5266,14637,1275,3929,1356,3615,2631,7544
311535,201910,763,2092,484,1512,76,255,163,469,239,724
311540,201910,492,1545,431,1431,87,314,265,862,352,1176
311545,201910,2018,5787,1730,5359,95,364,1325,4020,1420,4384
311547,201910,1448,3762,1257,3458,45,135,873,2441,918,2576
311550,201910,2658,7521,2076,6408,322,1134,880,2594,1202,3728
311560,201910,285,629,179,477,22,72,99,231,121,303
311570,201910,1743,4061,1223,3336,46,138,957,2655,1003,2793
311580,201910,2147,3965,1376,3062,140,292,931,2091,1071,2383
311590,201910,477,1270,384,1140,63,206,206,602,269,808
311600,201910,1715,3870,1444,3537,50,113,1247,3013,1297,3126
311610,201910,2200,7322,1804,6426,231,888,973,3425,1204,4313
311615,201910,2973,8702,2427,7760,133,501,1878,5890,2011,6391
311620,201910,425,1136,366,1063,13,46,302,871,315,917
311630,201910,1311,3637,1045,3098,88,293,692,1957,780,2250
311640,201910,540,1512,407,1263,62,225,192,555,254,780
311650,201910,1823,4775,1499,4258,127,416,1016,2797,1143,3213
311660,201910,2708,7735,1919,6192,364,1310,491,1335,855,2645
311670,201910,1500,3952,1076,3200,165,560,465,1377,630,1937
311680,201910,2109,6105,1558,5089,190,627,991,3231,1181,3858
311690,201910,569,1228,436,1061,42,89,311,798,353,887
311700,201910,2219,5342,1721,4636,29,133,1447,3782,1476,3915
311710,201910,1473,4242,1013,3377,241,884,385,1257,626,2141
311720,201910,388,1180,306,1025,25,110,172,558,197,668
311730,201910,3837,9796,2398,7068,723,2294,446,1342,1169,3636
311740,201910,832,2261,695,2091,31,84,607,1866,638,1950
311750,201910,3760,11429,3042,10130,440,1608,1713,5469,2153,7077
311760,201910,587,1690,481,1500,70,280,228,608,298,888
311770,201910,1986,5783,1521,4919,266,944,687,2110,953,3054
311780,201910,1233,3562,804,2678,172,641,228,663,400,1304
311783,201910,2194,6063,1770,5313,50,222,1406,4060,1456,4282
311787,201910,685,1977,495,1537,76,265,194,506,270,771
311790,201910,1431,3849,914,2898,247,863,244,729,491,1592
311800,201910,4679,14064,3721,11972,781,2697,629,1791,1410,4488
311810,201910,918,2841,716,2465,59,232,455,1545,514,1777
311820,201910,775,1918,564,1574,78,251,339,891,417,1142
311830,201910,8222,23772,5446,17687,1530,5355,660,2053,2190,7408
311840,201910,3367,8778,2774,7906,264,779,2022,5727,2286,6506
311850,201910,323,877,260,759,13,38,173,488,186,526
311860,201910,55238,140431,41507,116878,6352,19220,22800,61420,29152,80640
311870,201910,1866,4983,1220,3791,201,691,453,1268,654,1959
311880,201910,6176,16093,5129,14616,289,766,3876,11190,4165,11956
311890,201910,1558,3854,1198,3327,81,273,848,2245,929,2518
311900,201910,714,1871,526,1601,55,198,356,1056,411,1254
311910,201910,4146,10701,3091,9301,559,1671,1533,4721,2092,6392
311920,201910,1997,5474,1572,4831,115,328,981,3073,1096,3401
311930,201910,3398,8192,2432,6791,815,2439,717,1890,1532,4329
311940,201910,14111,37572,10203,30076,1497,4922,4704,12948,6201,17870
311950,201910,2135,5954,1571,4961,86,377,1025,3160,1111,3537
311960,201910,488,1218,391,1069,25,104,250,610,275,714
311970,201910,430,1402,288,1042,52,209,62,196,114,405
311980,201910,435,1185,218,746,30,108,65,221,95,329
311990,201910,543,1275,341,979,72,252,145,369,217,621
311995,201910,940,2624,466,1500,19,63,63,150,82,213
312000,201910,596,1584,489,1428,46,148,321,929,367,1077
312010,201910,900,2549,689,2176,56,203,417,1264,473,1467
312015,201910,1337,3986,1174,3708,61,286,917,2804,978,3090
312020,201910,1286,3956,981,3343,226,808,268,868,494,1676
312030,201910,2004,4991,1744,4694,24,99,1606,4302,1630,4401
312040,201910,736,2270,545,1853,63,230,254,853,317,1083
312050,201910,1182,3759,931,3247,212,855,271,840,483,1695
312060,201910,847,2101,548,1719,140,434,246,788,386,1222
312070,201910,855,2503,594,1971,57,211,299,945,356,1156
312080,201910,2652,6516,1954,5479,118,385,1243,3310,1361,3695
312083,201910,836,2205,619,1865,58,208,404,1159,462,1367
312087,201910,2372,6293,1930,5585,48,165,1511,4360,1559,4525
312090,201910,9453,25235,7174,21491,1138,3805,3455,10079,4593,13884
312100,201910,1485,4425,1111,3734,110,481,584,1881,694,2362
312110,201910,982,3080,812,2725,202,792,271,798,473,1590
312120,201910,768,2111,519,1667,156,581,158,420,314,1001
312125,201910,1704,4434,1396,3977,121,400,1022,2799,1143,3199
312130,201910,932,2302,686,1893,55,158,284,732,339,890
312140,201910,704,2043,572,1778,121,421,251,716,372,1137
312150,201910,453,1288,380,1127,14,67,269,731,283,798
312160,201910,7857,22018,5850,18382,767,2820,2790,8253,3557,11073
312170,201910,886,2423,668,1988,39,145,444,1275,483,1420
312180,201910,1326,3610,1031,3022,157,496,508,1427,665,1923
312190,201910,585,1669,407,1309,74,262,121,368,195,630
312200,201910,4604,12461,3606,10848,1091,3280,1315,4044,2406,7324
312210,201910,1314,3032,931,2460,37,119,682,1757,719,1876
312220,201910,1711,5298,1460,4820,114,416,915,3012,1029,3428
312230,201910,12096,31800,7752,23675,1954,6661,1512,4006,3466,10667
312235,201910,1871,4884,1474,4267,84,314,1058,2973,1142,3287
312240,201910,672,2213,496,1830,113,460,136,490,249,950
312245,201910,2538,6737,2061,5998,67,225,1658,4797,1725,5022
312247,201910,901,2253,626,1838,121,382,312,919,433,1301
312250,201910,969,2595,615,1875,83,260,244,739,327,999
312260,201910,849,2383,667,2093,40,168,485,1463,525,1631
312270,201910,689,1891,519,1567,30,135,284,770,314,905
312280,201910,413,1214,310,1022,95,320,44,133,139,453
312290,201910,709,2124,563,1849,117,439,189,583,306,1022
312300,201910,913,2753,607,2017,162,582,114,310,276,892
312310,201910,797,2534,637,2196,109,410,287,957,396,1367
312320,201910,1835,4815,1297,3834,328,1003,280,812,608,1815
312330,201910,845,2518,663,2141,63,215,415,1307,478,1522
312340,201910,262,682,183,549,46,165,71,187,117,352
312350,201910,256,532,185,453,18,53,127,296,145,349
312352,201910,1589,4760,1394,4411,94,312,862,2883,956,3195
312360,201910,2485,7307,1773,5851,366,1316,507,1603,873,2919
312370,201910,1742,4674,1406,4091,192,623,785,2170,977,2793
312380,201910,2132,4822,1754,4352,9,33,1564,3843,1573,3876
312385,201910,1222,3394,922,2830,156,509,432,1296,588,1805
312390,201910,1845,5355,1347,4396,207,779,478,1401,685,2180
312400,201910,2758,8139,2239,7159,701,2376,699,2220,1400,4596
312410,201910,11188,31225,9028,27485,1645,5200,4851,14565,6496,19765
312420,201910,3575,9950,2955,8871,560,1827,1539,4485,2099,6312
312430,201910,7620,20416,6149,17767,439,1482,4235,11919,4674,13401
312440,201910,866,2809,663,2332,365,1345,71,217,436,1562
312450,201910,1120,3359,846,2861,249,901,283,982,532,1883
312460,201910,430,1132,291,917,36,128,152,489,188,617
312470,201910,468,1136,293,823,35,112,118,290,153,402
312480,201910,1066,2668,721,2153,101,312,348,1004,449,1316
312490,201910,2038,5005,1524,4224,209,598,811,2197,1020,2795
312500,201910,934,2335,741,2050,46,165,503,1368,549,1533
312510,201910,3553,9522,2551,7605,693,1978,692,2107,1385,4085
312520,201910,152,453,125,402,34,116,53,166,87,282
312530,201910,579,1430,491,1320,14,50,434,1173,448,1223
312540,201910,1505,4312,992,3227,156,554,518,1622,674,2176
312550,201910,742,1998,555,1612,32,113,366,974,398,1087
312560,201910,1940,4988,1563,4406,73,232,1204,3408,1277,3640
312570,201910,2077,5237,1563,4577,448,1387,618,1814,1066,3201
312580,201910,594,1674,423,1305,56,204,196,552,252,756
312590,201910,1587,4712,1266,4055,95,424,767,2274,862,2698
312595,201910,1763,5354,1498,4894,285,882,873,3002,1158,3884
312600,201910,1059,2599,521,1638,96,355,131,414,227,769
312610,201910,5974,15261,3709,10942,546,1736,1289,3569,1835,5305
312620,201910,2478,6471,1803,5542,53,247,1438,4477,1491,4724
312630,201910,259,784,188,650,33,142,76,249,109,391
312640,201910,516,1434,344,1134,44,144,126,432,170,576
312650,201910,2055,5362,1381,4056,68,221,957,2675,1025,2896
312660,201910,1296,3200,963,2628,78,266,656,1691,734,1957
312670,201910,4776,12829,3937,11469,176,788,2834,7834,3010,8622
312675,201910,1200,3242,975,2889,60,218,777,2261,837,2479
312680,201910,1355,3875,1125,3512,60,272,910,2740,970,3012
312690,201910,2693,5890,2096,5161,62,173,1759,4285,1821,4458
312695,201910,933,2608,769,2322,36,94,587,1788,623,1882
312700,201910,2032,5409,1459,4352,151,528,839,2356,990,2884
312705,201910,1306,3293,1099,2960,19,69,962,2564,981,2633
312707,201910,1341,3965,1026,3388,69,343,643,1992,712,2335
312710,201910,6402,14703,3673,10345,992,3033,1019,2957,2011,5990
312720,201910,1036,2840,765,2389,98,332,469,1409,567,1741
312730,201910,1614,3870,1149,3216,95,312,662,1769,757,2081
312733,201910,1391,3670,1044,3027,41,157,698,1921,739,2078
312735,201910,615,1692,517,1502,66,227,331,854,397,1081
312737,201910,802,1847,533,1443,72,211,311,793,383,1004
312738,201910,605,1586,419,1258,46,162,222,625,268,787
312740,201910,420,1036,235,716,56,183,57,143,113,326
312750,201910,1395,4279,1099,3710,206,763,448,1415,654,2178
312760,201910,1777,5300,1236,4152,223,800,439,1410,662,2210
312770,201910,42760,103011,25722,73713,5572,16943,8400,23606,13972,40549
312780,201910,2393,7241,2009,6593,228,851,1297,4201,1525,5052
312790,201910,252,604,135,415,8,39,50,125,58,164
312800,201910,4808,13796,3634,11498,908,3051,1211,3721,2119,6772
312810,201910,1589,4221,1015,3262,243,882,353,1010,596,1892
312820,201910,1728,4709,1373,4042,46,182,1018,2906,1064,3088
312825,201910,1309,3117,1114,2850,25,89,943,2356,968,2445
312830,201910,2755,7815,1533,5224,331,1248,373,1205,704,2453
312840,201910,1222,3436,929,2905,111,433,447,1309,558,1742
312850,201910,872,2155,599,1735,27,110,353,941,380,1051
312860,201910,1215,3102,797,2461,215,699,177,513,392,1212
312870,201910,6003,16326,3541,11445,620,2192,803,2460,1423,4652
312880,201910,1379,3494,1057,2952,39,152,602,1674,641,1826
312890,201910,2133,5529,1477,4358,110,330,753,2250,863,2580
312900,201910,1150,2967,918,2674,79,254,528,1650,607,1904
312910,201910,1564,2913,800,1900,141,287,326,744,467,1031
312920,201910,971,2661,649,2091,129,494,260,759,389,1253
312930,201910,2141,5405,1649,4665,370,1068,735,2072,1105,3140
312940,201910,915,2579,710,2257,80,315,345,1034,425,1349
312950,201910,3095,7751,1963,5864,520,1717,619,1733,1139,3450
312960,201910,1777,4781,1492,4336,77,203,1152,3438,1229,3641
312965,201910,1622,4625,1336,4157,118,410,914,2770,1032,3180
312970,201910,1213,3482,940,3019,161,618,495,1462,656,2080
312980,201910,21812,60877,17332,52625,3159,10583,8727,24897,11886,35480
312990,201910,451,1177,274,862,53,192,120,358,173,550
313000,201910,456,1314,338,1092,31,135,191,572,222,707
313005,201910,2483,7208,2076,6510,143,457,1491,4621,1634,5078
313010,201910,4657,13076,3711,11474,683,2331,2135,6417,2818,8748
313020,201910,917,2804,600,2059,107,397,110,322,217,719
313030,201910,1103,2614,730,2040,67,245,471,1241,538,1486
313040,201910,766,2393,607,2033,45,191,355,1126,400,1317
313050,201910,1684,4767,1157,3954,192,796,357,1081,549,1877
313055,201910,1853,5071,1651,4764,64,212,1387,3959,1451,4171
313060,201910,946,2306,632,1795,187,615,144,326,331,941
313065,201910,1606,4895,1392,4526,62,267,1046,3301,1108,3568
313070,201910,940,2479,694,2041,67,208,400,1146,467,1354
313080,201910,371,1030,258,792,51,179,89,228,140,407
313090,201910,4783,13070,4072,11889,400,1354,2634,7540,3034,8894
313100,201910,1311,3430,996,2961,33,147,748,2154,781,2301
313110,201910,1436,3854,1013,3081,94,361,573,1607,667,1968
313115,201910,2392,7043,1929,6138,274,961,996,2984,1270,3945
313120,201910,3639,8592,2635,7257,254,799,1641,4484,1895,5283
313130,201910,28940,76236,21824,62760,2488,8130,12181,32957,14669,41087
313140,201910,575,1295,344,952,24,77,227,624,251,701
313150,201910,1331,3777,959,3050,275,941,256,747,531,1688
313160,201910,1008,2563,768,2172,28,102,571,1570,599,1672
313170,201910,10915,31650,7576,25078,1367,4908,2883,8937,4250,13845
313180,201910,2114,5628,1475,4370,180,565,824,2393,1004,2958
313190,201910,4117,11885,2900,9346,534,1863,989,2963,1523,4826
313200,201910,1058,3008,915,2762,18,78,770,2238,788,2316
313210,201910,3676,10815,2992,9595,371,1359,1787,5503,2158,6862
313220,201910,1697,4505,1096,3330,176,604,420,1121,596,1725
313230,201910,2947,8254,2418,7622,64,241,1990,6365,2054,6606
313240,201910,9173,22634,5475,16569,977,3394,2273,6254,3250,9648
313250,201910,5945,17509,4496,14494,774,2559,2059,6535,2833,9094
313260,201910,589,1562,404,1213,55,209,186,519,241,728
313270,201910,5471,14256,4363,12615,606,1800,2823,8273,3429,10073
313280,201910,438,1241,272,888,41,145,108,340,149,485
313290,201910,898,2821,672,2437,224,881,212,738,436,1619
313300,201910,1540,4160,1084,3335,291,950,224,602,515,1552
313310,201910,1061,3181,798,2598,123,484,211,578,334,1062
313320,201910,2093,5567,1449,4510,269,952,614,1896,883,2848
313330,201910,3987,10648,3014,9157,164,676,1964,5893,2128,6569
313340,201910,1314,2995,922,2440,89,244,645,1701,734,1945
313350,201910,2328,6665,1469,4666,189,678,549,1538,738,2216
313360,201910,1290,3211,843,2468,140,488,430,1173,570,1661
313370,201910,1325,3794,1106,3360,139,517,617,1712,756,2229
313375,201910,1633,4219,945,2925,182,633,207,609,389,1242
313380,201910,5762,14667,3988,11322,756,2378,1795,4550,2551,6928
313390,201910,821,2639,712,2458,48,225,470,1544,518,1769
313400,201910,3643,9057,2793,7877,168,524,2143,5930,2311,6454
313410,201910,1277,3366,960,2786,64,227,697,1977,761,2204
313420,201910,14776,33111,7121,20008,1615,5036,994,2718,2609,7754
313430,201910,873,2609,654,2156,116,455,267,785,383,1240
313440,201910,6033,13155,3899,10348,326,927,2474,6517,2800,7444
313450,201910,614,1703,424,1311,76,253,145,393,221,646
313460,201910,2067,6003,1641,5324,338,1247,761,2343,1099,3590
313470,201910,2838,7317,2211,6402,262,753,1389,4081,1651,4834
313480,201910,935,2698,500,1693,81,296,124,380,205,676
313490,201910,2202,5247,989,3102,314,1117,137,428,451,1545
313500,201910,426,1255,327,1022,43,140,118,344,161,484
313505,201910,9582,25711,8163,23780,339,1242,6581,19063,6920,20305
313507,201910,1440,3830,1175,3415,24,102,937,2669,961,2771
313510,201910,12619,35109,10001,30188,1225,4005,4937,14456,6162,18461
313520,201910,13679,39229,10920,34370,648,2442,7982,24565,8630,27007
313530,201910,521,1541,386,1242,36,128,157,458,193,586
313535,201910,2303,6357,1947,5680,222,577,1268,3695,1490,4272
313540,201910,744,2236,567,1796,113,365,238,701,351,1066
313545,201910,1155,3853,960,3439,156,582,512,1759,668,2341
313550,201910,1688,5198,1387,4479,332,1199,682,2095,1014,3294
313560,201910,2592,5161,1902,4319,61,113,1600,3643,1661,3756
313570,201910,915,2747,735,2401,174,593,302,929,476,1522
313580,201910,5446,14489,4094,12215,523,1668,2309,6948,2832,8616
313590,201910,937,2728,743,2443,207,725,318,1098,525,1823
313600,201910,3774,10343,3126,9310,98,411,2592,7573,2690,7984
313610,201910,984,2511,785,2159,96,281,482,1261,578,1542
313620,201910,5310,14236,4114,12039,572,1832,2270,6362,2842,8194
313630,201910,8345,20411,5684,16337,624,2069,3259,9141,3883,11210
313640,201910,1017,2395,610,1846,179,556,191,604,370,1160
313650,201910,1677,5096,1360,4561,91,371,900,3020,991,3391
313652,201910,738,2387,663,2214,115,419,403,1306,518,1725
313655,201910,1127,2903,887,2583,44,148,701,2023,745,2171
313657,201910,1216,3246,944,2813,43,177,695,1959,738,2136
313660,201910,867,2451,695,2123,90,330,399,1148,489,1478
313665,201910,4492,12179,3390,10127,433,1434,2008,5733,2441,7167
313670,201910,46657,115221,28712,84140,4469,14363,12342,34052,16811,48415
313680,201910,1002,2705,825,2429,64,220,536,1517,600,1737
313690,201910,790,2511,593,2120,139,533,166,567,305,1100
313695,201910,1717,4771,1318,4114,78,260,902,2797,980,3057
313700,201910,2962,9585,2547,9036,260,988,1897,6709,2157,7697
313710,201910,1340,3132,946,2590,77,217,637,1754,714,1971
313720,201910,5195,14416,3606,11129,570,2008,1510,4230,2080,6238
313730,201910,1270,2911,940,2460,80,175,632,1644,712,1819
313740,201910,1595,5718,1279,4887,318,1366,218,724,536,2090
313750,201910,1882,5148,1438,4294,276,910,651,1818,927,2728
313753,201910,2048,4926,1348,3809,132,397,767,2094,899,2491
313760,201910,4962,13725,3599,11078,796,2631,1455,4207,2251,6838
313770,201910,3861,10983,3027,9608,200,688,2200,7022,2400,7710
313780,201910,4003,10796,2869,8845,249,929,777,2434,1026,3363
313790,201910,470,1476,414,1371,48,182,229,727,277,909
313800,201910,1350,3180,979,2631,130,405,520,1309,650,1714
313810,201910,1552,4003,1213,3520,52,202,911,2573,963,2775
313820,201910,15971,39692,9799,27263,1610,4752,3129,8350,4739,13102
313830,201910,353,1031,258,814,54,177,101,285,155,462
313835,201910,906,2705,730,2368,66,260,390,1191,456,1451
313840,201910,6581,17338,4691,14086,1210,3832,987,3002,2197,6834
313850,201910,928,2295,730,2010,134,451,371,897,505,1348
313860,201910,2538,6916,1850,5561,295,1007,748,2090,1043,3097
313862,201910,1415,3013,638,1832,44,137,323,898,367,1035
313865,201910,2371,6417,1990,5794,104,325,1499,4282,1603,4607
313867,201910,1163,3575,971,3212,133,447,651,2165,784,2612
313868,201910,1680,5207,1371,4564,49,250,1057,3397,1106,3647
313870,201910,764,2099,549,1699,100,329,205,574,305,903
313880,201910,1481,3943,1081,3256,176,582,494,1333,670,1915
313890,201910,1958,4342,1444,3673,54,171,1049,2609,1103,2780
313900,201910,3858,11398,2719,9045,714,2626,665,2037,1379,4663
313910,201910,597,1790,440,1480,94,353,97,305,191,658
313920,201910,2876,9016,2401,8010,488,1602,1201,4024,1689,5626
313925,201910,1531,3944,1216,3361,186,486,769,2126,955,2612
313930,201910,4642,14102,3739,12446,278,1102,2457,8022,2735,9124
313940,201910,8309,24354,5828,19938,895,3654,1445,5377,2340,9031
313950,201910,5029,11358,3521,9429,433,1437,2087,5502,2520,6939
313960,201910,5375,13345,3521,10186,804,2589,1081,2841,1885,5430
313970,201910,1398,3864,1170,3455,19,67,746,2157,765,2224
313980,201910,1320,3458,851,2687,130,469,324,979,454,1448
313990,201910,1797,5857,1265,4589,350,1418,367,1161,717,2579
314000,201910,9314,24369,7698,21609,562,2005,5164,14174,5726,16179
314010,201910,1408,3455,1108,3036,52,179,825,2191,877,2370
314015,201910,1880,5237,1398,4392,193,735,727,2192,920,2927
314020,201910,475,1311,290,954,57,231,55,196,112,427
314030,201910,736,2128,580,1827,60,204,306,948,366,1152
314040,201910,622,1683,495,1435,75,247,267,741,342,988
314050,201910,1735,4656,1227,3706,159,550,634,1795,793,2345
314053,201910,1776,5313,1409,4574,269,856,712,2418,981,3274
314055,201910,2254,6140,1917,5619,47,179,1562,4574,1609,4753
314060,201910,1225,3285,901,2757,36,152,619,1865,655,2017
314070,201910,4418,12321,3417,10459,715,2177,1469,4409,2184,6586
314080,201910,2097,5548,1343,4174,186,702,555,1529,741,2231
314085,201910,2019,5879,1647,5290,254,853,907,2935,1161,3788
314090,201910,4256,11891,3623,10889,224,866,2315,6964,2539,7830
314100,201910,3123,7418,2380,6378,56,163,1828,4870,1884,5033
314110,201910,4305,12321,3480,10704,397,1428,1996,5761,2393,7189
314120,201910,823,1922,315,955,73,260,58,162,131,422
314130,201910,610,1585,358,1112,26,104,199,615,225,719
314140,201910,4506,12932,3477,10883,485,1611,1698,5187,2183,6798
314150,201910,1477,3716,1065,2986,93,266,703,1913,796,2179
314160,201910,2128,5754,1522,4616,220,729,637,1923,857,2652
314170,201910,933,2652,744,2274,49,177,463,1317,512,1494
314180,201910,5351,15044,4296,13297,383,1311,2525,7784,2908,9095
314190,201910,587,1489,397,1189,70,234,177,484,247,718
314200,201910,2828,8003,2299,7078,134,487,1650,4944,1784,5431
314210,201910,1950,5198,1523,4402,165,505,781,2200,946,2705
314220,201910,1289,3576,898,2885,188,709,337,983,525,1692
314225,201910,1072,3073,883,2770,77,217,631,2024,708,2241
314230,201910,750,1949,609,1771,69,228,394,1177,463,1405
314240,201910,990,2722,761,2378,185,595,302,951,487,1546
314250,201910,505,1411,309,1002,44,144,119,352,163,496
314260,201910,907,2536,713,2246,159,543,388,1173,547,1716
314270,201910,3204,9157,2597,8197,87,355,1913,5960,2000,6315
314280,201910,3270,7598,2084,5744,258,800,1065,2773,1323,3573
314290,201910,4436,11567,3610,10083,302,864,2462,6751,2764,7615
314300,201910,1754,5091,1164,3802,254,920,367,1132,621,2052
314310,201910,4138,10965,2757,8543,889,2981,455,1268,1344,4249
314315,201910,906,3152,770,2859,56,272,525,1879,581,2151
314320,201910,2802,7693,1763,5681,336,1185,622,1934,958,3119
314330,201910,47188,132377,34949,110523,9756,32072,7398,24476,17154,56548
314340,201910,2180,5408,1221,3657,255,904,307,764,562,1668
314345,201910,1362,4127,1110,3665,145,503,652,2122,797,2625
314350,201910,853,2333,553,1790,110,395,131,364,241,759
314360,201910,561,1616,337,1125,53,194,104,315,157,509
314370,201910,696,1899,547,1672,29,115,396,1164,425,1279
314380,201910,1128,3103,726,2335,168,621,168,525,336,1146
314390,201910,12257,31625,7639,22916,1582,5100,2276,6131,3858,11231
314400,201910,3902,11683,2945,9824,781,2703,1061,3663,1842,6366
314410,201910,2659,7451,1790,5791,258,937,637,2147,895,3084
314420,201910,808,1989,588,1665,28,131,407,1069,435,1200
314430,201910,7156,17951,4908,14043,763,2330,2215,6018,2978,8348
314435,201910,1624,4418,1270,3800,57,216,930,2743,987,2959
314437,201910,908,2357,634,1878,63,216,311,899,374,1115
314440,201910,601,1738,418,1356,119,421,87,239,206,660
314450,201910,1334,3599,1106,3235,101,339,668,1885,769,2224
314460,201910,3176,9766,2235,7685,578,2104,480,1598,1058,3702
314465,201910,2175,6329,1848,5688,56,212,1385,4116,1441,4328
314467,201910,831,2240,693,2010,24,82,556,1563,580,1645
314470,201910,2110,6133,1669,5207,290,990,752,2180,1042,3170
314480,201910,6220,18018,4377,14051,761,2740,1513,4289,2274,7029
314490,201910,978,2693,716,2126,72,238,439,1241,511,1479
314500,201910,1646,4049,1167,3326,259,730,447,1303,706,2033
314505,201910,1969,4889,1592,4353,105,294,1139,3053,1244,3347
314510,201910,1812,4746,1234,3856,246,853,550,1691,796,2544
314520,201910,4604,14284,3242,11242,652,2506,405,1198,1057,3704
314530,201910,5393,17541,4819,16415,358,1504,3469,11544,3827,13048
314535,201910,2563,6684,2046,5914,103,368,1553,4435,1656,4803
314537,201910,1094,3157,835,2714,54,217,578,1840,632,2057
314540,201910,376,961,250,737,19,66,128,355,147,421
314545,201910,1783,4454,1565,4183,36,97,1331,3668,1367,3765
314550,201910,627,1557,465,1318,41,156,249,636,290,792
314560,201910,3897,11951,2843,9508,473,1735,965,2957,1438,4692
314570,201910,293,809,212,657,28,103,93,292,121,395
314580,201910,413,1238,312,1031,91,308,86,295,177,603
314585,201910,626,1983,466,1616,63,265,207,686,270,951
314587,201910,1960,5394,1475,4608,201,575,831,2665,1032,3240
314590,201910,3657,10114,2492,7838,368,1287,1020,2995,1388,4282
314600,201910,1807,5029,1027,3475,206,751,131,403,337,1154
314610,201910,8519,21713,5743,17601,1052,3725,2387,7240,3439,10965
314620,201910,2158,5145,1672,4511,45,161,1379,3659,1424,3820
314625,201910,1487,4192,1257,3869,39,231,1046,3143,1085,3374
314630,201910,5195,13473,4220,12151,120,495,3484,10015,3604,10510
314640,201910,630,1543,447,1246,64,213,240,615,304,828
314650,201910,817,1888,482,1362,50,165,245,594,295,759
314655,201910,1558,4299,1093,3447,178,548,525,1629,703,2177
314660,201910,333,777,214,558,11,22,130,323,141,345
314670,201910,1652,3797,1119,3022,23,77,720,1919,743,1996
314675,201910,1687,4526,1440,4102,86,306,1108,3043,1194,3349
314690,201910,2025,5750,1537,4977,451,1592,468,1505,919,3097
314700,201910,9780,27706,6156,20405,1239,4539,1730,5537,2969,10076
314710,201910,7413,20943,5175,16136,982,3330,1561,4294,2543,7624
314720,201910,2028,6018,1334,4527,287,1085,353,1141,640,2226
314730,201910,2045,5580,1420,4360,299,984,459,1322,758,2306
314740,201910,2776,7900,2150,6745,283,959,1101,3375,1384,4334
314750,201910,308,851,234,698,25,88,132,348,157,436
314760,201910,1780,5449,1123,3884,179,711,257,728,436,1439
314770,201910,1081,3180,532,1726,45,156,162,486,207,642
314780,201910,341,815,225,641,42,139,119,298,161,437
314790,201910,9660,26250,6423,20153,1501,5382,1986,5705,3487,11087
314795,201910,1416,3821,1187,3416,33,149,932,2564,965,2713
314800,201910,10512,26756,5985,18109,1153,3840,1339,3581,2492,7421
314810,201910,8183,22099,5775,17796,1493,4920,1829,5532,3322,10452
314820,201910,1092,2766,845,2381,53,208,541,1448,594,1656
314830,201910,1416,4376,1165,3866,239,860,532,1751,771,2611
314840,201910,854,2739,671,2430,57,291,471,1626,528,1917
314850,201910,1934,4685,1548,4179,41,138,1328,3593,1369,3731
314860,201910,3095,9359,2551,8278,252,991,1683,5286,1935,6277
314870,201910,6196,16045,4664,13940,299,993,3401,10182,3700,11175
314875,201910,1703,5177,1495,4901,103,287,1212,4033,1315,4320
314880,201910,835,2045,637,1742,30,93,407,1118,437,1211
314890,201910,412,1222,299,967,46,170,118,346,164,516
314900,201910,647,1770,495,1513,94,318,190,558,284,876
314910,201910,1582,4565,1160,3857,232,897,528,1610,760,2507
314915,201910,2156,6436,1800,5812,128,420,1194,3792,1322,4212
314920,201910,462,1198,293,932,8,28,195,624,203,652
314930,201910,5137,14749,3804,12219,690,2386,1475,4425,2165,6811
314940,201910,383,987,313,863,29,78,199,518,228,596
314950,201910,460,1185,290,892,29,118,143,394,172,512
314960,201910,781,1922,600,1610,28,89,444,1140,472,1229
314970,201910,834,2383,622,1954,121,411,270,780,391,1191
314980,201910,1332,3475,933,2867,192,674,388,1164,580,1838
314990,201910,2292,6655,1515,4846,329,1152,293,819,622,1971
314995,201910,1594,4447,1259,3851,48,199,827,2408,875,2607
315000,201910,1096,2843,776,2330,67,227,505,1478,572,1705
315010,201910,369,1034,266,841,42,159,128,373,170,532
315015,201910,2192,6291,1893,5776,186,637,1219,3668,1405,4305
315020,201910,745,2214,525,1706,76,312,212,611,288,923
315030,201910,559,1504,356,1109,84,266,78,228,162,494
315040,201910,778,2268,648,1998,85,283,407,1252,492,1535
315050,201910,1084,2802,808,2390,58,222,455,1321,513,1543
315053,201910,1092,2877,817,2379,49,155,484,1353,533,1508
315057,201910,1625,5079,1341,4539,145,497,897,3053,1042,3550
315060,201910,551,1683,393,1356,76,280,97,314,173,594
315070,201910,514,1359,348,1058,87,294,85,231,172,525
315080,201910,2724,7943,2061,6601,312,1070,1149,3547,1461,4617
315090,201910,782,2410,562,1966,89,339,207,689,296,1028
315100,201910,1178,3562,721,2494,137,542,302,930,439,1472
315110,201910,1666,4159,1217,3442,140,386,600,1736,740,2122
315120,201910,11453,27241,8190,22195,1218,3093,4170,11787,5388,14880
315130,201910,1322,3798,1061,3303,134,483,433,1272,567,1755
315140,201910,2838,7928,2142,6656,397,1366,1046,3035,1443,4401
315150,201910,4167,10155,2819,7920,450,1456,1303,3496,1753,4952
315160,201910,1597,3992,1020,3052,236,743,435,1278,671,2021
315170,201910,1373,4349,924,3254,220,826,192,650,412,1476
315180,201910,16076,39428,8037,24144,1157,3890,2407,6294,3564,10184
315190,201910,2063,4621,1595,3998,201,470,1155,2934,1356,3404
315200,201910,3660,10672,2599,8712,795,2861,610,1955,1405,4816
315210,201910,7681,20264,5235,15016,644,2011,2559,6682,3203,8693
315213,201910,1096,2890,933,2665,18,57,760,2151,778,2208
315217,201910,2642,7917,2028,6839,96,482,1379,4447,1475,4929
315220,201910,7870,21657,6190,18670,1252,4007,2559,7725,3811,11732
315230,201910,3064,7211,2552,6562,162,279,1992,5383,2154,5662
315240,201910,2337,6947,1947,6233,447,1523,980,3093,1427,4616
315250,201910,11250,30824,7817,24245,1315,4421,3311,9820,4626,14241
315260,201910,924,2585,472,1571,86,280,32,92,118,372
315270,201910,782,2286,526,1759,72,262,169,483,241,745
315280,201910,2813,7127,1588,4824,392,1293,249,747,641,2040
315290,201910,1152,2879,675,2110,197,679,175,528,372,1207
315300,201910,632,1533,409,1203,100,338,181,528,281,866
315310,201910,1261,3584,918,2911,72,255,500,1499,572,1754
315320,201910,664,1953,458,1537,67,273,194,594,261,867
315330,201910,742,2559,395,1580,67,303,118,419,185,722
315340,201910,2969,7276,2117,6025,191,605,1264,3558,1455,4163
315350,201910,1526,4190,1161,3610,172,614,642,1959,814,2573
315360,201910,1625,4874,1167,3875,170,604,468,1451,638,2055
315370,201910,441,1292,345,1091,63,188,144,445,207,633
315380,201910,169,506,125,399,32,101,25,53,57,154
315390,201910,1069,3083,809,2569,155,565,336,973,491,1538
315400,201910,3892,10915,3040,9309,449,1431,1595,4710,2044,6141
315410,201910,2226,5186,1672,4373,465,1298,248,700,713,1998
315415,201910,1257,3464,999,3071,207,745,407,1270,614,2015
315420,201910,1243,3601,794,2691,160,575,138,433,298,1008
315430,201910,3517,8606,2433,6923,434,1457,1040,2755,1474,4212
315440,201910,980,2641,777,2294,72,253,447,1230,519,1483
315445,201910,1950,4742,1380,3915,93,305,991,2759,1084,3064
315450,201910,2177,6171,1763,5508,232,692,1083,3407,1315,4099
315460,201910,33844,96217,27658,84749,4844,16557,14129,40668,18973,57225
315470,201910,488,1380,372,1143,31,113,227,664,258,777
315480,201910,1183,3446,806,2621,164,553,253,794,417,1347
315490,201910,2883,7227,1915,5672,296,893,673,1959,969,2852
315500,201910,495,1356,291,893,35,133,132,350,167,483
315510,201910,1202,3207,1024,2943,23,109,879,2471,902,2580
315520,201910,1034,2859,803,2459,59,218,584,1730,643,1948
315530,201910,563,1640,436,1395,133,471,194,586,327,1057
315540,201910,1337,3678,904,2838,102,375,389,1194,491,1569
315550,201910,1831,4750,1136,3498,250,860,282,850,532,1710
315560,201910,6127,18878,5153,17058,293,969,3441,11521,3734,12490
315570,201910,1908,5270,1545,4659,91,360,926,2693,1017,3053
315580,201910,2471,5980,1836,4968,291,930,716,1816,1007,2746
315590,201910,861,2285,668,1973,73,266,349,959,422,1225
315600,201910,2402,7674,1718,6291,260,913,900,3428,1160,4341
315610,201910,881,2263,641,1804,107,370,290,703,397,1073
315620,201910,414,1186,318,1029,44,157,198,655,242,812
315630,201910,886,2387,688,2057,136,430,288,800,424,1230
315640,201910,344,867,258,759,26,102,157,433,183,535
315645,201910,933,2438,618,1907,157,519,154,459,311,978
315650,201910,1680,4179,1337,3684,34,123,1103,2935,1137,3058
315660,201910,2398,5893,1766,4796,99,296,1264,3306,1363,3602
315670,201910,13113,36339,9869,30333,2000,6391,4365,12920,6365,19311
315680,201910,2974,8812,2157,7218,332,1278,1037,3274,1369,4552
315690,201910,2973,7378,1717,5189,375,1120,538,1752,913,2872
315700,201910,7556,21346,5614,17390,933,3072,2517,7437,3450,10509
315710,201910,1823,4597,1274,3736,45,212,896,2500,941,2712
315720,201910,4243,11917,3556,10674,170,710,2556,7357,2726,8067
315725,201910,1935,5285,1444,4382,137,403,977,3025,1114,3428
315727,201910,550,1425,397,1168,57,191,163,455,220,646
315730,201910,589,1846,511,1684,84,316,198,615,282,931
315733,201910,1236,3132,828,2390,124,431,317,862,441,1293
315737,201910,1107,3220,859,2719,37,150,600,1840,637,1990
315740,201910,848,2396,654,1985,83,296,396,1118,479,1414
315750,201910,1236,3329,966,2855,82,257,615,1825,697,2082
315760,201910,1122,2693,996,2530,50,144,839,2089,889,2233
315765,201910,1851,4925,1503,4472,28,93,1318,3914,1346,4007
315770,201910,919,2636,709,2336,274,985,149,397,423,1382
315780,201910,26926,74886,22418,66766,1471,5473,15105,42930,16576,48403
315790,201910,3495,10907,2943,9830,357,1261,1736,5873,2093,7134
315800,201910,1207,4362,839,3333,145,637,226,809,371,1446
315810,201910,1291,3245,1062,2841,51,179,819,2086,870,2265
315820,201910,2525,6991,2028,6244,179,659,1380,4182,1559,4841
315830,201910,1066,3142,757,2515,76,281,303,960,379,1241
315840,201910,806,1960,515,1428,41,136,252,648,293,784
315850,201910,1105,3338,874,2915,170,614,431,1355,601,1969
315860,201910,463,1351,315,1070,75,271,86,265,161,536
315870,201910,447,1171,351,1027,27,93,237,646,264,739
315880,201910,1036,2730,680,2094,94,356,162,451,256,807
315890,201910,1587,4646,1256,4161,318,1131,615,1985,933,3116
315895,201910,5818,15793,4305,12801,428,1472,2257,6230,2685,7702
315900,201910,786,2053,675,1894,59,177,494,1341,553,1518
315910,201910,506,1445,423,1304,59,215,285,838,344,1053
315920,201910,1457,3756,781,2407,130,460,249,717,379,1177
315930,201910,1065,2438,688,1864,125,333,305,828,430,1161
315935,201910,766,2309,603,2001,114,399,212,705,326,1104
315940,201910,579,1646,454,1443,51,179,238,719,289,898
315950,201910,1144,3134,940,2808,92,265,707,2118,799,2383
315960,201910,4171,11860,2409,8216,794,3102,179,359,973,3461
315970,201910,621,1650,479,1460,61,214,318,962,379,1176
315980,201910,4130,9025,2178,5834,384,1095,768,1887,1152,2982
315990,201910,3494,8916,2686,7524,250,746,1581,4333,1831,5079
316000,201910,502,1338,373,1146,55,209,172,494,227,703
316010,201910,808,2134,585,1758,35,121,374,1047,409,1168
316020,201910,918,2824,737,2463,81,333,431,1354,512,1687
316030,201910,2697,7652,2008,6401,233,772,1264,4078,1497,4850
316040,201910,2349,6791,1677,5493,321,1164,376,1084,697,2248
316045,201910,2026,5317,1832,5072,75,167,1563,4444,1638,4611
316050,201910,361,1035,268,864,38,140,145,447,183,587
316060,201910,664,1720,489,1446,24,114,335,939,359,1053
316070,201910,5213,14726,4211,12779,742,2342,1947,5732,2689,8074
316080,201910,682,2134,514,1782,128,464,74,251,202,715
316090,201910,404,1203,280,933,39,155,133,384,172,539
316095,201910,1242,3870,988,3250,259,886,320,1031,579,1917
316100,201910,2391,7158,1657,5494,304,1091,584,1761,888,2852
316105,201910,837,2233,647,1947,42,145,451,1385,493,1530
316110,201910,12982,38271,10790,34499,886,3260,7247,22869,8133,26129
316120,201910,1118,3263,683,2186,123,410,191,503,314,913
316130,201910,1176,2641,730,1937,64,201,424,1094,488,1295
316140,201910,1135,3069,721,2294,107,376,359,1110,466,1486
316150,201910,1747,3892,1429,3482,185,565,582,1326,767,1891
316160,201910,987,2758,795,2415,49,178,522,1528,571,1706
316165,201910,848,2113,632,1761,91,312,328,844,419,1156
316170,201910,1067,2712,790,2278,57,206,534,1479,591,1685
316180,201910,1253,3586,811,2647,137,531,159,467,296,998
316190,201910,2532,7255,1427,4580,213,697,520,1496,733,2193
316200,201910,3134,9127,2229,7405,545,1929,422,1384,967,3313
316210,201910,4094,12065,2898,9381,1076,3772,202,530,1278,4302
316220,201910,584,1785,380,1308,94,358,40,160,134,518
316225,201910,1525,3492,1126,2827,42,163,855,1994,897,2157
316230,201910,387,1050,288,882,30,96,169,521,199,617
316240,201910,5482,16007,4788,14813,368,1267,3628,11002,3996,12269
316245,201910,2863,9595,2544,9037,142,837,1905,6389,2047,7226
316250,201910,9684,23771,6671,18892,1511,4649,2255,6211,3766,10860
316255,201910,2897,8136,2509,7508,143,489,1862,5602,2005,6091
316257,201910,1275,3194,891,2509,127,367,456,1241,583,1608
316260,201910,1917,5072,1450,4301,118,381,794,2413,912,2794
316265,201910,1127,3074,879,2645,32,117,621,1813,653,1930
316270,201910,3522,11099,2967,9822,526,1845,1367,4308,1893,6153
316280,201910,2789,8218,2354,7357,334,1127,1294,3891,1628,5018
316290,201910,3383,9362,2664,8012,312,1119,1130,3273,1442,4392
316292,201910,4814,12967,3827,11280,470,1516,2523,7148,2993,8664
316294,201910,787,2334,568,1947,101,389,146,486,247,875
316295,201910,2811,7975,2289,7055,143,558,1576,4582,1719,5140
316300,201910,953,2859,791,2590,47,186,553,1793,600,1979
316310,201910,797,2092,488,1537,100,382,77,195,177,577
316320,201910,591,1675,444,1421,52,207,206,630,258,837
316330,201910,1038,2813,768,2317,51,201,553,1592,604,1793
316340,201910,990,2751,721,2237,75,305,396,1148,471,1453
316350,201910,1210,3519,1017,3206,93,315,709,2212,802,2527
316360,201910,632,1674,500,1454,49,157,361,1012,410,1169
316370,201910,4771,13013,3486,10564,700,2431,1197,3196,1897,5627
316380,201910,1672,4016,1289,3475,48,107,936,2533,984,2640
316390,201910,809,2188,568,1752,226,790,100,278,326,1068
316400,201910,1116,3206,699,2341,118,437,234,705,352,1142
316410,201910,1067,3114,893,2842,63,214,693,2184,756,2398
316420,201910,1858,5177,1610,4852,54,201,1328,3924,1382,4125
316430,201910,839,2257,509,1629,94,340,149,460,243,800
316440,201910,698,2217,543,1948,124,508,107,362,231,870
316443,201910,525,1488,389,1231,100,353,80,233,180,586
316447,201910,1850,5084,1601,4665,35,135,1326,3795,1361,3930
316450,201910,2149,6594,1609,5458,218,786,956,3173,1174,3959
316460,201910,996,2593,790,2252,141,438,465,1244,606,1682
316470,201910,6336,18353,4420,14244,758,2778,1671,4946,2429,7724
316480,201910,202,557,167,500,39,116,82,240,121,356
316490,201910,298,813,211,659,27,92,83,215,110,307
316500,201910,1118,3582,708,2546,152,594,156,535,308,1129
316510,201910,705,2325,551,2024,118,448,244,910,362,1358
316520,201910,1095,2799,850,2376,123,412,409,1051,532,1463
316530,201910,1051,2802,766,2285,91,357,375,985,466,1342
316540,201910,797,2130,626,1858,109,375,292,794,401,1169
316550,201910,1350,4014,1151,3619,63,235,867,2686,930,2921
316553,201910,3635,11011,2481,8170,452,1655,812,2409,1264,4064
316555,201910,2435,7935,2209,7621,121,432,1753,6131,1874,6563
316556,201910,547,1326,377,1035,23,71,224,572,247,643
316557,201910,972,3072,827,2809,325,1173,225,752,550,1925
316560,201910,329,931,221,756,59,250,59,165,118,415
316570,201910,1165,3462,963,3077,241,787,361,1141,602,1928
316580,201910,372,792,221,548,35,100,112,260,147,360
316590,201910,1275,3379,895,2617,163,435,469,1329,632,1764
316600,201910,941,2937,800,2629,133,469,411,1327,544,1796
316610,201910,555,1785,468,1652,52,234,283,960,335,1194
316620,201910,1970,5440,1691,5059,88,281,1273,3841,1361,4122
316630,201910,1540,4627,1232,4048,337,1110,484,1716,821,2826
316640,201910,131,349,101,304,19,65,46,119,65,184
316650,201910,1015,3285,807,2947,72,294,501,1862,573,2156
316660,201910,186,473,75,233,7,24,9,28,16,52
316670,201910,1781,4535,1286,3718,315,981,467,1312,782,2293
316680,201910,2136,5457,1606,4516,101,300,1239,3413,1340,3713
316690,201910,1217,3592,932,3024,179,643,413,1293,592,1936
316695,201910,999,2934,815,2593,37,152,557,1749,594,1901
316700,201910,372,877,308,801,14,46,232,563,246,609
316710,201910,2913,9694,2183,8141,465,1830,841,3121,1306,4951
316720,201910,19718,54784,14084,43549,2658,8763,5740,16905,8398,25668
316730,201910,402,1135,317,962,46,156,153,420,199,576
316740,201910,677,2036,584,1878,60,234,368,1173,428,1407
316750,201910,375,1125,285,951,58,239,129,384,187,623
316760,201910,3559,11330,2843,9845,1125,4226,643,2099,1768,6325
316770,201910,1542,3633,1205,3173,24,83,1022,2724,1046,2807
316780,201910,527,1605,410,1372,150,562,64,188,214,750
316790,201910,675,1836,466,1414,112,358,131,354,243,712
316800,201910,5978,17089,4693,14687,453,1652,2504,7524,2957,9176
316805,201910,1007,2219,801,1992,64,176,620,1552,684,1728
316810,201910,633,1784,418,1313,83,300,197,569,280,869
316820,201910,308,747,151,456,9,33,70,203,79,236
316830,201910,680,1892,545,1666,73,271,337,977,410,1248
316840,201910,2695,7201,2158,6249,220,780,1408,3883,1628,4663
316850,201910,1914,5080,1340,4030,215,705,577,1683,792,2388
316860,201910,18015,47303,13216,39987,2244,7820,6097,17892,8341,25712
316870,201910,7164,19876,5252,16147,826,2859,2347,6682,3173,9541
316880,201910,781,2136,622,1914,132,451,280,819,412,1270
316890,201910,1078,2429,614,1790,103,375,337,874,440,1249
316900,201910,2150,5935,1633,4889,334,1107,535,1463,869,2570
316905,201910,517,1547,399,1309,100,362,159,524,259,886
316910,201910,851,2289,525,1702,139,506,46,130,185,636
316920,201910,1583,4049,1037,3163,208,695,406,1215,614,1910
316930,201910,7312,21324,5181,17342,1100,3959,1306,4225,2406,8184
316935,201910,3868,10661,2749,8502,495,1653,1109,3294,1604,4947
316940,201910,6377,19009,4794,15590,791,2845,1798,5424,2589,8269
316950,201910,1804,4252,1377,3651,50,151,1128,2943,1178,3094
316960,201910,4994,11435,3568,9383,385,1123,2337,5995,2722,7118
316970,201910,3469,10065,2989,9118,554,1760,1174,3437,1728,5197
316980,201910,661,2016,483,1662,156,601,73,253,229,854
316990,201910,10288,28493,7042,21590,1951,6401,950,2600,2901,9001
317000,201910,2513,7559,2214,7115,174,540,1622,5219,1796,5759
317005,201910,2521,7319,1977,6168,310,1015,1038,3163,1348,4178
317010,201910,22998,54192,13707,39930,3009,9530,4878,14629,7887,24159
317020,201910,61269,146244,33926,98075,6358,20084,10218,27186,16576,47270
317030,201910,638,1759,503,1572,20,90,392,1212,412,1302
317040,201910,10481,26877,7268,21326,1653,5186,2667,7952,4320,13138
317043,201910,822,1898,592,1573,63,172,410,1087,473,1259
317047,201910,1140,2768,769,2155,94,264,463,1269,557,1533
317050,201910,1151,3554,782,2673,112,389,316,950,428,1339
317052,201910,2302,6612,1834,5833,286,928,1108,3515,1394,4443
317057,201910,1698,4208,1223,3401,45,174,801,2170,846,2344
317060,201910,440,1173,263,796,37,130,115,312,152,442
317065,201910,1191,3505,960,3056,48,182,599,1774,647,1956
317070,201910,7191,19931,4867,15342,972,3495,1311,3843,2283,7338
317075,201910,871,2298,595,1793,104,352,227,619,331,971
317080,201910,5842,13931,4236,11298,1210,3464,1326,3338,2536,6802
317090,201910,4341,13254,3873,12475,311,983,2816,9049,3127,10032
317100,201910,2504,5922,1577,4432,373,1114,582,1577,955,2691
317103,201910,1917,5640,1617,5120,106,535,1170,3488,1276,4023
317107,201910,1352,3665,1027,3022,58,239,639,1657,697,1896
317110,201910,697,1612,338,1038,49,185,108,334,157,519
317115,201910,1061,3057,889,2741,44,122,629,1948,673,2070
317120,201910,11930,33392,9260,28858,1184,4284,5132,15460,6316,19744
317130,201910,10397,24439,6249,17632,1095,3401,2076,5755,3171,9156
317140,201910,690,1826,526,1570,42,126,340,1047,382,1173
317150,201910,990,2391,736,2061,33,111,566,1550,599,1661
317160,201910,3514,8568,2271,6603,184,581,1272,3729,1456,4310
317170,201910,1816,4606,1248,3582,205,691,496,1219,701,1910
317180,201910,1782,5717,1314,4559,267,994,344,1126,611,2120
317190,201910,1213,3310,895,2799,108,347,520,1610,628,1957
317200,201910,4791,12711,3554,10516,1008,3240,676,1811,1684,5051
317210,201910,1159,2844,878,2461,32,119,644,1821,676,1940
317220,201910,248,769,205,676,54,180,71,250,125,430
320010,201910,4442,13077,3531,11239,386,1369,2256,7046,2642,8415
320013,201910,1644,4796,1084,3580,180,599,509,1716,689,2315
320016,201910,2964,7702,2295,6683,122,341,1818,5264,1940,5605
320020,201910,3777,10039,2741,8234,670,2178,959,2949,1629,5127
320030,201910,1544,4521,1042,3453,201,723,358,1112,559,1835
320035,201910,1784,5019,1452,4430,372,1262,631,1861,1003,3123
320040,201910,3757,10921,3064,9583,432,1474,1688,5105,2120,6579
320050,201910,1727,3955,1478,3585,211,611,869,2028,1080,2639
320060,201910,11369,31922,8317,25786,1329,4557,3846,11237,5175,15794
320070,201910,1416,4042,954,3078,182,663,329,1005,511,1668
320080,201910,5465,14238,3774,10854,829,2510,1349,3713,2178,6223
320090,201910,7805,21093,5111,15493,1182,3877,1889,5306,3071,9183
320100,201910,2699,7701,2132,6654,388,1328,1108,3398,1496,4726
320110,201910,1461,3687,1072,3034,178,536,535,1464,713,2000
320115,201910,1757,5756,1495,5296,644,2407,429,1584,1073,3991
320120,201910,19350,50467,13070,38945,1998,6488,5802,16529,7800,23017
320130,201910,41447,117566,33886,103600,4865,16316,19425,57654,24290,73970
320140,201910,2878,8356,2098,6718,353,1286,872,2749,1225,4035
320150,201910,12864,33940,8789,25807,2352,7466,1547,4097,3899,11563
320160,201910,5409,15518,3955,12647,678,2290,1840,5811,2518,8101
320170,201910,1433,4229,1042,3449,292,982,409,1398,701,2380
320180,201910,680,2191,546,1915,189,710,145,476,334,1186
320190,201910,2661,8623,2014,7105,488,1827,535,1808,1023,3635
320200,201910,1079,3010,782,2450,198,695,269,840,467,1535
320210,201910,4351,11229,3301,9356,556,1716,1746,4733,2302,6449
320220,201910,2499,6803,1851,5677,360,1224,862,2526,1222,3750
320225,201910,1319,4163,890,3104,336,1241,164,566,500,1807
320230,201910,4538,12862,3413,10939,824,2875,1310,4084,2134,6959
320240,201910,14437,37568,10573,31160,2535,8035,3825,10979,6360,19014
320245,201910,2948,8969,2343,7703,941,3217,475,1515,1416,4732
320250,201910,1925,5483,1251,3866,303,1044,342,952,645,1996
320255,201910,1665,5367,1460,5004,456,1578,694,2481,1150,4059
320260,201910,1044,3131,730,2352,179,658,201,543,380,1201
320265,201910,2374,7461,1942,6593,928,3325,356,1198,1284,4523
320270,201910,2175,6326,1612,5182,368,1277,658,2107,1026,3384
320280,201910,6257,17140,4948,14792,1164,3697,2017,5890,3181,9587
320290,201910,1309,3927,821,2711,224,807,207,635,431,1442
320300,201910,3378,10518,2712,9063,816,2943,576,1775,1392,4718
320305,201910,4980,14332,3832,12013,758,2541,1855,5613,2613,8154
320310,201910,1904,5394,1299,4062,250,818,560,1693,810,2511
320313,201910,2289,5856,1393,4079,299,986,330,897,629,1883
320316,201910,1399,4093,1172,3659,182,587,688,2144,870,2731
320320,201910,20700,54979,14317,43757,3417,10914,5343,16299,8760,27213
320330,201910,2892,7953,2227,6735,464,1380,1126,3487,1590,4867
320332,201910,5770,16371,4578,14216,1171,3884,2102,6494,3273,10378
320334,201910,1732,5060,1189,3904,262,1023,252,646,514,1669
320335,201910,1391,4124,895,2956,222,785,208,627,430,1412
320340,201910,4585,11810,3797,10584,485,1467,2211,6202,2696,7669
320350,201910,5071,12726,3463,9751,467,1396,1802,4870,2269,6266
320360,201910,1407,3610,1018,2864,125,336,505,1372,630,1708
320370,201910,2355,7540,1825,6344,573,2051,600,2066,1173,4117
320380,201910,2381,6525,1969,5833,252,799,1217,3528,1469,4327
320390,201910,6979,19236,5098,15386,1081,3426,2017,5770,3098,9196
320400,201910,3153,9105,2438,7589,684,2263,907,2712,1591,4975
320405,201910,4346,11653,3210,9681,549,1778,1460,4309,2009,6087
320410,201910,4689,12282,3499,10349,639,1871,1722,5309,2361,7180
320420,201910,2843,7614,2158,6462,697,2336,424,1208,1121,3544
320425,201910,2029,4868,1533,4053,91,263,1038,2662,1129,2925
320430,201910,2836,7199,2206,6001,303,922,1407,3640,1710,4562
320435,201910,2216,6991,1723,5997,606,2195,530,1867,1136,4062
320440,201910,1344,3737,955,2972,151,521,425,1268,576,1789
320450,201910,1571,4603,1217,3939,298,1083,520,1556,818,2639
320455,201910,3912,11943,2546,8657,674,2438,684,2174,1358,4612
320460,201910,2021,6089,1385,4664,346,1225,342,1086,688,2311
320465,201910,1174,3382,874,2786,133,460,468,1481,601,1941
320470,201910,3610,10072,2448,7568,591,1986,568,1582,1159,3568
320480,201910,1602,4537,1307,4014,223,783,712,2107,935,2890
320490,201910,20227,53611,14503,43258,2579,8497,5954,17384,8533,25881
320495,201910,1325,3641,897,2815,193,693,325,961,518,1654
320500,201910,50042,135118,39859,116950,5971,18925,22717,63880,28688,82805
320501,201910,4243,12360,3028,10120,860,3176,1023,3342,1883,6518
320503,201910,1958,5955,1367,4663,405,1505,451,1416,856,2921
320506,201910,2500,7540,1705,5750,519,1870,179,589,698,2459
320510,201910,9601,26438,7685,22994,937,3220,4650,13402,5587,16622
320515,201910,1686,4673,1276,3821,368,1193,410,1177,778,2370
320517,201910,2091,6440,1630,5452,546,1967,429,1409,975,3376
320520,201910,33615,88456,24550,72872,4530,14709,10369,29767,14899,44476
320530,201910,29685,79889,22960,67724,2370,8331,14097,39160,16467,47491
330010,201910,20723,56290,16713,49378,2545,8004,10280,29691,12825,37695
330015,201910,1471,3677,1128,3114,199,624,610,1596,809,2220
330020,201910,19789,49751,16833,45463,2272,6995,11975,31408,14247,38403
330022,201910,1884,5077,1418,4257,247,757,804,2395,1051,3152
330023,201910,4806,11615,3332,9463,615,1907,1711,4698,2326,6605
330025,201910,4868,11936,3210,9162,936,2871,982,2731,1918,5602
330030,201910,10180,27529,7549,23026,852,3011,4553,13229,5405,16240
330040,201910,14160,37325,11084,31894,1130,3685,7257,20015,8387,23700
330045,201910,82236,196413,67346,177104,5395,14324,52950,138057,58345,152381
330050,201910,2408,6420,1746,5298,377,1219,793,2280,1170,3499
330060,201910,4735,12738,3871,11223,781,2482,1714,4588,2495,7070
330070,201910,21884,56603,17629,50143,2973,8969,10122,28518,13095,37487
330080,201910,8613,22094,7343,20248,965,2809,4998,13613,5963,16422
330090,201910,3450,7247,2211,5552,140,381,1501,3742,1641,4123
330093,201910,2433,6057,1771,5056,132,405,1293,3675,1425,4080
330095,201910,1196,3440,913,2890,76,291,543,1574,619,1865
330100,201910,68775,184533,57960,168060,3803,13184,43652,124269,47455,137453
330110,201910,2002,5731,1670,5151,279,949,887,2643,1166,3592
330115,201910,2100,5293,1572,4507,240,766,929,2568,1169,3334
330120,201910,3486,7935,2535,6648,265,778,1678,4237,1943,5015
330130,201910,3859,10658,3172,9620,460,1449,1967,5942,2427,7391
330140,201910,3519,9309,2774,8190,418,1348,1706,4910,2124,6258
330150,201910,2120,5727,1602,4866,324,1047,725,2152,1049,3199
330160,201910,1334,3636,1011,3093,178,600,541,1576,719,2176
330170,201910,100184,255754,80752,228640,11339,31838,53599,153109,64938,184947
330180,201910,2041,5000,1549,4267,111,354,1035,2742,1146,3096
330185,201910,9429,24172,7824,21824,589,1992,6056,16392,6645,18384
330187,201910,4103,10549,3206,9133,438,1374,1904,5370,2342,6744
330190,201910,31139,76997,26485,70436,2034,5838,20797,54535,22831,60373
330200,201910,15246,39690,12447,36081,2527,7013,7752,23053,10279,30066
330205,201910,2019,5056,1523,4219,92,312,1051,2798,1143,3110
330210,201910,3343,8465,2385,6734,363,1145,1120,2923,1483,4068
330220,201910,11076,28075,7696,22221,1734,5535,2621,6963,4355,12498
330225,201910,3615,9314,2719,7911,216,756,1908,5375,2124,6131
330227,201910,17000,41574,14374,38262,655,2001,12251,32102,12906,34103
330230,201910,1663,3841,1162,3194,113,320,767,2083,880,2403
330240,201910,23004,60585,18510,53231,2592,8121,11681,32647,14273,40768
330245,201910,1660,4165,953,2914,196,634,337,1037,533,1671
330250,201910,35942,93948,29826,84692,5662,16315,17369,49488,23031,65803
330260,201910,3908,9954,2947,8608,374,1217,1893,5316,2267,6533
330270,201910,26211,56069,15711,40295,2714,7512,6758,16857,9472,24369
330280,201910,2366,6300,1738,5194,188,626,1016,2911,1204,3537
330285,201910,21551,52871,16940,46113,1544,4877,12100,31830,13644,36707
330290,201910,3615,8983,2890,7997,339,1060,1963,5259,2302,6319
330300,201910,5643,13563,3960,11030,346,1087,2632,7180,2978,8267
330310,201910,2364,5980,1735,4926,108,271,1179,3351,1287,3622
330320,201910,15691,38100,12127,33528,1487,4121,8681,24079,10168,28200
330330,201910,34442,77490,26452,66400,2603,7148,18864,46259,21467,53407
330340,201910,14194,35577,10131,28996,1713,5424,5072,13845,6785,19269
330350,201910,120264,286883,98632,259863,6915,19169,79385,208042,86300,227211
330360,201910,7465,18143,6353,16758,244,679,5354,14003,5598,14682
330370,201910,4684,13540,3426,11307,785,2681,1417,4829,2202,7510
330380,201910,5115,13962,3810,11632,735,2546,1821,5312,2556,7858
330385,201910,3890,11381,3151,10269,762,2702,1470,4755,2232,7457
330390,201910,24905,68816,18873,57905,2830,9827,10433,30294,13263,40121
330395,201910,3135,7898,2558,7108,173,535,1815,4932,1988,5467
330400,201910,3077,8343,2632,7600,156,579,1956,5326,2112,5905
330410,201910,2872,7942,2144,6620,421,1447,985,2868,1406,4315
330411,201910,2741,7435,2115,6222,156,534,1478,4163,1634,4697
330412,201910,1462,4238,1178,3749,132,485,708,2104,840,2589
330414,201910,22657,57861,18090,51498,1735,5027,12967,36613,14702,41640
330415,201910,3925,10749,3005,9109,334,1039,1773,5387,2107,6426
330420,201910,10290,25653,6862,19910,920,2978,3331,9076,4251,12054
330430,201910,9180,22385,7753,20338,384,1237,5986,15174,6370,16411
330440,201910,2277,6233,1667,5198,309,1139,905,2676,1214,3815
330450,201910,1282,3754,1014,3275,142,495,523,1660,665,2155
330452,201910,15647,40397,12260,35110,1733,5508,7570,21001,9303,26509
330455,201910,538538,1293007,405582,1095864,61648,176825,250492,664596,312140,841421
330460,201910,1181,3242,867,2755,160,540,455,1412,615,1952
330470,201910,4748,12065,3408,9960,1079,3223,1096,3236,2175,6459
330475,201910,9022,23804,7235,21395,1217,4097,4527,13062,5744,17159
330480,201910,5880,15350,4932,13945,419,1306,3367,9257,3786,10563
330490,201910,110602,257719,89740,228901,10173,27348,64002,161102,74175,188450
330500,201910,6816,17220,5685,15634,638,1969,4056,10948,4694,12917
330510,201910,38338,96856,28705,82975,5510,16879,16671,47583,22181,64462
330513,201910,1243,3250,963,2834,211,679,483,1415,694,2094
330515,201910,2460,6611,1969,5872,422,1334,1016,2950,1438,4284
330520,201910,10874,29217,8780,25791,1233,4014,5263,14955,6496,18969
330530,201910,1649,4105,1175,3337,253,769,529,1467,782,2236
330540,201910,2879,7668,2163,6385,545,1666,890,2550,1435,4216
330550,201910,8493,23055,6587,20345,1996,6622,2491,7603,4487,14225
330555,201910,16015,35157,13210,31733,955,2608,10382,24932,11337,27540
330560,201910,4207,11344,3363,9890,522,1580,1969,5624,2491,7204
330570,201910,2742,7601,2243,6779,358,1177,1421,4218,1779,5395
330575,201910,5403,14137,4632,12774,315,1000,3631,9651,3946,10651
330580,201910,15550,42304,11678,35062,2290,7403,5405,15510,7695,22913
330590,201910,1423,3917,1196,3610,215,652,764,2329,979,2981
330600,201910,11408,30461,8980,26452,1074,3573,5441,15608,6515,19181
330610,201910,9140,24601,7345,21713,648,2269,5030,14422,5678,16691
330615,201910,2045,5629,1545,4921,303,1011,946,3059,1249,4070
330620,201910,3878,11276,3042,9786,722,2516,1253,3774,1975,6290
330630,201910,23959,60804,18550,52036,1551,5171,12990,34972,14541,40143
350010,201910,2059,5356,981,2983,214,687,141,303,355,990
350020,201910,675,1747,356,1101,45,134,147,409,192,543
350030,201910,3674,10381,2649,8492,670,2309,1000,3051,1670,5360
350040,201910,668,1948,376,1304,53,208,122,343,175,551
350050,201910,1134,2900,733,2161,175,590,236,565,411,1155
350055,201910,914,2395,674,2005,81,269,380,1052,461,1321
350060,201910,103,265,69,211,11,38,39,119,50,157
350070,201910,3462,9177,2091,6573,422,1483,618,1745,1040,3228
350075,201910,567,1706,407,1380,170,611,34,106,204,717
350080,201910,657,1714,393,1221,57,193,158,445,215,638
350090,201910,626,1487,350,986,72,225,136,346,208,571
350100,201910,2099,5689,1384,4365,120,457,808,2412,928,2869
350110,201910,474,1227,319,938,19,70,183,529,202,599
350115,201910,1268,3695,1015,3137,189,651,525,1472,714,2123
350120,201910,632,1474,316,866,40,126,150,363,190,489
350130,201910,2983,8024,2323,6794,419,1282,1115,3100,1534,4382
350140,201910,748,2136,472,1559,50,220,245,737,295,957
350150,201910,477,1472,384,1296,96,307,98,313,194,620
350160,201910,10770,26745,6892,19744,879,2929,4137,11161,5016,14090
350170,201910,1947,5753,1510,4756,289,949,623,1841,912,2790
350180,201910,1036,2565,500,1498,114,339,100,278,214,617
350190,201910,2802,7974,1904,6056,368,1360,789,2081,1157,3441
350200,201910,420,1184,325,1008,19,66,215,629,234,695
350210,201910,5387,12439,3511,9573,508,1478,2068,5437,2576,6915
350220,201910,2785,7581,1822,5685,428,1403,604,1695,1032,3098
350230,201910,960,2554,787,2287,159,498,413,1166,572,1664
350240,201910,655,1917,401,1313,81,262,119,371,200,633
350250,201910,2312,6874,1692,5771,616,2272,271,972,887,3244
350260,201910,774,1878,478,1348,52,158,295,809,347,967
350270,201910,4498,12258,3502,10330,558,1785,1801,4948,2359,6733
350275,201910,2338,6345,1833,5492,322,1091,1036,2903,1358,3994
350280,201910,18411,41309,10336,28009,1864,5358,3818,9971,5682,15329
350290,201910,3063,8491,2014,6298,385,1328,795,2295,1180,3623
350300,201910,644,1771,461,1406,77,256,223,622,300,878
350310,201910,817,2391,581,1879,106,414,226,639,332,1053
350315,201910,541,1417,344,1059,25,94,162,462,187,556
350320,201910,13687,35656,10049,29124,2257,7165,3541,9605,5798,16770
350330,201910,13679,33852,9484,25661,1148,3402,5822,14811,6970,18213
350335,201910,358,1016,266,836,30,110,137,406,167,516
350340,201910,1115,2876,643,2003,117,399,245,704,362,1103
350350,201910,747,1938,576,1746,76,279,324,952,400,1231
350360,201910,1070,3205,807,2636,220,722,233,762,453,1484
350370,201910,603,1519,409,1160,154,420,102,302,256,722
350380,201910,4265,11511,2768,8543,791,2440,640,2040,1431,4480
350390,201910,9479,25644,7273,21749,1796,5551,3005,8801,4801,14352
350395,201910,416,1066,200,643,22,65,67,194,89,259
350400,201910,7837,19602,5267,15232,1302,4054,1481,4118,2783,8172
350410,201910,9217,25983,6492,20532,1445,5052,2306,6703,3751,11755
350420,201910,672,1816,458,1382,85,284,111,308,196,592
350430,201910,638,1734,508,1511,67,239,308,813,375,1052
350440,201910,1828,4704,1454,4133,110,371,960,2646,1070,3017
350450,201910,6550,18185,5028,15479,1114,3720,2055,5920,3169,9640
350460,201910,1658,4311,800,2503,123,413,164,434,287,847
350470,201910,264,674,194,549,9,34,130,351,139,385
350480,201910,927,2399,549,1693,119,420,85,224,204,644
350490,201910,1838,4903,1268,3926,303,972,378,1079,681,2051
350500,201910,673,1816,499,1482,80,254,240,668,320,922
350510,201910,1095,2861,779,2260,100,340,436,1197,536,1537
350520,201910,2058,6395,1562,5362,250,971,698,2171,948,3142
350530,201910,2654,6707,1880,5210,220,684,1101,2843,1321,3527
350535,201910,1377,3831,1175,3529,176,599,726,2086,902,2685
350540,201910,1738,4398,1247,3620,179,556,735,2071,914,2627
350550,201910,8288,20567,5631,16057,613,2068,3251,8611,3864,10679
350560,201910,3836,10902,2999,9340,298,974,1827,5502,2125,6476
350570,201910,23318,65757,18407,55905,3651,12115,8973,25930,12624,38045
350580,201910,1898,5217,973,3147,259,914,153,399,412,1313
350590,201910,4678,12891,3347,9864,496,1655,1920,5210,2416,6865
350600,201910,36103,84109,21527,58124,3206,9632,10263,25341,13469,34973
350610,201910,6451,17870,4530,13945,850,2825,2028,5961,2878,8786
350620,201910,386,972,222,712,24,88,123,375,147,463
350630,201910,1412,3729,1012,2992,70,268,636,1744,706,2012
350635,201910,7867,19967,5845,16745,1008,3218,3294,8901,4302,12119
350640,201910,919,2497,465,1438,64,204,148,383,212,587
350650,201910,7727,20957,5063,15492,1029,3396,1754,4944,2783,8340
350660,201910,4490,11861,3389,9989,601,1771,1731,5106,2332,6877
350670,201910,1819,4860,1470,4340,152,487,988,2897,1140,3384
350680,201910,1102,2964,703,2210,153,488,269,818,422,1306
350690,201910,1228,3252,865,2612,143,470,470,1354,613,1824
350700,201910,4709,11986,3131,9482,549,1887,1405,3978,1954,5865
350710,201910,2691,7491,2218,6638,352,1236,1215,3404,1567,4640
350715,201910,826,2377,661,2053,72,292,339,946,411,1238
350720,201910,168,434,117,342,18,51,36,88,54,139
350730,201910,585,1604,470,1389,27,112,341,944,368,1056
350740,201910,1580,4335,1024,3151,198,634,303,869,501,1503
350745,201910,534,1402,298,910,27,95,150,426,177,521
350750,201910,9619,25297,7144,20875,1285,4268,3140,8186,4425,12454
350760,201910,13193,33413,9023,26006,2144,6732,3125,8107,5269,14839
350770,201910,938,2367,571,1716,44,145,348,1021,392,1166
350775,201910,656,1595,432,1234,46,137,203,563,249,700
350780,201910,1948,4916,1341,3998,243,817,470,1568,713,2385
350790,201910,1667,4500,1000,3234,197,690,240,635,437,1325
350800,201910,3219,9509,2734,8626,330,1161,1728,5284,2058,6445
350810,201910,2539,6375,1978,5557,245,721,1140,3202,1385,3923
350820,201910,896,2098,484,1357,53,172,228,589,281,761
350830,201910,822,2306,433,1428,79,248,127,359,206,607
350840,201910,2908,8705,2088,7046,514,1901,818,2503,1332,4404
350850,201910,6490,18430,4870,15350,1084,3678,1973,6017,3057,9695
350860,201910,3449,9421,2969,8716,140,518,2224,6427,2364,6945
350870,201910,2608,7449,1891,6255,277,1058,994,3168,1271,4226
350880,201910,1207,3530,923,2938,225,736,282,865,507,1601
350890,201910,531,1375,330,958,52,172,127,335,179,507
350900,201910,6593,18149,3996,12422,1017,3408,1059,2991,2076,6399
350910,201910,858,2192,720,1961,97,291,497,1317,594,1608
350920,201910,11504,28948,9603,25725,478,1565,7674,19779,8152,21344
350925,201910,4333,11954,3038,9504,583,1938,1398,4037,1981,5975
350930,201910,1428,3685,941,2758,118,358,532,1520,650,1878
350940,201910,2154,5822,1665,4980,202,661,1017,2934,1219,3595
350945,201910,824,2325,608,1900,98,367,314,888,412,1255
350950,201910,81965,213996,61788,174734,8483,26430,36991,99451,45474,125881
350960,201910,6033,16594,4614,13873,584,2014,2748,7815,3332,9829
350970,201910,3415,9832,2465,7873,751,2656,441,1213,1192,3869
350980,201910,605,1677,475,1438,141,448,202,603,343,1051
350990,201910,1735,4968,1253,4150,302,1128,435,1336,737,2464
350995,201910,748,2351,664,2183,51,204,460,1446,511,1650
351000,201910,2746,7183,1903,5646,356,1148,693,1943,1049,3091
351010,201910,312,770,200,568,20,65,112,305,132,370
351015,201910,762,2298,599,1952,89,339,284,816,373,1155
351020,201910,8863,24446,6567,20426,1364,4393,3147,9503,4511,13896
351030,201910,2572,7715,2050,6642,306,1098,1110,3489,1416,4587
351040,201910,4771,12009,3963,10757,214,705,3208,8430,3422,9135
351050,201910,17063,41833,11471,32769,2405,7268,4752,13264,7157,20532
351060,201910,46553,118277,35104,98360,3987,12300,23042,62394,27029,74694
351070,201910,1454,3656,770,2421,192,645,128,396,320,1041
351080,201910,2674,6634,1896,5663,251,899,1199,3370,1450,4269
351090,201910,316,934,216,740,49,165,53,185,102,350
351100,201910,2373,6431,1474,4612,332,1095,403,1337,735,2432
351110,201910,5935,15234,3711,11024,672,2176,1529,4232,2201,6408
351120,201910,751,1957,495,1500,62,189,194,572,256,761
351130,201910,1077,2793,450,1440,94,308,91,271,185,579
351140,201910,1858,5378,1307,4263,288,1038,472,1379,760,2417
351150,201910,2061,6060,1320,4380,257,936,510,1528,767,2464
351160,201910,1082,3413,811,2754,184,662,239,716,423,1378
351170,201910,1340,3769,1157,3426,109,351,782,2228,891,2579
351190,201910,1005,2790,607,1943,114,372,212,614,326,986
351200,201910,1548,3748,1135,3127,91,286,775,2020,866,2306
351210,201910,1500,3739,878,2491,76,251,526,1393,602,1644
351220,201910,3146,9001,2670,8183,337,1065,1733,5269,2070,6334
351230,201910,1747,4813,1258,3934,248,891,546,1523,794,2414
351240,201910,2173,5614,1331,3793,277,834,551,1412,828,2246
351250,201910,1064,2829,599,1874,71,223,223,701,294,924
351260,201910,891,2291,627,1802,144,401,211,609,355,1010
351270,201910,394,1101,321,976,34,116,192,520,226,636
351280,201910,3730,9943,2778,8132,517,1607,1295,3618,1812,5225
351290,201910,1134,2897,752,2207,125,384,402,1138,527,1522
351300,201910,15840,43810,10484,33176,2001,6832,4264,13055,6265,19887
351310,201910,3207,8057,2357,6666,197,692,1647,4383,1844,5075
351320,201910,902,2645,633,2041,124,440,225,643,349,1083
351330,201910,476,1111,390,957,32,91,280,616,312,707
351340,201910,6236,18052,4907,15655,1226,4059,2082,6612,3308,10671
351350,201910,11296,28824,9334,25579,1065,3142,6744,17915,7809,21057
351360,201910,3716,10103,3037,9026,759,2418,1105,3057,1864,5475
351370,201910,2071,5866,1345,4317,343,1169,427,1234,770,2403
351380,201910,45908,112970,31868,87622,4469,13162,17592,46157,22061,59319
351385,201910,290,750,146,441,26,74,42,120,68,194
351390,201910,1355,3342,789,2479,131,484,439,1283,570,1767
351400,201910,915,2569,725,2173,134,401,427,1244,561,1645
351410,201910,2570,7261,1790,5691,317,1016,687,2133,1004,3149
351420,201910,355,848,179,532,33,86,91,265,124,351
351430,201910,914,2555,695,2179,71,233,450,1362,521,1595
351440,201910,3265,8722,2047,6112,375,1190,555,1408,930,2598
351450,201910,1699,4534,1068,3298,224,753,175,435,399,1188
351460,201910,795,2107,600,1763,151,441,316,919,467,1360
351470,201910,1160,2992,864,2481,91,307,531,1437,622,1744
351480,201910,2510,7439,1955,6440,370,1332,811,2507,1181,3839
351490,201910,1881,5431,1587,4867,83,340,1232,3600,1315,3940
351492,201910,334,923,270,781,12,42,181,511,193,553
351495,201910,184,479,128,362,14,35,66,178,80,213
351500,201910,35474,89231,25845,72226,4220,12675,14728,39117,18948,51792
351510,201910,12480,31426,8886,24994,1148,3674,5461,14629,6609,18303
351512,201910,473,1285,310,925,56,168,100,270,156,438
351515,201910,3184,7136,1805,4921,340,1020,512,1460,852,2480
351518,201910,2353,5982,1466,4352,206,701,791,2125,997,2826
351519,201910,713,1984,399,1327,78,261,58,184,136,445
351520,201910,1142,2862,435,1363,54,181,177,492,231,673
351530,201910,337,919,184,577,28,91,69,167,97,258
351535,201910,1932,4674,1340,3661,205,622,696,1784,901,2406
351540,201910,2237,5636,1401,4136,323,1100,428,1077,751,2177
351550,201910,6362,16058,4170,11926,440,1489,2319,6111,2759,7600
351560,201910,429,1230,336,1046,86,302,97,276,183,578
351565,201910,189,553,147,476,32,118,41,120,73,238
351570,201910,19240,52667,14135,41776,1669,5366,8605,24253,10274,29619
351580,201910,259,664,148,448,14,45,64,198,78,243
351590,201910,498,1130,252,689,24,83,137,334,161,417
351600,201910,1315,3425,986,2828,94,304,624,1676,718,1980
351610,201910,761,1799,457,1252,30,97,251,634,281,731
351620,201910,21286,57654,15289,46667,2604,8971,6737,18456,9341,27427
351630,201910,25055,67464,19826,58150,3234,9958,11959,34031,15193,43989
351640,201910,15985,42988,12098,35525,1266,4216,8063,22711,9329,26927
351650,201910,381,1011,157,521,20,71,37,104,57,175
351660,201910,747,2129,440,1395,83,271,68,184,151,455
351670,201910,5304,14529,3627,10824,788,2357,1597,4476,2385,6833
351680,201910,419,1212,248,792,46,143,53,140,99,283
351685,201910,422,1226,334,1073,91,286,114,334,205,620
351690,201910,1022,2614,582,1702,91,299,239,628,330,927
351700,201910,1291,3289,910,2593,118,337,524,1420,642,1757
351710,201910,749,2017,499,1542,42,149,258,710,300,859
351720,201910,1392,3630,877,2701,148,493,322,937,470,1430
351730,201910,877,2319,719,2056,65,236,483,1313,548,1549
351740,201910,3505,8872,2676,7263,467,1368,1335,3357,1802,4725
351750,201910,1258,3358,757,2441,148,503,277,880,425,1383
351760,201910,3230,9164,2258,7096,481,1694,803,2271,1284,3965
351770,201910,1752,5266,1413,4582,287,972,708,2246,995,3218
351780,201910,1320,3403,718,2182,117,407,235,669,352,1076
351790,201910,1313,3140,1017,2736,173,462,593,1621,766,2083
351800,201910,510,1186,242,679,23,65,87,207,110,272
351810,201910,986,2600,779,2262,39,126,564,1558,603,1684
351820,201910,2466,6973,1672,5391,436,1547,360,1080,796,2627
351830,201910,4333,11823,3262,9896,321,1175,1993,5719,2314,6894
351840,201910,8075,22799,6000,18828,932,3257,2987,8769,3919,12026
351850,201910,1672,4511,1029,3218,190,690,331,881,521,1571
351860,201910,2748,8075,2104,6823,381,1310,1116,3636,1497,4946
351870,201910,22811,59094,16964,49191,4842,14361,6506,19328,11348,33689
351880,201910,114316,303858,83594,248607,21589,69750,33064,93547,54653,163297
351885,201910,884,2427,684,2059,81,283,426,1214,507,1497
351890,201910,694,1900,473,1513,114,367,72,193,186,560
351900,201910,1062,2882,813,2497,125,388,435,1335,560,1723
351905,201910,389,1085,251,801,19,68,100,277,119,345
351907,201910,21017,55514,15846,46003,1880,5955,10088,28227,11968,34182
351910,201910,1280,3386,870,2507,76,240,483,1263,559,1503
351920,201910,811,2153,584,1708,80,277,278,740,358,1017
351925,201910,854,2360,651,1961,93,307,320,893,413,1200
351930,201910,3122,8861,2793,8232,546,1640,1875,5424,2421,7064
351940,201910,1087,2851,766,2300,118,382,382,1116,500,1498
351950,201910,1566,3689,1119,3007,72,207,745,1946,817,2153
351960,201910,5157,13244,3667,10526,814,2495,1605,4279,2419,6774
351970,201910,6574,20005,5263,17618,866,3239,2870,9319,3736,12558
351980,201910,1041,2445,637,1775,81,261,365,942,446,1203
351990,201910,1398,3334,959,2652,68,255,443,1086,511,1341
352000,201910,2492,7243,2106,6430,269,960,1356,3861,1625,4821
352010,201910,2136,5861,1699,5092,445,1449,334,1041,779,2490
352020,201910,1416,3919,1074,3317,178,584,511,1494,689,2078
352030,201910,5363,14428,4183,12487,836,2756,2122,6123,2958,8879
352040,201910,2715,7408,1721,5324,276,914,582,1554,858,2468
352042,201910,3054,7527,1854,5498,368,1206,767,2205,1135,3411
352044,201910,2073,5601,1107,3699,192,719,232,702,424,1421
352050,201910,11586,31078,7072,21966,1808,6345,1193,3126,3001,9471
352060,201910,698,1899,491,1497,73,243,221,622,294,865
352070,201910,856,1745,534,1313,59,159,257,544,316,703
352080,201910,446,1127,263,758,32,103,100,254,132,357
352090,201910,1410,4204,1129,3597,145,551,513,1471,658,2022
352100,201910,2968,8451,2427,7412,569,1883,1132,3279,1701,5162
352110,201910,567,1700,426,1402,94,322,168,516,262,838
352115,201910,493,1379,402,1235,55,190,230,701,285,891
352120,201910,838,2549,659,2174,77,284,386,1183,463,1467
352130,201910,1868,5306,1199,3632,213,674,475,1339,688,2013
352140,201910,1244,3310,802,2428,140,454,367,1065,507,1519
352150,201910,808,2191,605,1829,99,316,367,1080,466,1396
352160,201910,981,2436,699,2007,85,289,379,1034,464,1323
352170,201910,2923,7969,2248,6576,357,1184,1257,3347,1614,4531
352180,201910,2510,6872,1912,5729,467,1549,564,1475,1031,3024
352190,201910,1153,3125,872,2681,149,458,419,1321,568,1779
352200,201910,352,1063,246,848,36,138,90,303,126,441
352210,201910,18748,45105,14499,39265,1138,3389,10993,29255,12131,32644
352215,201910,557,1489,479,1384,56,185,330,918,386,1103
352220,201910,17451,44093,11287,32846,2772,8476,3976,10978,6748,19454
352230,201910,12655,37404,9472,31189,2310,8485,3368,10239,5678,18724
352240,201910,10257,26823,7686,22356,1744,5710,3223,8549,4967,14259
352250,201910,22814,64366,18009,55651,3253,10655,10366,31408,13619,42063
352260,201910,4762,12152,3194,9023,467,1546,1825,4665,2292,6211
352265,201910,888,2523,780,2358,51,201,578,1687,629,1888
352270,201910,1436,4362,1044,3488,222,816,355,1103,577,1919
352280,201910,2382,6145,1793,5246,184,673,1038,2784,1222,3457
352290,201910,1118,3302,889,2828,139,499,452,1286,591,1785
352300,201910,900,2447,585,1770,89,313,300,824,389,1137
352310,201910,44683,119403,32179,96658,8176,25085,13684,41233,21860,66318
352320,201910,6231,16737,4677,13564,724,2349,2419,6355,3143,8704
352330,201910,2162,5788,1614,4996,323,1176,793,2273,1116,3449
352340,201910,5274,13994,3717,11133,637,2180,1832,5050,2469,7230
352350,201910,2110,6107,1632,5010,196,738,876,2386,1072,3124
352360,201910,1224,3289,1021,2925,92,323,756,2061,848,2384
352370,201910,1053,3032,904,2760,23,101,703,2090,726,2191
352380,201910,788,2193,585,1816,130,425,198,582,328,1007
352390,201910,15311,37708,10079,28453,1645,5050,5540,14775,7185,19825
352400,201910,3423,9529,2810,8350,530,1845,1624,4496,2154,6341
352410,201910,3106,8094,2313,6717,219,761,1404,3875,1623,4636
352420,201910,824,2021,563,1611,102,309,200,537,302,846
352430,201910,7457,18919,5204,14876,1244,3972,2256,6053,3500,10025
352440,201910,17116,46930,12559,37940,3095,9734,4819,14079,7914,23813
352450,201910,795,2025,380,1236,52,184,119,355,171,539
352460,201910,2890,8073,1920,6228,403,1443,723,2189,1126,3632
352470,201910,3271,8215,2335,6678,284,922,1305,3481,1589,4403
352480,201910,3522,8446,2243,6142,368,1140,1063,2649,1431,3789
352490,201910,691,2078,541,1780,104,368,247,769,351,1137
352500,201910,10135,26289,6612,19608,2909,9426,761,1312,3670,10738
352510,201910,3447,9368,2510,7726,579,1921,1080,3137,1659,5058
352520,201910,2566,6916,1966,5840,390,1322,1055,2830,1445,4152
352530,201910,9379,24902,5772,17562,1145,3932,1326,3277,2471,7209
352540,201910,529,1600,374,1232,67,240,111,330,178,570
352550,201910,966,2768,666,2161,133,476,196,564,329,1040
352560,201910,579,1612,430,1309,71,233,195,542,266,775
352570,201910,1963,5691,1232,4156,329,1181,149,436,478,1617
352580,201910,626,1627,508,1411,60,202,317,838,377,1040
352585,201910,252,737,186,599,16,67,103,292,119,359
352590,201910,12503,32956,8531,25260,2365,7612,3615,9917,5980,17529
352600,201910,1890,5150,1443,4283,196,643,833,2306,1029,2949
352610,201910,2981,8381,2186,6934,466,1662,885,2607,1351,4269
352620,201910,5603,14621,4257,12559,1280,3823,1602,4753,2882,8576
352630,201910,815,2053,602,1722,103,339,275,710,378,1049
352640,201910,2913,7605,2034,6034,222,685,1162,3306,1384,3991
352650,201910,574,1631,388,1197,59,211,145,420,204,631
352660,201910,1007,3021,797,2562,166,554,351,1092,517,1646
352670,201910,8641,23669,5338,16919,1494,5002,909,2803,2403,7805
352680,201910,3223,9696,2247,7374,366,1410,1108,3323,1474,4733
352690,201910,26279,66632,19629,54729,1574,5168,13276,35333,14850,40501
352700,201910,547,1360,387,1128,142,473,85,224,227,697
352710,201910,4867,12730,3359,9917,812,2648,1402,3821,2214,6469
352720,201910,7556,21019,5731,17436,2667,8218,907,2501,3574,10719
352725,201910,528,1328,269,797,19,56,127,361,146,417
352730,201910,2705,7754,2232,6639,333,1120,1316,3573,1649,4693
352740,201910,2206,5260,1605,4356,180,565,942,2424,1122,2989
352750,201910,395,996,215,666,38,130,83,217,121,347
352760,201910,1603,4477,1177,3596,151,490,589,1764,740,2254
352770,201910,885,2385,571,1761,118,380,225,662,343,1042
352780,201910,623,1795,424,1389,78,259,126,397,204,656
352790,201910,434,1182,283,859,29,99,111,301,140,400
352800,201910,1248,3857,867,2959,246,888,124,359,370,1247
352810,201910,1095,2627,672,1853,85,245,390,1019,475,1264
352820,201910,505,1338,322,1021,71,232,73,247,144,479
352830,201910,574,1465,243,751,23,77,50,121,73,198
352840,201910,3768,10921,3041,9580,1052,3618,958,2894,2010,6512
352850,201910,10313,25561,6708,19579,1923,6076,2024,5326,3947,11402
352860,201910,1006,2771,698,2183,149,496,228,671,377,1167
352870,201910,877,2209,595,1609,39,130,395,1010,434,1140
352880,201910,1747,4143,1194,3168,167,469,728,1824,895,2293
352885,201910,298,849,219,706,27,94,123,377,150,471
352890,201910,686,1623,425,1095,47,137,240,547,287,684
352900,201910,17493,45904,11317,33554,1891,5999,5056,14015,6947,20014
352910,201910,433,1151,211,665,22,70,59,167,81,237
352920,201910,2627,6817,1868,5441,149,473,1239,3473,1388,3946
352930,201910,5544,15089,3978,11957,727,2383,1817,5058,2544,7441
352940,201910,21374,59499,15195,46090,3446,11429,5643,16121,9089,27550
352950,201910,472,1262,262,849,70,239,33,96,103,335
352960,201910,708,1924,360,1168,56,196,81,240,137,436
352965,201910,257,693,139,464,39,129,33,106,72,235
352970,201910,2915,7002,2194,5831,256,731,1409,3695,1665,4426
352980,201910,1385,3716,1063,3202,272,860,519,1526,791,2386
352990,201910,4005,11348,3137,9899,625,2174,1568,4737,2193,6911
353000,201910,450,1241,228,708,35,114,56,145,91,259
353010,201910,2451,6122,1560,4534,373,1204,595,1570,968,2774
353020,201910,3608,9400,1991,5970,293,991,696,1943,989,2934
353030,201910,4145,10713,2723,8088,678,2170,692,1981,1370,4151
353040,201910,608,1450,430,1177,56,166,254,649,310,815
353050,201910,5001,14595,3532,11497,714,2515,1560,4851,2274,7366
353060,201910,47205,121298,38205,106664,2859,9616,28259,75814,31118,85430
353070,201910,9090,26019,6216,19808,1303,4530,2312,6777,3615,11307
353080,201910,3915,11035,2609,8422,521,1900,990,2798,1511,4698
353090,201910,541,1655,396,1337,36,131,228,745,264,876
353100,201910,297,813,125,411,25,85,33,91,58,176
353110,201910,7418,20356,5927,18128,1174,3656,3227,10088,4401,13744
353120,201910,392,996,274,786,41,139,113,291,154,430
353130,201910,2323,5566,1453,4124,397,1242,467,1218,864,2460
353140,201910,2634,6593,1860,5182,135,447,1251,3278,1386,3725
353150,201910,1460,3636,1008,2892,200,606,437,1172,637,1778
353160,201910,553,1433,380,1141,69,235,162,443,231,678
353170,201910,491,1375,369,1193,83,299,158,486,241,785
353180,201910,9459,23490,7278,19907,728,2249,5341,14162,6069,16411
353190,201910,3166,8595,2478,7218,279,907,1519,4138,1798,5045
353200,201910,1994,5352,907,2979,154,546,209,629,363,1175
353205,201910,330,1019,275,887,56,197,127,405,183,602
353210,201910,954,2250,587,1625,31,100,377,1014,408,1114
353215,201910,381,1089,292,908,49,161,135,370,184,531
353220,201910,728,1995,415,1302,99,292,51,150,150,442
353230,201910,782,2189,613,1917,171,581,240,678,411,1259
353240,201910,2235,6138,1772,5306,250,854,1029,2937,1279,3791
353250,201910,1260,2844,742,1967,99,284,402,1014,501,1298
353260,201910,1095,2583,589,1727,93,303,271,755,364,1058
353270,201910,677,1737,552,1509,42,134,382,992,424,1126
353280,201910,703,1895,473,1454,97,309,147,414,244,723
353282,201910,1745,4970,1457,4417,169,590,878,2496,1047,3086
353284,201910,351,816,169,466,21,77,72,169,93,246
353286,201910,159,399,93,289,19,62,37,116,56,178
353290,201910,1515,4025,892,2741,131,422,322,909,453,1331
353300,201910,1757,4771,1258,3763,212,716,561,1498,773,2214
353310,201910,388,957,264,730,21,75,176,461,197,536
353320,201910,643,1612,537,1446,13,44,463,1244,476,1288
353325,201910,633,1871,414,1382,94,309,152,485,246,794
353330,201910,511,1307,323,933,44,131,170,457,214,588
353340,201910,2729,7434,1871,5749,415,1402,815,2350,1230,3752
353350,201910,3260,8627,2177,6387,487,1576,563,1407,1050,2983
353360,201910,570,1624,437,1381,53,174,237,736,290,910
353370,201910,546,1589,439,1412,33,108,306,947,339,1055
353380,201910,265,804,210,687,32,116,102,304,134,420
353390,201910,5561,13929,3978,11152,503,1575,2189,5789,2692,7364
353400,201910,414,1165,306,949,49,176,102,263,151,439
353410,201910,499,1352,377,1127,63,204,215,633,278,837
353420,201910,438,1183,254,767,55,152,20,48,75,200
353430,201910,2164,6063,1565,4934,368,1281,635,1854,1003,3135
353440,201910,62701,171686,43691,133676,7611,25109,22410,64852,30021,89961
353450,201910,379,982,249,753,39,139,114,313,153,452
353460,201910,3222,8790,2277,6873,165,604,1091,3177,1256,3781
353470,201910,7533,20003,5209,15589,920,3110,2123,5787,3043,8897
353475,201910,1378,3589,947,2703,145,462,469,1232,614,1694
353480,201910,1609,4328,1248,3674,71,258,841,2364,912,2622
353490,201910,1061,2813,658,2009,100,323,279,808,379,1131
353500,201910,990,2331,731,1935,165,439,404,1074,569,1513
353510,201910,789,2396,545,1776,128,442,139,400,267,842
353520,201910,1076,2834,667,2068,88,307,296,852,384,1159
353530,201910,2382,6372,1804,5298,239,782,925,2528,1164,3310
353540,201910,1997,5484,1623,4865,274,860,916,2664,1190,3524
353550,201910,5706,14896,4460,12818,792,2412,2430,6712,3222,9124
353560,201910,1987,5533,1437,4626,454,1583,353,1045,807,2628
353570,201910,552,1410,406,1176,54,163,246,666,300,829
353580,201910,1976,5180,1518,4348,351,985,709,1989,1060,2974
353590,201910,694,1868,440,1349,103,348,162,488,265,836
353600,201910,1733,4331,1286,3526,157,428,691,1850,848,2278
353610,201910,542,1623,378,1289,87,351,104,324,191,675
353620,201910,2594,7033,1768,5498,356,1253,570,1582,926,2835
353625,201910,475,1167,298,860,21,66,194,552,215,618
353630,201910,1230,3878,988,3311,228,854,321,972,549,1826
353640,201910,1344,3502,1065,3071,142,433,614,1749,756,2182
353650,201910,8260,22298,5864,17474,662,2214,3386,9429,4048,11643
353657,201910,380,994,257,775,32,97,108,300,140,397
353660,201910,1230,2682,828,2113,333,842,234,582,567,1424
353670,201910,3966,11149,3002,9217,606,2059,1486,4221,2092,6280
353680,201910,645,1734,464,1458,86,287,253,761,339,1048
353690,201910,426,1077,159,498,10,27,22,62,32,89
353700,201910,1935,5167,1579,4525,130,420,1136,3129,1266,3549
353710,201910,4404,9818,2443,6342,229,636,1516,3567,1745,4203
353715,201910,433,1149,239,761,14,56,69,207,83,263
353720,201910,1855,5069,1416,4409,179,639,864,2631,1043,3270
353730,201910,4215,11377,3090,9229,493,1655,1472,4028,1965,5683
353740,201910,1946,5200,1312,4025,328,1097,428,1188,756,2285
353750,201910,795,2433,542,1926,134,501,94,365,228,866
353760,201910,12208,29033,9262,24849,1748,4837,5160,13483,6908,18320
353770,201910,708,2146,360,1232,63,233,54,156,117,389
353780,201910,5046,14353,3824,11833,817,2821,1701,4798,2518,7619
353790,201910,2495,7697,1784,6162,503,1969,378,1145,881,3114
353800,201910,16977,45417,12860,38481,2004,6407,6918,20595,8922,27002
353810,201910,1070,2908,696,2126,107,369,296,850,403,1219
353820,201910,1674,4649,1127,3504,259,861,358,1065,617,1926
353830,201910,621,1549,430,1230,74,220,192,519,266,739
353850,201910,1591,4504,1190,3703,289,917,407,1251,696,2168
353860,201910,2495,7055,1922,5971,473,1668,840,2345,1313,4013
353870,201910,27960,74405,19173,56771,2642,8832,9863,26603,12505,35435
353880,201910,2924,8250,2251,6907,190,693,1356,3990,1546,4683
353890,201910,2387,5322,1540,4096,148,415,1022,2599,1170,3014
353900,201910,714,2002,491,1548,91,318,186,543,277,861
353910,201910,1959,5631,1591,5007,213,812,1029,3127,1242,3939
353920,201910,1799,4992,1222,3845,276,994,324,850,600,1844
353930,201910,4099,11005,2674,8357,538,1895,996,2761,1534,4656
353940,201910,1073,3108,714,2344,144,491,240,725,384,1216
353950,201910,2965,8137,2303,6925,426,1412,1282,3562,1708,4974
353960,201910,713,1879,459,1383,91,294,177,503,268,797
353970,201910,688,1663,501,1385,42,125,323,860,365,985
353980,201910,14661,37695,11019,31017,933,2970,7627,20656,8560,23626
353990,201910,882,2165,508,1460,79,247,244,663,323,910
354000,201910,2436,5933,1283,3698,282,854,205,561,487,1415
354010,201910,343,897,243,729,37,122,136,394,173,516
354020,201910,3314,9324,2554,7676,668,2157,999,2750,1667,4907
354025,201910,725,2001,449,1454,79,293,92,265,171,558
354030,201910,494,1097,249,685,52,150,113,304,165,454
354040,201910,797,1906,496,1379,29,98,345,921,374,1019
354050,201910,944,2700,640,2131,161,559,185,618,346,1177
354060,201910,3361,9609,2209,7103,532,1795,729,2158,1261,3953
354070,201910,3390,9212,2274,7005,435,1524,850,2213,1285,3737
354075,201910,2440,7202,1834,6028,233,911,1019,3241,1252,4152
354080,201910,1363,3754,878,2797,180,616,203,583,383,1199
354085,201910,409,873,316,754,1,3,230,512,231,515
354090,201910,1494,4259,1292,3839,99,314,970,2834,1069,3148
354100,201910,18372,51313,12524,40642,2855,9951,4757,15326,7612,25277
354105,201910,1517,3811,979,2802,128,369,442,1182,570,1551
354110,201910,479,1332,313,1015,51,175,101,329,152,504
354120,201910,1440,3891,923,2775,185,601,321,841,506,1442
354130,201910,5553,14722,3474,10605,924,3007,214,412,1138,3419
354140,201910,18676,45675,11883,33248,2169,6629,4893,12624,7062,19253
354150,201910,3015,7275,2190,5909,497,1371,855,2268,1352,3639
354160,201910,2926,8545,2105,6843,628,2187,577,1722,1205,3909
354165,201910,595,1798,441,1477,77,302,222,692,299,994
354170,201910,1564,4421,1280,3843,82,303,818,2339,900,2642
354180,201910,405,1114,282,847,57,174,113,304,170,478
354190,201910,1429,4056,958,3050,73,269,395,1231,468,1500
354200,201910,842,2106,650,1797,82,237,398,1056,480,1293
354210,201910,711,1922,562,1661,41,143,403,1115,444,1258
354220,201910,2969,8108,2116,6358,406,1317,996,2829,1402,4146
354230,201910,709,1797,547,1589,39,154,385,1048,424,1202
354240,201910,1550,4331,993,3152,174,618,302,823,476,1441
354250,201910,502,1273,306,961,90,279,80,271,170,550
354260,201910,7967,21435,5928,17746,1305,4099,2382,6908,3687,11007
354270,201910,1014,3076,788,2621,193,620,288,944,481,1564
354280,201910,754,1936,627,1745,60,217,394,1019,454,1236
354290,201910,873,2787,721,2457,121,417,359,1255,480,1672
354300,201910,3507,10402,2952,9354,914,2882,993,3135,1907,6017
354310,201910,632,1902,501,1625,124,432,170,512,294,944
354320,201910,882,2182,541,1580,70,249,220,568,290,817
354323,201910,455,1117,298,830,36,82,123,332,159,414
354325,201910,1201,3576,833,2772,147,492,327,1064,474,1556
354330,201910,8860,22697,5565,15785,726,2445,3187,8340,3913,10785
354340,201910,29143,74720,19167,56690,3469,11362,9098,25542,12567,36904
354350,201910,1156,2988,907,2545,97,295,611,1642,708,1937
354360,201910,592,1532,308,1032,55,189,55,176,110,365
354370,201910,962,2843,770,2516,131,452,423,1351,554,1803
354380,201910,719,1914,500,1544,90,343,121,301,211,644
354390,201910,13062,31880,7919,22624,1522,4602,2930,7967,4452,12569
354400,201910,1517,4920,1150,4029,204,777,401,1367,605,2144
354410,201910,5385,14898,3928,11841,910,2925,1634,4704,2544,7629
354420,201910,1442,3826,1034,3038,131,399,627,1776,758,2175
354425,201910,2611,6467,1796,5009,434,1231,734,2054,1168,3285
354430,201910,1529,4123,1165,3485,135,470,666,1850,801,2320
354440,201910,555,1495,335,1022,48,172,152,417,200,589
354450,201910,398,1044,206,674,36,123,51,141,87,264
354460,201910,882,2238,554,1642,81,252,294,842,375,1094
354470,201910,485,1229,294,826,20,68,146,364,166,432
354480,201910,1129,2559,730,1941,64,174,500,1277,564,1451
354490,201910,777,2339,550,1827,114,398,230,713,344,1111
354500,201910,1955,5599,1596,5034,496,1689,369,1177,865,2866
354510,201910,722,2037,563,1699,58,180,300,828,358,1008
354515,201910,312,933,224,739,38,132,88,284,126,416
354520,201910,6349,17684,4185,12866,629,2187,2266,6479,2895,8666
354530,201910,4062,11790,3055,9732,739,2402,1194,3763,1933,6165
354540,201910,1292,3463,919,2791,227,724,319,975,546,1699
354550,201910,508,1347,378,1087,53,163,216,581,269,744
354560,201910,2031,5024,1049,3053,152,454,519,1426,671,1880
354570,201910,1171,2951,447,1301,89,272,59,170,148,442
354580,201910,8822,23134,5525,16807,858,2863,2705,7832,3563,10695
354600,201910,1744,4819,1304,3946,159,549,811,2328,970,2877
354610,201910,401,1048,213,645,27,89,91,258,118,347
354620,201910,415,1214,258,890,45,174,91,275,136,449
354625,201910,317,876,169,559,27,103,40,106,67,209
354630,201910,1853,5595,1460,4769,529,1795,236,721,765,2516
354640,201910,3068,8923,2164,7019,377,1382,730,2179,1107,3561
354650,201910,861,2251,672,1928,60,172,417,1190,477,1362
354660,201910,3679,8705,1866,5569,183,657,871,2381,1054,3038
354670,201910,1031,2928,695,2213,152,528,253,728,405,1256
354680,201910,4787,12900,3678,11034,893,2760,1817,5586,2710,8346
354690,201910,518,1663,347,1252,81,303,99,351,180,654
354700,201910,876,2317,602,1767,93,302,296,810,389,1112
354710,201910,466,1265,314,956,46,150,132,359,178,509
354720,201910,316,768,129,388,45,144,22,65,67,209
354730,201910,9489,26856,6912,21792,997,3459,3808,11568,4805,15027
354740,201910,312,864,120,424,21,86,18,60,39,146
354750,201910,2395,6307,1469,4495,274,892,606,1650,880,2542
354760,201910,1906,5280,1296,4077,327,1101,384,1114,711,2215
354765,201910,350,934,127,418,19,64,23,64,42,128
354770,201910,2278,5645,1622,4529,309,939,749,1946,1058,2885
354780,201910,52594,135416,38663,106997,4724,14616,23116,59883,27840,74499
354790,201910,982,2758,763,2378,95,324,444,1322,539,1646
354800,201910,2510,6591,1917,5585,498,1476,791,2181,1289,3657
354805,201910,1315,3045,863,2339,101,274,470,1154,571,1428
354810,201910,639,1861,338,1208,42,172,71,229,113,401
354820,201910,918,2667,644,2103,130,474,157,431,287,905
354830,201910,454,1129,272,789,57,169,88,239,145,408
354840,201910,895,2233,478,1405,44,138,267,746,311,884
354850,201910,20492,53770,13868,41478,1734,6004,8177,22911,9911,28915
354860,201910,1635,4630,1010,3280,196,700,314,898,510,1598
354870,201910,55184,140495,41829,115135,4943,14899,25141,65311,30084,80210
354880,201910,5648,14084,2526,7230,322,1065,890,2053,1212,3118
354890,201910,16616,41753,12562,34741,1763,5508,7318,19384,9081,24892
354900,201910,402,1038,250,764,42,136,61,169,103,305
354910,201910,5096,13667,2891,9441,678,2338,420,1304,1098,3642
354920,201910,440,1175,180,621,23,93,38,127,61,220
354925,201910,275,795,156,524,23,84,32,95,55,179
354930,201910,391,923,206,607,14,49,94,248,108,297
354940,201910,2140,6549,1456,4960,491,1801,243,747,734,2548
354950,201910,1407,3736,1099,3275,68,289,792,2201,860,2490
354960,201910,877,2359,661,2032,59,226,388,1116,447,1342
354970,201910,4034,11491,3081,9749,403,1387,1851,5680,2254,7067
354980,201910,30622,73372,19574,53859,2268,7426,11276,28709,13544,36135
354990,201910,60053,154281,43572,123490,4094,13271,27331,73119,31425,86390
354995,201910,2691,6263,1999,5319,192,634,1415,3549,1607,4183
355000,201910,1508,3863,1132,3295,183,618,518,1385,701,2003
355010,201910,3651,10012,2060,6583,698,2301,197,660,895,2961
355020,201910,3458,9870,2451,8023,663,2345,770,2380,1433,4725
355030,201910,1311079,3244746,908109,2439692,147126,432746,443384,1094917,590510,1527663
355040,201910,2775,7194,2177,6371,348,1028,1419,4182,1767,5210
355050,201910,940,2240,660,1793,185,533,247,622,432,1155
355060,201910,5776,15914,4175,12789,724,2543,2028,5627,2752,8170
355070,201910,8244,21639,6482,18714,770,2603,4057,10992,4827,13595
355080,201910,891,2582,525,1836,105,399,73,197,178,596
355090,201910,1102,3229,806,2688,219,703,212,751,431,1454
355100,201910,21848,57638,16604,49623,2849,8998,9869,29151,12718,38149
355110,201910,851,2391,605,1976,187,672,104,318,291,990
355120,201910,684,1805,469,1465,41,145,174,507,215,652
355130,201910,862,1897,385,1029,25,74,212,528,237,602
355140,201910,1741,4087,1465,3685,109,338,1187,2879,1296,3217
355150,201910,4244,11347,3305,9632,376,1208,2071,5783,2447,6991
355160,201910,1832,5110,1288,4099,321,1138,295,903,616,2041
355170,201910,9500,24684,7238,20757,1512,4649,3678,10181,5190,14830
355180,201910,2694,7351,1860,5888,412,1446,650,1859,1062,3305
355190,201910,1846,4858,1432,4206,326,989,756,2328,1082,3317
355200,201910,817,2552,683,2334,188,712,275,863,463,1575
355210,201910,2764,7706,2149,6381,392,1336,1099,3044,1491,4380
355220,201910,42761,115266,32862,95764,8167,25274,13077,35081,21244,60355
355230,201910,1113,2799,581,1734,104,308,188,527,292,835
355240,201910,23291,61791,15683,46338,2297,7395,8146,22738,10443,30133
355250,201910,35992,97417,25546,76681,6512,20698,9345,26514,15857,47212
355255,201910,709,1789,369,1133,62,201,127,368,189,569
355260,201910,1384,3545,985,2835,133,467,571,1515,704,1982
355270,201910,1185,3523,877,2850,218,732,279,837,497,1569
355280,201910,27879,72733,18896,55033,3024,9467,8814,24232,11838,33699
355290,201910,856,2400,619,1946,142,422,247,749,389,1171
355300,201910,1203,3565,908,2947,167,569,287,897,454,1466
355310,201910,992,2726,722,2259,95,296,411,1293,506,1589
355320,201910,516,1366,374,1096,68,234,160,387,228,621
355330,201910,2443,6498,1834,5389,139,513,1325,3716,1464,4229
355340,201910,3860,8598,2952,7358,390,884,1830,4648,2220,5532
355350,201910,1294,3838,936,3093,213,732,316,1019,529,1751
355360,201910,1157,2984,867,2530,111,349,520,1494,631,1843
355365,201910,370,996,184,643,44,141,26,94,70,235
355370,201910,5369,13712,4026,11618,949,2567,1809,5709,2758,8276
355380,201910,2887,7843,2104,6308,396,1291,733,1888,1129,3179
355385,201910,1389,3701,1118,3281,113,412,697,1885,810,2297
355390,201910,782,2163,541,1610,116,372,223,610,339,982
355395,201910,1902,5286,1269,3984,211,709,444,1237,655,1946
355400,201910,8836,25863,6874,21792,1794,6427,2322,6520,4116,12947
355410,201910,20961,57551,13156,42346,3014,10655,3196,10124,6210,20779
355420,201910,621,2029,492,1758,134,546,123,413,257,959
355430,201910,3652,9290,2701,7596,705,1942,1181,3340,1886,5282
355440,201910,807,2221,465,1471,76,249,141,411,217,660
355450,201910,3151,8242,1939,5795,385,1205,755,2056,1140,3261
355460,201910,508,1254,306,904,40,140,151,407,191,547
355465,201910,379,1039,279,860,47,149,124,375,171,524
355470,201910,1093,2838,580,1783,173,575,165,451,338,1026
355475,201910,354,841,276,724,16,39,201,514,217,553
355480,201910,3618,10255,2951,9229,460,1651,1867,5616,2327,7267
355490,201910,943,2542,488,1528,39,132,252,735,291,867
355495,201910,752,2136,528,1727,71,261,193,595,264,856
355500,201910,6613,17322,3671,11252,580,1960,1176,3280,1756,5240
355510,201910,1290,3233,785,2329,112,378,321,852,433,1230
355520,201910,375,829,164,475,28,81,49,124,77,205
355530,201910,409,938,139,410,20,74,56,145,76,219
355535,201910,496,1367,367,1153,80,305,155,434,235,739
355540,201910,10025,26019,8103,23115,1380,4259,4937,13612,6317,17871
355550,201910,633,1896,515,1670,71,254,268,823,339,1077
355560,201910,1111,2878,570,1811,124,435,38,123,162,558
355570,201910,243,697,123,408,23,81,30,90,53,171
355580,201910,1191,2943,770,2216,139,442,334,899,473,1341
355590,201910,178,443,134,370,17,49,78,202,95,251
355600,201910,1453,3578,946,2707,199,609,403,1115,602,1724
355610,201910,1701,4274,1107,3193,138,436,547,1505,685,1941
355620,201910,4409,12039,3162,9500,380,1381,1692,4642,2072,6023
355630,201910,2231,6199,1494,4749,259,858,722,2252,981,3110
355635,201910,885,2610,639,2119,131,471,192,585,323,1056
355640,201910,2717,7736,1788,5813,359,1264,482,1491,841,2755
355645,201910,4192,11889,3038,9812,425,1481,1676,5300,2101,6781
355650,201910,6338,17294,4943,14678,1461,4486,1791,4807,3252,9293
355660,201910,1285,3374,861,2557,133,471,293,853,426,1324
355670,201910,3353,9174,2117,6308,278,1011,1064,2758,1342,3769
355680,201910,2848,7876,1110,3702,299,1036,121,419,420,1455
355690,201910,763,2294,467,1688,109,405,14,29,123,434
355695,201910,241,692,132,439,12,56,22,48,34,104
355700,201910,6893,20019,5468,16748,1000,3182,2815,8159,3815,11341
355710,201910,8298,19653,4998,13529,819,2423,2172,5271,2991,7694
355715,201910,460,1208,231,721,50,171,43,111,93,282
355720,201910,1439,4141,1111,3523,185,629,585,1716,770,2345
355730,201910,911,2574,715,2173,147,485,305,838,452,1323
410010,201910,1214,3366,887,2667,196,653,183,518,379,1171
410020,201910,945,2999,728,2468,266,839,183,642,449,1481
410030,201910,1474,4171,1237,3784,186,630,640,1951,826,2581
410040,201910,11378,32103,8146,25777,1784,6038,2603,7645,4387,13683
410045,201910,855,2275,572,1750,81,278,196,565,277,843
410050,201910,2392,6056,1508,4441,311,1002,442,1201,753,2203
410060,201910,2016,5857,1508,4765,351,1135,457,1399,808,2534
410070,201910,1774,4591,1233,3538,218,720,449,1175,667,1895
410080,201910,1350,3618,944,2838,172,543,363,1080,535,1623
410090,201910,1044,2770,905,2538,83,222,560,1641,643,1863
410100,201910,1817,5305,1189,3763,173,633,178,520,351,1153
410105,201910,464,1199,235,718,31,106,65,188,96,294
410110,201910,3033,7829,2040,5847,289,899,838,2264,1127,3163
410115,201910,543,1400,374,1098,56,182,132,368,188,550
410120,201910,2326,6889,2012,6358,521,1821,894,2725,1415,4546
410130,201910,1140,3126,976,2801,227,720,449,1180,676,1900
410140,201910,13921,33972,8104,23264,1597,4962,1886,4884,3483,9846
410150,201910,15890,37731,7213,20370,1246,3841,1614,4229,2860,8070
410160,201910,2844,7987,2259,6927,501,1698,799,2434,1300,4132
410165,201910,711,1934,593,1690,55,190,348,924,403,1114
410170,201910,2503,6554,1615,4603,376,1164,145,433,521,1597
410180,201910,14249,40253,10756,32767,1570,5216,5648,16087,7218,21303
410185,201910,405,1149,287,881,54,178,90,254,144,432
410190,201910,2209,5586,1562,4397,330,945,434,1193,764,2138
410200,201910,4868,11497,2548,7363,413,1396,502,1421,915,2817
410210,201910,2962,7546,1785,5324,296,1002,620,1617,916,2619
410220,201910,502,1285,314,929,46,147,63,183,109,330
410230,201910,1594,4333,1203,3500,160,554,662,1793,822,2347
410240,201910,4608,12510,3121,9575,837,2846,224,633,1061,3479
410250,201910,2555,6184,1824,4943,133,459,885,2324,1018,2783
410260,201910,1774,4494,1102,3232,202,621,467,1337,669,1958
410270,201910,455,1211,313,943,47,158,109,309,156,467
410275,201910,612,1746,392,1260,54,187,185,550,239,737
410280,201910,2245,6072,1457,4456,218,741,580,1650,798,2391
410290,201910,3070,8732,2049,6476,536,1722,558,1741,1094,3463
410300,201910,626,1589,491,1360,39,120,238,616,277,736
410302,201910,390,965,186,570,30,99,90,257,120,356
410304,201910,1169,3095,970,2724,123,340,560,1543,683,1883
410305,201910,1673,4114,1123,3292,146,469,663,1882,809,2351
410310,201910,2547,7380,1957,6132,372,1264,810,2506,1182,3770
410315,201910,706,1704,355,1109,131,410,76,231,207,641
410320,201910,1076,3021,702,2211,114,410,114,341,228,751
410322,201910,550,1479,274,832,28,99,132,365,160,464
410330,201910,1468,3648,996,2716,166,502,290,769,456,1271
410335,201910,821,2258,633,1888,91,293,286,790,377,1083
410337,201910,787,1907,529,1402,52,140,228,573,280,713
410340,201910,457,1277,303,897,31,106,142,352,173,458
410345,201910,2327,5992,1194,3529,250,773,357,957,607,1730
410347,201910,680,1721,472,1328,48,170,146,394,194,564
410350,201910,1264,3222,874,2553,107,329,368,1027,475,1356
410360,201910,4178,10185,3209,8525,307,935,1955,4958,2262,5893
410370,201910,12064,32809,7650,22328,975,3153,3117,8036,4092,11189
410380,201910,1406,3668,1022,2916,139,442,397,1040,536,1482
410390,201910,2543,6650,1584,4811,394,1326,421,1162,815,2488
410395,201910,838,2452,676,2097,133,458,295,895,428,1353
410400,201910,5373,14500,3965,11794,657,2067,1777,5069,2434,7136
410405,201910,773,1899,582,1616,124,387,246,634,370,1021
410410,201910,1181,3210,1111,3107,170,584,687,1962,857,2546
410420,201910,8385,23882,6229,19427,1102,3813,2134,5976,3236,9789
410425,201910,2871,8244,1989,6385,352,1247,727,2113,1079,3360
410430,201910,12509,31875,8289,23874,1395,4394,2836,7749,4231,12143
410440,201910,2293,6978,1935,6270,303,1103,1009,3200,1312,4303
410442,201910,2125,6619,1745,5743,506,1673,529,1708,1035,3381
410445,201910,2212,6522,1658,5413,335,1229,415,1415,750,2644
410450,201910,1408,3572,981,2815,183,593,332,873,515,1466
410460,201910,1873,4667,1447,4018,164,492,704,1891,868,2383
410465,201910,2539,7522,1928,6257,364,1216,646,1978,1010,3194
410470,201910,1930,5483,1336,4289,375,1360,211,696,586,2056
410480,201910,35988,85695,18254,53594,3028,9993,3951,9866,6979,19859
410490,201910,10595,29795,7288,22700,1403,4739,2711,7981,4114,12720
410500,201910,1660,4541,1113,3418,245,889,314,821,559,1710
410510,201910,1894,4722,1213,3399,239,663,348,982,587,1645
410520,201910,3013,9592,2677,8893,869,2951,988,3329,1857,6280
410530,201910,1587,3990,724,2104,104,296,168,400,272,696
410540,201910,2474,6752,1723,5238,299,987,836,2478,1135,3465
410550,201910,6940,18752,4334,12859,776,2498,1151,2984,1927,5482
410560,201910,1395,3661,1012,2880,224,688,367,909,591,1597
410570,201910,2436,6805,1759,5545,506,1883,167,568,673,2451
410580,201910,23773,62588,17067,50035,3549,11008,7188,19690,10737,30698
410590,201910,1505,4336,958,2955,156,515,275,739,431,1254
410600,201910,1753,4768,1307,3884,279,791,474,1455,753,2246
410610,201910,708,1883,501,1475,54,190,224,636,278,826
410620,201910,2129,6355,1333,4408,295,1050,238,747,533,1797
410630,201910,2323,6242,1457,4391,287,964,268,654,555,1618
410640,201910,4552,10814,2847,7819,689,2167,378,1025,1067,3192
410645,201910,1008,2967,822,2707,263,891,342,1144,605,2035
410650,201910,2032,5684,1331,4184,286,978,460,1320,746,2298
410655,201910,903,2201,615,1663,25,85,317,810,342,895
410657,201910,593,1589,366,1119,57,207,140,361,197,568
410660,201910,3130,8192,1680,4942,297,925,404,1132,701,2057
410670,201910,1026,2581,587,1694,125,367,233,618,358,985
410680,201910,2611,7976,1828,5981,480,1590,357,1184,837,2774
410685,201910,552,1414,407,1157,94,306,164,412,258,718
410690,201910,119079,296364,74956,212222,12787,41126,26788,66319,39575,107445
410700,201910,2366,6084,1972,5466,279,810,1059,2836,1338,3646
410710,201910,795,2029,512,1507,67,206,245,699,312,905
410712,201910,613,1833,508,1602,126,437,184,552,310,989
410715,201910,810,2374,481,1600,79,271,155,494,234,765
410720,201910,3053,7896,2251,6279,322,1064,488,1275,810,2339
410725,201910,1060,2649,587,1739,118,370,92,223,210,593
410730,201910,606,1624,453,1329,101,348,94,263,195,611
410740,201910,924,2597,663,2106,96,335,262,810,358,1145
410750,201910,1719,4417,1342,3714,208,641,590,1537,798,2178
410752,201910,353,893,157,478,17,56,70,199,87,255
410753,201910,244,751,173,593,26,103,40,124,66,227
410754,201910,1083,2839,874,2510,57,157,603,1822,660,1979
410755,201910,564,1474,386,1113,60,195,167,419,227,614
410760,201910,3293,8593,2275,6736,597,2007,490,1327,1087,3334
410765,201910,12088,34526,9130,28496,1560,5375,1731,4882,3291,10257
410770,201910,999,2407,666,1825,69,204,352,951,421,1155
410773,201910,1261,3392,1082,3102,116,377,674,1863,790,2240
410775,201910,1422,3634,1226,3334,73,229,771,2072,844,2301
410780,201910,614,1541,383,1070,59,176,96,264,155,440
410785,201910,706,1917,527,1585,92,306,188,550,280,856
410790,201910,677,1943,538,1659,156,523,63,142,219,665
410800,201910,3286,7384,2590,6305,53,184,1663,3936,1716,4120
410810,201910,368,997,273,801,26,82,133,366,159,448
410820,201910,782,2242,389,1215,88,275,71,200,159,475
410830,201910,31451,77805,20528,58931,4498,14685,6857,18495,11355,33180
410832,201910,949,2509,749,2148,88,287,424,1130,512,1417
410840,201910,7581,19643,4342,13205,850,2803,1109,3028,1959,5831
410845,201910,1106,2869,849,2448,161,474,361,1024,522,1498
410850,201910,2199,6415,1886,5827,317,1056,922,2753,1239,3809
410855,201910,771,1946,487,1394,44,130,232,621,276,751
410860,201910,4157,10612,3282,9106,389,1219,1741,4603,2130,5822
410865,201910,1310,3964,1148,3631,147,531,680,2165,827,2696
410870,201910,1267,3452,1063,3111,70,226,733,2113,803,2339
410880,201910,4178,11601,2882,9080,500,1762,443,1540,943,3302
410890,201910,950,2688,673,2128,150,521,192,599,342,1120
410895,201910,959,3139,788,2732,263,976,146,480,409,1456
410900,201910,844,2264,546,1659,102,316,102,251,204,567
410910,201910,357,837,202,541,12,41,129,321,141,362
410920,201910,818,1959,535,1495,77,242,249,682,326,924
410930,201910,1543,4109,1085,3259,277,974,230,664,507,1638
410940,201910,21484,59816,15160,47904,3204,11138,4533,14158,7737,25296
410950,201910,1906,5608,1685,5257,55,195,1382,4251,1437,4446
410960,201910,6914,17716,4354,13159,1019,3434,1580,4646,2599,8080
410965,201910,960,2508,677,1958,89,289,377,1062,466,1351
410970,201910,3773,10289,2584,7935,601,2206,350,911,951,3117
410975,201910,1263,3229,930,2666,110,334,412,1192,522,1526
410980,201910,6787,17258,4143,12299,529,1753,1723,4763,2252,6516
410990,201910,1290,3232,832,2477,235,804,228,619,463,1423
411000,201910,584,1584,373,1158,50,178,111,301,161,479
411005,201910,399,1074,238,721,46,147,53,152,99,299
411007,201910,2192,6229,1774,5466,409,1315,618,1911,1027,3226
411010,201910,4135,12533,3192,10497,830,2960,354,1059,1184,4019
411020,201910,2204,6405,1780,5632,517,1714,500,1523,1017,3237
411030,201910,714,1779,469,1260,36,132,259,610,295,742
411040,201910,912,2316,425,1216,46,141,141,341,187,482
411050,201910,1779,5697,1445,4892,398,1444,223,649,621,2093
411060,201910,1756,4602,1096,3294,261,919,164,441,425,1360
411065,201910,368,982,242,741,37,123,101,295,138,418
411070,201910,6539,17133,5136,14670,749,2421,2473,6797,3222,9218
411080,201910,2082,5545,1609,4678,439,1440,321,876,760,2316
411090,201910,814,2150,504,1531,38,142,137,393,175,535
411095,201910,1525,3605,1006,2765,111,337,363,944,474,1281
411100,201910,1081,2815,710,2141,84,294,220,672,304,966
411110,201910,631,1631,257,803,37,105,19,42,56,147
411120,201910,1180,3376,939,2870,327,1138,211,554,538,1692
411125,201910,4952,14702,4332,13463,903,2830,2109,6783,3012,9613
411130,201910,676,1847,467,1425,86,245,182,583,268,828
411140,201910,2216,6896,1826,6008,541,1904,494,1584,1035,3488
411150,201910,3711,9691,2448,7035,515,1699,234,508,749,2207
411155,201910,953,2451,540,1654,68,201,231,670,299,871
411160,201910,347,811,223,626,32,104,46,132,78,236
411170,201910,697,2110,500,1632,109,340,165,533,274,873
411180,201910,5182,13952,3894,11565,621,2018,1762,4913,2383,6931
411190,201910,1519,3973,1110,3224,182,563,428,1154,610,1717
411200,201910,4836,13207,3236,10087,849,2871,600,1627,1449,4498
411210,201910,2811,6239,1783,4631,332,982,546,1297,878,2279
411220,201910,808,2146,578,1682,134,423,169,474,303,897
411230,201910,800,2163,547,1656,111,353,211,628,322,981
411240,201910,1534,3747,916,2538,99,325,451,1141,550,1466
411250,201910,2124,5747,1551,4683,322,1123,476,1383,798,2506
411260,201910,319,867,201,620,23,67,79,219,102,286
411270,201910,1936,5301,1446,4289,239,733,666,1833,905,2566
411275,201910,1343,3145,881,2366,148,465,384,961,532,1426
411280,201910,1287,3513,831,2611,224,721,112,347,336,1068
411290,201910,762,2034,484,1475,47,131,248,781,295,912
411295,201910,1171,2946,837,2279,97,278,385,997,482,1275
411300,201910,999,2484,598,1686,57,179,250,625,307,804
411310,201910,855,2024,636,1693,45,117,284,743,329,860
411320,201910,5210,13737,3687,10906,683,2110,1482,3981,2165,6091
411325,201910,1417,4034,1183,3611,200,597,665,2088,865,2685
411330,201910,3282,8944,2349,7195,545,1815,720,2208,1265,4023
411340,201910,819,2244,470,1450,70,235,165,486,235,721
411342,201910,977,2368,558,1538,96,278,239,640,335,918
411345,201910,1057,2773,775,2306,72,231,543,1614,615,1845
411350,201910,2520,7010,1576,5007,423,1452,200,587,623,2039
411360,201910,646,1588,457,1291,63,187,151,417,214,604
411370,201910,50483,125324,35214,98811,2709,9247,20908,54937,23617,64184
411373,201910,1334,3414,1066,2994,87,292,574,1623,661,1915
411375,201910,1068,2716,751,2102,126,366,278,731,404,1097
411380,201910,1109,2613,714,1840,37,110,420,994,457,1104
411390,201910,1525,4224,1148,3365,186,599,463,1187,649,1786
411400,201910,2176,5519,1646,4503,194,638,821,2124,1015,2762
411410,201910,2249,6292,1608,4860,352,1184,356,1036,708,2220
411420,201910,3928,9784,2031,6057,307,1042,362,827,669,1869
411430,201910,3316,9067,2485,7439,556,1824,897,2456,1453,4280
411435,201910,423,1206,260,840,48,143,86,239,134,382
411440,201910,2397,6899,1925,5959,409,1409,670,2030,1079,3439
411450,201910,2483,6640,1864,5596,257,749,1003,3053,1260,3802
411460,201910,3661,9677,2081,6456,397,1418,370,1065,767,2483
411470,201910,723,1903,513,1474,92,276,186,486,278,762
411480,201910,4394,12089,3099,9549,660,2371,968,2699,1628,5070
411490,201910,1582,4149,1193,3469,153,522,477,1247,630,1769
411500,201910,1288,3483,828,2482,145,488,172,448,317,936
411510,201910,2222,5790,1740,4919,384,1257,394,1133,778,2390
411520,201910,29467,72090,15997,45448,2046,6646,5935,15012,7981,21658
411530,201910,888,2350,530,1641,106,371,91,240,197,611
411535,201910,453,1319,231,762,29,105,45,112,74,217
411540,201910,2766,6840,1799,4996,221,715,853,2258,1074,2973
411545,201910,904,2644,746,2353,71,219,487,1552,558,1771
411550,201910,664,1726,461,1318,75,238,90,266,165,504
411560,201910,1865,5025,1040,3235,168,590,83,233,251,823
411570,201910,6825,16236,4355,12293,944,2912,852,2355,1796,5267
411573,201910,747,2050,625,1856,93,295,330,961,423,1256
411575,201910,1819,5076,1334,4071,268,868,310,935,578,1803
411580,201910,4359,10029,2406,6973,347,1218,434,1123,781,2341
411585,201910,627,1842,267,897,67,233,47,141,114,374
411590,201910,365,1040,249,775,22,79,135,367,157,446
411600,201910,283,719,169,531,38,119,56,171,94,290
411605,201910,1531,3562,897,2488,121,415,474,1285,595,1700
411610,201910,2360,5816,1637,4431,84,291,1052,2647,1136,2938
411620,201910,2776,7462,2342,6763,422,1282,1286,3668,1708,4950
411630,201910,722,1884,468,1394,72,246,151,400,223,646
411640,201910,458,1218,306,881,42,139,116,297,158,436
411650,201910,220,650,135,451,29,101,22,60,51,161
411660,201910,882,2231,615,1738,43,132,302,826,345,958
411670,201910,1290,3234,857,2348,96,282,391,987,487,1269
411680,201910,1455,3930,1079,3185,140,477,511,1466,651,1943
411690,201910,3502,9128,2595,7551,544,1642,788,2382,1332,4024
411695,201910,663,2036,407,1338,41,141,168,531,209,672
411700,201910,1586,4179,1004,3039,224,742,139,386,363,1128
411705,201910,1849,5800,1544,5269,313,1023,835,3066,1148,4089
411710,201910,1784,4586,1170,3382,297,881,185,530,482,1411
411720,201910,1065,2536,741,1943,130,362,307,750,437,1112
411721,201910,902,2343,659,1879,128,362,157,453,285,815
411722,201910,746,2051,386,1154,57,199,136,324,193,523
411725,201910,1133,3257,757,2477,173,603,168,567,341,1170
411727,201910,1458,4111,916,2910,216,725,155,448,371,1173
411729,201910,699,1717,427,1177,52,190,157,379,209,569
411730,201910,5132,13840,3806,11177,861,2661,1535,4397,2396,7058
411740,201910,530,1380,259,779,55,160,57,157,112,317
411745,201910,721,2061,452,1421,64,216,82,194,146,410
411750,201910,4873,12967,3366,9913,443,1405,1645,4547,2088,5952
411760,201910,6654,17953,5037,15071,1719,5303,988,3285,2707,8588
411770,201910,2921,8558,2052,6591,513,1761,285,835,798,2596
411780,201910,2805,8047,2341,7096,648,2072,788,2380,1436,4452
411790,201910,2771,6741,1407,4194,308,1026,181,437,489,1463
411800,201910,962,2713,659,2006,102,327,139,407,241,734
411810,201910,1519,4006,1095,3134,170,501,529,1441,699,1942
411820,201910,10570,30907,8462,26919,2262,7681,3432,10602,5694,18283
411830,201910,585,1425,395,1102,71,204,94,291,165,495
411840,201910,11418,30710,7318,21925,1304,4236,1936,5327,3240,9563
411845,201910,485,1397,245,796,35,134,46,143,81,277
411850,201910,7193,18561,4743,14143,1254,4160,733,1948,1987,6108
411860,201910,686,1982,495,1565,82,279,126,353,208,632
411870,201910,624,1869,430,1405,89,322,99,287,188,609
411880,201910,2101,5405,1499,4385,243,795,465,1329,708,2124
411885,201910,1029,2663,706,2065,82,269,255,712,337,981
411890,201910,1132,3022,723,2221,135,460,66,170,201,630
411900,201910,793,2239,451,1460,107,367,61,190,168,557
411910,201910,894,2680,629,2091,161,589,198,601,359,1190
411915,201910,15007,37113,9322,26595,1495,4764,3411,8690,4906,13454
411920,201910,1032,3133,855,2740,200,729,291,868,491,1597
411925,201910,466,1230,312,940,67,222,124,351,191,573
411930,201910,4927,15454,4103,13780,1787,6531,236,924,2023,7455
411940,201910,3218,9699,2437,7896,604,2060,734,2100,1338,4160
411950,201910,12996,35532,10454,31210,1663,5506,5771,16581,7434,22087
411960,201910,5651,15429,4487,13010,883,2844,1644,4449,2527,7293
411965,201910,411,1148,282,888,37,130,108,303,145,433
411970,201910,1038,2475,771,2097,158,398,316,987,474,1385
411980,201910,1430,3645,1013,2908,264,778,349,955,613,1733
411990,201910,37013,98254,22946,71434,4446,15173,7814,23067,12260,38240
411995,201910,2876,7331,2098,6084,605,1920,593,1628,1198,3548
412000,201910,1934,4453,1346,3441,35,107,946,2267,981,2374
412010,201910,582,1825,405,1421,61,233,102,284,163,517
412015,201910,536,1505,435,1318,53,179,262,792,315,971
412020,201910,435,1211,251,816,36,144,110,340,146,484
412030,201910,604,1702,402,1301,67,218,110,355,177,573
412033,201910,822,2214,558,1642,62,187,197,516,259,703
412035,201910,762,2049,476,1512,55,215,256,763,311,978
412040,201910,568,1543,341,1059,55,175,69,207,124,382
412050,201910,1665,4226,1102,3168,218,709,272,772,490,1481
412060,201910,6970,20992,5718,18388,1593,5760,1531,4653,3124,10413
412065,201910,607,1699,418,1272,87,277,116,355,203,632
412070,201910,1105,2847,834,2314,115,339,334,869,449,1208
412080,201910,1952,5556,1176,3817,185,623,186,537,371,1160
412085,201910,281,689,85,269,10,25,14,34,24,59
412090,201910,5687,14893,4217,12119,1185,3558,1451,4238,2636,7796
412100,201910,1532,4301,1127,3528,328,1117,240,816,568,1933
412110,201910,839,2230,574,1681,79,239,204,572,283,811
412120,201910,1887,5549,1433,4607,273,985,414,1154,687,2139
412125,201910,631,1793,441,1391,93,296,117,345,210,641
412130,201910,707,1833,481,1394,72,221,120,358,192,579
412135,201910,603,1606,259,780,35,107,90,249,125,356
412140,201910,1580,3922,982,2817,197,683,192,495,389,1178
412150,201910,2699,7225,2242,6390,315,1030,1348,3625,1663,4655
412160,201910,941,2943,556,1917,105,388,93,286,198,674
412170,201910,4119,11578,3420,10377,710,2327,1416,3970,2126,6297
412175,201910,1280,3738,1046,3328,229,748,442,1427,671,2175
412180,201910,1620,4514,1144,3591,152,561,512,1459,664,2020
412190,201910,3327,8374,2410,6735,312,953,1102,3049,1414,4002
412200,201910,1691,5131,1197,3926,330,1167,198,593,528,1760
412210,201910,614,1522,346,1005,51,164,110,289,161,453
412215,201910,3291,8971,2606,7654,696,1977,1097,3627,1793,5604
412217,201910,922,2442,770,2182,62,192,504,1391,566,1583
412220,201910,5739,16162,4528,13821,1127,3449,1459,4685,2586,8134
412230,201910,2540,7607,1994,6494,360,1330,554,1553,914,2883
412240,201910,6652,17102,4087,12051,719,2316,1243,3378,1962,5694
412250,201910,1955,5034,1440,4074,345,997,349,949,694,1946
412260,201910,1191,3231,821,2424,144,426,240,682,384,1108
412265,201910,851,2377,683,2081,130,427,289,833,419,1260
412270,201910,854,2395,548,1714,74,264,214,593,288,857
412280,201910,423,1196,324,1023,67,220,94,272,161,492
412290,201910,965,2494,636,1874,96,298,198,559,294,857
412300,201910,1408,3846,1080,3198,247,772,260,790,507,1562
412310,201910,731,2007,598,1763,44,195,330,928,374,1123
412320,201910,807,2088,529,1532,68,251,184,532,252,783
412330,201910,1457,3983,963,2983,195,657,317,1004,512,1661
412340,201910,1107,3134,649,2093,107,386,112,340,219,726
412350,201910,2774,7309,1690,5126,347,1065,325,931,672,1996
412360,201910,245,675,158,482,5,24,90,257,95,281
412370,201910,796,2296,516,1689,110,404,40,137,150,541
412380,201910,1521,4168,1030,3133,286,908,139,475,425,1383
412382,201910,494,1245,311,918,46,158,116,297,162,455
412385,201910,2122,5885,1701,5087,538,1528,526,1734,1064,3262
412390,201910,2344,5825,1872,5082,325,883,742,2049,1067,2932
412395,201910,687,1965,459,1442,53,163,195,599,248,762
412400,201910,858,2316,601,1793,121,393,154,470,275,863
412402,201910,1861,4674,1234,3594,295,894,149,439,444,1333
412405,201910,2954,7889,1868,5717,490,1792,47,137,537,1929
412410,201910,5574,14809,3947,11948,761,2652,1228,3489,1989,6141
412420,201910,492,1289,308,907,23,82,140,356,163,438
412430,201910,546,1382,319,927,25,80,149,420,174,500
412440,201910,2638,7396,1716,5521,451,1546,274,887,725,2433
412450,201910,370,1106,235,743,41,119,22,55,63,174
412460,201910,990,2656,769,2270,139,455,353,1021,492,1476
412470,201910,1515,4964,1219,4262,319,1162,284,995,603,2157
412480,201910,938,2554,587,1761,117,380,160,446,277,826
412490,201910,1217,3120,942,2588,122,347,503,1317,625,1664
412500,201910,1862,4774,1362,3791,298,815,377,990,675,1805
412510,201910,1888,5854,1267,4188,288,1020,119,337,407,1357
412520,201910,1241,3246,632,1876,157,472,53,142,210,614
412530,201910,629,1673,444,1281,70,227,108,300,178,527
412535,201910,780,2032,518,1519,87,285,111,277,198,562
412540,201910,1180,3104,801,2329,82,301,268,807,350,1108
412545,201910,673,1732,447,1252,72,203,147,396,219,599
412550,201910,29350,79596,19621,59390,3405,11190,7477,20824,10882,32014
412555,201910,259,693,165,476,16,45,49,108,65,153
412560,201910,4645,13679,3343,10551,559,1941,1020,3215,1579,5156
412570,201910,4133,10695,2206,6809,523,1796,281,953,804,2749
412575,201910,955,2459,751,2079,76,235,430,1115,506,1350
412580,201910,1381,3677,933,2772,104,362,466,1316,570,1678
412590,201910,413,1096,210,669,33,120,17,43,50,163
412600,201910,1406,3931,1021,3125,172,603,405,1171,577,1774
412610,201910,755,2008,517,1490,52,163,264,679,316,842
412620,201910,1222,3272,892,2727,169,598,292,825,461,1423
412625,201910,8533,22829,5014,15561,724,2534,318,878,1042,3412
412627,201910,1104,3133,663,2169,133,457,182,590,315,1047
412630,201910,2818,8281,1969,6379,404,1325,615,1816,1019,3141
412635,201910,348,936,235,686,36,124,78,181,114,305
412640,201910,1000,2667,521,1597,63,200,145,415,208,615
412650,201910,1553,4330,1205,3581,225,742,443,1144,668,1886
412660,201910,2346,6077,1568,4549,262,809,469,1230,731,2039
412665,201910,365,953,269,764,47,143,118,320,165,463
412667,201910,1673,4427,1231,3537,171,539,513,1395,684,1934
412670,201910,777,1907,506,1424,91,310,157,387,248,697
412680,201910,1667,4558,1096,3392,149,522,411,1138,560,1660
412690,201910,926,2514,682,2002,102,319,277,778,379,1097
412700,201910,1971,5269,1598,4655,201,685,855,2406,1056,3091
412710,201910,5729,17013,4228,13680,854,3069,1184,3480,2038,6549
412720,201910,1182,3514,876,2801,139,477,182,497,321,974
412730,201910,2158,5875,1300,4011,237,813,396,1146,633,1959
412740,201910,1761,4951,1159,3655,220,775,160,526,380,1301
412750,201910,3767,10028,3110,9042,323,1121,2032,5583,2355,6704
412760,201910,2840,7805,2313,6875,416,1369,1220,3409,1636,4778
412770,201910,10056,25528,5087,15497,723,2328,1159,3028,1882,5356
412780,201910,1171,3119,845,2521,182,593,333,963,515,1556
412785,201910,1960,4941,1343,3823,163,478,798,2233,961,2711
412788,201910,1278,3667,1035,3200,280,865,442,1337,722,2202
412790,201910,1258,3339,647,2020,104,377,205,576,309,953
412795,201910,1275,3334,653,1991,106,363,129,362,235,725
412796,201910,2196,6455,1784,5598,378,1266,583,1714,961,2980
412800,201910,3328,8176,2193,6006,271,841,962,2350,1233,3191
412810,201910,10825,27629,6491,18661,827,2759,2398,6110,3225,8869
412820,201910,6263,17340,4352,13412,1042,3413,1273,3869,2315,7282
412830,201910,331,947,218,689,30,97,56,175,86,272
412840,201910,1760,4499,1218,3406,145,449,487,1288,632,1737
412850,201910,2791,7410,1986,5949,318,1014,791,2315,1109,3329
412853,201910,1532,3888,1261,3355,177,527,634,1503,811,2030
412855,201910,1193,3205,749,2222,144,492,231,639,375,1131
412860,201910,777,1943,526,1538,82,266,274,756,356,1022
412862,201910,681,1675,441,1263,76,225,193,537,269,762
412863,201910,1204,3701,1107,3537,165,544,723,2291,888,2835
412865,201910,711,1958,508,1557,121,382,151,474,272,856
412870,201910,862,2227,608,1806,170,568,120,364,290,932
412880,201910,789,2162,497,1541,96,325,76,206,172,531
420005,201910,435,1301,231,818,33,123,107,379,140,502
420010,201910,3257,8007,2088,5999,150,477,1520,4370,1670,4847
420020,201910,459,1434,281,982,47,191,58,166,105,357
420030,201910,83,275,56,215,18,76,15,56,33,132
420040,201910,510,1590,291,1083,48,194,25,78,73,272
420050,201910,694,1628,439,1166,46,145,276,665,322,810
420055,201910,172,506,89,305,19,78,32,93,51,171
420060,201910,103,295,54,168,12,44,14,29,26,73
420070,201910,683,2140,504,1723,119,429,185,616,304,1045
420075,201910,76,205,34,108,7,25,8,13,15,38
420080,201910,325,952,250,786,73,253,90,276,163,529
420090,201910,395,1247,227,826,59,234,50,168,109,402
420100,201910,1182,3178,974,2845,52,183,783,2253,835,2436
420110,201910,238,770,213,717,45,177,95,291,140,468
420120,201910,467,1304,297,922,63,223,121,318,184,541
420125,201910,312,975,220,766,54,199,98,319,152,518
420127,201910,273,758,91,315,19,71,21,73,40,144
420130,201910,2714,7650,1991,6341,292,1155,1018,3022,1310,4177
420140,201910,3379,9250,2363,7451,655,2360,317,988,972,3348
420150,201910,597,1554,393,1201,48,164,226,669,274,833
420160,201910,212,522,82,262,12,36,22,68,34,104
420165,201910,151,431,84,274,21,72,27,77,48,149
420170,201910,263,792,164,551,21,62,35,96,56,158
420180,201910,173,543,96,353,16,58,26,92,42,150
420190,201910,180,599,105,396,36,149,19,64,55,213
420195,201910,1315,3481,924,2811,289,1014,116,287,405,1301
420200,201910,3719,9323,2060,6133,311,1128,791,1983,1102,3111
420205,201910,1507,4062,1025,3162,156,493,563,1755,719,2248
420207,201910,1688,4471,1013,3144,198,703,404,1186,602,1889
420208,201910,306,876,179,638,33,130,75,260,108,390
420209,201910,134,452,83,294,23,90,24,84,47,174
420210,201910,2631,6826,1647,5209,345,1198,744,2300,1089,3498
420213,201910,740,2333,609,2057,134,495,304,1000,438,1495
420215,201910,195,584,123,425,34,133,15,44,49,177
420220,201910,234,708,139,484,27,107,64,199,91,306
420230,201910,4558,12692,3383,10418,527,1747,1777,5308,2304,7055
420240,201910,11868,32722,7027,21711,929,3310,3498,9572,4427,12882
420243,201910,375,1085,300,934,46,155,173,513,219,668
420245,201910,1272,3346,863,2609,69,265,506,1450,575,1715
420250,201910,429,1252,360,1129,67,244,177,499,244,743
420253,201910,489,1213,340,989,35,110,194,569,229,679
420257,201910,161,422,104,316,23,81,51,147,74,228
420260,201910,1054,2846,746,2379,130,457,447,1405,577,1862
420270,201910,475,1274,221,679,35,120,82,250,117,370
420280,201910,1100,3259,794,2633,162,598,252,811,414,1409
420285,201910,75,199,41,125,7,33,11,28,18,61
420287,201910,441,1042,299,823,80,221,105,299,185,520
420290,201910,4056,11624,3003,9207,447,1608,1705,4758,2152,6366
420300,201910,6646,18868,3639,11775,729,2595,929,2689,1658,5284
420310,201910,816,1919,392,1094,52,155,196,494,248,649
420315,201910,761,2175,503,1672,113,403,208,698,321,1101
420320,201910,4324,12238,3178,10212,965,3428,736,2138,1701,5566
420325,201910,261,765,191,638,34,120,76,238,110,358
420330,201910,854,2585,545,1896,103,404,164,501,267,905
420340,201910,916,2615,659,2124,162,535,69,198,231,733
420350,201910,1226,3266,858,2572,79,280,575,1686,654,1966
420360,201910,2464,7020,1263,4278,250,927,128,412,378,1339
420370,201910,961,2651,751,2288,90,324,478,1392,568,1716
420380,201910,4247,11455,2777,8690,618,2102,965,2866,1583,4968
420390,201910,1062,2582,691,1791,114,375,330,604,444,979
420395,201910,924,2710,576,1954,97,381,69,181,166,562
420400,201910,855,2489,559,1822,104,387,182,555,286,942
420410,201910,486,1347,368,1105,39,134,236,676,275,810
420415,201910,274,842,204,683,53,197,77,261,130,458
420417,201910,609,1821,472,1534,128,421,165,550,293,971
420419,201910,136,487,97,378,39,160,6,20,45,180
420420,201910,10141,26658,6479,19866,1938,6649,1689,4706,3627,11355
420425,201910,623,1636,410,1220,40,139,191,545,231,684
420430,201910,2939,8097,1696,5332,396,1336,535,1504,931,2840
420435,201910,252,647,110,369,14,47,53,174,67,221
420440,201910,667,1885,416,1335,110,400,172,496,282,896
420445,201910,260,654,156,446,30,96,65,170,95,266
420450,201910,634,1878,445,1452,84,344,158,448,242,792
420455,201910,1902,4798,1355,3923,187,678,675,1810,862,2488
420460,201910,8299,22464,6055,18250,971,3235,2973,8597,3944,11832
420470,201910,584,1557,310,1008,62,237,71,192,133,429
420475,201910,60,155,24,76,7,23,1,2,8,25
420480,201910,5434,13547,3179,9637,678,2219,947,2873,1625,5092
420490,201910,342,1012,242,804,59,227,88,296,147,523
420500,201910,1349,3858,866,2896,149,542,360,1200,509,1742
420510,201910,160,457,81,267,11,47,22,65,33,112
420515,201910,42,112,28,81,1,1,13,42,14,43
420517,201910,727,2042,626,1860,46,137,475,1413,521,1550
420519,201910,280,665,188,529,22,67,104,303,126,370
420520,201910,307,826,139,478,26,96,13,42,39,138
420530,201910,759,2216,510,1679,93,357,172,491,265,848
420535,201910,210,606,80,266,14,53,34,108,48,161
420540,201910,31874,76243,19173,54187,3104,9814,6757,16172,9861,25986
420543,201910,208,623,156,494,21,67,85,261,106,328
420545,201910,1032,3058,765,2465,151,531,304,893,455,1424
420550,201910,3334,9121,2043,6819,378,1425,848,2860,1226,4285
420555,201910,284,820,191,623,27,102,105,323,132,425
420560,201910,398,999,259,785,60,190,135,404,195,594
420570,201910,2020,5716,1509,4716,293,1016,611,1805,904,2821
420580,201910,1733,4488,1163,3576,278,905,406,1264,684,2169
420590,201910,2772,7457,1532,4721,292,1064,389,885,681,1949
420600,201910,928,2736,701,2278,116,429,355,1112,471,1541
420610,201910,341,996,184,637,44,155,62,223,106,378
420620,201910,627,1567,392,1172,97,299,157,464,254,763
420630,201910,828,2510,584,1893,81,295,337,1023,418,1318
420640,201910,485,1360,218,774,65,230,22,68,87,298
420650,201910,3184,8649,1824,5626,281,946,692,1849,973,2795
420660,201910,344,891,209,616,46,140,54,144,100,284
420665,201910,544,1434,330,1049,60,212,140,402,200,614
420670,201910,1300,3571,827,2629,132,507,329,920,461,1427
420675,201910,155,441,85,298,23,97,33,98,56,195
420680,201910,319,727,147,480,25,99,68,211,93,310
420690,201910,799,2452,456,1588,65,274,113,312,178,586
420700,201910,2671,7103,1964,5873,257,862,1052,3020,1309,3882
420710,201910,774,2278,567,1807,59,241,335,977,394,1218
420720,201910,1227,3409,853,2752,198,645,384,1209,582,1854
420730,201910,2661,7084,1982,5960,334,1080,1094,3172,1428,4252
420740,201910,529,1640,323,1159,99,376,32,126,131,502
420750,201910,1779,5288,1124,3713,192,738,437,1317,629,2055
420757,201910,69,171,33,108,3,7,16,49,19,56
420760,201910,343,1016,148,467,38,135,32,78,70,213
420765,201910,388,1169,198,675,23,94,93,310,116,404
420768,201910,1225,3582,1049,3273,147,448,748,2314,895,2762
420770,201910,421,1147,191,678,32,127,81,272,113,399
420775,201910,271,821,186,620,44,169,41,108,85,277
420780,201910,841,2330,486,1560,118,400,84,238,202,638
420785,201910,182,487,124,365,17,56,58,139,75,195
420790,201910,981,3065,712,2491,134,554,362,1196,496,1750
420800,201910,668,1689,298,925,78,269,68,202,146,471
420810,201910,1398,4457,1109,3839,326,1280,347,1015,673,2295
420820,201910,10791,27312,7470,21744,1490,4923,3403,8934,4893,13857
420830,201910,3229,8676,2310,6988,456,1509,955,2783,1411,4292
420840,201910,493,1468,220,815,71,285,25,86,96,371
420845,201910,2145,5600,1239,3924,233,870,486,1467,719,2337
420850,201910,1010,3325,604,2213,124,496,102,339,226,835
420860,201910,284,740,151,500,35,128,36,107,71,235
420870,201910,753,2070,559,1705,146,538,248,687,394,1225
420880,201910,909,2810,704,2394,149,590,258,813,407,1403
420890,201910,7500,20434,4298,13733,677,2380,1413,3926,2090,6306
420895,201910,155,461,94,304,20,70,31,100,51,170
420900,201910,1322,3333,761,2322,103,381,332,881,435,1262
420910,201910,26222,69372,15585,48388,2469,8732,6034,16729,8503,25461
420915,201910,516,1865,371,1446,59,234,188,739,247,973
420917,201910,324,813,162,454,26,77,78,220,104,297
420920,201910,74,205,23,86,0,0,4,10,4,10
420930,201910,16374,42938,11210,33697,2065,6854,4907,13985,6972,20839
420940,201910,2516,6224,1415,4280,359,1226,237,572,596,1798
420945,201910,128,375,97,301,24,91,39,101,63,192
420950,201910,314,910,160,537,29,118,38,107,67,225
420960,201910,960,2404,647,1843,113,388,273,666,386,1054
420970,201910,2266,6475,1477,4885,434,1486,259,884,693,2370
420980,201910,251,842,223,786,114,396,64,248,178,644
420985,201910,303,894,147,532,34,128,46,146,80,274
420990,201910,314,974,162,594,31,115,27,79,58,194
421000,201910,477,1497,312,1109,67,264,81,255,148,519
421003,201910,467,1091,139,405,11,35,25,59,36,94
421005,201910,58,165,46,148,10,34,23,71,33,105
421010,201910,3052,8451,2140,6740,458,1636,565,1567,1023,3203
421020,201910,365,1141,279,983,42,177,140,470,182,647
421030,201910,729,2265,555,1885,165,630,171,526,336,1156
421040,201910,685,1581,392,1138,33,108,237,677,270,785
421050,201910,953,2670,585,1809,112,377,193,533,305,910
421055,201910,162,445,76,243,10,36,33,92,43,128
421060,201910,548,1614,338,1097,70,251,135,389,205,640
421070,201910,572,1738,305,1070,74,279,66,225,140,504
421080,201910,460,1344,385,1192,48,170,238,737,286,907
421085,201910,357,1046,122,450,25,93,16,45,41,138
421090,201910,249,634,146,432,15,52,53,138,68,190
421100,201910,842,1879,322,964,93,321,67,166,160,487
421105,201910,1462,4053,992,3092,171,533,426,1272,597,1805
421110,201910,997,2766,820,2507,28,78,604,1947,632,2025
421120,201910,849,2641,595,2036,92,353,198,624,290,977
421125,201910,261,690,187,550,70,228,64,150,134,378
421130,201910,4305,12858,3508,11247,839,3066,1776,5344,2615,8410
421140,201910,274,747,168,530,30,103,63,182,93,285
421145,201910,428,1219,267,863,57,209,120,358,177,567
421150,201910,543,1467,295,943,58,212,105,303,163,515
421160,201910,503,1354,350,1069,44,147,223,669,267,816
421165,201910,185,555,114,382,24,80,47,154,71,234
421170,201910,1043,2768,790,2370,141,405,469,1453,610,1858
421175,201910,1018,2576,604,1916,122,438,253,761,375,1199
421180,201910,358,924,191,589,33,127,73,205,106,332
421185,201910,303,818,194,585,27,88,111,333,138,421
421187,201910,276,844,162,544,30,102,50,157,80,259
421189,201910,346,1015,263,843,46,147,92,281,138,428
421190,201910,9538,25987,6103,19401,1232,4335,1902,5543,3134,9878
421200,201910,625,1876,500,1619,63,227,296,926,359,1153
421205,201910,172,466,128,392,27,94,65,189,92,283
421210,201910,1037,2717,602,1948,140,453,205,677,345,1130
421220,201910,1258,3901,964,3231,220,806,283,860,503,1666
421223,201910,340,959,206,689,52,173,89,299,141,472
421225,201910,863,2623,737,2389,135,490,424,1374,559,1864
421227,201910,886,2332,501,1558,85,291,219,689,304,980
421230,201910,579,1552,350,1124,69,241,114,371,183,612
421240,201910,261,799,108,406,15,70,16,57,31,127
421250,201910,1679,4324,1116,3392,157,532,570,1674,727,2206
421260,201910,159,475,42,163,11,46,10,37,21,83
421265,201910,579,1549,529,1484,8,28,495,1395,503,1423
421270,201910,392,1023,163,571,24,81,58,189,82,270
421280,201910,1561,4463,1140,3675,197,787,587,1738,784,2525
421290,201910,788,2150,416,1277,78,254,93,263,171,517
421300,201910,241,647,119,390,19,66,25,85,44,151
421310,201910,176,508,124,407,25,87,65,216,90,303
421315,201910,209,583,126,387,37,108,33,104,70,212
421320,201910,599,1781,274,925,38,134,43,102,81,236
421330,201910,580,1745,420,1404,81,303,123,395,204,698
421335,201910,336,1034,274,918,65,247,108,353,173,600
421340,201910,1250,3612,893,2899,184,678,342,1026,526,1704
421350,201910,1264,3341,820,2543,179,655,334,940,513,1595
421360,201910,2182,5971,1244,4022,244,966,450,1246,694,2212
421370,201910,489,1629,287,1072,62,251,71,224,133,475
421380,201910,751,2037,640,1842,83,281,398,1111,481,1392
421390,201910,169,456,59,198,13,42,19,50,32,92
421400,201910,271,872,183,663,36,148,84,281,120,429
421410,201910,210,554,81,281,13,49,21,68,34,117
421415,201910,188,574,98,328,25,81,22,63,47,144
421420,201910,471,1334,384,1158,37,126,241,699,278,825
421430,201910,112,352,86,292,9,34,28,87,37,121
421440,201910,592,1594,351,1135,77,240,144,461,221,701
421450,201910,399,1194,231,790,33,136,38,140,71,276
421460,201910,334,981,184,661,24,93,35,103,59,196
421470,201910,247,724,132,460,26,95,48,166,74,261
421480,201910,2616,7069,1647,5178,362,1350,616,1733,978,3083
421490,201910,109,350,64,225,6,24,20,49,26,73
421500,201910,2024,6029,1372,4644,385,1516,307,918,692,2434
421505,201910,282,826,239,756,35,124,153,465,188,589
421507,201910,391,1140,209,719,55,198,64,209,119,407
421510,201910,261,762,148,478,26,98,72,208,98,306
421520,201910,452,1195,269,779,30,103,163,440,193,543
421530,201910,293,907,163,592,35,158,41,121,76,279
421535,201910,375,1013,225,732,36,141,115,348,151,489
421540,201910,256,621,124,393,16,53,42,125,58,178
421545,201910,675,2009,493,1661,109,437,228,701,337,1138
421550,201910,1849,5131,1473,4548,276,893,805,2462,1081,3355
421555,201910,186,584,68,255,15,64,10,27,25,91
421560,201910,75,256,46,179,13,53,12,42,25,95
421565,201910,887,2330,591,1848,149,520,169,522,318,1042
421567,201910,424,1450,263,969,106,404,56,190,162,594
421568,201910,310,947,229,750,34,128,106,332,140,460
421569,201910,181,513,74,250,18,62,34,112,52,174
421570,201910,945,2589,659,2029,172,588,186,537,358,1125
421575,201910,259,780,193,609,34,123,80,216,114,339
421580,201910,3133,8832,1990,6376,368,1390,747,2040,1115,3430
421590,201910,133,422,101,341,36,132,26,74,62,206
421600,201910,506,1390,332,1033,77,257,94,250,171,507
421605,201910,698,1845,478,1473,90,249,221,718,311,967
421610,201910,969,2677,594,1936,113,395,167,530,280,925
421620,201910,3773,10088,2086,6877,477,1730,530,1672,1007,3402
421625,201910,166,468,63,208,13,42,13,43,26,85
421630,201910,2250,5998,1289,4030,235,869,404,1057,639,1926
421635,201910,230,629,146,442,22,74,83,233,105,307
421640,201910,656,1827,463,1511,94,334,173,561,267,895
421650,201910,2125,5880,1301,4291,307,1170,340,938,647,2108
421660,201910,8399,23670,5848,18709,920,3348,2435,7091,3355,10439
421670,201910,720,2079,491,1542,83,287,246,757,329,1044
421680,201910,942,2669,710,2231,193,658,314,890,507,1548
421690,201910,1210,3550,822,2701,151,568,304,1003,455,1571
421700,201910,459,1409,250,890,44,167,81,268,125,435
421710,201910,212,671,90,306,21,76,25,79,46,155
421715,201910,96,275,73,220,15,41,49,142,64,183
421720,201910,1832,5061,1016,3273,264,952,277,758,541,1710
421725,201910,214,530,103,331,20,71,39,91,59,162
421730,201910,367,1056,192,566,21,67,99,277,120,344
421740,201910,605,1695,399,1248,115,369,91,255,206,624
421750,201910,835,1963,363,1074,81,268,142,390,223,658
421755,201910,155,414,85,250,12,48,43,109,55,157
421760,201910,838,2283,515,1675,88,315,167,471,255,786
421770,201910,2235,6045,1600,4908,417,1323,554,1812,971,3135
421775,201910,193,499,123,362,21,69,59,154,80,223
421780,201910,782,2361,499,1727,105,416,200,643,305,1059
421790,201910,730,1885,404,1295,92,308,189,591,281,899
421795,201910,196,554,128,390,25,90,45,121,70,211
421800,201910,2331,6481,1671,5222,237,861,910,2678,1147,3539
421810,201910,592,1653,396,1276,51,187,235,737,286,924
421820,201910,902,2652,480,1613,92,358,139,365,231,723
421825,201910,1277,3620,1127,3378,127,410,773,2259,900,2669
421830,201910,1893,5782,1562,5148,311,1119,702,2235,1013,3354
421835,201910,197,498,105,330,21,75,30,86,51,161
421840,201910,207,671,133,487,29,112,31,108,60,220
421850,201910,357,1025,189,662,43,168,59,163,102,331
421860,201910,302,870,168,589,20,82,56,176,76,258
421870,201910,3680,9397,2522,7177,471,1573,1183,3009,1654,4582
421875,201910,209,612,96,334,14,52,27,74,41,126
421880,201910,514,1456,331,1063,95,352,68,227,163,579
421885,201910,186,525,114,363,30,101,33,92,63,193
421890,201910,753,2358,553,1938,116,464,250,819,366,1283
421895,201910,388,1024,315,926,40,132,208,630,248,762
421900,201910,924,2385,615,1762,93,305,277,726,370,1031
421910,201910,280,835,189,635,39,146,53,161,92,307
421915,201910,371,1063,196,638,39,126,27,78,66,204
421917,201910,555,1322,302,978,112,389,68,223,180,612
421920,201910,375,1171,264,936,116,438,71,247,187,685
421930,201910,2321,5961,1076,3469,280,1004,240,676,520,1680
421935,201910,392,1262,307,1063,62,230,167,546,229,776
421940,201910,312,935,121,409,20,78,36,106,56,184
421950,201910,2890,7232,1417,4402,302,1047,337,913,639,1960
421960,201910,166,422,85,273,18,67,20,54,38,121
421970,201910,1763,4590,973,2964,212,740,326,849,538,1589
421985,201910,242,649,141,448,15,51,52,155,67,206
422000,201910,1712,4579,1363,3984,151,504,913,2635,1064,3139
430003,201910,519,1450,332,1087,65,241,135,427,200,668
430005,201910,263,705,164,524,34,118,79,240,113,358
430010,201910,1641,4102,1319,3567,143,431,936,2431,1079,2862
430020,201910,557,1294,415,1097,51,164,270,680,321,844
430030,201910,971,2315,521,1511,144,451,161,427,305,878
430040,201910,9418,23106,5326,15630,1398,4467,528,1695,1926,6162
430045,201910,504,1272,335,954,23,79,216,595,239,674
430047,201910,243,519,89,246,19,59,24,65,43,124
430050,201910,847,2187,467,1397,109,340,115,328,224,668
430055,201910,234,592,105,312,10,43,62,165,72,208
430057,201910,82,181,26,72,5,18,7,17,12,35
430060,201910,15533,42327,11815,36318,2579,8397,5345,16387,7924,24784
430063,201910,833,2350,647,1947,125,371,359,1078,484,1449
430064,201910,974,2731,713,2167,206,657,262,759,468,1416
430066,201910,98,214,70,170,4,9,55,125,59,134
430070,201910,692,1758,83,284,9,34,13,34,22,68
430080,201910,761,1897,450,1282,71,237,222,540,293,777
430085,201910,841,1946,503,1389,95,277,218,579,313,856
430087,201910,458,1214,368,1081,62,181,223,670,285,851
430090,201910,537,1377,166,523,14,56,57,166,71,222
430100,201910,639,1558,339,974,70,231,132,328,202,559
430105,201910,1033,2793,642,2110,127,471,297,958,424,1429
430107,201910,165,488,96,309,19,69,25,61,44,130
430110,201910,2051,5145,1468,4271,223,706,815,2327,1038,3033
430120,201910,1245,3733,759,2486,138,477,337,1114,475,1591
430130,201910,3229,7648,2358,6401,927,2520,441,1433,1368,3953
430140,201910,873,2450,596,1900,140,439,271,851,411,1290
430150,201910,540,1402,277,857,67,216,90,274,157,490
430155,201910,247,631,109,332,19,54,21,55,40,109
430160,201910,17631,43109,13631,37123,1865,5500,7548,20466,9413,25966
430163,201910,2576,6403,1725,4986,93,295,1197,3461,1290,3756
430165,201910,321,780,80,262,16,40,14,39,30,79
430170,201910,897,2381,307,1068,57,203,51,162,108,365
430175,201910,639,1951,521,1689,140,456,246,771,386,1227
430180,201910,625,1548,493,1320,64,177,342,896,406,1073
430185,201910,451,1078,264,739,60,166,70,167,130,333
430187,201910,648,1530,451,1266,73,222,225,661,298,883
430190,201910,1337,3615,1052,3141,237,768,469,1324,706,2092
430192,201910,132,357,47,138,7,20,10,25,17,45
430195,201910,379,1135,42,155,6,16,6,20,12,36
430200,201910,1043,3177,836,2787,269,920,250,864,519,1784
430205,201910,456,1215,388,1082,14,47,329,893,343,940
430210,201910,4483,11531,2958,8386,606,1828,947,2210,1553,4038
430215,201910,294,764,179,530,39,124,73,216,112,340
430220,201910,627,1551,160,543,29,119,32,81,61,200
430222,201910,171,496,121,380,11,42,48,145,59,187
430223,201910,230,619,182,532,21,67,119,341,140,408
430225,201910,15,28,10,20,1,2,9,18,10,20
430230,201910,1714,4872,1474,4501,140,450,1091,3309,1231,3759
430235,201910,275,806,182,583,44,161,57,157,101,318
430237,201910,505,1236,347,971,20,67,239,640,259,707
430240,201910,1094,2470,590,1621,74,251,329,832,403,1083
430245,201910,658,1954,504,1651,163,531,224,753,387,1284
430250,201910,858,2180,620,1801,221,710,34,79,255,789
430258,201910,111,303,84,250,7,17,44,138,51,155
430260,201910,599,1610,415,1250,61,192,233,691,294,883
430265,201910,201,578,137,451,27,94,40,119,67,213
430270,201910,2625,6692,2077,5801,383,1160,1221,3304,1604,4464
430280,201910,4855,11708,3290,8912,724,2002,1378,3659,2102,5661
430290,201910,2080,4901,1736,4486,54,175,1482,3748,1536,3923
430300,201910,8812,23058,6667,19172,1146,3589,3453,9738,4599,13327
430310,201910,10464,26336,6674,19029,915,2961,3141,8306,4056,11267
430320,201910,938,2498,491,1561,69,214,262,847,331,1061
430330,201910,617,1556,374,1050,63,193,174,429,237,622
430340,201910,698,1549,358,1018,49,151,209,570,258,721
430350,201910,6663,17617,4833,14128,902,2781,2424,6809,3326,9590
430355,201910,317,811,100,330,18,55,17,50,35,105
430360,201910,812,1950,517,1429,116,364,205,515,321,879
430367,201910,303,725,154,440,36,109,69,196,105,305
430370,201910,453,1219,195,604,37,119,50,133,87,252
430380,201910,653,1624,310,977,72,270,80,234,152,504
430390,201910,2881,7053,1533,4489,271,891,182,369,453,1260
430400,201910,1046,2250,805,1898,61,165,602,1360,663,1525
430410,201910,527,1279,351,982,49,156,214,576,263,732
430420,201910,2553,7134,1923,5707,530,1647,779,2198,1309,3845
430430,201910,590,1510,274,840,63,190,63,189,126,379
430435,201910,1420,3663,1052,3050,208,643,505,1469,713,2112
430440,201910,3529,9976,2620,8216,343,1234,1510,4646,1853,5880
430450,201910,6473,16629,5047,14040,698,2179,2808,7532,3506,9711
430460,201910,28102,72858,19719,58660,3840,12596,9160,25987,13000,38583
430461,201910,314,816,90,286,11,36,30,81,41,117
430462,201910,230,611,124,404,18,56,42,149,60,205
430463,201910,4892,13427,3606,11066,747,2553,1665,4904,2412,7457
430465,201910,416,1093,337,948,50,159,213,575,263,734
430466,201910,3800,9707,2931,8228,743,2153,1358,3612,2101,5765
430467,201910,478,1169,323,919,45,150,166,446,211,596
430468,201910,1244,3077,960,2651,96,284,593,1598,689,1882
430469,201910,625,1739,74,256,8,29,13,17,21,46
430470,201910,5224,13617,3394,10303,1043,3396,877,2502,1920,5898
430471,201910,486,1437,401,1273,66,225,216,655,282,880
430480,201910,739,1974,369,1165,54,181,79,228,133,409
430485,201910,164,444,59,195,16,48,8,26,24,74
430490,201910,384,1000,203,606,26,91,97,257,123,348
430495,201910,353,973,195,637,28,96,69,205,97,301
430500,201910,962,2518,650,1975,204,665,188,510,392,1175
430510,201910,22935,60536,15787,46081,2907,9668,6804,18095,9711,27763
430511,201910,320,951,117,406,15,59,16,45,31,104
430512,201910,903,2083,691,1767,175,442,248,649,423,1091
430513,201910,770,1945,352,1025,51,159,177,493,228,652
430515,201910,362,1026,252,793,34,96,127,402,161,498
430517,201910,1028,3213,766,2584,138,462,384,1328,522,1790
430520,201910,1231,3233,594,1829,105,347,128,351,233,698
430530,201910,977,2509,362,1137,65,195,90,279,155,474
430535,201910,3006,7951,2108,6268,310,968,1066,3076,1376,4044
430537,201910,313,1109,286,1023,24,77,229,821,253,898
430540,201910,551,1366,321,976,46,140,161,484,207,624
430543,201910,689,1276,383,918,60,116,183,479,243,595
430544,201910,623,1817,425,1352,97,309,187,587,284,896
430545,201910,2059,5460,1504,4584,301,940,732,2288,1033,3228
430550,201910,365,1024,230,729,43,135,81,249,124,384
430558,201910,106,237,41,112,4,7,12,33,16,40
430560,201910,334,746,136,408,14,44,42,124,56,168
430570,201910,717,1693,514,1382,95,296,268,666,363,962
430580,201910,837,2111,589,1714,146,458,257,720,403,1178
430583,201910,196,488,35,114,3,11,6,18,9,29
430585,201910,221,541,110,299,16,46,50,122,66,168
430587,201910,198,567,134,426,22,70,58,189,80,259
430590,201910,1363,3268,1131,2908,54,159,951,2407,1005,2566
430593,201910,18,63,12,41,1,3,6,19,7,22
430595,201910,406,972,86,281,5,21,23,56,28,77
430597,201910,398,1060,205,621,21,69,75,176,96,245
430600,201910,1790,4625,762,2256,146,468,221,611,367,1079
430605,201910,1090,3032,779,2402,113,418,340,989,453,1407
430607,201910,518,1236,410,1059,26,78,300,767,326,845
430610,201910,5375,12972,3497,10031,1019,3198,705,2057,1724,5255
430613,201910,251,583,63,176,9,28,17,38,26,66
430620,201910,553,1392,401,1095,53,165,233,593,286,758
430630,201910,412,1136,108,349,18,61,23,65,41,126
430632,201910,504,1361,212,668,25,83,99,300,124,383
430635,201910,512,1252,370,1006,45,127,262,709,307,836
430637,201910,440,1105,343,952,41,131,211,562,252,693
430640,201910,994,2567,547,1646,79,243,194,563,273,806
430642,201910,333,922,243,710,46,130,133,366,179,496
430645,201910,165,390,54,150,14,42,15,45,29,87
430650,201910,1500,4463,1214,3985,315,1036,585,2003,900,3039
430655,201910,263,653,151,430,24,76,71,176,95,252
430660,201910,4747,12468,3524,10328,821,2577,1541,4453,2362,7030
430670,201910,620,1513,461,1232,28,81,293,783,321,864
430673,201910,533,1218,196,577,37,112,75,206,112,318
430675,201910,211,602,50,175,12,46,24,80,36,126
430676,201910,4408,11240,3408,9652,439,1395,2142,5886,2581,7281
430680,201910,889,2424,525,1642,161,524,126,377,287,901
430690,201910,2772,7620,2176,6508,730,2281,588,1697,1318,3978
430692,201910,205,634,151,539,10,45,109,386,119,431
430693,201910,949,2509,541,1666,104,384,140,385,244,769
430695,201910,454,1172,241,718,33,93,129,366,162,459
430697,201910,382,962,287,805,70,183,137,418,207,601
430700,201910,6325,15871,3354,10232,767,2478,509,1507,1276,3985
430705,201910,392,964,182,551,25,88,75,204,100,292
430710,201910,1606,3554,1113,2845,153,433,643,1615,796,2048
430720,201910,706,1694,351,1057,58,172,168,509,226,681
430730,201910,1007,2743,676,2111,102,300,350,1091,452,1391
430740,201910,571,1586,282,952,50,177,78,277,128,454
430745,201910,398,1079,215,659,36,127,71,184,107,311
430750,201910,1272,3308,885,2624,183,568,476,1359,659,1927
430755,201910,446,1080,269,723,17,58,154,378,171,436
430760,201910,1864,4721,1439,4031,351,1042,621,1666,972,2708
430770,201910,5823,14766,4398,12572,599,1928,2731,7560,3330,9488
430780,201910,1868,4612,1045,3173,224,727,369,1086,593,1813
430781,201910,430,1206,231,721,35,111,65,174,100,285
430783,201910,389,881,219,612,25,83,132,352,157,435
430786,201910,30,103,19,77,3,13,4,20,7,33
430790,201910,4148,10279,2766,7810,360,1194,1643,4314,2003,5508
430800,201910,736,1744,533,1412,39,106,354,932,393,1038
430805,201910,385,1034,230,690,24,87,144,400,168,487
430807,201910,380,874,179,497,15,50,93,233,108,283
430810,201910,739,1766,245,780,32,123,81,246,113,369
430820,201910,1267,3344,656,2129,143,488,163,529,306,1017
430825,201910,249,623,78,202,13,33,23,55,36,88
430830,201910,1610,4684,1284,4046,60,218,919,2857,979,3075
430840,201910,905,2361,668,1930,90,288,450,1255,540,1543
430843,201910,117,279,42,119,4,12,18,46,22,58
430845,201910,388,930,241,673,62,184,85,225,147,409
430850,201910,2223,5870,1499,4450,228,745,656,1933,884,2678
430860,201910,830,1880,394,1117,50,175,189,458,239,633
430865,201910,479,1220,359,1012,64,193,194,530,258,723
430870,201910,608,1594,240,775,38,141,79,227,117,368
430880,201910,1303,3065,854,2351,154,440,441,1178,595,1618
430885,201910,173,454,83,277,9,33,47,153,56,186
430890,201910,943,2431,612,1826,59,253,112,305,171,558
430900,201910,2857,6335,1916,4948,181,547,1231,2981,1412,3528
430905,201910,741,1900,448,1326,81,266,166,461,247,727
430910,201910,1423,3799,972,2874,153,532,464,1225,617,1757
430912,201910,483,1331,312,995,28,86,209,678,237,764
430915,201910,483,1492,345,1219,118,422,104,367,222,789
430920,201910,22195,56704,16582,47141,2405,7553,9854,27119,12259,34672
430925,201910,106,242,40,122,6,20,17,53,23,73
430930,201910,9750,23206,5948,17205,1183,3517,2425,7279,3608,10796
430940,201910,1004,2675,548,1652,161,506,115,268,276,774
430950,201910,707,1708,440,1223,39,141,270,671,309,812
430955,201910,229,602,68,217,17,51,18,48,35,99
430957,201910,179,613,165,580,29,105,100,348,129,453
430960,201910,1298,3103,728,2046,152,462,326,890,478,1352
430965,201910,1561,3740,1181,3141,65,194,924,2468,989,2662
430970,201910,364,905,172,507,28,91,83,214,111,305
430975,201910,469,1457,353,1175,77,269,163,529,240,798
430980,201910,370,860,197,566,30,98,87,226,117,324
430990,201910,545,1567,316,1005,37,124,163,516,200,640
430995,201910,543,1411,386,1149,51,165,200,575,251,740
431000,201910,1299,3092,493,1475,88,292,35,88,123,380
431010,201910,1958,5030,1114,3552,218,753,173,462,391,1215
431020,201910,7963,17456,4511,12076,1049,3135,1502,3516,2551,6651
431030,201910,320,868,142,477,24,87,25,75,49,162
431033,201910,3347,8056,2013,5886,478,1447,692,2056,1170,3503
431036,201910,332,714,68,192,9,23,20,48,29,71
431040,201910,877,2268,553,1658,93,312,228,631,321,943
431041,201910,441,1023,316,842,25,63,191,505,216,568
431043,201910,368,883,176,554,38,131,79,247,117,378
431046,201910,108,282,43,133,3,8,11,33,14,41
431050,201910,1323,3256,933,2630,150,440,492,1394,642,1834
431053,201910,574,1580,296,966,65,236,90,268,155,504
431055,201910,566,1394,465,1243,47,115,344,917,391,1032
431057,201910,248,712,110,373,21,71,33,102,54,173
431060,201910,4911,13095,3275,10176,847,2846,780,2432,1627,5278
431065,201910,405,1039,282,836,52,162,114,327,166,489
431070,201910,415,1186,221,733,54,191,42,135,96,326
431075,201910,215,646,132,449,23,77,37,122,60,199
431080,201910,573,1600,377,1174,73,257,130,388,203,645
431085,201910,686,1839,432,1227,70,197,215,596,285,793
431087,201910,425,1194,335,1008,23,62,233,720,256,782
431090,201910,403,946,142,453,25,81,43,137,68,218
431100,201910,3167,7122,2180,5764,329,914,1075,2870,1404,3784
431110,201910,1331,3109,895,2352,257,683,355,886,612,1569
431112,201910,495,1459,408,1282,81,283,206,610,287,893
431113,201910,340,955,292,862,49,158,180,519,229,677
431115,201910,967,2768,737,2328,110,404,419,1241,529,1645
431120,201910,2200,6283,1486,4789,501,1801,333,942,834,2743
431123,201910,373,1049,233,742,42,114,132,442,174,556
431125,201910,969,2902,731,2399,279,892,231,811,510,1703
431127,201910,225,581,51,166,8,26,8,23,16,49
431130,201910,2876,7540,2059,6083,345,1165,1063,3017,1408,4182
431140,201910,4848,11568,2642,7305,345,1024,1154,2829,1499,3853
431142,201910,476,1284,342,1032,54,167,197,598,251,765
431150,201910,991,2679,681,2080,133,439,283,840,416,1279
431160,201910,673,1925,442,1412,78,279,141,440,219,719
431162,201910,502,1207,252,745,23,80,145,396,168,476
431164,201910,177,405,33,106,8,24,4,10,12,34
431170,201910,484,1370,332,1037,102,318,89,265,191,583
431171,201910,596,1421,481,1270,85,205,301,808,386,1013
431173,201910,396,1043,285,867,85,288,109,308,194,596
431175,201910,1082,2614,640,1836,117,348,223,609,340,957
431177,201910,693,1997,513,1689,137,491,266,854,403,1345
431179,201910,332,721,78,227,12,37,17,41,29,78
431180,201910,2140,5415,1237,3632,334,955,312,920,646,1875
431190,201910,423,1137,200,637,27,85,58,152,85,237
431198,201910,318,972,263,865,99,343,74,262,173,605
431200,201910,359,908,67,203,13,37,5,16,18,53
431205,201910,179,508,80,280,22,82,30,109,52,191
431210,201910,576,1486,456,1311,111,317,226,676,337,993
431213,201910,239,638,170,505,12,38,84,263,96,301
431215,201910,556,1320,224,658,28,93,105,287,133,380
431217,201910,154,411,100,309,7,27,60,167,67,194
431220,201910,567,1472,317,970,38,146,173,486,211,632
431225,201910,1480,3573,1096,2911,109,308,754,2010,863,2318
431230,201910,643,1871,470,1450,62,215,285,838,347,1053
431235,201910,149,377,20,66,2,5,3,14,5,19
431237,201910,302,979,252,860,47,172,130,431,177,603
431238,201910,25,64,19,50,5,12,6,14,11,26
431240,201910,3838,9803,2909,8272,511,1594,1509,4142,2020,5736
431242,201910,264,725,219,644,52,163,110,315,162,478
431244,201910,320,768,148,419,21,78,59,133,80,211
431245,201910,1236,2921,763,2075,86,247,388,1003,474,1250
431247,201910,216,591,106,340,21,74,27,70,48,144
431250,201910,1544,4023,1118,3406,248,772,567,1786,815,2558
431260,201910,223,629,132,438,20,90,47,143,67,233
431261,201910,219,702,178,628,18,75,92,307,110,382
431262,201910,371,1020,169,546,13,44,113,367,126,411
431265,201910,1476,3463,540,1583,67,235,189,464,256,699
431267,201910,256,694,141,417,4,18,100,265,104,283
431270,201910,2594,6012,1360,3879,346,1054,395,1149,741,2203
431275,201910,126,361,65,207,22,69,9,27,31,96
431280,201910,222,592,57,188,7,25,7,13,14,38
431290,201910,287,833,183,579,34,116,39,100,73,216
431295,201910,68,181,19,63,1,4,7,21,8,25
431300,201910,305,774,52,163,5,18,15,37,20,55
431301,201910,299,854,60,198,9,23,4,9,13,32
431303,201910,558,1488,312,948,25,90,136,381,161,471
431306,201910,2040,4827,1144,3286,176,556,451,1150,627,1706
431308,201910,23,72,21,68,10,35,9,27,19,62
431310,201910,504,1448,354,1095,41,144,166,478,207,622
431320,201910,575,1590,264,894,39,128,42,131,81,259
431330,201910,1586,3769,706,2089,169,577,225,579,394,1156
431333,201910,214,583,98,291,18,53,35,97,53,150
431335,201910,39,111,22,75,5,10,3,6,8,16
431337,201910,2462,6659,1748,5421,371,1303,819,2425,1190,3728
431339,201910,376,997,270,796,76,235,112,319,188,554
431340,201910,18594,45448,12370,34702,2313,7098,5188,13612,7501,20710
431342,201910,429,941,313,775,14,38,280,689,294,727
431344,201910,388,996,217,648,9,32,132,379,141,411
431346,201910,244,605,86,277,15,53,28,92,43,145
431349,201910,652,1710,336,1000,87,261,120,345,207,606
431350,201910,3806,10041,2742,8136,411,1356,1401,4040,1812,5396
431360,201910,567,1369,281,807,77,229,82,233,159,462
431365,201910,1775,4334,1417,3834,125,384,1046,2817,1171,3201
431370,201910,4051,10219,2856,8176,705,2118,1261,3713,1966,5831
431380,201910,774,2120,631,1880,36,124,442,1309,478,1433
431390,201910,2380,5826,1365,3979,174,599,610,1545,784,2144
431395,201910,1188,3046,826,2475,192,599,359,1097,551,1696
431400,201910,323,909,160,513,30,88,35,108,65,196
431402,201910,812,1860,573,1486,76,210,373,934,449,1144
431403,201910,177,489,137,411,23,79,69,168,92,247
431405,201910,4211,11218,3196,9568,627,2119,1471,4120,2098,6239
431406,201910,492,1427,349,1113,81,241,171,561,252,802
431407,201910,451,1251,294,911,59,206,137,403,196,609
431410,201910,15685,40179,9818,29265,1561,5333,4682,12968,6243,18301
431413,201910,227,594,53,173,5,14,11,37,16,51
431415,201910,650,1598,389,1166,79,275,170,444,249,719
431417,201910,529,1182,355,919,51,151,203,515,254,666
431420,201910,1450,3393,1079,2850,178,488,552,1455,730,1943
431430,201910,519,1332,226,734,35,130,68,179,103,309
431440,201910,27571,65738,19059,51951,3519,10321,7269,18711,10788,29032
431442,201910,106,293,47,156,6,18,9,23,15,41
431445,201910,406,1155,123,418,16,48,13,44,29,92
431446,201910,278,814,192,633,41,143,89,279,130,422
431447,201910,627,1713,381,1182,79,261,139,436,218,697
431449,201910,710,1870,411,1217,78,217,171,502,249,719
431450,201910,2091,4429,1651,3808,91,221,1271,2845,1362,3066
431454,201910,35,109,31,100,6,19,11,38,17,57
431455,201910,582,1404,276,759,35,104,137,337,172,441
431460,201910,2707,6803,1914,5350,523,1536,541,1527,1064,3063
431470,201910,1369,3886,962,2999,180,571,431,1359,611,1930
431475,201910,251,713,36,149,4,18,5,20,9,38
431477,201910,396,1035,225,675,36,105,93,244,129,349
431478,201910,274,714,51,160,14,40,6,16,20,56
431480,201910,2937,7485,2214,6322,535,1571,1094,3130,1629,4701
431490,201910,102752,246324,78684,208521,6312,19738,57329,146040,63641,165778
431500,201910,479,1215,339,947,63,178,181,483,244,661
431505,201910,295,720,194,557,17,49,129,369,146,418
431507,201910,335,790,133,388,40,125,42,112,82,237
431510,201910,1469,3853,982,2883,219,712,371,1066,590,1778
431513,201910,215,490,114,314,9,22,78,214,87,236
431514,201910,90,238,57,177,3,7,42,128,45,135
431515,201910,458,1165,314,893,63,179,163,458,226,637
431517,201910,70,202,55,166,11,31,22,64,33,95
431520,201910,418,1021,153,492,26,93,58,157,84,250
431530,201910,3770,7938,2143,5678,548,1475,482,1275,1030,2750
431531,201910,199,513,118,349,12,41,53,143,65,184
431532,201910,527,1244,302,835,74,225,121,318,195,543
431535,201910,240,637,95,309,20,71,19,49,39,120
431540,201910,1761,5653,1639,5476,59,252,1334,4449,1393,4701
431545,201910,341,890,56,177,10,31,11,32,21,63
431550,201910,1908,4941,1465,4116,248,755,749,2018,997,2773
431555,201910,658,1496,402,1066,23,79,251,646,274,725
431560,201910,20647,51145,13332,39261,2757,8621,4337,13416,7094,22037
431570,201910,4523,11034,3472,9523,421,1326,2358,6192,2779,7518
431575,201910,218,567,162,464,34,89,43,114,77,203
431580,201910,545,1387,307,895,40,147,166,449,206,596
431590,201910,584,1616,429,1293,93,296,174,536,267,832
431595,201910,337,921,210,642,46,140,86,242,132,382
431600,201910,1231,2873,862,2359,230,679,321,911,551,1590
431610,201910,1312,3425,878,2591,137,383,456,1386,593,1769
431620,201910,454,1202,199,606,34,113,76,217,110,330
431630,201910,1261,3180,548,1668,101,339,196,539,297,878
431640,201910,5871,14679,5046,13577,573,1622,3602,9753,4175,11375
431642,201910,486,1173,304,827,24,65,167,418,191,483
431643,201910,349,871,145,426,18,49,49,138,67,187
431645,201910,1747,4044,1361,3487,77,245,1053,2654,1130,2899
431647,201910,224,570,81,232,9,28,17,38,26,66
431650,201910,124,331,79,249,10,36,40,113,50,149
431660,201910,852,2301,428,1397,73,276,113,340,186,616
431670,201910,1084,2612,679,1878,97,280,365,967,462,1247
431673,201910,229,577,79,269,15,46,15,49,30,95
431675,201910,536,1306,92,291,10,43,21,50,31,93
431680,201910,6965,18194,4960,14325,1236,3708,2074,5860,3310,9568
431690,201910,21125,52534,13568,38831,3016,9148,5090,14673,8106,23821
431695,201910,131,315,80,234,14,54,43,98,57,152
431697,201910,441,1060,322,871,52,131,179,499,231,630
431700,201910,1340,3512,1115,3091,158,417,668,1827,826,2244
431710,201910,11487,28680,8066,23592,1631,5013,3730,11208,5361,16221
431720,201910,5541,14205,3234,9495,852,2652,507,1309,1359,3961
431725,201910,24,66,17,51,5,14,8,24,13,38
431730,201910,3536,8769,2192,6540,526,1674,686,2161,1212,3835
431740,201910,4784,11582,3053,8537,895,2853,690,1600,1585,4453
431750,201910,6933,18026,5388,15569,1159,3626,2452,6950,3611,10576
431755,201910,306,829,60,215,6,22,11,41,17,63
431760,201910,5230,11775,3325,8780,341,1069,2008,4962,2349,6031
431770,201910,1766,4276,1385,3768,96,327,1036,2728,1132,3055
431775,201910,196,516,91,286,20,56,16,46,36,102
431780,201910,1854,4670,1184,3441,216,712,497,1383,713,2095
431790,201910,776,2118,542,1644,101,308,244,708,345,1016
431795,201910,227,583,99,300,21,65,30,87,51,152
431800,201910,7268,18035,4543,13525,1283,4335,565,1758,1848,6093
431805,201910,301,715,81,272,5,17,31,99,36,116
431810,201910,3157,7622,1960,5370,365,1066,843,2211,1208,3277
431820,201910,2061,5701,1628,4981,481,1543,565,1804,1046,3347
431830,201910,8409,18605,6069,15344,1577,4578,1965,4942,3542,9520
431840,201910,2432,6562,1944,5724,349,1028,1131,3359,1480,4387
431842,201910,615,1533,198,624,29,101,62,177,91,278
431843,201910,312,843,233,682,28,96,116,310,144,406
431844,201910,213,546,58,195,16,57,18,64,34,121
431845,201910,509,1348,352,1029,26,79,209,601,235,680
431846,201910,275,733,232,665,13,41,200,569,213,610
431848,201910,109,277,62,185,8,26,8,19,16,45
431849,201910,399,966,57,170,2,4,6,20,8,24
431850,201910,3872,10663,2940,8762,702,2260,918,2694,1620,4954
431860,201910,637,1582,357,1024,63,189,186,509,249,698
431861,201910,95,258,48,149,14,44,12,32,26,76
431862,201910,409,1299,331,1163,72,289,166,556,238,845
431870,201910,17009,44561,13616,38940,1856,5957,8035,22127,9891,28084
431880,201910,3841,9965,2655,7791,440,1485,1194,3328,1634,4813
431890,201910,3995,10237,2406,7133,730,2357,398,1294,1128,3651
431900,201910,948,2416,580,1707,85,292,299,815,384,1107
431910,201910,751,1809,239,681,48,133,67,150,115,283
431912,201910,436,1240,337,1062,69,227,202,632,271,859
431915,201910,1011,2582,798,2223,23,78,608,1647,631,1725
431920,201910,1140,2805,951,2542,32,90,811,2157,843,2247
431930,201910,640,1728,425,1331,123,349,203,661,326,1010
431935,201910,81,227,49,155,15,53,10,35,25,88
431936,201910,288,851,155,510,33,113,54,168,87,281
431937,201910,168,417,102,274,21,70,44,92,65,162
431940,201910,2811,6743,1591,4467,188,599,791,2120,979,2719
431950,201910,1696,4583,1370,4049,437,1294,533,1586,970,2880
431960,201910,2726,6818,1957,5394,566,1586,518,1426,1084,3012
431970,201910,418,1066,142,439,37,112,36,98,73,210
431971,201910,58,147,32,100,5,20,6,11,11,31
431973,201910,459,1486,375,1322,39,153,272,951,311,1104
431975,201910,103,218,18,65,4,17,3,7,7,24
431980,201910,989,2608,752,2198,172,535,336,936,508,1471
431990,201910,5551,13435,3550,10407,528,1795,1606,4465,2134,6260
432000,201910,10096,24568,7114,19774,1752,4952,3076,8645,4828,13597
432010,201910,1938,4951,1411,3978,216,688,805,2140,1021,2828
432020,201910,1665,4121,1052,2997,220,657,483,1311,703,1968
432023,201910,500,1205,245,695,41,130,116,290,157,420
432026,201910,989,2764,687,2179,176,554,242,754,418,1308
432030,201910,319,812,173,518,25,70,90,270,115,340
432032,201910,338,877,226,664,27,97,120,319,147,416
432035,201910,625,1782,539,1632,183,560,201,641,384,1201
432040,201910,1059,2387,337,1054,59,207,106,292,165,499
432045,201910,174,472,99,319,23,76,37,124,60,200
432050,201910,450,1188,329,961,81,236,133,399,214,635
432055,201910,622,1662,391,1204,137,452,85,236,222,688
432057,201910,229,604,167,449,31,76,79,201,110,277
432060,201910,445,1074,137,434,29,101,45,121,74,222
432065,201910,212,598,144,447,28,84,56,164,84,248
432067,201910,700,2046,590,1795,55,188,419,1228,474,1416
432070,201910,1651,4399,1030,3151,234,794,308,850,542,1644
432080,201910,4050,9971,3038,8261,558,1759,1403,3623,1961,5382
432085,201910,352,907,233,714,74,223,92,301,166,524
432090,201910,1220,3101,820,2367,164,522,408,1114,572,1636
432100,201910,926,2412,410,1304,82,282,73,182,155,464
432110,201910,2023,5487,1328,4186,328,1179,111,333,439,1512
432120,201910,2637,7322,2040,6250,434,1473,728,2148,1162,3621
432130,201910,2385,6282,1970,5664,632,1833,815,2410,1447,4243
432132,201910,176,488,105,340,20,68,45,122,65,190
432135,201910,963,2324,607,1674,34,108,438,1188,472,1296
432140,201910,1473,4486,1099,3732,152,555,677,2289,829,2844
432143,201910,1327,3534,1018,3042,73,236,679,2013,752,2249
432145,201910,1303,3456,727,2217,113,373,224,576,337,949
432146,201910,99,273,60,203,21,74,17,52,38,126
432147,201910,471,1384,279,948,90,328,65,193,155,521
432149,201910,407,1034,193,578,13,39,93,265,106,304
432150,201910,2758,7203,1996,5807,451,1481,712,1976,1163,3457
432160,201910,4918,13287,3568,10982,943,3148,1214,3559,2157,6707
432162,201910,266,583,34,97,6,13,5,14,11,27
432163,201910,126,319,25,72,0,0,3,6,3,6
432166,201910,559,1596,413,1283,67,216,149,420,216,636
432170,201910,1263,3417,768,2461,149,532,279,823,428,1355
432180,201910,2482,6088,1276,3743,246,776,439,1147,685,1923
432183,201910,351,1031,220,716,57,219,69,202,126,421
432185,201910,778,2000,438,1334,37,133,238,680,275,813
432190,201910,1735,4273,1058,3113,211,703,495,1370,706,2073
432195,201910,915,2284,571,1649,160,430,210,639,370,1069
432200,201910,3025,7985,2114,6449,380,1180,1118,3480,1498,4660
432210,201910,353,932,202,623,37,141,96,250,133,391
432215,201910,613,1799,548,1701,49,141,404,1267,453,1408
432218,201910,251,630,105,303,16,53,47,124,63,177
432220,201910,3449,8223,2542,6800,433,1237,1415,3711,1848,4948
432225,201910,83,243,59,189,13,44,30,98,43,142
432230,201910,678,1632,362,1041,55,165,149,388,204,553
432232,201910,480,1188,283,831,63,207,105,283,168,490
432234,201910,263,667,106,313,19,45,16,42,35,87
432235,201910,72,196,20,60,5,15,5,19,10,34
432237,201910,333,858,284,774,9,20,232,615,241,635
432240,201910,14054,36370,10271,31013,778,2697,6528,20421,7306,23118
432250,201910,4330,13110,3501,11470,993,3317,1370,4535,2363,7852
432252,201910,419,1014,250,707,38,116,123,334,161,450
432253,201910,947,2950,550,1914,142,523,35,118,177,641
432254,201910,680,1618,134,428,28,90,18,46,46,136
432255,201910,104,266,55,167,6,21,27,70,33,91
432260,201910,4472,11676,3193,9207,946,2815,924,2594,1870,5409
432270,201910,1697,4837,1316,4055,403,1346,257,757,660,2103
432280,201910,1153,2942,561,1713,89,302,214,552,303,854
432285,201910,167,496,21,68,0,0,3,6,3,6
432290,201910,327,939,165,539,59,192,28,59,87,251
432300,201910,24459,63270,18076,52634,2784,9072,10356,29016,13140,38088
432310,201910,759,2101,541,1692,50,157,366,1151,416,1308
432320,201910,207,479,67,195,9,33,25,64,34,97
432330,201910,216,500,64,195,8,22,17,47,25,69
432335,201910,196,556,62,226,7,31,11,33,18,64
432340,201910,311,745,123,392,12,39,42,123,54,162
432345,201910,629,1469,555,1376,20,53,440,1072,460,1125
432350,201910,328,869,168,549,31,105,61,193,92,298
432360,201910,223,665,43,148,4,15,18,58,22,73
432370,201910,297,736,186,545,15,49,126,360,141,409
432375,201910,459,1164,336,921,64,159,169,477,233,636
432377,201910,177,552,31,110,5,20,3,6,8,26
432380,201910,1531,4124,957,3036,172,612,476,1452,648,2064
500020,201910,2389,6242,1640,4913,203,713,946,2740,1149,3453
500025,201910,1218,2907,743,2059,65,195,420,1115,485,1310
500060,201910,6894,19475,4801,15402,631,2112,2858,9442,3489,11554
500070,201910,3940,10320,2709,8218,505,1577,1195,3725,1700,5302
500080,201910,1331,3352,848,2498,163,535,361,954,524,1489
500085,201910,1941,4832,1265,3720,294,918,620,1737,914,2655
500090,201910,1878,5091,1250,3972,230,757,480,1580,710,2337
500100,201910,3410,8753,2555,7336,455,1458,1210,3278,1665,4736
500110,201910,7247,18918,4532,14521,1046,3681,1360,5037,2406,8718
500124,201910,1930,5830,1533,5120,264,824,835,2931,1099,3755
500150,201910,1253,2877,756,2118,163,471,264,717,427,1188
500190,201910,4067,10060,2674,7810,651,1933,763,2206,1414,4139
500200,201910,2086,4999,1502,4018,178,504,916,2330,1094,2834
500210,201910,4405,11076,3144,9345,823,2475,1379,4199,2202,6674
500215,201910,1307,3750,904,2975,91,340,468,1542,559,1882
500220,201910,2366,6742,1495,5066,266,963,415,1365,681,2328
500230,201910,2031,4792,1481,3994,196,510,959,2566,1155,3076
500240,201910,3399,10236,2315,7962,382,1458,890,3157,1272,4615
500260,201910,2993,6438,1787,4737,242,644,926,2379,1168,3023
500270,201910,130100,307510,73604,209298,13322,41382,26251,70410,39573,111792
500280,201910,1203,3057,803,2419,102,330,473,1386,575,1716
500290,201910,3457,8112,1836,5430,345,1184,579,1528,924,2712
500295,201910,3104,7641,1815,5267,313,1006,689,1729,1002,2735
500310,201910,887,1889,592,1510,96,194,308,829,404,1023
500315,201910,3403,9781,2683,8648,248,797,1853,6161,2101,6958
500320,201910,17404,48394,11940,39193,3161,10803,4147,14467,7308,25270
500325,201910,4063,9186,2748,7391,241,672,1794,4888,2035,5560
500330,201910,6533,15053,4148,11444,328,1002,2331,6568,2659,7570
500345,201910,1932,4758,1214,3596,289,882,413,1201,702,2083
500348,201910,2322,5994,1761,5049,261,771,983,2881,1244,3652
500350,201910,1234,3367,643,2043,72,233,284,887,356,1120
500370,201910,23319,61024,15720,48209,2316,8046,7950,24340,10266,32386
500375,201910,2294,6082,1497,4444,314,1000,493,1385,807,2385
500380,201910,3333,8389,2201,6440,620,1929,599,1778,1219,3707
500390,201910,494,1065,298,809,51,160,173,465,224,625
500400,201910,1238,3219,779,2303,153,508,265,724,418,1232
500410,201910,2296,5800,1611,4743,166,486,964,2912,1130,3398
500430,201910,2478,6202,1617,4870,229,807,682,2147,911,2954
500440,201910,1084,2632,637,1908,90,298,238,765,328,1063
500450,201910,1361,3440,726,2220,150,496,158,462,308,958
500460,201910,3492,9489,2061,6660,384,1388,663,2129,1047,3517
500470,201910,2336,6392,1393,4412,426,1502,277,754,703,2256
500480,201910,2081,6310,1769,5811,160,563,1276,4291,1436,4854
500490,201910,959,2249,525,1591,124,448,143,427,267,875
500500,201910,4150,11257,2606,8675,950,3685,459,1540,1409,5225
500510,201910,662,1711,419,1236,28,98,254,731,282,829
500515,201910,1749,4406,1335,3758,141,439,874,2377,1015,2816
500520,201910,2882,9411,2283,8222,632,2323,954,3584,1586,5907
500525,201910,827,2498,672,2259,60,219,410,1396,470,1615
500540,201910,4129,10783,2427,7750,685,2681,239,674,924,3355
500560,201910,5091,14384,4093,13057,295,1025,3201,10319,3496,11344
500568,201910,4214,9237,2433,6590,582,1731,824,2212,1406,3943
500570,201910,7176,16897,4078,11477,805,2466,1321,3461,2126,5927
500580,201910,2875,7777,2114,6445,453,1460,1024,3101,1477,4561
500600,201910,2971,7463,2057,6069,438,1313,900,2740,1338,4053
500620,201910,7052,18955,4600,14189,1067,3444,1609,4845,2676,8289
500625,201910,467,1277,258,806,47,161,89,245,136,406
500627,201910,705,1841,412,1291,61,196,147,461,208,657
500630,201910,6093,14296,3369,9664,707,2208,1029,2974,1736,5182
500635,201910,2817,9000,2162,8115,171,698,1533,6181,1704,6879
500640,201910,1639,3616,1063,2830,40,129,729,1890,769,2019
500660,201910,15922,42726,10771,34777,3586,12951,2645,8737,6231,21688
500690,201910,2048,5669,1377,4614,551,2121,93,209,644,2330
500710,201910,2791,7675,2107,6431,644,2062,619,1772,1263,3834
500720,201910,4756,12153,2947,9106,676,2235,866,2713,1542,4948
500730,201910,894,2277,533,1616,69,189,195,601,264,790
500740,201910,4412,10557,2969,8223,380,1122,1611,4480,1991,5602
500750,201910,905,2337,581,1739,89,268,221,590,310,858
500755,201910,837,2250,445,1481,89,320,79,237,168,557
500769,201910,4677,11588,2371,7114,470,1564,377,885,847,2449
500770,201910,1444,3928,901,2933,169,617,296,955,465,1572
500780,201910,1193,2957,748,2193,160,509,213,594,373,1103
500790,201910,7157,18996,5498,16244,1097,3486,2846,8448,3943,11934
500793,201910,1850,4768,1236,3675,365,1177,340,920,705,2097
500795,201910,2447,6371,1998,5794,95,273,1701,5047,1796,5320
500797,201910,653,1666,428,1261,118,364,153,450,271,814
500800,201910,2769,6466,1698,4877,550,1836,214,681,764,2517
500830,201910,16768,42637,11103,32114,2276,7176,4325,11711,6601,18887
500840,201910,1334,3278,745,2130,85,245,314,858,399,1103
510010,201910,1797,4071,1149,3204,110,314,799,2249,909,2563
510020,201910,3399,8741,1741,5358,387,1279,359,1009,746,2288
510025,201910,6504,16220,3892,11744,609,2054,1538,4447,2147,6501
510030,201910,2241,5085,1444,3922,329,899,517,1410,846,2309
510035,201910,1165,3032,702,2285,82,294,417,1424,499,1718
510040,201910,2146,4893,1540,4087,148,382,977,2677,1125,3059
510050,201910,1954,4281,1266,3334,158,492,852,2158,1010,2650
510060,201910,1341,3416,953,2780,199,647,291,795,490,1442
510080,201910,1170,3110,741,2358,234,785,219,607,453,1392
510100,201910,642,1522,429,1175,51,145,228,603,279,748
510120,201910,247,468,136,337,3,12,106,266,109,278
510125,201910,2002,5014,1561,4351,177,656,797,2070,974,2726
510130,201910,1408,3546,959,2823,207,663,296,881,503,1544
510140,201910,2892,7637,1959,6429,727,2788,653,1958,1380,4746
510160,201910,1660,4319,1195,3702,181,536,830,2621,1011,3157
510170,201910,4381,11631,3147,9620,778,2460,1258,3961,2036,6421
510180,201910,13265,30708,7796,22308,1799,5573,2277,7434,4076,13007
510185,201910,1621,4320,1050,3482,428,1422,283,1172,711,2594
510190,201910,1908,5524,1223,4298,350,1352,224,828,574,2180
510250,201910,14835,38698,11442,33826,2186,6777,6167,18854,8353,25631
510260,201910,1966,8163,1578,7439,273,1386,937,4820,1210,6206
510263,201910,2891,8119,1701,5643,283,1050,217,642,500,1692
510267,201910,4509,13050,2592,8755,548,1965,307,983,855,2948
510268,201910,1226,3032,905,2525,109,292,590,1634,699,1926
510269,201910,986,2724,600,1975,159,572,185,565,344,1137
510270,201910,2791,8083,1859,6334,348,1291,735,2461,1083,3752
510279,201910,1712,4486,1080,3368,220,763,459,1363,679,2126
510285,201910,1053,2836,722,2268,226,788,153,433,379,1221
510300,201910,3577,9119,2598,7772,410,1229,1488,4670,1898,5899
510305,201910,1421,3951,827,2780,176,616,195,727,371,1343
510310,201910,891,2229,591,1713,179,549,159,470,338,1019
510320,201910,3499,8941,2373,6931,540,1701,621,1840,1161,3541
510325,201910,4213,12581,3137,10626,921,3250,1008,3524,1929,6774
510330,201910,2659,8135,1751,6473,337,1267,649,2741,986,4008
510335,201910,4350,12738,3228,10967,505,1846,1811,6321,2316,8167
510336,201910,438,1246,313,1044,61,191,143,522,204,713
510337,201910,1523,4554,997,3577,396,1549,179,657,575,2206
510340,201910,87273,194834,51217,141033,13102,42506,14397,36574,27499,79080
510343,201910,1004,2760,666,2103,123,428,287,869,410,1297
510345,201910,1200,3437,875,2782,164,527,385,1182,549,1709
510350,201910,2710,7139,1692,5387,374,1236,662,2094,1036,3330
510360,201910,1808,3791,1123,2982,65,134,812,2293,877,2427
510370,201910,1662,4900,1168,4006,164,633,690,2400,854,3033
510380,201910,537,1354,281,888,58,212,100,303,158,515
510385,201910,1183,4003,844,3341,94,426,524,2136,618,2562
510390,201910,1136,3180,767,2671,219,739,312,1203,531,1942
510395,201910,714,1597,464,1231,31,92,274,779,305,871
510410,201910,4498,12713,3251,10415,629,2078,1735,5727,2364,7805
510420,201910,2207,4775,1492,3814,114,340,973,2468,1087,2808
510450,201910,471,1162,256,753,67,197,40,134,107,331
510452,201910,675,1910,453,1476,64,219,237,762,301,981
510454,201910,858,2425,645,2052,60,167,430,1442,490,1609
510455,201910,867,2457,613,1928,104,384,237,672,341,1056
510460,201910,1721,4261,1198,3472,93,322,783,2169,876,2491
510480,201910,4489,10944,2881,7910,565,1749,1131,2960,1696,4709
510490,201910,1654,4359,1205,3767,204,653,722,2284,926,2937
510500,201910,1511,3820,881,2739,165,544,309,968,474,1512
510510,201910,3258,9712,2369,8032,639,2415,709,2517,1348,4932
510515,201910,5139,13464,3201,9798,780,2631,768,2120,1548,4751
510517,201910,1001,2933,757,2501,238,882,132,381,370,1263
510520,201910,2060,4172,1143,3036,79,222,607,1723,686,1945
510523,201910,1008,2635,733,2163,153,434,394,1196,547,1630
510525,201910,6156,17151,4497,13862,781,2708,2036,5915,2817,8623
510530,201910,518,1338,369,1119,36,115,219,649,255,764
510550,201910,2343,6925,1643,5662,407,1469,688,2387,1095,3856
510558,201910,2115,5705,1505,4738,170,525,742,2500,912,3025
510560,201910,1597,4604,915,3221,198,772,240,901,438,1673
510562,201910,5004,13447,3465,10523,900,2988,1129,3503,2029,6491
510590,201910,3023,7572,2152,6444,183,597,1518,4598,1701,5195
510600,201910,1424,3251,891,2439,179,498,371,1035,550,1533
510610,201910,2702,6577,1799,5313,175,594,1109,3286,1284,3880
510615,201910,2420,6223,1560,4763,288,883,804,2539,1092,3422
510617,201910,919,2753,674,2343,108,440,396,1418,504,1858
510618,201910,1202,3220,799,2488,166,580,387,1168,553,1748
510619,201910,717,1831,443,1348,69,226,103,291,172,517
510620,201910,1331,3018,591,1833,154,569,33,73,187,642
510621,201910,1421,3842,842,2736,186,674,256,789,442,1463
510622,201910,4264,12126,2881,9080,1019,3428,415,1178,1434,4606
510623,201910,2538,6370,1711,5043,395,1406,482,1356,877,2762
510624,201910,1611,4083,662,2254,85,319,156,456,241,775
510625,201910,2689,6602,1382,4237,258,921,314,949,572,1870
510626,201910,1420,3437,855,2540,254,868,207,611,461,1479
510627,201910,581,1512,316,983,87,290,77,253,164,543
510628,201910,1480,3409,945,2677,189,564,382,1074,571,1638
510629,201910,1511,4390,1097,3602,235,846,396,1282,631,2128
510630,201910,3156,8900,1800,6253,430,1607,314,1186,744,2793
510631,201910,570,1380,397,1125,13,39,306,886,319,925
510637,201910,3199,7832,2245,6402,600,1900,628,1783,1228,3683
510642,201910,5124,14992,3926,13145,1043,3726,1614,5594,2657,9320
510645,201910,804,1706,469,1261,110,311,209,524,319,835
510650,201910,6858,17880,5448,16324,634,1721,3781,12373,4415,14094
510665,201910,1735,3885,997,2682,138,395,429,1195,567,1590
510670,201910,410,884,232,619,24,66,133,367,157,433
510675,201910,5565,15598,3711,12053,1137,4018,589,1883,1726,5901
510677,201910,2007,5208,1345,4198,196,684,700,2152,896,2836
510680,201910,672,1770,370,1180,79,272,76,219,155,491
510682,201910,1533,4563,1103,3812,359,1373,237,792,596,2165
510685,201910,549,1602,391,1274,56,198,195,630,251,828
510700,201910,3834,9443,2663,7752,310,1026,1856,5339,2166,6365
510704,201910,10189,24170,6414,17555,1361,4042,1778,4622,3139,8664
510706,201910,1902,5697,1329,4780,248,899,705,2746,953,3645
510710,201910,2521,6461,1599,4675,363,1114,546,1521,909,2635
510715,201910,565,1287,416,1082,41,122,196,519,237,641
510718,201910,2231,5049,1251,3752,443,1308,352,1340,795,2648
510719,201910,413,873,240,638,26,68,140,355,166,423
510720,201910,899,2139,567,1629,110,359,250,668,360,1027
510724,201910,730,1994,481,1532,80,280,231,707,311,987
510726,201910,1080,1966,545,1300,58,151,283,673,341,824
510729,201910,594,1413,253,780,37,129,58,186,95,315
510730,201910,2807,6902,1857,5370,277,904,872,2449,1149,3353
510735,201910,1002,2919,752,2557,80,315,539,1826,619,2141
510740,201910,850,2096,518,1471,79,229,250,704,329,933
510757,201910,524,1673,415,1493,143,579,141,468,284,1047
510760,201910,40474,89639,22879,62178,5016,15663,7068,17513,12084,33176
510770,201910,4182,9529,2835,7860,265,711,1907,5519,2172,6230
510774,201910,333,881,223,680,38,117,109,338,147,455
510775,201910,572,1564,385,1255,89,327,83,255,172,582
510776,201910,426,1063,291,802,74,208,92,269,166,477
510777,201910,1502,4057,1059,3465,139,531,688,2216,827,2747
510779,201910,601,1628,451,1389,44,140,274,881,318,1021
510780,201910,3530,9246,2557,7829,602,1831,1135,3874,1737,5705
510785,201910,1955,5216,1096,3584,288,1009,178,652,466,1661
510787,201910,2479,7102,1594,5206,572,1965,169,547,741,2512
510788,201910,615,1453,414,1145,65,182,179,572,244,754
510790,201910,16271,42549,9330,29184,2065,7243,1423,3826,3488,11069
510792,201910,8287,22460,4918,15890,1023,3694,924,2693,1947,6387
510794,201910,1162,3146,748,2423,243,873,159,442,402,1315
510795,201910,7703,20599,4858,15311,1141,3954,1221,3827,2362,7781
510800,201910,1652,4320,1041,3251,376,1167,125,370,501,1537
510805,201910,1493,4155,974,3142,214,764,297,832,511,1596
510810,201910,632,1306,390,972,104,273,162,401,266,674
510820,201910,746,1437,400,993,27,88,207,518,234,606
510830,201910,821,2020,571,1685,51,137,402,1251,453,1388
510835,201910,546,1329,353,1045,45,146,199,575,244,721
510840,201910,48897,106517,33188,86976,6189,15383,17441,49784,23630,65167
510850,201910,1781,4274,971,2965,323,1116,93,218,416,1334
510860,201910,2243,6043,1381,4565,434,1663,128,408,562,2071
510880,201910,662,1912,487,1567,120,403,187,610,307,1013
510885,201910,528,1287,353,1031,66,223,122,345,188,568
510890,201910,616,1815,456,1536,104,372,207,691,311,1063
510895,201910,1209,3146,781,2438,175,649,318,905,493,1554
520005,201910,2313,6097,1779,5437,512,1580,776,2666,1288,4246
520010,201910,2124,6205,1495,4922,382,1415,422,1203,804,2618
520013,201910,2662,6969,1750,5256,387,1189,502,1633,889,2822
520015,201910,501,1279,354,1063,81,262,124,388,205,650
520017,201910,1070,2800,795,2372,99,318,516,1504,615,1822
520020,201910,379,877,283,751,29,101,203,510,232,611
520025,201910,32293,90827,27651,84260,2804,9354,19903,60234,22707,69588
520030,201910,5278,13747,4177,12174,343,1115,2892,8360,3235,9475
520050,201910,406,943,255,681,12,33,153,423,165,456
520055,201910,1534,3828,1016,2830,70,182,582,1569,652,1751
520060,201910,1368,3883,996,3175,273,946,245,769,518,1715
520080,201910,1796,4628,1322,3988,245,748,620,2057,865,2805
520082,201910,864,2236,685,1927,69,186,380,1107,449,1293
520085,201910,783,2123,603,1825,115,369,278,797,393,1166
520090,201910,809,1593,549,1302,55,97,426,1053,481,1150
520110,201910,36870,99980,25144,80372,8117,29345,2018,5857,10135,35202
520120,201910,200,483,107,320,14,49,39,113,53,162
520130,201910,3532,8760,2728,7478,521,1472,1184,3275,1705,4747
520140,201910,38346,104194,26529,83516,9807,33353,3363,10924,13170,44277
520145,201910,536,1261,360,999,65,202,192,486,257,688
520150,201910,594,1354,425,1131,78,205,230,630,308,835
520160,201910,769,1772,545,1424,101,242,260,721,361,963
520170,201910,4937,10046,3261,8101,194,544,2480,6025,2674,6569
520180,201910,2036,5694,1671,5144,335,1141,883,2671,1218,3812
520215,201910,1753,4234,1226,3407,311,943,451,1198,762,2141
520235,201910,585,1361,332,959,37,127,130,358,167,485
520250,201910,1428,3705,1018,3049,327,1075,207,627,534,1702
520260,201910,806,1884,492,1359,102,285,198,558,300,843
520280,201910,664,1677,498,1415,110,314,230,688,340,1002
520310,201910,1093,2405,684,1795,162,481,256,696,418,1177
520320,201910,1585,4304,1188,3655,145,507,648,1944,793,2451
520330,201910,3708,10172,2653,8408,418,1602,1334,4099,1752,5701
520340,201910,2323,5200,1441,3953,184,471,836,2398,1020,2869
520350,201910,2764,6705,1970,5452,604,1771,742,2044,1346,3815
520355,201910,1735,4775,1224,3750,347,1160,365,1038,712,2198
520357,201910,721,1749,524,1452,39,102,388,1103,427,1205
520360,201910,666,1745,489,1442,149,460,134,429,283,889
520380,201910,1247,3121,720,2140,76,252,365,1011,441,1263
520390,201910,979,2141,556,1608,164,517,171,531,335,1048
520393,201910,511,1233,337,956,44,150,154,395,198,545
520396,201910,773,2036,640,1821,49,163,456,1252,505,1415
520400,201910,1569,3920,1186,3384,167,507,770,2222,937,2729
520410,201910,1860,4135,1068,2934,177,526,461,1209,638,1735
520420,201910,358,821,274,681,29,81,205,479,234,560
520425,201910,1377,3342,816,2349,214,638,234,652,448,1290
520430,201910,2168,4957,1138,3368,220,774,42,114,262,888
520440,201910,2897,6998,1708,4909,425,1339,450,1236,875,2575
520450,201910,11564,27892,7466,21477,2391,7487,1189,3511,3580,10998
520455,201910,642,1772,454,1479,123,436,128,419,251,855
520460,201910,964,2282,741,1992,83,196,577,1590,660,1786
520465,201910,758,1972,600,1747,92,303,396,1100,488,1403
520470,201910,2004,5320,1569,4745,385,1137,750,2463,1135,3600
520480,201910,876,2436,584,1930,187,620,129,467,316,1087
520485,201910,1532,4290,1272,3930,195,614,864,2653,1059,3267
520490,201910,3853,10651,2846,9067,972,3188,1051,3471,2023,6659
520495,201910,1520,3340,1142,2833,49,135,913,2253,962,2388
520500,201910,1268,3365,842,2544,193,636,332,1012,525,1648
520505,201910,704,1616,479,1317,69,195,285,775,354,970
520510,201910,7379,18586,4760,14430,1120,3791,1283,4168,2403,7959
520520,201910,1113,2870,814,2388,200,623,257,758,457,1381
520530,201910,1910,5660,1402,4787,472,1687,413,1539,885,3226
520540,201910,2739,7298,1629,5034,308,1016,360,1066,668,2082
520545,201910,909,2396,683,2032,147,422,264,809,411,1231
520547,201910,750,2047,591,1770,158,484,271,813,429,1297
520549,201910,12448,34057,10140,30533,1549,4940,6555,19640,8104,24580
520551,201910,4301,11793,3587,10745,411,1462,2509,7297,2920,8759
520552,201910,800,2084,657,1903,122,346,398,1216,520,1562
520570,201910,536,1205,351,947,91,218,129,392,220,610
520580,201910,2106,4951,1601,4333,111,354,1167,3101,1278,3455
520590,201910,1121,2907,764,2305,227,704,182,562,409,1266
520620,201910,7913,21504,6138,18878,1571,4964,2738,8660,4309,13624
520630,201910,687,1772,422,1289,70,218,80,243,150,461
520640,201910,2347,5817,1762,4807,430,1161,725,2058,1155,3219
520650,201910,839,1999,590,1633,101,278,293,854,394,1132
520660,201910,513,1230,244,740,49,170,60,172,109,342
520670,201910,894,2502,760,2313,75,241,490,1451,565,1692
520680,201910,684,1706,494,1409,85,228,247,731,332,959
520690,201910,339,795,226,630,69,179,67,211,136,390
520710,201910,400,964,276,747,9,21,195,517,204,538
520725,201910,1510,3589,1037,2815,125,381,640,1665,765,2046
520735,201910,705,1737,457,1330,102,287,163,517,265,804
520740,201910,1995,4584,1492,3969,259,645,828,2344,1087,2989
520750,201910,646,1585,450,1268,79,216,222,640,301,856
520753,201910,1283,3437,968,2833,187,575,386,1058,573,1633
520760,201910,1126,2507,984,2329,42,74,887,2141,929,2215
520780,201910,1453,3430,1025,2822,107,317,505,1332,612,1649
520790,201910,3318,7870,2283,6240,288,789,1277,3663,1565,4452
520800,201910,15183,39684,11746,34664,1958,5964,6825,20698,8783,26662
520810,201910,1251,2675,891,2258,160,436,541,1426,701,1862
520815,201910,576,1705,408,1364,73,261,113,390,186,651
520830,201910,1805,3858,1254,3225,44,113,1025,2598,1069,2711
520840,201910,2420,6564,1936,5936,833,2729,521,1716,1354,4445
520850,201910,641,1664,448,1375,158,546,104,336,262,882
520860,201910,6031,16361,4420,13757,1130,3787,1651,5090,2781,8877
520870,201910,96074,224869,63026,175107,15138,45478,21345,57870,36483,103348
520880,201910,6304,18104,4828,15488,1153,3822,1778,5765,2931,9587
520890,201910,3698,9077,2470,7148,531,1647,1042,3036,1573,4683
520910,201910,4480,11399,2787,8392,710,2323,613,1839,1323,4162
520915,201910,667,1838,380,1184,63,211,123,372,186,583
520920,201910,4302,9799,2907,7963,366,1022,1650,4641,2016,5663
520929,201910,690,1607,475,1264,87,210,224,652,311,862
520940,201910,956,2544,738,2233,44,148,544,1612,588,1760
520945,201910,469,1057,375,919,24,55,271,648,295,703
520960,201910,977,2476,759,2112,123,343,471,1291,594,1634
520970,201910,2379,6667,1877,5832,491,1673,484,1595,975,3268
520980,201910,766,1887,550,1583,112,352,217,584,329,936
520990,201910,2921,7939,2330,7157,338,1033,1488,4637,1826,5670
520993,201910,1030,2437,680,1873,90,281,397,1044,487,1325
520995,201910,2204,5635,1641,4850,274,817,667,2022,941,2839
521000,201910,8132,21243,5372,16383,1173,3742,1633,4945,2806,8687
521010,201910,3601,9289,2642,7635,271,788,1527,4360,1798,5148
521015,201910,762,1902,521,1461,46,140,322,857,368,997
521020,201910,3000,7732,1721,5222,505,1654,150,486,655,2140
521030,201910,469,1006,309,781,46,96,145,401,191,497
521040,201910,7393,18000,5379,14848,1126,3244,2321,6510,3447,9754
521056,201910,869,2299,671,2010,214,633,196,652,410,1285
521060,201910,937,2462,689,2018,50,144,363,1077,413,1221
521080,201910,1084,2372,534,1481,73,222,226,549,299,771
521090,201910,3150,8442,2082,6368,606,1978,256,823,862,2801
521100,201910,1716,4004,1201,3274,194,527,694,1915,888,2442
521120,201910,4581,10728,3195,8999,209,527,1614,5207,1823,5734
521130,201910,933,2128,543,1477,21,61,296,846,317,907
521140,201910,1198,3080,847,2453,121,368,398,1146,519,1514
521150,201910,12017,26390,7275,19669,1295,4072,3403,9252,4698,13324
521160,201910,604,1268,417,985,48,114,275,629,323,743
521170,201910,1017,2388,727,1948,62,181,497,1295,559,1476
521180,201910,6784,19063,5532,16863,972,3223,2771,8146,3743,11369
521190,201910,10113,25587,5648,17842,1450,4837,1139,3807,2589,8644
521200,201910,710,1755,474,1352,51,144,261,739,312,883
521205,201910,596,1487,447,1246,15,44,329,883,344,927
521210,201910,701,1776,386,1135,100,316,67,153,167,469
521220,201910,3614,8968,2295,6809,485,1621,687,1947,1172,3568
521225,201910,332,738,243,638,33,93,149,383,182,476
521230,201910,1235,3251,1105,3088,383,1077,539,1597,922,2674
521250,201910,29138,79379,22410,69444,8446,27374,6618,21772,15064,49146
521260,201910,565,1331,404,1068,55,148,233,599,288,747
521270,201910,1768,4499,1515,4191,82,213,1164,3225,1246,3438
521280,201910,1786,4800,1325,4023,333,1099,518,1584,851,2683
521290,201910,452,1073,309,888,44,150,182,507,226,657
521295,201910,1036,2263,802,2006,59,132,634,1653,693,1785
521300,201910,1826,4540,1421,3974,274,718,872,2516,1146,3234
521305,201910,681,1658,457,1304,58,154,266,765,324,919
521308,201910,4594,12394,3218,9757,328,996,1824,5436,2152,6432
521310,201910,8038,20593,5367,16039,1212,3939,2122,6068,3334,10007
521340,201910,407,954,286,767,20,56,202,526,222,582
521350,201910,1991,5143,1503,4393,154,536,1027,2872,1181,3408
521370,201910,1195,3063,697,2185,201,734,92,310,293,1044
521375,201910,1300,3218,873,2588,202,585,273,894,475,1479
521377,201910,1452,3103,1037,2588,76,141,844,2197,920,2338
521380,201910,5978,15980,3839,11926,413,1436,986,3232,1399,4668
521385,201910,626,1513,472,1310,62,162,269,808,331,970
521390,201910,674,1671,468,1351,147,468,163,486,310,954
521400,201910,2470,5713,1880,4992,209,564,1329,3609,1538,4173
521405,201910,1223,3148,894,2595,186,549,403,1168,589,1717
521410,201910,765,2045,580,1735,111,309,294,943,405,1252
521440,201910,1190,3031,830,2468,273,892,236,700,509,1592
521450,201910,3746,11239,2719,9187,700,2436,727,2560,1427,4996
521460,201910,5556,14793,3893,11805,1380,4330,832,2578,2212,6908
521470,201910,632,1715,370,1158,49,145,124,378,173,523
521480,201910,336,833,189,550,35,104,51,134,86,238
521483,201910,2408,5784,1628,4536,374,1106,618,1688,992,2794
521486,201910,1707,4033,1257,3405,79,225,927,2490,1006,2715
521487,201910,415,1011,290,832,52,158,136,403,188,561
521490,201910,870,2361,627,1953,39,149,450,1361,489,1510
521500,201910,2083,5226,1515,4296,105,370,1056,2903,1161,3273
521520,201910,717,1656,497,1332,78,226,211,563,289,789
521523,201910,11120,34873,9197,31637,2566,9605,2483,8760,5049,18365
521525,201910,1029,2353,748,1958,75,201,527,1367,602,1568
521530,201910,2244,5826,1271,3800,271,855,316,970,587,1825
521540,201910,814,2047,515,1545,72,254,234,726,306,980
521550,201910,1368,3456,759,2258,143,474,208,646,351,1120
521560,201910,4307,11520,2932,9648,486,1878,1481,5051,1967,6929
521565,201910,610,1487,470,1293,78,199,287,780,365,979
521570,201910,3373,9054,2158,6731,439,1569,243,805,682,2374
521580,201910,495,1206,276,824,38,122,81,212,119,334
521590,201910,620,1482,459,1253,93,274,251,666,344,940
521600,201910,374,1023,226,710,40,106,83,263,123,369
521630,201910,1640,3611,970,2605,193,552,338,870,531,1422
521640,201910,1766,4176,1192,3333,271,830,388,1050,659,1880
521645,201910,544,1420,340,1046,79,216,114,355,193,571
521680,201910,1086,3311,820,2766,239,873,116,416,355,1289
521690,201910,502,1279,430,1170,61,183,257,681,318,864
521710,201910,3088,7779,1902,5759,353,1201,442,1269,795,2470
521720,201910,2160,5056,1404,3889,157,477,795,2196,952,2673
521730,201910,3457,9866,2612,8363,777,2830,609,1630,1386,4460
521740,201910,3770,9911,2801,8490,728,2382,1015,3207,1743,5589
521760,201910,14441,40119,11101,34904,2998,10339,4027,13093,7025,23432
521770,201910,2858,6942,1865,5264,584,1785,453,1277,1037,3062
521800,201910,5964,16293,4349,13569,1064,3441,1584,5377,2648,8818
521805,201910,498,1191,358,987,120,320,146,407,266,727
521810,201910,628,1483,426,1200,64,181,233,666,297,847
521830,201910,5274,14753,4200,13107,313,1193,2978,9105,3291,10298
521839,201910,656,1643,472,1322,86,268,233,582,319,850
521850,201910,5235,12551,3164,9253,547,1775,330,886,877,2661
521860,201910,1590,4192,1077,3280,189,625,348,1040,537,1665
521870,201910,664,1854,458,1453,103,357,115,323,218,680
521878,201910,637,1639,444,1271,66,223,228,591,294,814
521880,201910,17856,43286,11722,33894,3021,9246,3928,11595,6949,20841
521890,201910,2940,7698,1892,5773,539,1766,326,909,865,2675
521900,201910,1529,3610,891,2642,293,844,134,419,427,1263
521910,201910,1205,2576,756,2026,73,193,435,1231,508,1424
521920,201910,441,1245,318,1015,61,216,137,426,198,642
521925,201910,717,1899,527,1611,92,287,274,822,366,1109
521930,201910,5190,12629,3342,9738,871,2423,1260,4010,2131,6433
521935,201910,956,2321,635,1727,68,194,362,924,430,1118
521940,201910,1222,2765,797,2179,188,557,325,868,513,1425
521945,201910,521,1441,402,1229,92,283,207,650,299,933
521950,201910,730,1780,513,1446,128,382,227,593,355,975
521960,201910,695,1832,442,1338,53,179,233,657,286,836
521970,201910,2483,6143,1989,5552,150,409,1541,4358,1691,4767
521971,201910,724,1713,491,1372,128,351,141,395,269,746
521973,201910,1217,3200,933,2747,45,166,670,1926,715,2092
521975,201910,11545,30572,9469,27672,1492,4579,5995,17530,7487,22109
521980,201910,2495,5896,1890,5088,148,373,1425,3901,1573,4274
521990,201910,1057,2947,828,2548,157,491,371,1157,528,1648
522000,201910,2438,6639,1952,6004,237,720,1310,4144,1547,4864
522005,201910,332,810,247,685,51,132,120,352,171,484
522010,201910,3808,9359,2639,7459,649,1952,870,2406,1519,4358
522015,201910,915,2409,650,1984,162,485,246,780,408,1265
522020,201910,5248,12568,3425,9682,719,2137,1385,3976,2104,6113
522026,201910,657,1858,465,1486,79,269,158,485,237,754
522028,201910,429,1106,307,884,58,174,131,364,189,538
522040,201910,2989,6808,2103,5614,261,758,1400,3649,1661,4407
522045,201910,16682,46766,12052,38268,2929,9990,3222,9901,6151,19891
522050,201910,943,2477,638,1982,170,588,226,652,396,1240
522060,201910,2534,6836,1872,5775,167,527,1125,3582,1292,4109
522068,201910,1775,4635,1385,4156,145,386,1024,3156,1169,3542
522070,201910,601,1494,484,1315,20,62,401,1064,421,1126
522100,201910,664,1729,451,1377,56,185,241,720,297,905
522108,201910,912,2442,714,2145,54,237,565,1617,619,1854
522119,201910,1470,3742,1096,3231,178,549,590,1791,768,2340
522130,201910,371,919,255,758,45,136,141,448,186,584
522140,201910,16420,43940,11429,35026,3054,10046,2955,8622,6009,18668
522145,201910,790,1950,533,1563,129,365,225,677,354,1042
522150,201910,1032,2547,714,2021,201,562,206,616,407,1178
522155,201910,891,2257,683,1933,125,342,407,1171,532,1513
522157,201910,523,1316,438,1197,25,86,339,928,364,1014
522160,201910,5814,15131,3704,11234,1028,3386,289,948,1317,4334
522170,201910,2583,6627,1878,5570,313,964,1025,3051,1338,4015
522180,201910,439,1054,278,782,60,175,32,105,92,280
522185,201910,17098,42898,12071,35942,5001,15973,2709,8758,7710,24731
522190,201910,744,1790,500,1360,100,270,179,479,279,749
522200,201910,1616,4627,1032,3435,216,778,148,445,364,1223
522205,201910,1583,3705,1198,3182,115,337,844,2220,959,2557
522220,201910,1267,3200,922,2654,155,447,478,1424,633,1871
522230,201910,1109,2880,896,2573,207,719,450,1201,657,1920
530010,201910,164380,448092,132718,399242,21685,71189,75442,222995,97127,294184
110001,201911,3854,10881,2533,8353,603,2123,990,3290,1593,5413
110002,201911,11562,30535,7925,24182,2281,7381,2227,6830,4508,14211
110003,201911,611,1813,422,1413,104,380,103,328,207,708
110004,201911,10522,28005,6797,21104,1561,5204,1865,5927,3426,11131
110005,201911,2500,6510,1575,4882,360,1207,431,1440,791,2647
110006,201911,1733,4861,1041,3400,211,776,187,566,398,1342
110007,201911,1322,3372,809,2524,267,890,207,761,474,1651
110008,201911,3217,9115,2330,7731,271,880,1543,5404,1814,6284
110009,201911,4186,11899,2648,9005,640,2266,999,3452,1639,5718
110010,201911,7127,23428,5215,19613,1159,4354,2483,10165,3642,14519
110011,201911,6496,17609,4422,13776,1614,5237,629,2059,2243,7296
110012,201911,14334,36331,8215,25274,2073,6713,796,2656,2869,9369
110013,201911,5206,15242,3746,12251,1575,5384,494,1772,2069,7156
110014,201911,3652,9845,2396,7426,642,2069,876,2688,1518,4757
110015,201911,5120,13496,2863,8940,709,2391,532,1536,1241,3927
110018,201911,3589,9146,2023,6344,416,1481,580,1760,996,3241
110020,201911,73128,177886,50630,146313,11356,33636,21010,65822,32366,99458
110025,201911,4865,11946,3099,8862,675,2086,1341,3811,2016,5897
110026,201911,493,1300,340,1073,91,302,144,469,235,771
110028,201911,6464,16694,3853,11877,1041,3458,577,1759,1618,5217
110029,201911,1406,3439,785,2357,182,558,299,942,481,1500
110030,201911,12597,29299,7628,21941,1669,5548,1703,5198,3372,10746
110032,201911,2931,8459,1841,6097,577,1910,412,1439,989,3349
110033,201911,3582,11404,2769,9844,1014,3678,679,2700,1693,6378
110034,201911,3380,8088,2151,6370,681,2200,769,2385,1450,4585
110037,201911,1594,4806,1199,4087,279,947,562,1965,841,2912
110040,201911,2957,8376,2069,6701,611,2125,599,1864,1210,3989
110045,201911,5016,14587,3735,12219,1010,3543,1343,4425,2353,7968
110050,201911,1750,4838,1212,3872,489,1678,235,768,724,2446
110060,201911,746,2237,507,1700,199,715,76,251,275,966
110070,201911,1644,5209,1219,4245,395,1479,243,758,638,2237
110080,201911,6119,14370,4416,12345,528,1368,3078,9079,3606,10447
110090,201911,539,1448,375,1157,87,297,166,491,253,788
110092,201911,1146,3398,821,2769,141,490,422,1513,563,2003
110094,201911,2764,8304,2047,6949,875,3162,325,1133,1200,4295
110100,201911,1675,5026,1338,4348,364,1234,583,1905,947,3139
110110,201911,1721,4825,1160,3814,384,1310,258,890,642,2200
110120,201911,1251,3724,912,3057,232,814,292,973,524,1787
110130,201911,2595,6654,1615,4876,348,1166,582,1741,930,2907
110140,201911,1993,5996,1344,4629,344,1219,347,1237,691,2456
110143,201911,1301,3562,865,2681,289,881,159,503,448,1384
110145,201911,821,2211,520,1664,129,424,176,585,305,1009
110146,201911,434,1161,301,961,60,187,142,484,202,671
110147,201911,756,1968,451,1345,69,224,174,447,243,671
110148,201911,782,2222,440,1507,106,397,53,185,159,582
110149,201911,3013,8330,2058,6790,748,2546,443,1573,1191,4119
110150,201911,2616,6448,1698,5149,531,1737,464,1647,995,3384
110155,201911,675,2026,490,1593,117,398,169,519,286,917
110160,201911,1438,4544,1031,3611,319,1125,242,887,561,2012
110170,201911,2191,5718,1318,3991,258,816,664,1942,922,2758
110175,201911,1650,4708,1138,3799,200,721,491,1723,691,2444
110180,201911,1337,3742,885,2822,155,503,441,1397,596,1900
120001,201911,3127,9338,2564,8486,418,1433,1630,5533,2048,6966
120005,201911,1958,7524,1766,7237,165,739,1374,5730,1539,6469
120010,201911,5262,15998,4408,14647,457,1473,3152,10798,3609,12271
120013,201911,2178,7840,1958,7559,458,1696,1179,4871,1637,6567
120017,201911,2465,8952,2188,8511,353,1383,1436,5911,1789,7294
120020,201911,14949,59177,13728,56759,1156,5439,10681,44435,11837,49874
120025,201911,3057,8853,2457,8102,405,1326,1670,5684,2075,7010
120030,201911,6545,25826,6086,24969,424,2335,4743,19484,5167,21819
120032,201911,1660,7514,1571,7337,104,682,1290,5918,1394,6600
120033,201911,4069,15118,3809,14650,133,745,3300,12578,3433,13323
120034,201911,2627,9592,2223,8856,114,702,1833,7135,1947,7837
120035,201911,3605,14629,3409,14264,302,1478,2734,11469,3036,12947
120038,201911,2717,8796,2328,8158,547,1991,1232,4404,1779,6395
120039,201911,2004,8730,1863,8416,147,887,1470,6589,1617,7476
120040,201911,43484,138715,37295,128328,5558,20153,23157,80675,28715,100828
120042,201911,3351,12633,3050,12028,147,802,2516,9843,2663,10645
120043,201911,1385,5632,1260,5430,41,243,1140,4932,1181,5175
120045,201911,6091,15973,5293,15075,125,517,4833,13607,4958,14124
120050,201911,9335,33709,8498,32399,426,2212,7021,26801,7447,29013
120060,201911,9646,37202,8843,35963,414,2430,7649,30901,8063,33331
120070,201911,3132,10175,2706,9575,254,920,1929,7098,2183,8018
120080,201911,4242,13954,3780,13220,492,1838,2695,9593,3187,11431
130002,201911,3069,12233,2743,11740,194,883,2316,10050,2510,10933
130006,201911,2399,9034,1965,8232,190,868,1457,6119,1647,6987
130008,201911,2617,9199,2317,8742,72,388,1984,7459,2056,7847
130010,201911,3963,11534,3304,10772,86,276,3029,9988,3115,10264
130014,201911,3041,9194,2335,8007,434,1520,1402,4924,1836,6444
130020,201911,2708,10718,2452,10312,150,876,1962,8203,2112,9079
130030,201911,9893,32446,8988,31362,290,1023,7982,28300,8272,29323
130040,201911,3817,11525,3168,10629,179,639,2605,8810,2784,9449
130050,201911,7631,27837,6372,26208,174,918,5780,23960,5954,24878
130060,201911,7563,30112,6476,28665,474,2696,5294,23306,5768,26002
130063,201911,6326,20721,5649,19964,218,980,5104,18106,5322,19086
130068,201911,3726,13430,3147,12498,242,1344,2330,9099,2572,10443
130070,201911,7529,21444,6173,19934,311,998,5144,17039,5455,18037
130080,201911,6851,25474,5998,24456,273,1549,5010,20788,5283,22337
130083,201911,2742,9084,2440,8707,178,746,2064,7365,2242,8111
130090,201911,3442,10728,3054,10228,63,285,2653,9059,2716,9344
130100,201911,7978,24034,6803,22801,60,145,6389,21977,6449,22122
130110,201911,8583,24579,7029,22626,1025,2685,5112,17689,6137,20374
130115,201911,5356,16759,4614,15903,106,376,4070,14269,4176,14645
130120,201911,14345,50833,12678,48634,1137,4825,10301,39835,11438,44660
130130,201911,5265,16975,4067,15393,394,1647,2997,11334,3391,12981
130140,201911,7124,25190,6371,24333,209,1166,5597,21432,5806,22598
130150,201911,3682,13757,3456,13493,84,533,3153,12334,3237,12867
130160,201911,5052,18137,4342,17231,282,1284,3673,14740,3955,16024
130165,201911,3252,12360,3059,12109,129,590,2746,10936,2875,11526
130170,201911,11847,34992,9417,32122,745,2932,7521,25821,8266,28753
130180,201911,4500,14451,4258,14176,41,231,4103,13620,4144,13851
130185,201911,18482,45766,15078,42108,980,1783,12772,37604,13752,39387
130190,201911,19052,63159,15330,57540,1831,7142,10737,41524,12568,48666
130195,201911,2463,8979,2014,8407,71,390,1784,7470,1855,7860
130200,201911,2581,7328,2135,6732,112,448,1758,5498,1870,5946
130210,201911,1287,4889,1152,4730,103,607,916,3656,1019,4263
130220,201911,2306,8094,1998,7680,65,340,1744,6726,1809,7066
130230,201911,4516,18889,3936,18045,259,1581,3344,15312,3603,16893
130240,201911,12062,36305,9760,33210,204,1189,8702,29533,8906,30722
130250,201911,26196,78945,22466,74704,1738,5376,18014,62175,19752,67551
130255,201911,4337,14650,3779,13656,172,787,3049,11020,3221,11807
130260,201911,262331,739220,213032,666105,58393,193918,97873,312994,156266,506912
130270,201911,8904,32551,7475,30268,1155,4711,5005,21049,6160,25760
130280,201911,3538,14267,3242,13936,102,520,2995,13039,3097,13559
130290,201911,13271,44964,11471,42624,701,2846,9668,36567,10369,39413
130300,201911,4737,16609,4292,15985,156,864,3710,13753,3866,14617
130310,201911,6123,20948,5353,19897,327,1492,4463,16573,4790,18065
130320,201911,3489,11274,2927,10562,366,1296,2160,8041,2526,9337
130330,201911,4648,14911,3749,13783,221,986,3193,11718,3414,12704
130340,201911,23428,74254,20147,70455,1511,4744,16748,60579,18259,65323
130350,201911,3935,14425,3547,13923,150,847,3110,12099,3260,12946
130353,201911,7293,20066,5853,18211,856,2573,4082,13183,4938,15756
130356,201911,5164,16725,4316,15369,749,2634,2664,9983,3413,12617
130360,201911,3044,9647,2620,9123,94,368,2368,8230,2462,8598
130370,201911,5737,22508,4993,21446,295,1637,4096,17480,4391,19117
130380,201911,7090,29616,6574,28869,394,2277,5546,24094,5940,26371
130390,201911,5953,25070,5235,23838,579,3072,3764,17143,4343,20215
130395,201911,2331,7435,1985,6862,199,724,1501,5163,1700,5887
130400,201911,2736,8655,2348,8143,98,338,2088,7355,2186,7693
130406,201911,11051,39105,9358,36958,1685,6687,6359,26012,8044,32699
130410,201911,4175,14955,3544,13865,1084,4429,1588,6429,2672,10858
130420,201911,13561,47866,11336,45115,951,4848,8869,35411,9820,40259
130423,201911,4269,13623,3741,13018,186,895,3274,11226,3460,12121
130426,201911,2828,11138,2644,10900,75,426,2432,10060,2507,10486
130430,201911,4199,11982,3643,11235,280,1019,2977,9038,3257,10057
130440,201911,4819,15162,4148,14361,116,487,3804,13260,3920,13747
140002,201911,2214,6578,1909,6193,95,372,1594,5177,1689,5549
140005,201911,3280,9094,2906,8664,143,380,2510,7647,2653,8027
140010,201911,54579,144342,42669,126479,11023,34282,17569,53346,28592,87628
140015,201911,3715,11292,3161,10611,211,707,2756,9385,2967,10092
140017,201911,4339,12317,3794,11626,272,815,3080,9674,3352,10489
140020,201911,5283,15616,4514,14566,255,1096,3658,11696,3913,12792
140023,201911,2446,7310,1997,6680,209,701,1485,5070,1694,5771
140028,201911,2075,5343,1751,4926,101,322,1401,3924,1502,4246
140030,201911,5242,13505,4629,12797,362,738,3966,11363,4328,12101
140040,201911,2508,9986,2292,9679,100,615,2045,8519,2145,9134
140045,201911,2571,9326,2152,8746,352,1247,1474,6429,1826,7676
140047,201911,6250,17894,5238,16412,633,1991,3713,11839,4346,13830
140050,201911,1421,4166,1182,3823,123,406,876,2890,999,3296
140060,201911,1661,4425,1397,4037,123,331,1090,3220,1213,3551
140070,201911,1917,9977,1849,9822,123,840,1536,8071,1659,8911
150010,201911,45624,113857,41262,108239,962,2402,36878,96458,37840,98860
150013,201911,1970,5056,1612,4667,149,311,1248,3838,1397,4149
150020,201911,14369,43320,13311,41918,1300,3346,11053,35848,12353,39194
150030,201911,8680,32774,7888,31791,433,1978,6831,27709,7264,29687
150034,201911,4234,10548,3478,9580,230,584,2892,8123,3122,8707
150040,201911,16568,42719,14489,40413,1297,2074,11951,36320,13248,38394
150050,201911,6981,24543,6383,23729,148,669,5811,21832,5959,22501
150060,201911,21748,59624,17532,53259,2883,9000,10999,34156,13882,43156
150070,201911,6671,25136,5842,24130,222,1131,5200,21696,5422,22827
150080,201911,94717,212062,78897,190463,18995,49974,23834,70224,42829,120198
150085,201911,7517,22009,6810,21155,142,498,6365,19860,6507,20358
150090,201911,9839,36801,9246,35617,660,2687,7455,28863,8115,31550
150095,201911,5597,16624,4897,15730,276,656,4102,13737,4378,14393
150100,201911,2894,10216,2553,9623,199,686,1990,7642,2189,8328
150110,201911,4418,18326,4135,17992,210,992,3757,16443,3967,17435
150120,201911,7941,25099,7566,24641,271,731,6743,22640,7014,23371
150125,201911,748,2033,548,1754,104,396,318,992,422,1388
150130,201911,22532,65549,19461,60914,3159,8916,13062,42890,16221,51806
150140,201911,244959,571914,206693,518355,31921,78007,120708,315469,152629,393476
150145,201911,4345,13285,3658,12254,917,2774,2044,7529,2961,10303
150150,201911,15991,41345,13960,38734,638,1904,11584,32139,12222,34043
150157,201911,3484,9587,2803,8693,299,966,1981,6383,2280,7349
150160,201911,3003,8995,2787,8663,564,1672,1708,5514,2272,7186
150170,201911,24573,80768,21326,75249,4023,13356,12990,48717,17013,62073
150172,201911,4752,13136,3808,11806,265,770,2888,9227,3153,9997
150175,201911,1605,5099,1344,4591,235,848,787,2704,1022,3552
150178,201911,10524,28639,8691,26482,232,632,7695,23793,7927,24425
150180,201911,22114,79114,20149,76795,1073,3776,17648,68703,18721,72479
150190,201911,6708,22750,6231,22123,295,1286,5424,19161,5719,20447
150195,201911,5206,16812,4943,16409,82,447,4585,15059,4667,15506
150200,201911,5818,17113,5323,16565,62,164,5032,15790,5094,15954
150210,201911,25658,90703,23933,88313,1774,6636,19765,74631,21539,81267
150215,201911,7602,21661,6471,19985,1224,3698,3764,12146,4988,15844
150220,201911,12143,34718,10630,32535,1104,3298,7318,22835,8422,26133
150230,201911,12445,35449,10803,33270,1195,3320,7439,23890,8634,27210
150240,201911,32202,89913,26411,79740,7532,23143,8916,27460,16448,50603
150250,201911,4175,16230,3924,15918,612,2441,2978,12388,3590,14829
150260,201911,2741,9053,2477,8635,176,604,1930,6815,2106,7419
150270,201911,8772,25271,6112,20606,2019,7111,1715,6129,3734,13240
150275,201911,6829,21952,6260,21143,232,921,5438,18269,5670,19190
150276,201911,2298,6175,1953,5761,257,692,1336,4332,1593,5024
150277,201911,5243,13800,4214,12602,327,886,3246,10327,3573,11213
150280,201911,6771,27456,6540,27055,497,2045,5477,22923,5974,24968
150285,201911,3310,11626,2903,10977,245,986,2099,8045,2344,9031
150290,201911,10596,28899,9589,27804,315,696,8658,25708,8973,26404
150293,201911,9491,23578,7063,20335,1055,3024,4231,12801,5286,15825
150295,201911,7963,21337,5672,18240,1944,6733,1890,6799,3834,13532
150300,201911,2371,7136,2119,6806,46,174,1918,6172,1964,6346
150304,201911,4104,12262,3342,11047,617,1930,2031,7015,2648,8945
150307,201911,6172,19869,5687,19068,357,1172,4635,15734,4992,16906
150309,201911,6226,18944,4974,16728,921,3048,2752,9653,3673,12701
150310,201911,7311,28887,6952,28445,223,1256,6162,25419,6385,26675
150320,201911,9485,25902,8639,24689,416,1292,6693,19041,7109,20333
150330,201911,14052,45430,12936,43617,1328,4186,9757,33853,11085,38039
150340,201911,2567,7493,2268,7046,346,1004,1561,4985,1907,5989
150345,201911,8058,23756,7265,22698,433,1438,6187,19406,6620,20844
150350,201911,9021,22948,8262,21955,747,1439,6765,18567,7512,20006
150360,201911,24190,67422,19294,61092,2042,5579,13469,45193,15511,50772
150370,201911,10607,32695,8716,30128,985,2953,6380,23532,7365,26485
150375,201911,3481,14199,3145,13695,255,1231,2617,11492,2872,12723
150380,201911,11150,28585,9150,25932,145,524,8042,22841,8187,23365
150390,201911,8050,32220,7222,30888,1127,4252,5056,22892,6183,27144
150400,201911,6430,23354,6156,22827,283,1114,5340,19870,5623,20984
150405,201911,9276,24560,8122,23155,494,1145,6528,19255,7022,20400
150410,201911,1928,6170,1625,5640,204,640,1062,3775,1266,4415
150420,201911,40937,114602,31184,99802,8897,29760,10486,38813,19383,68573
150430,201911,8449,24797,7706,23814,848,2015,6031,19462,6879,21477
150440,201911,5583,18161,5103,17453,749,2294,3603,12842,4352,15136
150442,201911,25687,62115,21100,56189,2335,6146,14490,39388,16825,45534
150445,201911,6351,19592,5578,18390,216,772,4766,15738,4982,16510
150450,201911,5052,21852,4706,21370,367,1868,4017,18209,4384,20077
150460,201911,8456,27758,7734,26832,256,1049,6602,23691,6858,24740
150470,201911,21685,56136,19298,53404,402,1057,18098,50180,18500,51237
150475,201911,4861,15488,4214,14493,173,665,3490,12130,3663,12795
150480,201911,13700,44581,12264,42413,2256,7146,8077,29793,10333,36939
150490,201911,8329,28952,7671,28126,266,1162,6821,25121,7087,26283
150495,201911,5241,18136,5019,17803,117,599,4570,16091,4687,16690
150497,201911,2937,9333,2351,8289,551,1975,1189,4505,1740,6480
150500,201911,3301,8511,2920,7956,248,595,2278,6240,2526,6835
150503,201911,4812,12578,3295,10538,1000,3391,1043,3818,2043,7209
150506,201911,10308,31012,8649,28744,1851,5407,5379,19743,7230,25150
150510,201911,9794,35853,8477,33356,1141,4312,5706,23490,6847,27802
150520,201911,7112,27530,6793,27123,236,1394,6098,24236,6334,25630
150530,201911,12455,42518,10781,40069,1570,4716,7691,30541,9261,35257
150540,201911,4990,13734,4243,12594,208,579,3554,10584,3762,11163
150543,201911,7303,19667,5936,17926,516,1604,4505,14170,5021,15774
150548,201911,10236,31961,9217,30585,306,1150,8093,26922,8399,28072
150549,201911,1995,5998,1713,5611,42,182,1479,4839,1521,5021
150550,201911,19774,58468,16497,53055,3943,12893,7359,25276,11302,38169
150553,201911,26198,77369,20611,67406,6396,21385,7114,25070,13510,46455
150555,201911,1898,5050,1458,4352,136,331,1013,3147,1149,3478
150560,201911,1828,5599,1612,5171,268,829,947,3164,1215,3993
150563,201911,2436,7524,2045,6829,449,1570,1115,3723,1564,5293
150565,201911,4340,13974,3824,13137,117,524,3130,10842,3247,11366
150570,201911,6237,20077,5841,19513,252,997,5079,16899,5331,17896
150580,201911,10447,41439,9136,39962,645,3244,7418,33510,8063,36754
150590,201911,8014,27769,6919,26433,198,1151,6234,23699,6432,24850
150600,201911,9697,32149,9008,31284,237,910,8288,28975,8525,29885
150610,201911,2861,8509,2556,8005,98,379,2131,6613,2229,6992
150611,201911,3198,9051,2820,8504,93,350,2482,7417,2575,7767
150613,201911,13598,37595,10173,31668,1883,6246,4994,15506,6877,21752
150616,201911,3386,9326,2432,7719,607,2006,1004,3151,1611,5157
150618,201911,6893,20104,5538,17975,526,1641,3560,12169,4086,13810
150619,201911,6305,17921,5223,16358,167,637,4365,13693,4532,14330
150620,201911,6624,21922,5683,20333,670,2300,3958,14568,4628,16868
150630,201911,6143,16774,5596,16080,439,1182,4605,13408,5044,14590
150635,201911,4670,12966,3898,11698,545,1581,2529,7797,3074,9378
150640,201911,2235,6554,2034,6313,32,95,1898,5980,1930,6075
150650,201911,11606,32414,10125,29966,3106,8670,4425,14292,7531,22962
150655,201911,5878,16726,5288,15858,211,642,4555,13641,4766,14283
150658,201911,4449,12628,3481,11148,552,1864,2103,7072,2655,8936
150660,201911,5749,16505,5104,15572,463,1338,3578,11177,4041,12515
150670,201911,8363,19529,6525,17439,662,1483,5104,14317,5766,15800
150680,201911,67750,199644,51341,173566,12502,41517,23244,87898,35746,129415
150690,201911,3030,8173,2627,7692,106,246,2334,7001,2440,7247
150700,201911,6193,18358,5532,17499,352,969,4385,14252,4737,15221
150710,201911,3797,12649,3446,12070,265,941,2633,9388,2898,10329
150715,201911,5016,14528,4125,13143,317,984,3229,10435,3546,11419
150720,201911,6889,24657,6393,23852,452,1854,5283,19841,5735,21695
150730,201911,11940,36593,10373,34316,1217,4190,7737,26188,8954,30378
150740,201911,3969,11175,3487,10405,306,786,2633,8005,2939,8791
150745,201911,5139,14618,4097,13058,826,2784,2626,8421,3452,11205
150746,201911,1632,5026,1483,4799,82,270,1215,3936,1297,4206
150747,201911,4828,15555,4241,14552,753,2299,2794,10059,3547,12358
150750,201911,3686,11578,3070,10613,225,822,2343,8311,2568,9133
150760,201911,12035,35365,10908,33849,1552,4398,7685,24590,9237,28988
150770,201911,6328,22849,5982,22440,200,649,5449,21037,5649,21686
150775,201911,914,2601,708,2309,130,467,380,1251,510,1718
150780,201911,4580,13707,4057,13085,136,399,3673,12093,3809,12492
150790,201911,5631,16146,4848,15297,214,526,3968,13690,4182,14216
150795,201911,13605,42779,11978,40167,3083,9766,6708,24001,9791,33767
150796,201911,3782,9379,3278,8773,182,450,2785,7556,2967,8006
150797,201911,4005,12479,3424,11606,141,393,2908,9999,3049,10392
150800,201911,13437,42133,12150,40453,1489,4628,9230,31724,10719,36352
150803,201911,7074,22861,6628,22166,358,1186,5639,19007,5997,20193
150805,201911,3493,10783,2937,9951,237,818,2260,7770,2497,8588
150808,201911,6112,17390,4393,14506,1712,6187,600,2230,2312,8417
150810,201911,20925,55282,15692,48895,3372,10786,7934,26978,11306,37764
150812,201911,5435,15392,4749,14217,439,1374,3474,10205,3913,11579
150815,201911,9420,28023,7891,26132,626,2081,6448,21678,7074,23759
150820,201911,12042,33016,10107,30581,1034,2657,7775,24553,8809,27210
150830,201911,11547,42898,10827,42000,418,1953,9399,37196,9817,39149
150835,201911,2353,7875,2015,7261,370,1314,1124,4105,1494,5419
150840,201911,7482,21396,5882,18725,992,3358,3219,10168,4211,13526
160005,201911,1173,3261,1040,3075,59,213,882,2605,941,2818
160010,201911,2443,6416,2293,6251,20,106,2227,6004,2247,6110
160015,201911,2666,7953,2398,7603,75,255,2190,6961,2265,7216
160020,201911,2045,6695,1800,6380,172,593,1419,5147,1591,5740
160021,201911,1081,4223,991,4107,66,384,802,3263,868,3647
160023,201911,1248,4452,1091,4183,111,384,771,3115,882,3499
160025,201911,1861,5540,1781,5444,11,39,1742,5336,1753,5375
160027,201911,8988,24958,8023,23740,638,1781,6468,19520,7106,21301
160030,201911,69272,198603,55599,180024,12107,37003,30219,107385,42326,144388
160040,201911,5654,19449,5098,18726,84,400,4745,17531,4829,17931
160050,201911,4852,14967,3788,13475,1448,4910,1327,5815,2775,10725
160053,201911,3718,11661,3394,11265,238,694,2822,9645,3060,10339
160055,201911,902,2657,870,2620,29,91,810,2437,839,2528
160060,201911,24312,65741,19765,60499,969,3142,15816,50360,16785,53502
160070,201911,2782,10511,2492,10046,210,830,1948,8113,2158,8943
160080,201911,3322,10675,2996,10298,39,202,2778,9621,2817,9823
170025,201911,620,1641,440,1371,79,250,228,720,307,970
170030,201911,1195,3641,901,3089,147,496,444,1557,591,2053
170035,201911,1466,3825,1046,3138,101,339,621,1876,722,2215
170040,201911,1868,5355,1459,4774,98,389,887,3012,985,3401
170070,201911,1810,4253,1268,3561,75,256,746,2146,821,2402
170100,201911,2455,7050,2005,6296,195,576,1280,4112,1475,4688
170105,201911,716,2099,473,1559,116,342,168,561,284,903
170110,201911,895,2776,675,2350,126,470,283,988,409,1458
170130,201911,1316,3960,920,3193,175,654,443,1565,618,2219
170190,201911,1345,3862,906,3122,315,1116,167,752,482,1868
170200,201911,1875,4595,1143,3347,218,664,384,1135,602,1799
170210,201911,24539,66894,18347,56414,6511,21740,2029,7312,8540,29052
170215,201911,1317,3533,1069,3203,45,183,841,2511,886,2694
170220,201911,5852,18301,4869,16472,1296,4184,2053,7535,3349,11719
170230,201911,1232,3708,902,3043,267,907,173,639,440,1546
170240,201911,2640,7427,1995,6379,147,569,1371,4259,1518,4828
170255,201911,4011,11665,2787,9356,505,1728,1247,4292,1752,6020
170270,201911,977,2353,630,1866,30,87,390,1146,420,1233
170290,201911,2905,8600,2458,8024,112,385,1943,6526,2055,6911
170300,201911,1961,5373,1572,4788,181,561,1045,3230,1226,3791
170305,201911,654,1808,521,1577,62,222,265,782,327,1004
170307,201911,931,3206,734,2798,102,425,407,1561,509,1986
170310,201911,1583,4000,1071,3144,170,541,495,1455,665,1996
170320,201911,1034,2675,765,2243,68,209,478,1417,546,1626
170330,201911,913,2806,822,2659,47,212,677,2141,724,2353
170360,201911,485,1319,331,1048,25,81,214,638,239,719
170370,201911,1279,3454,910,2834,299,903,216,793,515,1696
170380,201911,1756,5105,1280,4343,112,438,723,2540,835,2978
170382,201911,539,1620,432,1424,37,168,309,967,346,1135
170384,201911,1586,5701,1282,5090,258,1073,640,2578,898,3651
170386,201911,878,2433,532,1746,79,302,181,560,260,862
170388,201911,605,1730,417,1389,61,236,184,612,245,848
170389,201911,1017,3199,846,2908,43,169,635,2221,678,2390
170390,201911,1693,3923,1231,3350,59,145,992,2785,1051,2930
170410,201911,557,1649,394,1334,24,104,253,845,277,949
170460,201911,375,979,288,833,44,123,175,524,219,647
170510,201911,894,2637,636,2154,41,177,405,1326,446,1503
170550,201911,6543,17584,4673,14471,1225,4079,1084,3620,2309,7699
170555,201911,1347,3719,1029,3212,63,207,535,1723,598,1930
170560,201911,1029,2918,753,2518,68,266,471,1672,539,1938
170600,201911,1321,3552,1058,3157,219,514,602,1958,821,2472
170610,201911,1677,4488,1193,3745,75,264,745,2331,820,2595
170625,201911,419,1151,250,786,39,120,80,246,119,366
170650,201911,1256,3768,969,3273,152,527,522,1836,674,2363
170700,201911,3345,9873,2459,8187,506,1736,1080,3674,1586,5410
170710,201911,1540,4085,1147,3416,158,516,697,2071,855,2587
170720,201911,1774,4473,1379,3885,74,156,1001,2941,1075,3097
170730,201911,1014,2807,747,2365,145,421,353,1197,498,1618
170740,201911,2074,6924,1753,6298,191,742,1225,4379,1416,5121
170755,201911,895,2509,604,1972,52,207,297,929,349,1136
170765,201911,1194,3070,806,2451,160,488,351,1123,511,1611
170770,201911,1804,5275,1468,4738,174,541,961,3189,1135,3730
170820,201911,3340,10140,2673,8872,492,1727,1315,4447,1807,6174
170825,201911,943,2272,748,1996,79,218,534,1415,613,1633
170830,201911,1384,3746,1136,3356,58,175,871,2585,929,2760
170900,201911,2658,8560,2227,7917,185,684,1736,6265,1921,6949
170930,201911,3664,10200,2760,8475,637,2056,955,2925,1592,4981
170950,201911,11096,30839,7422,24031,2149,7839,904,3158,3053,10997
170980,201911,439,1190,348,1043,15,68,249,703,264,771
171050,201911,1588,5090,1371,4697,53,267,1137,3858,1190,4125
171070,201911,1347,3897,1138,3588,298,966,506,1804,804,2770
171090,201911,1041,2590,829,2278,79,218,558,1524,637,1742
171110,201911,567,1537,394,1215,61,203,184,509,245,712
171150,201911,1094,2740,632,1927,72,253,376,1125,448,1378
171180,201911,766,2125,494,1591,77,225,209,684,286,909
171190,201911,1745,5917,1484,5446,250,990,866,3279,1116,4269
171195,201911,805,2622,649,2326,90,384,393,1370,483,1754
171200,201911,529,1511,398,1273,74,250,182,580,256,830
171215,201911,358,1013,283,882,43,151,185,557,228,708
171240,201911,753,2518,609,2227,37,188,406,1460,443,1648
171245,201911,657,1990,498,1644,51,197,301,945,352,1142
171250,201911,1033,2703,732,2241,138,450,355,1093,493,1543
171270,201911,435,1594,332,1364,70,315,132,574,202,889
171280,201911,854,2611,657,2252,69,231,373,1334,442,1565
171320,201911,4012,11367,3077,9710,638,2015,1174,3880,1812,5895
171330,201911,2697,7394,2044,6258,391,1153,981,3113,1372,4266
171360,201911,1408,4091,1101,3637,81,307,798,2672,879,2979
171370,201911,667,1713,510,1485,51,142,343,1011,394,1153
171380,201911,1481,4357,1222,3975,106,319,870,2955,976,3274
171395,201911,951,2663,645,2069,64,241,380,1183,444,1424
171420,201911,1888,5658,1349,4561,231,865,606,2046,837,2911
171430,201911,1036,3088,844,2713,59,210,572,1784,631,1994
171488,201911,2315,6904,1783,5998,293,1013,907,3155,1200,4168
171500,201911,988,2472,743,2091,41,120,557,1564,598,1684
171510,201911,780,2603,674,2389,42,186,470,1654,512,1840
171515,201911,459,1206,319,966,28,108,192,550,220,658
171525,201911,674,1969,520,1706,32,144,307,953,339,1097
171550,201911,333,969,236,801,30,121,140,458,170,579
171570,201911,1105,3381,913,3033,135,456,529,1794,664,2250
171575,201911,1801,4801,1129,3566,138,462,495,1547,633,2009
171610,201911,5766,16201,4226,13503,913,3246,1184,4023,2097,7269
171620,201911,2648,7502,2210,6863,119,468,1758,5445,1877,5913
171630,201911,964,2605,764,2321,110,344,507,1574,617,1918
171650,201911,2068,5983,1554,5059,394,1388,474,1665,868,3053
171660,201911,2338,5967,1564,4652,241,678,809,2441,1050,3119
171665,201911,1305,3649,983,3119,164,596,468,1496,632,2092
171670,201911,1876,5043,1411,4272,213,714,775,2323,988,3037
171700,201911,1211,3483,873,2861,104,317,482,1610,586,1927
171720,201911,800,2064,612,1767,54,189,434,1220,488,1409
171750,201911,1265,3593,854,2837,219,753,106,449,325,1202
171780,201911,1234,3139,870,2610,84,275,590,1728,674,2003
171790,201911,1397,4663,1126,4088,224,822,510,1928,734,2750
171800,201911,735,2038,537,1729,70,277,302,962,372,1239
171820,201911,11048,31220,8033,25901,2004,6673,2529,8739,4533,15412
171830,201911,1493,4907,1242,4438,109,495,798,2820,907,3315
171840,201911,747,2001,585,1738,24,69,393,1167,417,1236
171845,201911,590,1518,424,1271,54,198,251,740,305,938
171850,201911,855,2917,720,2603,68,337,508,1766,576,2103
171855,201911,1023,3130,848,2803,74,254,523,1693,597,1947
171865,201911,375,1194,297,1053,55,214,143,474,198,688
171870,201911,799,2266,556,1804,67,234,284,928,351,1162
171875,201911,1263,3761,1002,3332,46,206,754,2485,800,2691
171880,201911,1157,3589,1010,3387,38,137,803,2734,841,2871
171884,201911,823,2337,595,1951,114,429,215,750,329,1179
171886,201911,1414,3940,984,3192,289,1044,191,623,480,1667
171888,201911,722,2042,491,1597,32,121,314,995,346,1116
171889,201911,397,1225,317,1071,76,283,126,419,202,702
171890,201911,1148,3193,838,2692,182,551,454,1511,636,2062
171900,201911,527,1832,363,1406,77,292,145,583,222,875
172000,201911,559,1699,460,1506,44,157,264,843,308,1000
172010,201911,1046,3656,876,3291,78,334,521,1904,599,2238
172015,201911,372,1313,271,1097,70,293,108,452,178,745
172020,201911,2555,7454,2252,7046,159,576,1688,5398,1847,5974
172025,201911,726,2011,523,1669,38,143,361,1148,399,1291
172030,201911,1233,3664,1039,3356,47,185,811,2609,858,2794
172049,201911,1289,3142,850,2513,171,480,462,1464,633,1944
172065,201911,1456,3617,1115,3196,105,223,890,2720,995,2943
172080,201911,2323,6880,1862,6058,105,405,1233,3977,1338,4382
172085,201911,462,1260,299,908,55,159,108,313,163,472
172090,201911,3978,10124,3016,8853,124,414,2284,6726,2408,7140
172093,201911,469,1393,329,1144,25,113,181,601,206,714
172097,201911,627,1662,436,1332,55,170,212,657,267,827
172100,201911,48590,120899,32686,94977,6147,19785,11215,33374,17362,53159
172110,201911,1599,5819,1367,5439,144,585,983,4126,1127,4711
172120,201911,4920,14597,3825,12810,509,1781,2154,7454,2663,9235
172125,201911,308,847,230,719,22,69,120,366,142,435
172130,201911,641,1592,506,1375,25,89,354,892,379,981
172208,201911,2485,6208,1985,5546,183,461,1419,4051,1602,4512
172210,201911,2691,6932,2025,6070,365,1172,1112,3444,1477,4616
210005,201911,19071,55059,14504,47412,4283,14550,5472,18740,9755,33290
210010,201911,1943,6001,1750,5746,71,314,1507,4961,1578,5275
210015,201911,3325,9952,2952,9462,108,314,2576,8349,2684,8663
210020,201911,7451,17340,6384,16097,83,246,5922,14961,6005,15207
210030,201911,4810,15892,4451,15358,208,936,3827,13161,4035,14097
210040,201911,1816,4374,1636,4155,27,47,1530,3926,1557,3973
210043,201911,6303,17904,5245,16481,490,1480,3909,12603,4399,14083
210047,201911,6724,20962,5451,19222,151,758,4696,16521,4847,17279
210050,201911,2242,7618,1744,6686,169,744,1211,4621,1380,5365
210055,201911,1868,6027,1684,5736,69,287,1425,4842,1494,5129
210060,201911,7124,26375,6317,24895,739,3074,4429,17892,5168,20966
210070,201911,7182,20442,6729,19848,41,172,6404,18894,6445,19066
210080,201911,4115,14181,3910,13937,40,241,3678,13183,3718,13424
210083,201911,5663,16058,4630,14957,46,240,4382,14149,4428,14389
210087,201911,3052,8334,2643,7803,110,261,2273,6882,2383,7143
210090,201911,9381,29412,8703,28208,524,1445,7361,24106,7885,25551
210095,201911,6309,20544,5809,19939,205,911,4962,17425,5167,18336
210100,201911,6822,20802,6100,19660,316,1097,4972,16088,5288,17185
210110,201911,3015,10153,2778,9861,63,383,2538,8924,2601,9307
210120,201911,22977,63834,19018,58580,2059,5393,12818,41884,14877,47277
210125,201911,4367,11782,3816,11115,787,1807,2706,8475,3493,10282
210130,201911,4390,11596,3604,10596,168,385,3056,9084,3224,9469
210135,201911,1469,4446,1264,4114,65,204,1015,3354,1080,3558
210140,201911,18199,48730,13905,43111,2667,8062,7816,25455,10483,33517
210150,201911,4404,10631,3873,9893,131,358,3366,8482,3497,8840
210160,201911,16539,48800,14304,45895,1313,4439,10135,33583,11448,38022
210170,201911,15061,47218,14006,45839,744,2294,12290,40437,13034,42731
210173,201911,2290,8703,2100,8352,66,412,1862,7403,1928,7815
210177,201911,3448,9418,3016,8899,114,201,2700,8253,2814,8454
210180,201911,1434,3909,1262,3689,26,81,1149,3348,1175,3429
210190,201911,5226,14538,4466,13440,78,382,3837,11329,3915,11711
210193,201911,1273,3761,1126,3532,36,147,889,2836,925,2983
210197,201911,2057,6534,1889,6294,150,520,1541,5208,1691,5728
210200,201911,7542,24524,6738,23173,470,1753,5386,18553,5856,20306
210203,201911,6969,20779,5999,19475,435,1462,4874,16078,5309,17540
210207,201911,3705,9480,2969,8662,138,325,2473,7404,2611,7729
210210,201911,8184,26547,7513,25627,129,788,6810,23095,6939,23883
210215,201911,2332,7550,2041,7125,50,263,1820,6351,1870,6614
210220,201911,6203,21350,5866,20830,191,1223,5129,17790,5320,19013
210230,201911,5240,15880,4701,15075,395,1024,3920,12873,4315,13897
210232,201911,11419,35888,9336,32751,1566,5513,5800,21721,7366,27234
210235,201911,3389,10125,2936,9517,70,314,2602,8448,2672,8762
210237,201911,2699,9041,2353,8625,33,200,2179,7985,2212,8185
210240,201911,2616,8279,2394,7889,86,350,2066,6724,2152,7074
210250,201911,5607,17154,5102,16518,72,412,4581,14811,4653,15223
210255,201911,2474,7660,2080,6925,300,1009,1302,4298,1602,5307
210260,201911,5509,16509,4834,15512,227,841,4156,13293,4383,14134
210270,201911,4777,13330,4261,12672,108,495,3783,11160,3891,11655
210275,201911,3592,9038,3160,8508,52,116,2888,7866,2940,7982
210280,201911,5524,15916,4402,14137,271,1118,3163,9989,3434,11107
210290,201911,7200,19588,6442,18631,132,404,5907,17092,6039,17496
210300,201911,33114,90046,27011,81431,1824,5777,19798,61553,21622,67330
210310,201911,3078,7938,2693,7368,128,295,2339,6441,2467,6736
210312,201911,2698,6983,2367,6610,41,176,2187,6032,2228,6208
210315,201911,2950,8294,2496,7777,62,168,2280,7244,2342,7412
210317,201911,4130,13111,3735,12645,113,610,3343,11228,3456,11838
210320,201911,19032,58023,17307,55748,439,2173,15291,48862,15730,51035
210325,201911,3533,10195,3052,9572,81,259,2731,8703,2812,8962
210330,201911,24409,69628,19946,63678,6135,17803,9292,34396,15427,52199
210340,201911,10064,29893,8952,28341,722,2284,6852,22257,7574,24541
210350,201911,9365,27051,8160,25555,160,571,7223,22747,7383,23318
210355,201911,4274,14472,3743,13640,103,522,3196,11718,3299,12240
210360,201911,13437,42309,11984,40147,601,2737,9270,30569,9871,33306
210370,201911,10797,24357,8373,21782,249,448,7647,20357,7896,20805
210375,201911,3333,8841,2475,7693,656,2062,1138,3889,1794,5951
210380,201911,5542,14281,4767,13353,229,562,4073,11491,4302,12053
210390,201911,2573,9176,2371,8818,134,634,1966,7275,2100,7909
210400,201911,4505,13856,3968,13181,146,475,3524,11861,3670,12336
210405,201911,7026,18988,5610,16938,1075,3034,3131,10074,4206,13108
210407,201911,1969,6556,1633,5928,87,387,1311,4692,1398,5079
210408,201911,2495,9407,2326,9143,145,713,1883,7410,2028,8123
210409,201911,3796,13153,3450,12661,107,617,2863,10525,2970,11142
210410,201911,3413,10466,2871,9574,154,614,2170,7180,2324,7794
210420,201911,3909,12456,3511,11775,205,596,2944,10003,3149,10599
210430,201911,2262,6637,2026,6342,79,224,1791,5653,1870,5877
210440,201911,4332,11820,3808,11139,72,271,3504,10182,3576,10453
210450,201911,2436,7227,2094,6705,92,308,1721,5496,1813,5804
210455,201911,4277,11313,3203,9942,941,2943,1506,4911,2447,7854
210460,201911,3670,10558,3121,9845,80,343,2735,8563,2815,8906
210462,201911,1600,4942,1365,4548,36,155,1111,3702,1147,3857
210465,201911,2641,7757,2296,7273,56,233,1995,6313,2051,6546
210467,201911,5793,18826,5121,17948,308,1254,4265,15068,4573,16322
210470,201911,2088,5436,1424,4486,80,187,1086,3555,1166,3742
210480,201911,16321,48034,13457,44493,1196,3582,9883,35036,11079,38618
210490,201911,3716,9404,2984,8371,66,199,2588,7277,2654,7476
210500,201911,6229,24243,5742,23373,373,1835,4697,18988,5070,20823
210510,201911,6022,19923,5281,19107,124,547,4711,17321,4835,17868
210515,201911,3716,10927,3238,10392,107,384,2829,9183,2936,9567
210520,201911,2562,7349,2283,6993,80,281,2003,6090,2083,6371
210530,201911,53238,129143,41017,111026,6667,22589,11179,38610,17846,61199
210535,201911,3085,10507,2865,10164,115,452,2412,8643,2527,9095
210540,201911,14625,42459,12146,38985,1416,4256,8559,28613,9975,32869
210542,201911,6510,15237,5237,13834,315,533,4353,12248,4668,12781
210545,201911,2212,6927,2081,6708,46,196,1832,5824,1878,6020
210547,201911,3519,12765,3082,11885,319,1217,2220,8813,2539,10030
210550,201911,6250,18798,4926,16737,338,1334,3627,12591,3965,13925
210560,201911,3538,10841,3153,10219,125,408,2630,8482,2755,8890
210565,201911,1465,4865,1214,4484,63,341,953,3538,1016,3879
210570,201911,10613,28976,9383,27481,304,886,8314,24722,8618,25608
210580,201911,2969,7996,2490,7420,161,316,2002,6276,2163,6592
210590,201911,4308,12909,3730,12157,75,404,3308,10739,3383,11143
210592,201911,2587,7692,2384,7352,26,128,2130,6503,2156,6631
210594,201911,2514,6798,1913,5857,91,256,1416,4487,1507,4743
210596,201911,2512,8990,2245,8448,119,512,1795,6800,1914,7312
210598,201911,1840,5385,1685,5150,36,157,1513,4577,1549,4734
210600,201911,3077,8192,2453,7298,88,212,1987,6038,2075,6250
210610,201911,2652,7563,2290,7118,60,295,1958,6044,2018,6339
210620,201911,2699,7392,2248,6848,52,144,2046,6355,2098,6499
210630,201911,3052,10287,2775,9840,120,611,2293,8007,2413,8618
210632,201911,4404,14324,3904,13590,232,1028,3076,10603,3308,11631
210635,201911,1767,6267,1654,6069,123,435,1352,5070,1475,5505
210637,201911,2370,7929,2066,7477,159,692,1545,5653,1704,6345
210640,201911,4641,16636,4389,16333,62,313,4136,15380,4198,15693
210650,201911,7416,21188,6724,20286,59,289,6246,18870,6305,19159
210660,201911,8206,24338,7227,22759,268,1057,6243,19409,6511,20466
210663,201911,2572,7576,2368,7335,129,326,2035,6468,2164,6794
210667,201911,1888,6216,1750,6015,42,170,1584,5497,1626,5667
210670,201911,4451,15222,4060,14610,128,638,3517,12572,3645,13210
210675,201911,5070,13802,4332,12822,206,503,3647,11022,3853,11525
210680,201911,4309,10869,3621,10019,117,207,3244,9177,3361,9384
210690,201911,7711,23779,6567,22493,250,1136,5769,19836,6019,20972
210700,201911,2689,7460,2147,6722,141,414,1625,5291,1766,5705
210710,201911,4964,15577,4342,14684,113,611,3796,12707,3909,13318
210720,201911,2892,9563,2621,9226,58,345,2356,8220,2414,8565
210725,201911,1329,4491,1136,4182,44,186,817,3127,861,3313
210730,201911,1187,3170,990,2892,54,146,818,2397,872,2543
210735,201911,4650,13769,3945,12813,195,624,3362,11158,3557,11782
210740,201911,5177,14031,4513,13284,108,377,3769,11056,3877,11433
210745,201911,4418,12072,4067,11605,122,350,3701,10557,3823,10907
210750,201911,22853,58384,19793,54550,1575,4110,13975,40502,15550,44612
210760,201911,5955,15788,5063,14832,31,74,4818,14234,4849,14308
210770,201911,6145,15877,5285,14887,54,236,4962,13903,5016,14139
210780,201911,7229,23164,6351,21681,556,1737,4949,17243,5505,18980
210790,201911,4392,13735,3942,13129,216,584,3156,11136,3372,11720
210800,201911,4917,13045,4187,12068,61,238,3794,10814,3855,11052
210805,201911,3926,14414,3752,14156,112,637,3336,12468,3448,13105
210810,201911,4913,14289,4465,13711,250,541,3788,11987,4038,12528
210820,201911,6942,19796,5777,17914,693,2233,3490,11137,4183,13370
210825,201911,6751,20937,6106,20085,249,851,5287,17600,5536,18451
210830,201911,7732,21884,7076,21063,406,910,6082,18614,6488,19524
210840,201911,3230,8599,2865,8091,60,214,2547,7071,2607,7285
210845,201911,6518,17714,5855,16984,21,80,5669,16490,5690,16570
210850,201911,5899,20186,4956,18745,257,1273,3877,14705,4134,15978
210860,201911,20912,54290,17385,49838,765,1946,14061,42286,14826,44232
210870,201911,7211,19016,5764,17350,208,602,5030,15230,5238,15832
210880,201911,4322,13295,3896,12795,189,715,3222,10603,3411,11318
210890,201911,3949,11669,3534,11178,235,613,2893,9452,3128,10065
210900,201911,4454,13096,3371,11070,1355,4755,537,1976,1892,6731
210905,201911,1972,5492,1644,5057,43,74,1504,4732,1547,4806
210910,201911,7242,21905,6033,19963,865,2909,3886,12991,4751,15900
210920,201911,3261,10711,2820,10116,78,453,2517,8931,2595,9384
210923,201911,1442,4451,1246,4120,59,216,939,3116,998,3332
210927,201911,5285,16625,4624,15852,202,724,3905,13629,4107,14353
210930,201911,2480,8560,2174,7968,176,729,1627,5926,1803,6655
210940,201911,4046,11452,3765,11115,115,463,3437,10023,3552,10486
210945,201911,6262,18299,5626,17538,238,710,4777,15190,5015,15900
210950,201911,5142,14549,3942,12849,601,1568,2603,9178,3204,10746
210955,201911,1552,4955,1333,4568,135,475,941,3279,1076,3754
210960,201911,8966,26884,7706,24982,1283,3842,4888,16642,6171,20484
210970,201911,1303,4010,1033,3545,58,235,805,2697,863,2932
210975,201911,1680,5351,1499,5059,77,280,1197,4040,1274,4320
210980,201911,10058,23173,8735,21805,95,211,8244,20685,8339,20896
210990,201911,15738,45010,12416,40595,729,2658,9400,31220,10129,33878
211000,201911,14476,42711,12095,39855,649,2380,9802,33262,10451,35642
211003,201911,5593,16818,4686,15717,132,529,4054,13881,4186,14410
211010,201911,6466,23378,5836,22590,93,492,5282,20736,5375,21228
211020,201911,8156,23971,7137,22779,224,935,6067,19730,6291,20665
211023,201911,1968,6493,1858,6346,89,364,1574,5326,1663,5690
211027,201911,2964,9640,2832,9423,157,503,2475,8200,2632,8703
211030,201911,3931,10886,3495,10351,246,563,2841,8671,3087,9234
211040,201911,4550,16525,4220,15936,120,722,3748,14024,3868,14746
211050,201911,9185,23800,8314,22680,121,371,7663,20895,7784,21266
211060,201911,6943,21081,6349,20288,128,530,5840,18646,5968,19176
211065,201911,2137,6042,1767,5564,79,245,1467,4727,1546,4972
211070,201911,7439,24033,6361,22364,504,1788,4972,17676,5476,19464
211080,201911,1267,3554,1003,3136,35,188,767,2253,802,2441
211085,201911,2005,5765,1713,5366,75,177,1498,4819,1573,4996
211090,201911,3170,8795,2845,8387,42,197,2623,7678,2665,7875
211100,201911,6746,17168,6220,16520,44,137,5720,15264,5764,15401
211102,201911,2965,10346,2728,9995,127,616,2373,8591,2500,9207
211105,201911,2342,7502,1943,6747,174,621,1388,4793,1562,5414
211107,201911,4563,14530,3882,13505,141,633,3178,11290,3319,11923
211110,201911,5900,16300,4541,14207,386,1144,3312,10571,3698,11715
211120,201911,43692,108436,36872,100544,4928,12428,23714,69063,28642,81491
211125,201911,2086,6161,1747,5642,39,160,1471,4759,1510,4919
211130,201911,194753,464522,170933,433578,24791,62064,75958,220052,100749,282116
211140,201911,4947,14778,4330,13948,211,636,3670,11887,3881,12523
211150,201911,9321,25573,7893,23696,342,989,6634,20034,6976,21023
211153,201911,2499,7316,1996,6697,282,1010,1307,4595,1589,5605
211157,201911,1072,3434,889,3104,32,170,655,2256,687,2426
211160,201911,4007,11530,3170,10285,160,614,2352,7511,2512,8125
211163,201911,1673,5281,1530,5078,24,122,1375,4620,1399,4742
211167,201911,1537,4913,1438,4751,30,139,1322,4333,1352,4472
211170,201911,6432,15850,5992,15341,44,149,5710,14549,5754,14698
211172,201911,2434,6690,2076,6149,101,313,1697,4879,1798,5192
211174,201911,2850,8287,2587,7986,47,244,2387,7327,2434,7571
211176,201911,4248,12182,3269,10730,159,668,2596,8487,2755,9155
211178,201911,4663,10894,3975,10140,36,156,3762,9509,3798,9665
211180,201911,3957,13171,3666,12732,205,780,3119,10847,3324,11627
211190,201911,3029,9031,2576,8340,33,193,2248,7208,2281,7401
211195,201911,1335,3856,1141,3561,45,114,972,3097,1017,3211
211200,201911,2089,6011,1665,5448,210,671,1160,3875,1370,4546
211210,201911,6359,19411,5750,18599,260,1050,4957,15912,5217,16962
211220,201911,36324,92223,29571,83883,2808,7580,21810,63451,24618,71031
211223,201911,5107,13575,4282,12466,394,1154,3193,9331,3587,10485
211227,201911,1748,5841,1575,5591,34,161,1405,5059,1439,5220
211230,201911,7384,21765,6464,20339,407,1127,5188,16636,5595,17763
211240,201911,8170,26035,7709,25431,149,799,7121,23221,7270,24020
211245,201911,6895,17533,6211,16821,75,202,6011,16299,6086,16501
211250,201911,13196,40992,11894,39296,593,2450,9864,32232,10457,34682
211260,201911,7874,25722,7086,24645,203,921,6384,22271,6587,23192
211270,201911,10485,33480,8989,31417,389,1771,7338,25739,7727,27510
211280,201911,12731,35387,11265,33552,963,2328,8963,27865,9926,30193
211285,201911,1750,5845,1527,5519,163,655,1027,3815,1190,4470
211290,201911,7427,22486,6719,21512,176,753,5811,18493,5987,19246
211300,201911,7922,22464,7035,21226,170,592,6230,18682,6400,19274
211400,201911,11360,32664,9242,29692,1067,3416,6232,20981,7299,24397
220005,201911,1832,4872,1649,4607,39,155,1386,3790,1425,3945
220010,201911,1481,4239,1218,3769,31,123,930,2854,961,2977
220020,201911,3472,9882,3008,9192,161,588,2430,7322,2591,7910
220025,201911,2236,5113,1895,4594,23,62,1580,3703,1603,3765
220027,201911,1247,3200,1074,2973,18,59,912,2469,930,2528
220030,201911,3280,8395,3061,8094,82,250,2699,7030,2781,7280
220040,201911,7031,21383,6148,19671,1410,4172,3319,11131,4729,15303
220045,201911,1468,4520,1204,4059,37,192,964,3189,1001,3381
220050,201911,4662,12840,3954,11868,75,372,3594,10615,3669,10987
220060,201911,2409,5070,2028,4632,26,68,1911,4338,1937,4406
220070,201911,2499,6321,2127,5783,75,163,1752,4771,1827,4934
220080,201911,699,1990,596,1840,27,111,513,1546,540,1657
220090,201911,1787,4310,1475,3875,21,70,1215,3309,1236,3379
220095,201911,636,1628,603,1593,23,35,547,1457,570,1492
220100,201911,1367,3767,1091,3318,50,179,868,2567,918,2746
220105,201911,1983,6203,1723,5678,137,482,1281,4222,1418,4704
220110,201911,3413,9433,3173,9000,44,216,2829,7902,2873,8118
220115,201911,2673,7820,2458,7511,66,257,2234,6744,2300,7001
220117,201911,1358,3288,1041,2841,15,67,869,2317,884,2384
220120,201911,12695,34355,11556,32885,90,321,10878,30890,10968,31211
220130,201911,1094,2973,919,2732,16,85,823,2411,839,2496
220140,201911,2037,4315,1729,3943,117,309,1492,3328,1609,3637
220150,201911,6344,18951,5845,18124,131,653,4919,14911,5050,15564
220155,201911,1126,3279,892,2841,28,106,635,1983,663,2089
220157,201911,1042,2574,883,2329,21,85,715,1816,736,1901
220160,201911,2773,7788,2385,7093,33,166,1985,5787,2018,5953
220170,201911,1551,4085,1294,3702,13,67,1167,3291,1180,3358
220173,201911,2094,5863,1610,4975,39,178,1328,3966,1367,4144
220177,201911,1983,5645,1879,5525,11,39,1847,5436,1858,5475
220180,201911,1112,2759,896,2384,3,15,696,1730,699,1745
220190,201911,6655,17037,5549,15492,364,1133,4192,11713,4556,12846
220191,201911,1448,4503,1316,4270,68,266,973,3051,1041,3317
220192,201911,1857,5014,1432,4250,31,112,1175,3418,1206,3530
220194,201911,1683,4857,1490,4526,56,214,1220,3637,1276,3851
220196,201911,1961,5145,1766,4840,27,122,1507,4043,1534,4165
220198,201911,1287,3554,1073,3279,8,34,987,3042,995,3076
220200,201911,5122,14749,4415,13819,138,539,3718,11623,3856,12162
220202,201911,2159,6079,1844,5561,31,160,1580,4675,1611,4835
220205,201911,2512,7162,2232,6674,51,221,1884,5522,1935,5743
220207,201911,772,2322,631,2079,64,226,397,1311,461,1537
220208,201911,1650,5145,1343,4528,161,593,787,2592,948,3185
220209,201911,1582,4503,1363,4131,28,126,1101,3290,1129,3416
220210,201911,1648,4133,1397,3734,21,81,1182,3099,1203,3180
220211,201911,1571,4078,1447,3905,19,72,1261,3426,1280,3498
220213,201911,1753,4706,1497,4232,31,117,1218,3339,1249,3456
220217,201911,2082,6305,1965,6180,32,91,1837,5846,1869,5937
220220,201911,10334,27090,8453,24153,509,1318,5869,17421,6378,18739
220225,201911,1045,2734,841,2475,8,43,772,2240,780,2283
220230,201911,5760,14228,4908,13049,168,416,4220,11243,4388,11659
220240,201911,2889,8507,2632,8045,109,362,2129,6511,2238,6873
220245,201911,1673,4039,1287,3552,10,53,1173,3254,1183,3307
220250,201911,3010,8387,2634,7904,19,106,2447,7301,2466,7407
220253,201911,1612,4397,1390,4013,68,237,1155,3222,1223,3459
220255,201911,1860,4507,1556,4057,39,178,1307,3262,1346,3440
220260,201911,4187,12994,3671,12057,167,643,2952,9649,3119,10292
220265,201911,1267,4098,1138,3912,36,174,929,3124,965,3298
220270,201911,6308,19868,5887,19091,222,1040,4909,15371,5131,16411
220271,201911,1464,3757,1266,3483,29,108,1116,3060,1145,3168
220272,201911,1766,5066,1562,4690,69,215,1158,3383,1227,3598
220273,201911,1215,3484,1004,3091,42,170,768,2310,810,2480
220275,201911,2281,5482,1757,4746,31,105,1542,4171,1573,4276
220277,201911,2131,5399,1818,4918,28,90,1544,4082,1572,4172
220280,201911,1626,3851,1336,3456,30,110,1144,2908,1174,3018
220285,201911,1439,3656,1207,3378,14,61,1096,3031,1110,3092
220290,201911,6224,17940,4881,16026,346,1269,3572,11920,3918,13189
220300,201911,1971,5714,1581,5191,40,246,1304,4214,1344,4460
220310,201911,3059,8204,2349,7366,41,200,1962,6113,2003,6313
220320,201911,3002,8890,2298,7541,97,440,1768,5619,1865,6059
220323,201911,1613,4755,1272,4192,58,236,1044,3385,1102,3621
220325,201911,1263,3723,1069,3395,25,125,876,2730,901,2855
220327,201911,1488,4246,1293,3922,55,230,1064,3130,1119,3360
220330,201911,4336,10491,3590,9573,64,199,3216,8493,3280,8692
220335,201911,1705,5103,1516,4868,28,104,1365,4376,1393,4480
220340,201911,1843,4849,1411,4123,56,191,973,2736,1029,2927
220342,201911,1137,3359,1001,3152,43,204,790,2438,833,2642
220345,201911,3127,7039,2413,6015,15,54,2184,5410,2199,5464
220350,201911,3335,8563,2656,7530,136,413,1881,5318,2017,5731
220360,201911,1226,3138,960,2700,17,57,773,2149,790,2206
220370,201911,8703,25102,7852,23735,175,764,6865,20432,7040,21196
220375,201911,1594,4542,1411,4319,7,26,1336,4115,1343,4141
220380,201911,1506,3586,1198,3133,14,43,1051,2703,1065,2746
220385,201911,835,1991,661,1676,9,28,574,1439,583,1467
220390,201911,9718,25611,7382,21901,1910,5547,2850,9264,4760,14811
220400,201911,1484,3541,1120,2990,23,66,865,2250,888,2316
220410,201911,1160,3191,919,2772,52,155,745,2204,797,2359
220415,201911,804,2069,671,1850,19,56,536,1456,555,1512
220420,201911,1973,5439,1571,4674,48,136,1228,3607,1276,3743
220430,201911,2488,6735,2340,6520,83,272,1994,5483,2077,5755
220435,201911,1727,4469,1477,4102,39,140,1214,3297,1253,3437
220440,201911,2386,7508,2049,6964,111,467,1692,5633,1803,6100
220450,201911,2467,6423,1999,5834,71,252,1680,4913,1751,5165
220455,201911,1322,4048,1250,3952,18,87,1107,3486,1125,3573
220460,201911,963,2366,890,2276,35,87,767,1942,802,2029
220465,201911,2337,7257,2051,6804,179,606,1515,5108,1694,5714
220470,201911,3449,9594,3064,8982,84,234,2481,7179,2565,7413
220480,201911,2633,6884,2094,5995,166,417,1436,4104,1602,4521
220490,201911,2450,6200,2110,5753,28,139,1854,4966,1882,5105
220500,201911,2624,6898,2352,6462,47,179,1957,5186,2004,5365
220510,201911,2538,7199,1979,6190,86,265,1552,4869,1638,5134
220515,201911,1633,3954,1483,3741,33,59,1301,3270,1334,3329
220520,201911,4903,12736,4399,12015,101,291,3841,10420,3942,10711
220525,201911,1309,3293,1122,3055,10,49,1029,2760,1039,2809
220527,201911,1329,3707,1130,3414,14,55,967,2974,981,3029
220530,201911,1423,3542,1212,3269,32,102,1116,2967,1148,3069
220535,201911,803,2254,747,2180,41,143,599,1720,640,1863
220540,201911,3219,10304,3028,9945,119,436,2562,8362,2681,8798
220545,201911,1377,4216,1268,4035,68,270,1044,3275,1112,3545
220550,201911,8521,26092,7541,24439,498,1748,5674,18227,6172,19975
220551,201911,1397,4005,1211,3677,27,119,993,2951,1020,3070
220552,201911,1580,4578,1282,4041,36,180,1015,3074,1051,3254
220553,201911,1680,4437,1399,4050,56,132,1123,3346,1179,3478
220554,201911,868,2326,627,1910,49,118,405,1231,454,1349
220555,201911,2226,6718,2009,6407,44,210,1643,5333,1687,5543
220556,201911,1202,3508,1031,3160,62,252,721,2098,783,2350
220557,201911,1608,4912,1349,4390,65,249,984,3110,1049,3359
220558,201911,1388,3600,1070,3151,21,84,923,2690,944,2774
220559,201911,1667,4264,1405,3852,7,24,1132,3134,1139,3158
220560,201911,1758,3956,1405,3500,36,70,1270,3183,1306,3253
220570,201911,7211,21521,6534,20561,457,1476,5149,16260,5606,17736
220580,201911,6969,19159,6370,18181,88,314,5758,16297,5846,16611
220585,201911,1979,6285,1676,5733,46,157,1370,4728,1416,4885
220590,201911,1316,3609,1074,3236,80,240,772,2320,852,2560
220595,201911,2499,6828,2251,6491,23,105,2018,5763,2041,5868
220600,201911,1384,3087,1152,2789,95,127,956,2392,1051,2519
220605,201911,1631,4736,1373,4274,21,125,1105,3335,1126,3460
220610,201911,2725,8064,2557,7829,28,123,2379,7270,2407,7393
220620,201911,7929,24510,7261,23603,197,1026,6558,21013,6755,22039
220630,201911,359,1072,271,905,25,85,174,588,199,673
220635,201911,1603,5114,1416,4703,52,253,1061,3419,1113,3672
220640,201911,2518,6916,2133,6348,81,315,1717,5035,1798,5350
220650,201911,2055,5637,1741,5139,34,122,1412,4147,1446,4269
220660,201911,2655,8262,2257,7577,94,473,1846,6024,1940,6497
220665,201911,1242,3765,1042,3432,36,192,849,2720,885,2912
220667,201911,1585,4977,1411,4646,63,261,1138,3708,1201,3969
220669,201911,1664,5053,1588,4935,62,286,1372,4159,1434,4445
220670,201911,2196,5753,1734,5092,21,90,1496,4374,1517,4464
220672,201911,3204,7881,2570,7119,116,370,2234,6128,2350,6498
220675,201911,1216,3339,1093,3112,39,119,899,2537,938,2656
220680,201911,2663,7316,2530,7119,98,234,2309,6529,2407,6763
220690,201911,1510,4031,1333,3762,83,245,1045,2939,1128,3184
220695,201911,865,2423,802,2301,22,69,692,1978,714,2047
220700,201911,9687,24011,7711,21242,347,1023,5925,16165,6272,17188
220710,201911,891,2477,661,2036,27,99,503,1510,530,1609
220720,201911,2133,5030,1914,4729,17,69,1656,4030,1673,4099
220730,201911,1295,3635,1083,3274,16,89,925,2725,941,2814
220735,201911,963,2251,727,1880,12,43,623,1560,635,1603
220740,201911,1385,3624,1086,3235,34,96,908,2739,942,2835
220750,201911,3838,9772,3339,9048,206,478,2877,7841,3083,8319
220755,201911,1257,3130,1028,2774,30,111,824,2149,854,2260
220760,201911,3045,8584,2648,8042,89,307,2333,7147,2422,7454
220770,201911,21739,65722,18209,59512,5776,19825,6417,21593,12193,41418
220775,201911,1125,2913,1024,2784,12,52,984,2657,996,2709
220777,201911,1636,4147,1238,3529,32,76,939,2680,971,2756
220779,201911,1314,3280,1130,3021,20,62,980,2604,1000,2666
220780,201911,5507,14060,4798,12967,222,723,3909,10279,4131,11002
220785,201911,1475,3260,1297,3027,8,19,1254,2911,1262,2930
220790,201911,10002,28615,8980,27133,231,1088,7521,22379,7752,23467
220793,201911,908,2386,712,2037,14,35,589,1708,603,1743
220795,201911,1381,3585,1224,3377,16,59,1090,3008,1106,3067
220800,201911,17632,39793,14752,35881,640,1539,11369,27425,12009,28964
220810,201911,2929,8213,2464,7365,50,168,2038,6015,2088,6183
220820,201911,5135,13320,4396,12250,317,769,3264,9088,3581,9857
220830,201911,7240,19210,6470,18132,242,800,5411,14955,5653,15755
220840,201911,12187,37441,10108,33102,2367,7422,4671,15990,7038,23412
220850,201911,3139,9711,2785,9264,66,362,2462,8155,2528,8517
220855,201911,676,1727,582,1583,15,60,520,1392,535,1452
220860,201911,1006,2518,858,2277,20,76,763,1990,783,2066
220865,201911,2496,6591,1927,5612,92,318,1418,4013,1510,4331
220870,201911,2932,8242,2414,7556,42,207,2210,6875,2252,7082
220880,201911,5276,12502,4534,11582,80,298,4154,10478,4234,10776
220885,201911,1386,4258,1136,3842,60,256,907,3079,967,3335
220887,201911,1527,3334,1248,2967,10,30,1166,2744,1176,2774
220890,201911,1409,4343,1210,4019,50,176,990,3327,1040,3503
220900,201911,2029,4853,1673,4376,30,74,1471,3815,1501,3889
220910,201911,1504,4157,1264,3801,52,168,1042,3120,1094,3288
220915,201911,957,2576,736,2153,7,28,567,1597,574,1625
220920,201911,1340,4402,1146,4131,68,325,935,3344,1003,3669
220930,201911,1656,4552,1414,4187,22,75,1304,3837,1326,3912
220935,201911,1061,3048,843,2593,26,104,570,1650,596,1754
220937,201911,1381,3688,1175,3360,24,83,944,2670,968,2753
220940,201911,1504,4255,1186,3671,41,151,895,2730,936,2881
220945,201911,435,1517,371,1367,21,121,268,944,289,1065
220950,201911,1424,3296,898,2453,16,58,720,1889,736,1947
220955,201911,1596,4141,1329,3672,40,123,1105,3002,1145,3125
220960,201911,817,2077,611,1733,11,43,457,1234,468,1277
220965,201911,1761,4848,1531,4510,22,138,1322,3790,1344,3928
220970,201911,1874,4547,1370,3780,39,104,1135,3090,1174,3194
220975,201911,692,2042,589,1909,17,101,520,1615,537,1716
220980,201911,1159,3255,1023,3064,35,133,858,2538,893,2671
220985,201911,1204,3194,1048,2955,46,151,840,2289,886,2440
220987,201911,1444,4307,1240,3934,53,228,999,3115,1052,3343
220990,201911,1693,4674,1486,4366,19,107,1248,3602,1267,3709
220995,201911,1082,3300,860,2884,40,146,630,2102,670,2248
220997,201911,2404,7100,2199,6771,49,233,1978,6000,2027,6233
221000,201911,4382,12101,3878,11325,100,478,3295,9425,3395,9903
221005,201911,1485,3930,1351,3703,29,137,1167,3071,1196,3208
221010,201911,1191,2770,950,2470,26,70,824,2089,850,2159
221020,201911,1504,4587,1389,4370,20,87,1071,3322,1091,3409
221030,201911,1618,4064,1378,3765,27,88,1193,3277,1220,3365
221035,201911,1501,3918,1285,3624,21,33,1124,3263,1145,3296
221037,201911,648,1823,539,1626,9,34,377,1093,386,1127
221038,201911,523,1474,403,1242,16,58,277,846,293,904
221039,201911,860,2345,734,2126,18,78,605,1683,623,1761
221040,201911,4003,12042,3489,11116,151,553,2771,8796,2922,9349
221050,201911,3865,10210,3379,9581,64,254,3043,8561,3107,8815
221060,201911,8430,23280,6918,20905,245,711,5641,17138,5886,17849
221062,201911,1148,3749,974,3444,40,195,785,2724,825,2919
221063,201911,1043,2935,871,2676,70,243,652,1969,722,2212
221065,201911,2584,6694,2275,6136,22,100,1994,5269,2016,5369
221070,201911,3226,10155,2650,8952,296,997,1668,5728,1964,6725
221080,201911,3530,8628,2831,7581,59,223,2331,6126,2390,6349
221090,201911,1404,3640,1134,3165,10,43,975,2653,985,2696
221093,201911,1337,3776,1228,3559,121,347,847,2408,968,2755
221095,201911,894,2327,744,2089,8,25,618,1702,626,1727
221097,201911,819,2152,624,1793,21,66,464,1277,485,1343
221100,201911,109973,295231,91514,263678,10449,32021,59495,166857,69944,198878
221110,201911,9798,29222,8966,28149,160,826,8020,24882,8180,25708
221120,201911,4713,13098,4175,12211,175,549,3596,10468,3771,11017
221130,201911,5177,13654,3799,10931,753,2047,1833,5335,2586,7382
221135,201911,1600,4296,1431,4065,41,146,1265,3576,1306,3722
221140,201911,1325,3143,1109,2858,10,37,989,2487,999,2524
221150,201911,1098,2712,835,2239,22,97,654,1623,676,1720
221160,201911,742,1832,640,1696,18,33,525,1394,543,1427
221170,201911,976,2821,891,2666,23,71,760,2267,783,2338
230010,201911,3141,8191,2494,7068,47,163,1975,5484,2022,5647
230015,201911,2966,9690,2600,8937,178,720,1809,6166,1987,6886
230020,201911,12858,40680,12018,39365,356,1520,10131,32867,10487,34387
230030,201911,12923,32456,10813,29659,197,602,9485,25969,9682,26571
230040,201911,4456,11537,3686,10276,63,295,3048,8344,3111,8639
230050,201911,2771,8656,2052,6909,322,1042,911,2996,1233,4038
230060,201911,2318,6320,1842,5473,42,192,1466,4262,1508,4454
230070,201911,3864,10353,3088,8830,145,447,2153,6070,2298,6517
230075,201911,9076,29385,8271,27958,460,1989,6591,21888,7051,23877
230080,201911,3079,6412,2313,5460,6,25,2108,4984,2114,5009
230090,201911,4289,10626,3583,9475,151,407,2865,7521,3016,7928
230100,201911,17994,47216,15870,44241,1245,3595,11223,31349,12468,34944
230110,201911,12735,37858,10718,33801,1730,5381,5714,18100,7444,23481
230120,201911,7299,19889,6394,18379,511,1341,4709,13726,5220,15067
230125,201911,3099,8238,2500,7253,76,278,1926,5516,2002,5794
230130,201911,5667,17494,4571,15058,319,1145,3091,9978,3410,11123
230140,201911,3420,10260,2890,9161,107,429,2200,6792,2307,7221
230150,201911,1579,4731,1302,4098,207,556,759,2485,966,3041
230160,201911,6488,16940,5545,15466,211,754,4456,12153,4667,12907
230170,201911,6138,17500,5020,15200,308,932,3632,10801,3940,11733
230180,201911,1649,4547,1382,4040,23,100,1110,3140,1133,3240
230185,201911,4264,12249,3589,11110,243,835,2668,8224,2911,9059
230190,201911,13015,38021,10937,34130,1536,5009,6122,18968,7658,23977
230195,201911,5265,15500,4759,14560,344,1053,3631,11063,3975,12116
230200,201911,4972,13702,4162,12140,139,458,3187,9105,3326,9563
230205,201911,4027,12212,3543,11427,169,631,2667,8503,2836,9134
230210,201911,10353,24960,8675,22642,351,1144,6807,17432,7158,18576
230220,201911,13767,34625,12063,32148,555,1566,10000,26329,10555,27895
230230,201911,6807,20576,6067,19018,390,1234,4479,13971,4869,15205
230240,201911,12806,34270,11116,31407,284,1169,9186,25399,9470,26568
230250,201911,8846,25083,8320,24255,244,888,6628,18740,6872,19628
230260,201911,14524,43719,12551,40117,1595,5022,7308,23737,8903,28759
230270,201911,7418,20262,5661,16914,459,1363,3786,11347,4245,12710
230280,201911,20411,54476,16483,47780,501,2104,13037,36382,13538,38486
230290,201911,4788,13342,3991,11814,280,743,2990,8860,3270,9603
230300,201911,4776,12863,4330,12230,90,298,3781,10574,3871,10872
230310,201911,4630,13170,3874,11817,141,611,2790,8261,2931,8872
230320,201911,7720,22187,6500,19936,267,1089,4945,14830,5212,15919
230330,201911,4686,12792,3723,10928,163,541,2769,7958,2932,8499
230340,201911,3593,11179,3036,10045,278,956,2023,6636,2301,7592
230350,201911,17628,48832,15506,45603,900,3100,10306,30491,11206,33591
230360,201911,2810,7636,2233,6596,145,426,1489,4359,1634,4785
230365,201911,3050,7593,2505,6761,43,224,2116,5636,2159,5860
230370,201911,57997,162292,49046,148472,7617,23326,28612,88016,36229,111342
230380,201911,6404,17828,5001,15187,129,517,3668,10917,3797,11434
230390,201911,3350,9969,2887,9212,104,458,2219,6993,2323,7451
230393,201911,3153,9478,2515,8166,85,460,1919,5972,2004,6432
230395,201911,5864,15941,5083,14591,343,917,3532,10156,3875,11073
230400,201911,5575,15415,4910,14291,112,571,3914,11034,4026,11605
230410,201911,14422,42542,11757,37525,948,3293,7901,25083,8849,28376
230420,201911,28129,77877,22710,68103,2821,8791,12691,37819,15512,46610
230423,201911,4691,13886,4064,12622,91,392,3277,9997,3368,10389
230425,201911,5549,17156,5022,16048,410,1397,3568,11332,3978,12729
230426,201911,2716,7172,1953,5667,32,121,1464,4169,1496,4290
230427,201911,1877,5281,1301,4042,68,235,873,2595,941,2830
230428,201911,9606,25823,8290,23794,1132,3290,4877,13840,6009,17130
230430,201911,4874,13805,3828,11976,153,556,2903,8924,3056,9480
230435,201911,5670,14945,4729,13313,541,1479,2989,8443,3530,9922
230440,201911,408018,1018118,335847,908877,36069,103399,211898,566255,247967,669654
230445,201911,4272,11351,3415,9839,182,516,2336,6595,2518,7111
230450,201911,3598,10412,3114,9672,252,991,2235,6722,2487,7713
230460,201911,2143,5948,1848,5473,67,260,1524,4493,1591,4753
230465,201911,3972,11166,3359,10008,101,416,2499,7148,2600,7564
230470,201911,11143,36920,9989,34724,843,3425,7116,24286,7959,27711
230480,201911,1419,4123,1179,3681,83,329,838,2511,921,2840
230490,201911,2473,6910,2063,6139,166,541,1298,3656,1464,4197
230495,201911,5787,17174,5053,15841,372,1408,3318,10276,3690,11684
230500,201911,9235,29757,8313,28063,280,1138,6744,22670,7024,23808
230510,201911,1620,4984,1222,4094,186,665,585,1924,771,2589
230520,201911,4529,12845,3888,11674,318,900,2713,8148,3031,9048
230523,201911,14901,44112,11732,37210,2713,8542,3175,10652,5888,19194
230526,201911,3803,10790,3180,9680,171,531,2335,7118,2506,7649
230530,201911,5364,16691,4480,14955,299,1125,3226,10668,3525,11793
230533,201911,4255,10465,3567,9346,89,268,2961,7636,3050,7904
230535,201911,5262,14668,4440,13257,215,667,3147,9487,3362,10154
230540,201911,16182,44026,13868,40544,262,1062,11494,33199,11756,34261
230550,201911,20529,54844,16387,47638,1489,4451,10364,29892,11853,34343
230560,201911,8072,19775,6324,16943,53,235,5505,14562,5558,14797
230565,201911,3017,8433,2504,7476,81,344,1881,5502,1962,5846
230570,201911,3492,8867,2954,8147,70,228,2456,6729,2526,6957
230580,201911,10745,27983,9176,25726,324,987,7629,21204,7953,22191
230590,201911,8916,25468,7323,22495,412,1492,5362,15908,5774,17400
230600,201911,3648,9550,2816,8036,93,301,1942,5568,2035,5869
230610,201911,6597,18229,5801,16881,448,1283,4550,13182,4998,14465
230620,201911,2090,5660,1564,4611,116,362,962,2761,1078,3123
230625,201911,7734,22177,6436,19743,1934,6175,1746,5736,3680,11911
230630,201911,10650,31839,9184,28808,1573,4672,5105,16483,6678,21155
230640,201911,27662,83655,24829,79069,1355,5321,19522,61225,20877,66546
230650,201911,5170,14126,4366,12694,141,600,3486,9854,3627,10454
230655,201911,9312,31577,8727,30523,626,2298,6887,24283,7513,26581
230660,201911,6065,18023,4909,15925,156,819,3970,12613,4126,13432
230670,201911,6142,14682,4460,11940,127,425,3597,9383,3724,9808
230680,201911,2594,7143,2191,6416,134,387,1569,4619,1703,5006
230690,201911,7038,20929,6089,19006,410,1424,3837,11754,4247,13178
230700,201911,9711,24965,8055,21961,311,879,6065,16154,6376,17033
230710,201911,6674,21113,5783,19215,583,2022,3938,12866,4521,14888
230720,201911,1926,5659,1528,4832,121,371,1014,3125,1135,3496
230725,201911,3878,11789,3444,10949,389,1368,1939,6070,2328,7438
230730,201911,55880,152497,43496,132867,9784,32221,14435,46144,24219,78365
230740,201911,6049,16818,5124,15308,126,479,4120,12223,4246,12702
230750,201911,8411,22528,6936,20054,171,666,5457,15295,5628,15961
230760,201911,11101,29450,9673,27226,550,1805,7235,19869,7785,21674
230763,201911,4699,13041,3921,11571,130,587,3128,8913,3258,9500
230765,201911,40018,109431,32943,97650,5344,16450,16075,47304,21419,63754
230770,201911,25264,62887,21079,57221,2213,6134,13854,37656,16067,43790
230780,201911,6153,21840,5628,20594,793,2967,3323,12414,4116,15381
230790,201911,2945,8590,2619,8038,109,478,1959,5841,2068,6319
230800,201911,7921,25274,6969,23303,808,2963,4219,13825,5027,16788
230810,201911,11587,34527,10270,32356,415,1556,7859,24283,8274,25839
230820,201911,3292,10832,2728,9512,258,1087,1659,5494,1917,6581
230830,201911,7596,20692,6397,18644,144,624,5257,14928,5401,15552
230835,201911,4229,10125,3186,8429,76,232,2636,6848,2712,7080
230837,201911,3132,9635,2674,8791,112,535,2138,6798,2250,7333
230840,201911,8889,26217,7619,24084,724,2212,5494,17531,6218,19743
230850,201911,9446,27524,7906,24420,362,1312,5643,17192,6005,18504
230860,201911,5121,13152,4241,11842,66,247,3736,10339,3802,10586
230870,201911,16465,40258,14005,36172,397,1116,11440,29189,11837,30305
230880,201911,2099,6419,1904,6083,50,274,1499,4643,1549,4917
230890,201911,4561,14631,4136,13766,335,1230,2956,9659,3291,10889
230900,201911,2992,8656,2537,7751,185,655,1699,5057,1884,5712
230910,201911,3007,8137,2425,7196,65,308,1966,5774,2031,6082
230920,201911,4547,12889,3814,11696,147,602,2969,8866,3116,9468
230930,201911,6447,18129,5363,16123,300,900,3748,11269,4048,12169
230940,201911,7777,20187,6750,18612,191,516,5681,15542,5872,16058
230945,201911,6499,18730,5544,16849,329,1155,3896,11662,4225,12817
230950,201911,6304,15815,5567,14830,115,272,4880,13096,4995,13368
230960,201911,12869,37674,11353,34797,1747,5395,5851,18113,7598,23508
230970,201911,13397,35774,11083,32078,1773,5146,6073,17788,7846,22934
230980,201911,2681,7845,2329,7211,376,1126,1421,4524,1797,5650
230990,201911,1668,4732,1385,4157,70,292,952,2725,1022,3017
231000,201911,2457,6570,2015,5698,77,203,1471,4068,1548,4271
231010,201911,3398,8055,2697,6841,44,161,2333,5756,2377,5917
231020,201911,8053,25618,7147,23739,1318,4062,4014,13878,5332,17940
231025,201911,7441,20718,6463,19104,769,2228,4438,13231,5207,15459
231030,201911,7297,21763,5669,18280,911,2852,2984,9641,3895,12493
231040,201911,2945,8566,2553,7840,111,355,1989,6021,2100,6376
231050,201911,11710,30405,9272,25981,666,1841,6809,18589,7475,20430
231060,201911,2779,7937,2425,7347,64,233,1982,5972,2046,6205
231070,201911,7882,22896,6612,20633,748,2386,4161,12903,4909,15289
231080,201911,3959,11338,3372,10357,130,577,2556,7694,2686,8271
231085,201911,6705,16362,5276,14627,215,559,4095,11332,4310,11891
231090,201911,4399,11531,3207,9177,104,412,2232,6149,2336,6561
231095,201911,2268,6774,1770,5671,139,457,1183,3766,1322,4223
231100,201911,3096,9001,2546,7959,125,456,1919,5933,2044,6389
231110,201911,3502,10400,3192,9814,122,461,2410,7272,2532,7733
231120,201911,2222,6552,1841,5869,81,308,1297,4082,1378,4390
231123,201911,1897,4903,1555,4309,74,181,1149,3179,1223,3360
231126,201911,5419,15003,4291,12827,240,738,3143,9253,3383,9991
231130,201911,20851,53964,17324,49407,1051,3840,12688,35433,13739,39273
231135,201911,4109,11555,3392,10161,144,505,2443,7171,2587,7676
231140,201911,16625,46808,13198,40625,598,2518,9227,27618,9825,30136
231150,201911,5641,15506,4318,12948,701,2143,1946,5959,2647,8102
231160,201911,6130,18695,5358,17232,813,2493,3047,10065,3860,12558
231170,201911,4381,12876,3558,11254,192,703,2448,7475,2640,8178
231180,201911,14187,40514,11454,34632,3151,9237,3910,12224,7061,21461
231190,201911,3827,10815,3154,9561,73,328,2436,7182,2509,7510
231195,201911,4799,14570,3975,12871,213,814,2916,9284,3129,10098
231200,201911,7752,24366,6664,22087,232,1154,5222,16726,5454,17880
231210,201911,4798,14144,4053,12864,193,730,3033,9407,3226,10137
231220,201911,11893,31088,9088,25694,424,1318,6719,18293,7143,19611
231230,201911,9263,29514,8128,27480,452,1842,6003,20255,6455,22097
231240,201911,11389,33423,9965,30679,1557,4681,5969,18565,7526,23246
231250,201911,2101,5438,1351,3765,100,284,819,2221,919,2505
231260,201911,3207,9143,2758,8416,267,786,1879,5879,2146,6665
231270,201911,6425,16813,5209,14793,147,566,3938,10939,4085,11505
231280,201911,1678,5271,1541,5014,90,307,1160,3746,1250,4053
231290,201911,37264,111623,30816,98127,5207,16451,14323,45322,19530,61773
231300,201911,4021,11192,3127,9368,219,707,2046,5999,2265,6706
231310,201911,7211,18866,5712,16060,479,1366,3867,10653,4346,12019
231320,201911,7743,21323,5988,18160,91,437,4688,13993,4779,14430
231325,201911,2499,6650,2011,5878,165,424,1338,3991,1503,4415
231330,201911,9520,28708,7768,25138,1422,4409,4114,13843,5536,18252
231335,201911,5791,15160,4854,13657,80,359,4258,11822,4338,12181
231340,201911,17180,53615,15273,50172,1369,4544,10904,36213,12273,40757
231350,201911,15734,42837,14239,40725,327,1151,12699,35923,13026,37074
231355,201911,4388,13107,3904,12213,245,841,2982,9219,3227,10060
231360,201911,7325,22207,6314,20419,282,1053,4944,15916,5226,16969
231370,201911,2188,5983,1719,5141,35,117,1329,3941,1364,4058
231375,201911,4403,13646,3993,12955,138,613,3313,10625,3451,11238
231380,201911,5953,16134,5370,15333,182,504,4384,12675,4566,13179
231390,201911,3339,9749,2977,9142,144,548,2175,6483,2319,7031
231395,201911,3909,11570,3216,10454,452,1459,1866,6152,2318,7611
231400,201911,9428,27171,7943,24398,282,1184,6048,18173,6330,19357
231410,201911,14646,45655,13151,43124,615,2378,10553,34112,11168,36490
240010,201911,2485,6656,1913,5578,190,604,1159,3288,1349,3892
240020,201911,12224,34535,10232,30973,670,2503,6772,20084,7442,22587
240030,201911,2851,7069,2591,6669,99,306,2232,5653,2331,5959
240040,201911,800,2292,646,1998,33,126,461,1359,494,1485
240050,201911,3158,8506,2594,7468,47,138,2026,5736,2073,5874
240060,201911,1378,3708,1137,3266,25,86,924,2601,949,2687
240070,201911,2123,6215,1934,5826,190,611,1417,4153,1607,4764
240080,201911,2870,7772,2357,6814,55,217,1829,5175,1884,5392
240090,201911,2254,5557,1814,4794,18,55,1522,3973,1540,4028
240100,201911,9906,24610,7835,20768,227,727,6135,15686,6362,16413
240110,201911,4423,12639,3744,11380,195,712,2704,8050,2899,8762
240120,201911,3360,9216,2565,8273,202,740,1785,5879,1987,6619
240130,201911,3608,7546,3001,6755,32,105,2746,6071,2778,6176
240140,201911,1820,5424,1537,4876,168,570,1036,3252,1204,3822
240145,201911,6588,18415,5367,16254,833,2571,3015,9193,3848,11764
240150,201911,887,2621,794,2423,55,201,608,1793,663,1994
240160,201911,1426,4321,1193,3872,49,231,885,2873,934,3104
240165,201911,961,2644,791,2305,43,138,628,1798,671,1936
240170,201911,2404,6584,2013,5873,198,652,1355,3832,1553,4484
240180,201911,2980,8832,2347,7548,545,1670,1094,3724,1639,5394
240185,201911,1204,3840,1090,3653,57,234,897,2959,954,3193
240190,201911,1014,3011,885,2789,24,104,736,2334,760,2438
240200,201911,10686,27655,8517,23850,872,2654,4900,13401,5772,16055
240210,201911,2975,7527,2555,6890,30,150,2153,5618,2183,5768
240220,201911,7311,21917,6512,20646,362,1588,5041,15610,5403,17198
240230,201911,5825,14891,4662,12896,198,558,3704,10235,3902,10793
240240,201911,1850,5329,1114,3512,120,408,421,1158,541,1566
240250,201911,2857,7623,2531,7148,114,325,2092,5904,2206,6229
240260,201911,14028,41412,12059,37989,1701,5095,7455,24563,9156,29658
240270,201911,2202,6573,1919,6122,101,321,1437,4674,1538,4995
240280,201911,1672,4269,1418,3861,50,129,1139,3057,1189,3186
240290,201911,1180,3429,955,2926,29,125,666,1908,695,2033
240300,201911,2183,5636,1543,4418,74,238,1004,2795,1078,3033
240310,201911,8506,22515,6669,19168,880,2671,3493,9850,4373,12521
240320,201911,2048,5553,1455,4376,32,149,1113,3181,1145,3330
240325,201911,29930,80899,23132,68731,4383,13497,9719,29183,14102,42680
240330,201911,1716,4673,1285,3832,48,170,881,2503,929,2673
240340,201911,1971,4572,1603,3999,65,152,1300,3179,1365,3331
240350,201911,2097,5449,1909,5240,22,87,1730,4745,1752,4832
240360,201911,8429,23572,7486,22053,883,2618,5149,15408,6032,18026
240370,201911,1894,5056,1456,4141,75,225,1009,2803,1084,3028
240375,201911,890,2251,733,1957,28,103,590,1520,618,1623
240380,201911,2249,6394,1629,4993,137,408,968,2914,1105,3322
240390,201911,987,2453,661,1820,28,73,423,1084,451,1157
240400,201911,1378,3449,1076,2906,36,139,759,1937,795,2076
240410,201911,574,1756,474,1535,47,192,295,896,342,1088
240420,201911,4551,16061,3982,14771,476,2129,2317,8369,2793,10498
240430,201911,3322,8747,2781,7732,187,594,2033,5455,2220,6049
240440,201911,2574,5653,2148,5051,152,316,1703,3988,1855,4304
240450,201911,4483,12201,3470,10267,353,1120,2043,5793,2396,6913
240460,201911,2871,8209,2601,7776,261,826,2001,5956,2262,6782
240470,201911,3569,10741,2712,8960,454,1422,1425,4899,1879,6321
240480,201911,546,1502,369,1119,28,85,174,513,202,598
240485,201911,2095,5946,1712,5205,138,427,1160,3541,1298,3968
240490,201911,1641,4186,1275,3511,71,175,958,2649,1029,2824
240500,201911,2138,5763,1851,5284,83,243,1522,4323,1605,4566
240510,201911,1675,4375,1473,4082,71,266,1220,3280,1291,3546
240520,201911,1366,3436,1065,3015,43,155,821,2292,864,2447
240530,201911,2099,6111,1894,5768,106,314,1528,4648,1634,4962
240540,201911,2271,5684,1966,5200,66,146,1705,4494,1771,4640
240550,201911,688,1963,627,1844,23,99,502,1415,525,1514
240560,201911,3253,8512,2745,7822,305,796,1981,5732,2286,6528
240570,201911,2762,7268,1800,5097,264,779,740,1940,1004,2719
240580,201911,8028,23414,7096,21683,558,1669,5661,17347,6219,19016
240590,201911,708,1865,605,1689,14,49,463,1265,477,1314
240600,201911,1780,4801,1294,3780,48,160,873,2461,921,2621
240610,201911,4208,11404,3536,10156,136,461,2676,7528,2812,7989
240615,201911,1168,3121,921,2638,62,206,638,1730,700,1936
240620,201911,1860,5224,1565,4688,87,247,1243,3694,1330,3941
240630,201911,2058,5911,1848,5543,134,320,1301,4024,1435,4344
240640,201911,924,2503,724,2152,27,111,542,1577,569,1688
240650,201911,3996,11015,3460,10007,196,589,2673,7633,2869,8222
240660,201911,3052,7853,2687,7376,54,169,2424,6654,2478,6823
240670,201911,2419,6797,1949,5839,141,443,1260,3669,1401,4112
240680,201911,1624,4325,1283,3740,54,170,977,2771,1031,2941
240690,201911,980,2474,767,2105,16,71,611,1601,627,1672
240700,201911,2398,6951,1950,6108,66,256,1523,4678,1589,4934
240710,201911,16072,41729,13344,36937,1839,4968,8125,22547,9964,27515
240720,201911,5163,12857,4456,11827,395,1118,3240,8470,3635,9588
240725,201911,1114,3183,851,2639,31,106,568,1709,599,1815
240730,201911,2144,6049,1776,5320,65,232,1358,3981,1423,4213
240740,201911,1816,4867,1464,4195,46,184,1078,2919,1124,3103
240750,201911,2152,7113,1787,6336,271,1050,939,3365,1210,4415
240760,201911,1547,3747,1078,3026,48,87,839,2414,887,2501
240770,201911,3189,8804,2673,8045,122,457,2151,6368,2273,6825
240780,201911,4973,13557,3957,11857,509,1545,2434,7423,2943,8968
240790,201911,844,2409,692,2112,12,50,520,1550,532,1600
240800,201911,45347,110830,34961,94661,4815,13458,17876,48345,22691,61803
240810,201911,85728,224945,72404,202286,9969,28238,44700,123458,54669,151696
240820,201911,5755,17264,4940,15769,665,2135,3076,9936,3741,12071
240830,201911,8674,24939,7750,23513,261,1159,6359,18981,6620,20140
240840,201911,1137,2837,893,2424,34,91,632,1643,666,1734
240850,201911,1288,3533,916,2733,41,131,534,1535,575,1666
240860,201911,1241,3370,930,2798,16,73,695,1986,711,2059
240870,201911,1122,2866,841,2362,132,382,462,1303,594,1685
240880,201911,1273,3995,1116,3680,80,335,870,2799,950,3134
240890,201911,4463,12201,3330,9990,471,1539,1668,4774,2139,6313
240895,201911,2603,8180,2362,7817,132,465,2059,6808,2191,7273
240910,201911,3248,8917,2760,8018,58,212,2271,6487,2329,6699
240920,201911,830,2320,694,2090,63,190,395,1224,458,1414
240930,201911,3682,8425,3035,7632,190,277,2308,6069,2498,6346
240933,201911,1764,4273,1430,3772,44,176,1234,3200,1278,3376
240940,201911,6133,15133,4751,12766,429,1187,3079,8031,3508,9218
240950,201911,990,2965,855,2710,29,127,690,2135,719,2262
240960,201911,680,2075,604,1918,29,108,469,1452,498,1560
240970,201911,1838,4733,1474,4117,59,216,1208,3259,1267,3475
240980,201911,3197,9618,2863,8997,129,543,2303,7075,2432,7618
240990,201911,2555,7262,2263,6674,262,870,1598,4511,1860,5381
241000,201911,925,2459,734,2099,33,81,533,1515,566,1596
241010,201911,2776,8886,2526,8336,168,681,1866,6025,2034,6706
241020,201911,2071,5579,1504,4415,159,464,949,2756,1108,3220
241025,201911,1723,4963,1357,4256,50,212,971,2991,1021,3203
241030,201911,2503,7801,1988,6700,222,778,1288,4314,1510,5092
241040,201911,2283,7222,2023,6778,101,445,1622,5389,1723,5834
241050,201911,1306,3621,1054,3149,37,134,793,2307,830,2441
241060,201911,724,2055,638,1865,26,88,455,1278,481,1366
241070,201911,647,1763,563,1620,14,53,438,1206,452,1259
241080,201911,1129,3185,837,2595,8,34,608,1859,616,1893
241090,201911,2017,5855,1616,5165,52,263,1276,3998,1328,4261
241100,201911,1151,3246,899,2702,62,199,601,1750,663,1949
241105,201911,999,3039,801,2645,258,843,255,873,513,1716
241110,201911,919,2618,686,2111,39,139,459,1347,498,1486
241120,201911,7567,21407,6398,19321,979,2897,3697,11486,4676,14383
241140,201911,3270,8647,2581,7256,167,477,1866,5107,2033,5584
241142,201911,764,2060,552,1638,26,96,323,895,349,991
241150,201911,5918,15472,5220,14302,153,534,4279,11487,4432,12021
241160,201911,1157,3101,939,2703,141,408,588,1643,729,2051
241170,201911,1306,3340,1123,3027,31,125,939,2411,970,2536
241180,201911,1019,2646,730,2089,96,276,374,1029,470,1305
241190,201911,1108,2930,905,2522,18,71,667,1783,685,1854
241200,201911,18829,49584,16132,45225,2591,7244,9392,26423,11983,33667
241210,201911,1393,3766,981,2925,121,394,567,1632,688,2026
241220,201911,8669,25856,7509,23848,1803,5650,3473,11529,5276,17179
241230,201911,2893,7657,2536,7091,93,322,2124,5814,2217,6136
241240,201911,1181,3317,692,2203,58,191,320,1021,378,1212
241250,201911,5268,15392,4226,13399,166,771,3109,9443,3275,10214
241255,201911,2135,6785,1852,6165,109,467,1374,4446,1483,4913
241260,201911,4844,12697,3764,10856,86,369,2966,8342,3052,8711
241270,201911,1762,5097,1443,4462,119,415,1011,3083,1130,3498
241280,201911,2188,5492,1873,4914,67,187,1572,4050,1639,4237
241290,201911,3399,8325,2532,6893,74,281,2013,5301,2087,5582
241300,201911,1422,3822,1110,3244,37,130,772,2191,809,2321
241310,201911,2090,5255,1773,4805,14,62,1495,4076,1509,4138
241320,201911,992,3181,817,2828,93,383,511,1742,604,2125
241330,201911,1763,4574,1364,4054,22,102,1173,3461,1195,3563
241335,201911,3195,8938,2816,8225,101,342,2344,6764,2445,7106
241340,201911,1543,4406,1180,3636,249,793,498,1504,747,2297
241350,201911,2004,5809,1765,5373,98,337,1350,4042,1448,4379
241355,201911,1292,3483,1050,3017,19,64,823,2333,842,2397
241360,201911,2082,5400,1543,4280,45,134,1119,2991,1164,3125
241370,201911,1339,3702,1030,3057,50,171,721,2035,771,2206
241380,201911,617,1755,473,1451,70,197,253,792,323,989
241390,201911,2731,8076,2420,7598,182,531,1868,5924,2050,6455
241400,201911,3495,9718,3105,9107,160,507,2524,7333,2684,7840
241410,201911,2367,7051,1896,6074,340,1112,966,3094,1306,4206
241415,201911,1641,4850,1336,4248,63,234,945,2923,1008,3157
241420,201911,2193,7106,1861,6513,446,1698,876,3049,1322,4747
241430,201911,582,1607,395,1171,23,79,252,718,275,797
241440,201911,7343,22989,6553,21583,354,1385,5190,16865,5544,18250
241445,201911,1097,2813,974,2655,23,52,878,2449,901,2501
241450,201911,2574,6482,2207,5894,382,857,1464,4028,1846,4885
241460,201911,3637,9884,2939,8406,188,599,2088,5816,2276,6415
241470,201911,1423,3732,1135,3312,26,96,937,2719,963,2815
241475,201911,1191,3382,904,2815,23,121,655,1930,678,2051
241480,201911,2844,8928,2334,7818,721,2374,779,2909,1500,5283
241490,201911,651,1556,519,1368,23,68,361,925,384,993
241500,201911,810,2310,718,2191,7,31,652,1995,659,2026
250010,201911,2558,7615,2098,6661,60,247,1530,4725,1590,4972
250020,201911,1581,4295,1103,3345,30,78,813,2433,843,2511
250030,201911,6845,18845,6028,17556,497,1524,4521,12967,5018,14491
250040,201911,4058,12480,3489,11413,217,837,2504,8030,2721,8867
250050,201911,3562,9629,3218,9132,103,420,2674,7489,2777,7909
250053,201911,1164,3325,1050,3142,69,233,765,2272,834,2505
250057,201911,654,2338,612,2271,8,33,548,2079,556,2112
250060,201911,5411,14258,4891,13603,314,837,3982,11134,4296,11971
250070,201911,3950,11091,3386,10093,44,187,2703,7851,2747,8038
250073,201911,750,2001,607,1779,6,25,495,1405,501,1430
250077,201911,2225,6003,1652,5043,63,222,1233,3732,1296,3954
250080,201911,4771,12067,4107,11186,66,308,3556,9528,3622,9836
250090,201911,3227,7985,2825,7440,52,164,2431,6275,2483,6439
250100,201911,3625,11119,3287,10481,171,635,2580,8030,2751,8665
250110,201911,4856,13608,4355,12875,279,1026,3399,9814,3678,10840
250115,201911,675,1775,481,1474,10,55,339,1026,349,1081
250120,201911,1820,5347,1517,4826,32,154,1190,3743,1222,3897
250130,201911,5444,15053,4600,13836,78,424,3838,11353,3916,11777
250135,201911,1163,3200,1032,2983,19,77,913,2616,932,2693
250140,201911,2231,6627,2073,6420,121,548,1751,5293,1872,5841
250150,201911,4821,15044,4323,14164,150,657,3461,11122,3611,11779
250153,201911,1418,3707,1169,3329,27,82,949,2660,976,2742
250157,201911,1703,5101,1519,4736,63,264,1211,3700,1274,3964
250160,201911,3888,9713,3109,8646,33,146,2760,7637,2793,7783
250170,201911,1833,4691,1623,4381,29,111,1400,3717,1429,3828
250180,201911,19742,48217,16879,44480,785,2477,13086,33580,13871,36057
250190,201911,4064,10920,3389,9874,355,1028,2271,6492,2626,7520
250200,201911,1913,5155,1622,4727,55,188,1364,3959,1419,4147
250205,201911,826,2569,705,2364,17,81,585,1943,602,2024
250210,201911,1564,4772,1408,4515,51,272,1120,3509,1171,3781
250215,201911,1515,4182,1253,3789,71,243,771,2316,842,2559
250220,201911,659,1857,537,1673,30,113,358,1077,388,1190
250230,201911,1570,3568,1120,2887,24,70,906,2263,930,2333
250240,201911,2265,6846,1991,6357,42,197,1669,5243,1711,5440
250250,201911,4563,12689,3941,11773,84,290,3336,9959,3420,10249
250260,201911,1697,4723,1405,4221,42,128,1115,3315,1157,3443
250270,201911,1199,3615,1067,3450,67,230,801,2671,868,2901
250280,201911,3234,9121,2851,8517,94,294,2275,6757,2369,7051
250290,201911,1607,4216,1350,3847,24,68,1067,3056,1091,3124
250300,201911,5471,14621,4954,14019,196,891,4097,11130,4293,12021
250310,201911,1126,3102,936,2779,36,127,724,2112,760,2239
250320,201911,11455,26164,9860,24299,267,774,8724,21180,8991,21954
250330,201911,2325,6518,1933,5993,108,352,1554,4790,1662,5142
250340,201911,1095,2793,963,2614,7,19,879,2363,886,2382
250350,201911,4021,11182,3570,10449,156,412,2843,8541,2999,8953
250355,201911,1979,5983,1763,5682,28,150,1578,5046,1606,5196
250360,201911,1761,4893,1573,4624,44,166,1297,3784,1341,3950
250370,201911,13060,34019,10750,30524,282,1084,8900,24858,9182,25942
250375,201911,1187,3075,947,2782,6,18,881,2619,887,2637
250380,201911,1598,4144,1461,3967,30,132,1266,3309,1296,3441
250390,201911,1767,4563,1489,4113,99,261,1164,3195,1263,3456
250400,201911,69682,170253,49427,138660,13518,40143,15203,44529,28721,84672
250403,201911,1703,4793,1519,4567,68,351,1170,3353,1238,3704
250407,201911,1202,3048,968,2701,60,133,703,1995,763,2128
250410,201911,603,1632,522,1498,6,14,433,1225,439,1239
250415,201911,1816,5168,1598,4808,35,157,1364,4079,1399,4236
250420,201911,1195,3366,1080,3215,21,89,973,2868,994,2957
250430,201911,6267,15435,5288,14093,136,452,4362,11374,4498,11826
250435,201911,1511,4186,1208,3661,12,54,923,2759,935,2813
250440,201911,4578,12063,3911,11225,66,207,3459,9920,3525,10127
250450,201911,1790,4814,1489,4401,26,108,1232,3636,1258,3744
250460,201911,7376,19890,6497,18592,328,1032,5250,14921,5578,15953
250470,201911,1536,3954,1268,3546,53,171,979,2681,1032,2852
250480,201911,4112,11017,3504,10300,26,96,3142,9340,3168,9436
250485,201911,716,1632,518,1348,34,69,378,951,412,1020
250490,201911,5127,12228,4551,11555,178,551,3996,9945,4174,10496
250500,201911,1974,5454,1744,5056,72,235,1417,4091,1489,4326
250510,201911,5471,13684,4681,12641,83,233,4114,11185,4197,11418
250520,201911,1834,4965,1557,4563,132,424,1099,3192,1231,3616
250523,201911,2239,5487,1983,5160,74,304,1648,4149,1722,4453
250527,201911,1671,4312,1506,4119,24,69,1321,3648,1345,3717
250530,201911,630,1629,533,1500,6,17,464,1304,470,1321
250535,201911,1339,3937,1215,3693,27,131,991,2905,1018,3036
250540,201911,3004,6828,2459,6218,70,122,2160,5551,2230,5673
250550,201911,771,2475,670,2282,24,98,504,1681,528,1779
250560,201911,1683,4647,1477,4335,41,159,1235,3525,1276,3684
250570,201911,2622,7888,2238,7181,78,310,1754,5511,1832,5821
250580,201911,1059,2739,934,2566,45,162,780,2097,825,2259
250590,201911,827,2311,722,2154,23,92,600,1780,623,1872
250600,201911,8204,20846,6827,19059,294,897,5633,15584,5927,16481
250610,201911,3035,8427,2698,7927,127,477,2230,6433,2357,6910
250620,201911,752,2012,632,1794,11,45,476,1319,487,1364
250625,201911,2543,7312,2259,6842,45,237,1894,5552,1939,5789
250630,201911,9982,27827,8049,24338,865,2679,5166,15258,6031,17937
250640,201911,3314,9241,3016,8842,64,325,2608,7461,2672,7786
250650,201911,931,2273,776,2061,16,55,670,1739,686,1794
250660,201911,1563,3894,1313,3557,41,118,1095,2886,1136,3004
250670,201911,2324,7249,2112,6877,44,198,1835,5857,1879,6055
250680,201911,5913,13520,5227,12738,80,287,4781,11449,4861,11736
250690,201911,6839,15521,5833,14248,107,278,5161,12456,5268,12734
250700,201911,4300,12067,3733,11192,402,1203,2645,7855,3047,9058
250710,201911,4444,12709,3799,11815,297,1042,2725,8440,3022,9482
250720,201911,2755,7295,2468,6889,36,178,2161,5939,2197,6117
250730,201911,4118,10908,3588,10206,104,421,2996,8274,3100,8695
250740,201911,1973,4937,1599,4440,96,255,1230,3408,1326,3663
250750,201911,101495,251590,85918,229533,7267,21152,62005,162114,69272,183266
250760,201911,2343,6023,2034,5524,93,284,1609,4246,1702,4530
250770,201911,3980,12041,3561,11470,370,1210,2570,8302,2940,9512
250780,201911,1723,4641,1426,4091,62,216,1080,3016,1142,3232
250790,201911,2445,7285,2105,6761,166,649,1405,4396,1571,5045
250800,201911,2452,6505,2109,5955,88,184,1722,4897,1810,5081
250810,201911,1263,3378,1010,3005,20,49,865,2586,885,2635
250820,201911,1951,5482,1805,5315,37,158,1645,4801,1682,4959
250830,201911,5708,17032,4712,15054,260,1020,3263,10097,3523,11117
250840,201911,775,2428,656,2194,15,58,485,1632,500,1690
250850,201911,1777,5362,1587,5021,32,161,1313,4042,1345,4203
250855,201911,939,2756,811,2535,59,201,613,1905,672,2106
250860,201911,3108,9233,2562,8283,446,1530,1471,4741,1917,6271
250870,201911,1033,2841,860,2546,37,135,701,2047,738,2182
250880,201911,1594,4097,1300,3671,92,284,974,2737,1066,3021
250890,201911,9966,26433,8854,24885,444,1894,7009,18667,7453,20561
250900,201911,2781,7817,2384,7076,60,241,2014,5829,2074,6070
250905,201911,2365,6759,2160,6455,49,198,1948,5798,1997,5996
250910,201911,6012,14876,4919,13613,85,306,4198,11689,4283,11995
250915,201911,2102,4950,1499,4295,18,47,1320,3865,1338,3912
250920,201911,3539,8965,3075,8238,323,757,2249,6016,2572,6773
250930,201911,2215,5946,1998,5652,62,232,1714,4752,1776,4984
250933,201911,1157,3445,1021,3195,22,117,775,2347,797,2464
250937,201911,703,1882,571,1659,22,76,431,1266,453,1342
250939,201911,1728,4633,1499,4328,64,208,1174,3360,1238,3568
250940,201911,3885,10504,3415,9873,30,115,2992,8637,3022,8752
250950,201911,1685,4310,1349,3877,22,91,1132,3207,1154,3298
250960,201911,1101,3223,961,2993,25,133,780,2337,805,2470
250970,201911,8284,21433,7217,19722,258,829,5878,15706,6136,16535
250980,201911,2489,6612,2220,6196,38,159,1884,5118,1922,5277
250990,201911,1997,6089,1661,5474,57,269,1241,4031,1298,4300
251000,201911,2036,5732,1643,5065,40,180,1331,4053,1371,4233
251010,201911,2603,7342,2357,6959,24,103,2143,6312,2167,6415
251020,201911,1652,4470,1484,4211,31,140,1293,3590,1324,3730
251030,201911,994,2638,815,2302,34,97,574,1591,608,1688
251040,201911,1838,5249,1545,4738,43,203,1229,3730,1272,3933
251050,201911,1073,2911,899,2571,46,152,647,1788,693,1940
251060,201911,1069,2300,799,1962,8,32,646,1540,654,1572
251065,201911,467,1269,366,1090,14,38,253,729,267,767
251070,201911,714,1860,608,1710,7,29,516,1425,523,1454
251080,201911,18424,47394,15006,42234,1771,5274,9799,27534,11570,32808
251090,201911,2715,7834,2287,7054,54,191,1855,5682,1909,5873
251100,201911,793,2534,705,2372,27,103,527,1703,554,1806
251110,201911,1694,4548,1422,4067,44,119,1094,3101,1138,3220
251120,201911,7101,20191,5979,18769,255,1013,4730,14722,4985,15735
251130,201911,3904,8756,3440,8232,121,291,3050,7269,3171,7560
251140,201911,4216,11771,3787,11169,74,321,3174,9223,3248,9544
251150,201911,2663,7708,2379,7258,112,459,1932,5734,2044,6193
251160,201911,2071,6091,1803,5711,63,255,1525,4755,1588,5010
251170,201911,1542,4213,1350,3953,36,130,1166,3393,1202,3523
251180,201911,2596,7011,2134,6368,169,513,1440,4252,1609,4765
251190,201911,4339,11321,3984,10907,43,230,3612,9693,3655,9923
251200,201911,4305,12655,3819,12021,83,354,3331,10506,3414,10860
251203,201911,938,3052,862,2891,23,106,656,2137,679,2243
251207,201911,1072,2949,823,2526,22,114,575,1710,597,1824
251210,201911,7425,19075,5961,17111,253,636,4565,13282,4818,13918
251220,201911,1183,2868,908,2490,51,127,711,1971,762,2098
251230,201911,4609,12755,3951,11625,126,483,3137,8988,3263,9471
251240,201911,3607,9862,2996,8858,139,424,2261,6526,2400,6950
251250,201911,10010,27048,8781,25000,781,2377,6443,17761,7224,20138
251260,201911,479,1386,437,1314,11,56,346,1002,357,1058
251270,201911,4240,13200,3787,12581,109,443,3119,10554,3228,10997
251272,201911,1352,3673,1209,3472,42,165,1003,2793,1045,2958
251274,201911,903,2502,716,2165,58,195,485,1391,543,1586
251275,201911,1212,3385,1034,3106,37,174,784,2263,821,2437
251276,201911,1323,3555,1153,3335,32,171,928,2582,960,2753
251278,201911,573,1611,509,1510,40,108,372,1121,412,1229
251280,201911,2238,6135,1972,5714,50,190,1641,4672,1691,4862
251290,201911,5873,13950,5339,13280,149,515,4660,11173,4809,11688
251300,201911,835,2478,752,2352,7,35,644,2001,651,2036
251310,201911,2736,7844,2371,7262,53,269,1879,5609,1932,5878
251315,201911,1690,5322,1550,5071,74,232,1164,3753,1238,3985
251320,201911,1613,4259,1122,3401,30,103,837,2502,867,2605
251330,201911,2077,4817,1694,4360,21,75,1541,3988,1562,4063
251335,201911,1023,3083,922,2923,24,103,800,2473,824,2576
251340,201911,3681,8942,2920,7907,114,347,2210,5912,2324,6259
251350,201911,1066,3093,946,2893,31,133,781,2335,812,2468
251360,201911,1804,5083,1452,4589,19,87,1246,3938,1265,4025
251365,201911,703,1946,553,1640,8,26,428,1258,436,1284
251370,201911,22876,61195,19657,56608,2345,7003,12691,36847,15036,43850
251380,201911,1200,3423,1047,3157,18,102,872,2537,890,2639
251385,201911,730,1891,561,1586,15,54,422,1145,437,1199
251390,201911,6372,18697,5581,17408,487,1605,3645,11336,4132,12941
251392,201911,972,2657,802,2398,26,117,622,1812,648,1929
251394,201911,609,1796,496,1593,22,90,372,1168,394,1258
251396,201911,698,1872,589,1686,19,59,408,1143,427,1202
251398,201911,935,2379,658,1894,16,66,492,1378,508,1444
251400,201911,1213,3005,974,2667,27,96,765,2022,792,2118
251410,201911,1466,3470,1190,3063,19,85,1017,2524,1036,2609
251420,201911,1905,5047,1537,4618,40,151,1194,3552,1234,3703
251430,201911,1526,4672,1354,4382,32,154,1166,3759,1198,3913
251440,201911,1128,3167,906,2735,35,94,716,2182,751,2276
251445,201911,1528,4323,1405,4141,34,145,1186,3411,1220,3556
251450,201911,4417,13060,3930,12321,83,380,3267,10128,3350,10508
251455,201911,868,2639,785,2483,23,99,605,1879,628,1978
251460,201911,883,2533,769,2352,19,73,639,1947,658,2020
251465,201911,431,1278,362,1138,5,22,271,838,276,860
251470,201911,1161,3222,864,2605,66,226,518,1473,584,1699
251480,201911,983,2605,804,2287,20,88,618,1674,638,1762
251490,201911,1878,4956,1478,4398,51,165,1093,3234,1144,3399
251500,201911,1939,5453,1763,5212,32,127,1597,4700,1629,4827
251510,201911,2644,7952,2166,6965,122,459,1446,4537,1568,4996
251520,201911,942,2483,714,2056,61,173,475,1332,536,1505
251530,201911,14492,34873,11715,31377,112,620,10340,27168,10452,27788
251540,201911,2855,8371,2563,7818,90,329,2091,6263,2181,6592
251550,201911,3700,8844,2924,7856,88,203,2452,6602,2540,6805
251560,201911,570,1706,494,1588,62,211,336,1044,398,1255
251570,201911,919,2613,743,2254,20,90,578,1698,598,1788
251580,201911,1918,4552,1702,4230,47,187,1473,3516,1520,3703
251590,201911,1577,3993,1332,3701,60,184,1079,2904,1139,3088
251593,201911,865,2551,785,2417,80,261,516,1546,596,1807
251597,201911,2097,5897,1891,5620,19,88,1664,4887,1683,4975
251600,201911,6399,17331,5613,16106,168,548,4637,13099,4805,13647
251610,201911,3242,9182,2753,8274,249,687,1906,5814,2155,6501
251615,201911,1238,3097,992,2717,23,62,791,2113,814,2175
251620,201911,18558,43148,14304,37935,128,423,12079,32510,12207,32933
251630,201911,4684,11021,3733,9703,201,554,2865,7347,3066,7901
251640,201911,2097,5799,1863,5407,33,162,1609,4541,1642,4703
251650,201911,4010,10694,3474,9986,122,393,2972,8506,3094,8899
251660,201911,3476,10375,3044,9606,77,370,2514,7767,2591,8137
251670,201911,4019,11427,3551,10762,48,252,3153,9451,3201,9703
251675,201911,649,1857,574,1763,77,238,381,1173,458,1411
251680,201911,2544,6788,2094,6181,39,142,1699,5011,1738,5153
251690,201911,3135,8839,2626,7926,85,273,1974,5866,2059,6139
251700,201911,2036,5881,1724,5488,42,194,1459,4555,1501,4749
251710,201911,772,2021,516,1481,42,152,304,852,346,1004
251720,201911,1307,3694,1054,3242,22,98,805,2400,827,2498
251740,201911,603,1698,480,1466,40,150,338,984,378,1134
260005,201911,29768,62643,24245,55504,1641,3759,18680,41875,20321,45634
260010,201911,10042,26392,8255,23530,465,1403,4955,14195,5420,15598
260020,201911,6747,15900,5757,14472,115,512,4804,11868,4919,12380
260030,201911,6647,17162,5582,15576,150,490,4519,12499,4669,12989
260040,201911,7684,20206,6350,18160,492,1368,4359,12663,4851,14031
260050,201911,13791,35934,11445,33336,165,745,10459,30488,10624,31233
260060,201911,3997,10100,3398,9118,187,472,2701,7200,2888,7672
260070,201911,10413,26386,8925,24211,380,1290,7097,18777,7477,20067
260080,201911,6569,14991,5743,13867,116,385,4806,11341,4922,11726
260090,201911,4710,12167,4176,11442,515,1413,2889,7939,3404,9352
260100,201911,3045,8228,2544,7476,59,274,2064,5972,2123,6246
260105,201911,4982,13529,4442,12813,136,489,3706,10542,3842,11031
260110,201911,22318,61509,19803,57841,1012,3473,16216,46600,17228,50073
260120,201911,14512,38964,12067,35223,1542,4419,7505,22264,9047,26683
260130,201911,3023,7869,2703,7392,202,583,2021,5413,2223,5996
260140,201911,12940,29502,11079,27226,597,1624,9215,22313,9812,23937
260150,201911,3591,8343,3066,7697,89,282,2676,6617,2765,6899
260160,201911,6526,17075,5462,15730,89,352,4880,14154,4969,14506
260170,201911,19241,46397,16266,42306,1033,2672,12789,32921,13822,35593
260180,201911,3450,9249,2970,8593,83,314,2533,7204,2616,7518
260190,201911,18432,37069,15397,33500,170,484,13561,28836,13731,29320
260200,201911,11123,26656,9524,24619,448,1042,7967,20794,8415,21836
260210,201911,11804,33362,9944,30334,315,1259,7911,23921,8226,25180
260220,201911,10339,24989,9521,23932,162,559,8379,20688,8541,21247
260230,201911,10661,26287,9271,24410,206,691,7780,20085,7986,20776
260240,201911,2661,7981,2315,7320,126,448,1781,5567,1907,6015
260250,201911,2175,5741,1887,5298,125,295,1429,4007,1554,4302
260260,201911,12856,33646,11402,31366,409,1399,8994,24173,9403,25572
260270,201911,4119,10133,3597,9478,142,549,2974,7644,3116,8193
260280,201911,12698,38337,11376,36463,484,2070,9597,30297,10081,32367
260290,201911,39431,101129,33860,92787,3696,10338,22840,62225,26536,72563
260300,201911,9699,26086,8356,24224,224,972,6952,20050,7176,21022
260310,201911,4934,12847,4361,12100,284,763,3393,9504,3677,10267
260320,201911,7673,22064,6490,20033,264,840,5262,16218,5526,17058
260330,201911,2525,7782,2210,7120,71,275,1770,5553,1841,5828
260340,201911,2047,5455,1749,4993,33,153,1478,4110,1511,4263
260345,201911,24735,64964,20647,58812,3168,9632,10796,30071,13964,39703
260350,201911,5413,12827,4695,11979,93,251,4143,10523,4236,10774
260360,201911,2483,6471,2244,6032,39,175,1569,4151,1608,4326
260370,201911,5537,15910,4754,14572,241,863,3629,11014,3870,11877
260380,201911,4894,14596,4180,13394,162,612,3112,9827,3274,10439
260390,201911,4442,13359,3678,11763,212,714,2508,7832,2720,8546
260392,201911,3390,10827,3012,10341,126,740,2397,8216,2523,8956
260400,201911,17264,40488,14927,37405,493,1444,11704,28231,12197,29675
260410,201911,71727,175263,54856,151104,9847,28575,24917,70237,34764,98812
260415,201911,4492,12230,3864,11157,71,294,3128,8879,3199,9173
260420,201911,12791,26588,10802,24360,116,335,9930,22147,10046,22482
260430,201911,2777,8583,2354,7755,111,438,1659,5429,1770,5867
260440,201911,3661,9617,3212,8894,78,288,2671,7238,2749,7526
260450,201911,5704,14461,5111,13712,302,667,4166,11364,4468,12031
260460,201911,5208,15592,4425,14167,489,1742,2616,8201,3105,9943
260470,201911,4947,12970,4157,12043,92,227,3776,11116,3868,11343
260480,201911,3990,10605,3328,9650,214,780,2313,6703,2527,7483
260490,201911,5322,12282,4704,11350,45,170,4242,10045,4287,10215
260500,201911,6133,15448,5241,14161,449,1166,3676,10005,4125,11171
260510,201911,9580,23756,8023,21583,133,516,7044,18742,7177,19258
260515,201911,4195,11554,3227,9677,140,433,2149,6262,2289,6695
260520,201911,17223,39953,15019,37071,863,2120,12093,29449,12956,31569
260530,201911,9757,27878,8323,25661,173,811,7077,21508,7250,22319
260540,201911,7171,15544,6322,14455,180,416,5633,12769,5813,13185
260545,201911,49,147,18,71,2,7,5,15,7,22
260550,201911,3022,8423,2471,7489,117,493,1668,4925,1785,5418
260560,201911,6029,15346,5055,13933,132,538,4199,11310,4331,11848
260570,201911,7696,20981,6728,19656,415,1318,5255,15376,5670,16694
260580,201911,4461,10595,3978,9945,22,82,3642,9071,3664,9153
260590,201911,6718,15578,5605,14320,220,556,4668,12017,4888,12573
260600,201911,30351,79062,24584,70026,1155,3673,18438,51617,19593,55290
260610,201911,7154,18619,6424,17652,406,1223,4787,13008,5193,14231
260620,201911,15933,41734,13911,38773,1329,4181,9953,27125,11282,31306
260630,201911,2349,6354,1907,5636,32,139,1533,4419,1565,4558
260640,201911,21111,48362,17722,44401,850,2174,14177,35218,15027,37392
260650,201911,5955,15783,4743,14275,156,638,4026,12027,4182,12665
260660,201911,7153,18870,6107,17458,161,699,5177,14451,5338,15150
260670,201911,2175,5693,1788,5096,74,189,1335,3770,1409,3959
260680,201911,27179,65260,22736,58802,1650,4562,15855,40189,17505,44751
260690,201911,3588,9270,2918,8245,100,371,2282,6371,2382,6742
260700,201911,6034,17434,5656,16982,22,76,5484,16580,5506,16656
260710,201911,1329,3552,1156,3310,35,142,894,2563,929,2705
260720,201911,22536,57555,19676,53513,2125,5981,13808,37083,15933,43064
260730,201911,7475,21793,6547,20467,280,1047,5419,16666,5699,17713
260740,201911,1339,3753,1110,3388,11,60,881,2741,892,2801
260750,201911,7019,19388,5890,17948,114,398,5236,16169,5350,16567
260760,201911,5617,13348,4804,12362,194,558,3928,10120,4122,10678
260765,201911,7820,22781,6794,21337,431,1804,4766,14619,5197,16423
260770,201911,3837,9840,3209,8779,103,352,2538,6837,2641,7189
260775,201911,5240,13943,4603,12945,206,759,3555,9666,3761,10425
260780,201911,3580,10592,3172,9934,282,1071,2060,6234,2342,7305
260790,201911,117903,265479,97270,237896,15086,35911,59831,146306,74917,182217
260795,201911,3013,7791,2566,7180,98,333,1972,5527,2070,5860
260800,201911,5408,12613,4791,11734,139,444,4199,9920,4338,10364
260805,201911,3610,10262,3014,9191,168,612,2230,6661,2398,7273
260810,201911,6566,17736,5728,16120,519,1405,4067,11232,4586,12637
260820,201911,4387,10382,3861,9744,119,417,3178,7861,3297,8278
260825,201911,2924,8714,2524,8007,111,408,1866,5835,1977,6243
260830,201911,4269,12398,3547,11083,461,1287,2242,7196,2703,8483
260840,201911,4196,10948,3730,10287,219,571,3079,8500,3298,9071
260845,201911,4197,11152,3737,10335,233,641,2813,7710,3046,8351
260850,201911,4865,13471,4037,11847,345,1088,2644,7512,2989,8600
260860,201911,3489,9819,2929,8847,97,350,2342,6880,2439,7230
260870,201911,4513,10843,3867,10044,79,314,3425,8722,3504,9036
260875,201911,6894,17167,5609,15233,584,1608,3822,10342,4406,11950
260880,201911,9788,27325,8453,24977,509,1509,6583,19451,7092,20960
260890,201911,13119,33781,11326,30979,657,1967,8174,21800,8831,23767
260900,201911,5252,14909,4342,13533,316,1112,2878,8863,3194,9975
260910,201911,3170,8706,2736,8029,99,332,2149,6252,2248,6584
260915,201911,5159,15147,4520,14369,55,287,4125,13105,4180,13392
260920,201911,3315,8254,2796,7674,89,251,2366,6540,2455,6791
260930,201911,3678,11588,3130,10583,183,742,2327,7664,2510,8406
260940,201911,14469,34830,12543,32037,950,2466,9368,23523,10318,25989
260950,201911,6635,17907,5356,15644,368,1259,3405,9481,3773,10740
260960,201911,68389,154451,54657,136322,6218,16119,34399,84311,40617,100430
260970,201911,5428,14400,4816,13560,209,532,3666,10354,3875,10886
260980,201911,4512,13155,3983,12479,59,206,3615,11437,3674,11643
260990,201911,18021,49853,15128,45886,889,3020,11656,35009,12545,38029
261000,201911,16191,38378,13571,34925,413,1492,10821,27113,11234,28605
261010,201911,2405,6250,2098,5833,74,192,1821,5085,1895,5277
261020,201911,6115,16610,5182,14980,205,754,4175,11574,4380,12328
261030,201911,4068,11663,3485,10679,133,540,2748,8174,2881,8714
261040,201911,5186,15211,4152,13161,172,697,3070,9494,3242,10191
261050,201911,7763,20316,7034,19141,456,975,5240,14316,5696,15291
261060,201911,13999,35099,12194,32869,304,1010,10113,26950,10417,27960
261070,201911,62461,136659,51495,121956,2854,6716,39175,90832,42029,97548
261080,201911,6436,15700,5863,14952,135,331,5381,13698,5516,14029
261090,201911,18675,44760,16544,41984,317,1134,14322,35708,14639,36842
261100,201911,8263,22980,7108,21252,525,1683,5129,15352,5654,17035
261110,201911,61782,173202,51432,154831,7972,25108,29306,87627,37278,112735
261120,201911,3768,9346,3214,8589,92,232,2747,7361,2839,7593
261130,201911,7337,17893,6414,16629,133,384,5636,14493,5769,14877
261140,201911,3590,8304,3194,7780,166,446,2570,6135,2736,6581
261150,201911,5327,13911,4673,12924,79,305,4058,11074,4137,11379
261153,201911,1877,5623,1600,5087,60,221,1091,3474,1151,3695
261160,201911,206678,483254,166639,426646,41070,108183,68808,178623,109878,286806
261170,201911,6005,15007,5321,13964,345,845,4238,11028,4583,11873
261180,201911,9608,24073,8389,22447,452,1245,6089,16256,6541,17501
261190,201911,4571,13472,4075,12625,214,894,3138,9411,3352,10305
261200,201911,3364,7779,2990,7264,136,371,2492,5918,2628,6289
261210,201911,1931,4635,1619,4200,62,188,1357,3453,1419,3641
261220,201911,13727,38894,11305,34328,1435,4691,6450,19263,7885,23954
261230,201911,4085,11665,3411,10703,60,253,2821,8914,2881,9167
261240,201911,5264,13272,4584,12190,256,707,3772,9878,4028,10585
261245,201911,3569,10078,2990,9044,78,357,2366,6922,2444,7279
261247,201911,2899,8686,2394,7748,143,528,1645,5258,1788,5786
261250,201911,21755,49914,18686,46270,1648,3706,14237,36073,15885,39779
261255,201911,4060,11953,3297,10470,139,611,2419,7421,2558,8032
261260,201911,12824,34351,11023,32030,346,1459,9426,26962,9772,28421
261270,201911,4254,10775,3746,10101,174,548,3116,8235,3290,8783
261280,201911,2564,7145,2250,6598,70,263,1789,5111,1859,5374
261290,201911,2933,7621,2470,7074,76,302,2002,5753,2078,6055
261300,201911,12091,34096,10168,30751,596,2189,7283,21517,7879,23706
261310,201911,8771,22444,7437,20565,696,2184,5345,14342,6041,16526
261320,201911,5999,16947,5206,15597,88,397,4337,12760,4425,13157
261330,201911,5979,14662,5360,13833,127,455,4655,11770,4782,12225
261340,201911,4203,11964,3627,11184,152,571,2936,8946,3088,9517
261350,201911,8748,25422,7747,23730,121,577,6328,19017,6449,19594
261360,201911,8232,19922,6940,18071,231,733,5517,13898,5748,14631
261370,201911,22637,57051,18976,51918,2136,5815,12222,33583,14358,39398
261380,201911,4017,12147,3541,11310,461,1578,2305,7252,2766,8830
261390,201911,16404,46811,13706,42348,1205,4065,9011,27597,10216,31662
261400,201911,4607,14629,3969,13257,160,735,2959,9594,3119,10329
261410,201911,9469,23828,7779,21167,535,1494,5980,15939,6515,17433
261420,201911,7310,22045,6601,21159,790,2919,4605,14630,5395,17549
261430,201911,3444,9693,2871,8792,68,288,2376,7158,2444,7446
261440,201911,1461,4347,1220,3876,39,197,875,2643,914,2840
261450,201911,15061,40602,13302,37810,219,838,10965,31089,11184,31927
261460,201911,7499,20654,6613,19294,179,685,5475,15782,5654,16467
261470,201911,4209,10458,3676,9751,29,149,3133,8291,3162,8440
261480,201911,5060,15528,4337,14291,201,836,3350,10768,3551,11604
261485,201911,5024,14252,4275,13042,369,1220,2973,8924,3342,10144
261500,201911,5814,14969,5056,13929,377,928,3524,10027,3901,10955
261510,201911,1881,5618,1613,5161,63,239,1202,3893,1265,4132
261520,201911,2368,7262,2132,6765,86,308,1520,4831,1606,5139
261530,201911,11569,34198,9328,29947,989,3785,4664,14400,5653,18185
261540,201911,8078,23179,7227,21924,1064,3216,4111,13046,5175,16262
261550,201911,3622,9659,3121,8865,220,695,2229,6201,2449,6896
261560,201911,7829,23228,6743,21590,326,1230,5081,16281,5407,17511
261570,201911,3479,9347,2761,8175,202,726,1900,5479,2102,6205
261580,201911,6629,17489,5792,16369,122,562,5151,14337,5273,14899
261590,201911,2666,6833,2119,6051,70,223,1587,4486,1657,4709
261600,201911,5053,12920,4220,11655,359,890,2867,8191,3226,9081
261610,201911,2265,6301,1822,5522,88,331,1267,3800,1355,4131
261618,201911,2539,6370,2196,5868,66,202,1766,4659,1832,4861
261620,201911,4109,11610,3775,11122,864,2266,2304,7154,3168,9420
261630,201911,6355,17761,5358,15877,362,1299,3584,10172,3946,11471
261640,201911,37150,83369,31601,76428,1745,3524,24040,59566,25785,63090
261650,201911,4150,10286,3556,9498,154,494,2650,7009,2804,7503
270010,201911,4307,14505,3710,13470,167,947,2898,10230,3065,11177
270020,201911,3896,9797,3399,9160,150,521,2878,7562,3028,8083
270030,201911,32826,89817,27546,81310,3748,10857,18100,53602,21848,64459
270040,201911,10905,29298,9349,27450,368,1467,7721,22398,8089,23865
270050,201911,5549,12752,4713,11811,200,482,4138,10413,4338,10895
270060,201911,2040,5271,1700,4873,111,302,1381,3997,1492,4299
270070,201911,4632,13038,4015,12157,154,583,3345,9921,3499,10504
270080,201911,1430,3894,1187,3476,42,130,906,2541,948,2671
270090,201911,1813,5511,1606,5114,70,304,1297,4003,1367,4307
270100,201911,5518,14689,4770,13584,174,667,3887,10810,4061,11477
270110,201911,3261,7736,2608,6957,142,355,2057,5713,2199,6068
270120,201911,2829,7663,2447,7152,76,326,2059,5925,2135,6251
270130,201911,5111,13193,4414,12361,130,428,3773,10560,3903,10988
270135,201911,2012,4836,1700,4485,55,173,1518,3985,1573,4158
270140,201911,9747,22606,7767,19839,319,1151,6149,14883,6468,16034
270150,201911,2724,8119,2504,7802,7,40,2367,7359,2374,7399
270160,201911,6069,16683,5201,15669,59,358,4809,14369,4868,14727
270170,201911,3410,9941,2865,9176,187,882,2142,6580,2329,7462
270180,201911,2255,6948,2049,6679,41,199,1825,5897,1866,6096
270190,201911,1645,4905,1459,4669,38,200,1268,4010,1306,4210
270200,201911,2398,7278,2062,6804,118,461,1508,4899,1626,5360
270210,201911,5727,13531,4902,12598,85,352,4488,11340,4573,11692
270220,201911,1437,3794,1129,3363,206,640,633,1859,839,2499
270230,201911,9251,25770,7616,23214,665,2263,5348,16074,6013,18337
270235,201911,5781,17790,4984,16496,138,632,4044,13200,4182,13832
270240,201911,10666,29067,8545,26161,838,2845,6123,18639,6961,21484
270250,201911,2773,7014,2406,6496,194,513,1867,5048,2061,5561
270255,201911,4478,12835,3454,10946,121,498,2581,8034,2702,8532
270260,201911,5642,16568,5109,15688,107,540,4443,13286,4550,13826
270270,201911,1044,2728,874,2513,116,342,622,1770,738,2112
270280,201911,3953,9416,3132,8382,471,765,2187,6314,2658,7079
270290,201911,7524,23930,6729,22594,198,923,5748,19065,5946,19988
270300,201911,4171,10937,3251,9926,159,457,2492,7771,2651,8228
270310,201911,6973,19480,5983,17976,133,669,5048,14727,5181,15396
270320,201911,5510,16069,4774,14675,473,1517,3336,10017,3809,11534
270330,201911,3861,12629,3411,11946,264,1088,2589,8998,2853,10086
270340,201911,1613,4410,1395,4120,55,175,1155,3371,1210,3546
270350,201911,1827,4386,1497,3985,157,464,1032,2767,1189,3231
270360,201911,2562,6494,2274,6166,75,198,2078,5642,2153,5840
270370,201911,1369,4271,1240,4021,43,203,1011,3221,1054,3424
270375,201911,3103,7209,2575,6620,19,57,2419,6231,2438,6288
270380,201911,5477,15578,4581,14382,619,1919,2913,9499,3532,11418
270390,201911,1199,3014,984,2766,23,96,807,2261,830,2357
270400,201911,6232,16581,5204,14971,226,714,4066,11487,4292,12201
270410,201911,4585,13283,3963,12299,174,622,3263,10043,3437,10665
270420,201911,5500,16300,4953,15500,131,640,4262,13046,4393,13686
270430,201911,137168,328770,107515,290420,21730,61095,50380,137698,72110,198793
270440,201911,4766,12886,4104,12067,92,417,3534,10246,3626,10663
270450,201911,6848,18586,6050,17622,247,921,5085,14744,5332,15665
270460,201911,3791,8365,3264,7747,120,277,2953,6945,3073,7222
270470,201911,11090,30960,9585,28760,734,2430,7232,21632,7966,24062
270480,201911,2927,7786,2484,7146,111,447,2002,5599,2113,6046
270490,201911,959,2674,828,2512,49,170,662,1979,711,2149
270500,201911,4910,15052,4353,14143,290,1096,3349,10737,3639,11833
270510,201911,5590,14920,4724,13779,351,1413,3509,9741,3860,11154
270520,201911,3823,11008,2996,9548,640,2113,1221,4011,1861,6124
270530,201911,1216,3514,1039,3241,52,147,748,2360,800,2507
270540,201911,2163,6322,1878,5948,62,297,1617,5006,1679,5303
270550,201911,6694,17331,5368,15860,585,1433,4009,12311,4594,13744
270560,201911,2976,7793,2580,7258,152,477,2049,5695,2201,6172
270570,201911,4143,11646,3497,10650,113,405,2834,8532,2947,8937
270580,201911,2299,6509,2075,6180,95,290,1781,5259,1876,5549
270590,201911,1614,4817,1484,4648,17,91,1399,4358,1416,4449
270600,201911,2735,8455,2467,8039,53,279,2175,6979,2228,7258
270610,201911,3686,9582,3146,8861,80,299,2791,7771,2871,8070
270620,201911,1183,3670,1079,3465,35,156,920,2868,955,3024
270630,201911,17324,42473,14895,39073,599,1935,12449,31865,13048,33800
270640,201911,5351,15370,4625,14203,165,664,3756,11266,3921,11930
270642,201911,2500,8040,2208,7553,159,683,1675,5589,1834,6272
270644,201911,3584,8946,2912,8054,258,645,2191,6194,2449,6839
270650,201911,3098,9176,2718,8627,410,1367,1837,5785,2247,7152
270660,201911,2047,5152,1673,4620,81,306,1257,3394,1338,3700
270670,201911,16072,37348,13344,34000,430,1362,11276,28072,11706,29434
270680,201911,5406,13109,4806,12436,125,187,4489,11770,4614,11957
270690,201911,8965,22341,7380,20343,630,1671,5577,15395,6207,17066
270700,201911,527,1570,457,1454,30,128,336,1050,366,1178
270710,201911,5469,16516,4885,15629,237,1005,3938,12310,4175,13315
270720,201911,3446,10303,3035,9596,67,382,2667,8249,2734,8631
270730,201911,8131,18128,7140,17034,241,507,5644,14818,5885,15325
270740,201911,2354,6188,2079,5861,98,347,1722,4749,1820,5096
270750,201911,5632,15013,4908,14066,110,489,4275,12163,4385,12652
270760,201911,3282,9308,2842,8707,56,292,2387,7214,2443,7506
270770,201911,20843,50806,16445,45391,2576,6467,10251,29770,12827,36237
270780,201911,1730,5004,1586,4795,102,377,1276,3780,1378,4157
270790,201911,1551,4414,1293,4030,105,362,901,2766,1006,3128
270800,201911,10732,29602,9573,27953,360,1362,8158,23333,8518,24695
270810,201911,3271,9333,2549,8087,176,683,1776,5520,1952,6203
270820,201911,1672,4981,1396,4514,56,249,1078,3406,1134,3655
270830,201911,5325,12602,4282,11311,178,582,3448,8958,3626,9540
270840,201911,8196,24355,7300,23093,193,1101,6386,19593,6579,20694
270850,201911,9004,21441,7979,20200,649,1896,6566,16265,7215,18161
270860,201911,12795,29847,10456,27108,382,1250,8694,22086,9076,23336
270870,201911,2126,6024,1755,5402,223,704,1166,3636,1389,4340
270880,201911,8122,24260,7228,22902,235,1007,5953,18501,6188,19508
270890,201911,2740,7473,2313,6862,182,582,1615,4752,1797,5334
270895,201911,3045,9532,2774,9167,78,418,2441,7902,2519,8320
270900,201911,1791,4617,1340,3885,41,123,1044,3008,1085,3131
270910,201911,3877,11301,3314,10372,106,413,2638,8123,2744,8536
270915,201911,9251,26708,7472,23696,675,2521,5047,15581,5722,18102
270920,201911,5142,16035,4627,15163,174,855,3768,11917,3942,12772
270930,201911,17167,40181,13287,35625,1877,4577,8964,24978,10841,29555
270940,201911,6443,17170,5530,16060,192,931,4469,12575,4661,13506
280010,201911,675,1854,534,1549,15,60,379,987,394,1047
280020,201911,4751,12182,4043,11053,500,1261,2681,7410,3181,8671
280030,201911,73758,174286,57141,150524,12594,33412,25129,68702,37723,102114
280040,201911,2953,8292,2569,7706,260,846,1706,5040,1966,5886
280050,201911,3883,11056,3333,10165,556,1760,1962,5975,2518,7735
280060,201911,5586,14850,4410,13008,802,2492,2169,6599,2971,9091
280067,201911,6879,17192,5820,15586,325,903,4237,11105,4562,12008
280070,201911,1900,5714,1763,5484,83,319,1474,4486,1557,4805
280100,201911,3921,10521,3272,9460,323,985,2276,6522,2599,7507
280110,201911,1369,3730,1191,3457,22,101,1041,2944,1063,3045
280120,201911,7483,21796,6655,20451,761,2177,4859,15222,5620,17399
280130,201911,9088,21378,7924,19701,446,1187,6391,15753,6837,16940
280140,201911,5526,13236,4837,12307,217,633,4072,10235,4289,10868
280150,201911,4020,10055,3466,9338,251,649,2776,7477,3027,8126
280160,201911,1234,3543,1022,3172,99,326,680,2055,779,2381
280170,201911,5206,13690,4621,12902,237,668,3673,10233,3910,10901
280190,201911,1226,2730,1036,2467,56,146,821,1907,877,2053
280200,201911,1287,3364,1040,2991,95,340,737,2054,832,2394
280210,201911,16233,41034,14050,37833,1579,4468,8954,23972,10533,28440
280220,201911,1762,4720,1495,4350,42,209,1227,3532,1269,3741
280230,201911,4147,10473,3490,9513,270,671,2524,6887,2794,7558
280240,201911,3356,8939,3009,8420,58,307,2557,6922,2615,7229
280250,201911,865,2165,688,1891,55,180,449,1179,504,1359
280260,201911,2118,5189,1875,4892,37,98,1727,4515,1764,4613
280270,201911,2298,6392,2027,5954,112,396,1699,4880,1811,5276
280280,201911,4177,12485,3711,11814,465,1331,2622,8654,3087,9985
280290,201911,17737,47001,15132,43302,1334,4154,10252,29463,11586,33617
280300,201911,11563,28504,10040,26851,280,843,7681,22113,7961,22956
280310,201911,1364,3509,1120,3086,33,117,842,2245,875,2362
280320,201911,8590,23268,7400,21457,845,2530,4963,14147,5808,16677
280330,201911,4615,11494,3859,10407,274,756,2823,7528,3097,8284
280340,201911,5520,11494,4602,10502,214,386,3996,9248,4210,9634
280350,201911,25617,60452,22207,55833,1201,3267,17331,42769,18532,46036
280360,201911,5787,16111,5007,14771,773,2318,2919,8664,3692,10982
280370,201911,2193,5407,1790,4723,59,159,1415,3652,1474,3811
280380,201911,976,2683,822,2468,72,231,546,1636,618,1867
280390,201911,3632,9032,3001,8002,132,342,2385,6307,2517,6649
280400,201911,3896,9932,3331,9136,502,1223,2035,5861,2537,7084
280410,201911,2220,6197,1755,5393,201,657,1031,3083,1232,3740
280420,201911,4346,11632,3943,11098,82,304,3586,10023,3668,10327
280430,201911,2036,4994,1776,4643,64,251,1436,3611,1500,3862
280440,201911,4248,11478,3705,10646,165,584,3090,8644,3255,9228
280445,201911,2275,5762,2012,5294,52,166,1537,3867,1589,4033
280450,201911,10320,23653,8953,21823,719,1394,6731,16843,7450,18237
280460,201911,6859,16363,6179,15390,388,931,5178,12767,5566,13698
280470,201911,1695,4841,1449,4393,57,217,1066,3148,1123,3365
280480,201911,41401,100841,35610,92689,2875,8160,25525,64949,28400,73109
280490,201911,3666,10424,3149,9531,99,433,2423,7090,2522,7523
280500,201911,989,2374,832,2159,34,129,698,1767,732,1896
280510,201911,2544,6562,2181,6019,81,309,1671,4490,1752,4799
280520,201911,1603,4104,1398,3825,68,182,1116,3015,1184,3197
280530,201911,2558,6345,2171,5811,302,687,1509,4136,1811,4823
280540,201911,9012,24190,8143,22898,252,916,7093,19595,7345,20511
280550,201911,6657,15547,5395,13730,220,762,4355,10654,4575,11416
280560,201911,7047,19863,6588,19164,138,541,5772,16577,5910,17118
280570,201911,6463,15761,5215,14146,207,690,3883,10401,4090,11091
280580,201911,5586,15098,4782,13863,546,1509,3341,9758,3887,11267
280590,201911,2933,6594,2470,6053,113,420,1928,4511,2041,4931
280600,201911,3578,9576,3133,8927,165,531,2230,6337,2395,6868
280610,201911,2480,6105,2227,5726,138,353,1812,4615,1950,4968
280620,201911,5384,13292,4544,12166,415,931,3194,8876,3609,9807
280630,201911,3821,10850,3462,10325,174,621,2798,8247,2972,8868
280640,201911,2398,6440,2104,6100,65,207,1866,5402,1931,5609
280650,201911,1198,3139,950,2760,98,326,682,1902,780,2228
280660,201911,3273,7482,2858,6977,130,307,2491,6038,2621,6345
280670,201911,19630,44274,16845,40675,888,2336,13481,32171,14369,34507
280680,201911,2781,6670,2361,6071,215,398,1698,4436,1913,4834
280690,201911,928,2320,764,2090,32,102,591,1584,623,1686
280700,201911,1150,2902,981,2644,24,97,778,2044,802,2141
280710,201911,15185,34171,12757,31401,498,1032,10886,27298,11384,28330
280720,201911,2666,6065,2180,5485,72,229,1506,3963,1578,4192
280730,201911,1051,2709,932,2510,47,144,713,1861,760,2005
280740,201911,14139,34548,11950,31182,794,2219,8497,21654,9291,23873
280750,201911,3578,10032,3108,9195,177,604,2231,6472,2408,7076
280760,201911,6333,17053,5489,15742,556,1486,3669,10797,4225,12283
290010,201911,3176,6668,2064,4928,9,32,1682,3824,1691,3856
290020,201911,5442,14384,4905,13682,347,681,4113,11856,4460,12537
290030,201911,4431,10375,3605,9452,164,417,3049,8038,3213,8455
290035,201911,5217,11397,4230,10114,389,621,3304,8258,3693,8879
290040,201911,4225,10281,3566,9485,122,316,2827,7833,2949,8149
290050,201911,2040,6519,1697,5782,129,520,1128,3739,1257,4259
290060,201911,1316,3185,952,2591,71,237,633,1688,704,1925
290070,201911,36734,80899,31406,74142,1820,4542,24178,56359,25998,60901
290080,201911,5381,15808,4566,14573,459,1614,3170,10172,3629,11786
290090,201911,2175,4187,1545,3515,20,66,1406,3167,1426,3233
290100,201911,9865,25841,7937,22902,1288,3502,4343,13068,5631,16570
290110,201911,5206,13805,4601,12805,352,1035,3281,9037,3633,10072
290115,201911,3995,11568,3338,10405,232,791,2473,7632,2705,8423
290120,201911,6501,16157,5460,14723,138,491,4661,12349,4799,12840
290130,201911,4709,11390,3670,10052,164,507,2858,7764,3022,8271
290135,201911,4246,9974,3415,8597,213,556,2609,6387,2822,6943
290140,201911,4496,11911,3487,10545,102,409,2951,8821,3053,9230
290150,201911,2476,6449,2116,5988,140,404,1616,4564,1756,4968
290160,201911,3202,7543,2827,7025,326,693,2138,5382,2464,6075
290170,201911,3358,8572,2957,8121,113,320,2622,7251,2735,7571
290180,201911,2981,8139,2427,7215,82,299,1967,5792,2049,6091
290190,201911,4165,11911,3643,11201,157,676,2970,8958,3127,9634
290195,201911,2397,5893,1876,5179,29,150,1572,4289,1601,4439
290200,201911,4108,11397,3336,10108,216,732,2520,7565,2736,8297
290205,201911,3373,8675,2967,8079,135,489,2324,6106,2459,6595
290210,201911,13380,36988,11693,34410,936,2497,8882,26674,9818,29171
290220,201911,2831,7086,2472,6624,130,374,2019,5356,2149,5730
290225,201911,3327,7074,2568,6264,164,285,2151,5354,2315,5639
290230,201911,2507,6594,2266,6308,33,107,2025,5614,2058,5721
290240,201911,3683,9286,2945,8333,81,286,2482,6984,2563,7270
290250,201911,4044,11756,3398,10803,121,424,2742,8860,2863,9284
290260,201911,5365,13328,4370,11910,177,634,3580,9489,3757,10123
290265,201911,3471,10197,2778,8840,159,594,2036,6397,2195,6991
290270,201911,11231,38131,10486,36819,539,2394,8371,29031,8910,31425
290280,201911,5994,17967,5158,16317,307,1101,3702,11550,4009,12651
290290,201911,9898,28827,7951,25176,811,2824,5216,16227,6027,19051
290300,201911,4284,11594,3126,9379,164,549,2230,6652,2394,7201
290310,201911,1564,3916,1262,3537,69,289,957,2582,1026,2871
290320,201911,24448,64031,19180,55819,4298,12352,9067,27658,13365,40010
290323,201911,3761,10198,3242,9396,98,312,2585,7431,2683,7743
290327,201911,4158,12046,3508,10772,271,789,2472,7544,2743,8333
290330,201911,2193,4602,1703,4066,46,82,1505,3624,1551,3706
290340,201911,5674,14394,4372,12760,481,1457,3094,9160,3575,10617
290350,201911,4771,13233,3922,11787,274,843,2800,8436,3074,9279
290360,201911,5046,13253,4403,12405,132,386,3807,10754,3939,11140
290370,201911,5269,12763,3853,10901,172,412,2843,8190,3015,8602
290380,201911,5641,14951,4717,13676,114,298,4057,11953,4171,12251
290390,201911,14675,41206,12126,37282,1293,3856,8000,25021,9293,28877
290395,201911,2815,8204,2265,7236,73,342,1749,5481,1822,5823
290400,201911,3776,10090,3009,8820,83,361,2302,6556,2385,6917
290405,201911,4619,13509,3893,12222,279,933,2715,8665,2994,9598
290410,201911,5737,15724,4392,13494,115,555,3328,9903,3443,10458
290420,201911,2986,8370,2433,7482,73,277,1867,5678,1940,5955
290430,201911,3131,8634,2544,7704,245,780,1679,5043,1924,5823
290440,201911,2808,7090,1988,5795,41,130,1411,4189,1452,4319
290450,201911,3400,8825,2662,7710,149,450,1990,5765,2139,6215
290460,201911,11811,33124,9856,29405,2003,6091,4503,13316,6506,19407
290470,201911,4522,11207,3327,9533,374,1171,1894,5489,2268,6660
290475,201911,6520,18870,5441,16935,113,577,4367,13271,4480,13848
290480,201911,1769,4483,1449,4017,87,291,1001,2650,1088,2941
290485,201911,4544,13272,3997,12484,119,602,3374,10318,3493,10920
290490,201911,9261,21718,8178,20232,532,1231,6401,15971,6933,17202
290500,201911,3958,11934,2993,9766,532,1812,1339,4261,1871,6073
290510,201911,3441,8582,2852,7813,74,261,2451,6641,2525,6902
290515,201911,3731,10168,3184,9422,50,148,2827,8543,2877,8691
290520,201911,11387,32480,8704,27214,515,1790,5417,16649,5932,18439
290530,201911,4955,14178,4171,12872,133,504,3499,10749,3632,11253
290540,201911,3454,9119,3075,8658,69,230,2818,7900,2887,8130
290550,201911,4323,11265,3721,10555,13,65,3426,9823,3439,9888
290560,201911,6515,16875,4919,14476,420,1524,3249,9190,3669,10714
290570,201911,43875,108014,38978,101695,2483,6678,31297,81044,33780,87722
290580,201911,7906,23134,6808,21521,644,2025,4893,15819,5537,17844
290590,201911,7029,21733,5934,19753,142,593,4807,16031,4949,16624
290600,201911,18728,52090,16489,48447,709,2264,13181,38609,13890,40873
290610,201911,2537,7954,1959,6747,95,410,1365,4637,1460,5047
290620,201911,6543,18274,5591,16682,214,628,4659,13851,4873,14479
290630,201911,9200,22355,7272,19790,599,1582,5575,15300,6174,16882
290640,201911,2741,7116,2089,6146,78,243,1541,4536,1619,4779
290650,201911,12860,32446,11393,30719,2681,6918,6781,19174,9462,26092
290660,201911,3689,9461,3055,8546,50,131,2297,6669,2347,6800
290670,201911,6684,18606,5635,16861,383,1104,4311,13027,4694,14131
290680,201911,10738,29928,9028,27390,200,1079,7413,21965,7613,23044
290682,201911,4751,12380,4100,11478,135,333,3464,9777,3599,10110
290685,201911,3378,7676,2414,6291,188,472,1529,4232,1717,4704
290687,201911,6627,17959,5338,15798,717,2038,3373,10231,4090,12269
290689,201911,2818,7910,2176,6724,125,375,1608,4988,1733,5363
290690,201911,5633,14506,4515,12910,334,1026,3252,9161,3586,10187
290700,201911,2612,7140,2290,6716,73,252,1899,5589,1972,5841
290710,201911,8359,23503,7086,21716,154,656,5998,18339,6152,18995
290720,201911,18819,51350,16987,48538,944,3077,13431,37774,14375,40851
290730,201911,7149,17074,6073,15804,299,632,4744,12497,5043,13129
290740,201911,1034,2806,774,2369,35,135,621,1897,656,2032
290750,201911,11126,27828,9567,25258,687,1958,7001,17885,7688,19843
290755,201911,2096,5896,1677,5117,96,306,1149,3512,1245,3818
290760,201911,3796,11063,3023,9578,196,586,2024,6562,2220,7148
290770,201911,2628,8467,2369,8146,52,276,1995,6897,2047,7173
290780,201911,8328,20534,7115,18905,283,631,5598,15134,5881,15765
290790,201911,4696,12818,4054,11923,160,471,3381,10077,3541,10548
290800,201911,7203,14935,5093,12443,316,744,3756,9233,4072,9977
290810,201911,5488,14398,4345,12691,119,387,3251,9648,3370,10035
290820,201911,4860,13103,4339,12324,179,534,3284,9461,3463,9995
290830,201911,4563,10337,4063,9700,34,101,3558,8371,3592,8472
290840,201911,17006,45250,14594,41452,1894,4486,9382,28188,11276,32674
290850,201911,6568,15977,5893,15243,266,666,4993,13048,5259,13714
290860,201911,6047,17516,5251,16569,221,744,4419,14188,4640,14932
290870,201911,4827,13278,3626,11015,120,415,2560,7684,2680,8099
290880,201911,1388,3480,1093,3089,66,183,769,2226,835,2409
290890,201911,9215,18662,8220,17526,176,394,7676,16272,7852,16666
290900,201911,2330,6115,1731,5096,97,270,1110,3233,1207,3503
290910,201911,5141,12315,3891,10418,45,153,3271,8667,3316,8820
290920,201911,5098,12788,4626,12225,52,115,4357,11600,4409,11715
290930,201911,7785,21722,6194,18936,198,910,4808,14234,5006,15144
290940,201911,3737,10446,3065,9473,164,637,2407,7438,2571,8075
290950,201911,1473,3717,1195,3299,64,183,845,2335,909,2518
290960,201911,5515,14498,4907,13721,160,429,4136,11565,4296,11994
290970,201911,3473,10115,2806,8919,118,427,2125,6742,2243,7169
290980,201911,12265,29508,10206,26274,820,2304,6313,15737,7133,18041
290990,201911,9464,25273,8256,23294,278,1117,6890,18776,7168,19893
291000,201911,3386,8877,2638,7927,130,388,2145,6532,2275,6920
291005,201911,15311,37610,13405,35074,1143,2850,10516,27529,11659,30379
291010,201911,2966,9005,2383,7768,116,438,1576,4998,1692,5436
291020,201911,1270,3140,1010,2655,22,77,737,1835,759,1912
291030,201911,2500,6084,1724,4732,103,275,1085,2899,1188,3174
291040,201911,5398,14957,4535,13719,175,710,3535,10631,3710,11341
291050,201911,7686,20261,6584,18679,702,2220,4672,12988,5374,15208
291060,201911,5929,18344,5084,17161,339,1431,3834,12833,4173,14264
291070,201911,15804,42723,13135,38432,453,1606,10623,30812,11076,32418
291072,201911,24333,62616,17338,50362,3280,9881,7432,21803,10712,31684
291075,201911,5320,13294,4730,12367,110,305,3920,10041,4030,10346
291077,201911,1581,4132,1223,3505,45,108,867,2484,912,2592
291080,201911,94389,241732,73996,212173,23549,69207,19218,58838,42767,128045
291085,201911,5645,14259,4739,12876,204,640,3956,10663,4160,11303
291090,201911,1983,3693,1430,3082,35,75,1178,2509,1213,2584
291100,201911,3191,7021,2197,5817,117,335,1671,4361,1788,4696
291110,201911,5976,17737,5046,16137,334,1361,3765,11569,4099,12930
291120,201911,7709,18853,6502,17301,324,944,4959,13123,5283,14067
291125,201911,2191,3860,1615,3217,118,175,1244,2558,1362,2733
291130,201911,3195,9169,2339,7448,88,405,1682,5150,1770,5555
291140,201911,4785,13004,3456,10526,430,1152,2152,6592,2582,7744
291150,201911,2420,5287,1885,4681,6,22,1776,4394,1782,4416
291160,201911,5186,14193,4241,12784,405,1269,2778,8314,3183,9583
291165,201911,2138,5859,1621,4869,41,177,1178,3400,1219,3577
291170,201911,20892,52891,17375,46894,966,2863,11392,30225,12358,33088
291180,201911,6182,14439,4520,12134,309,781,3443,9286,3752,10067
291185,201911,3104,8378,2714,7739,90,277,2084,5917,2174,6194
291190,201911,7620,18780,6280,17019,324,1022,4920,13259,5244,14281
291200,201911,2763,7639,2031,6236,96,327,1238,3670,1334,3997
291210,201911,6920,15074,5244,13111,149,499,3919,9818,4068,10317
291220,201911,4022,11490,3606,10841,193,720,2813,8334,3006,9054
291230,201911,4443,9622,3400,8471,44,100,3042,7658,3086,7758
291240,201911,4276,10958,3654,9925,66,225,3128,8366,3194,8591
291250,201911,3428,10090,2666,8684,164,530,1722,5629,1886,6159
291260,201911,1443,3385,1190,3057,34,105,970,2494,1004,2599
291270,201911,5324,13974,4153,12221,621,1806,2632,7908,3253,9714
291280,201911,2519,6267,1872,5302,131,437,1216,3325,1347,3762
291290,201911,5917,15644,4577,13515,349,1129,3161,9229,3510,10358
291300,201911,3857,10370,2934,8840,117,420,2223,6578,2340,6998
291310,201911,5088,13632,4310,12184,108,370,3623,10049,3731,10419
291320,201911,6184,17212,4736,14492,1117,3189,2263,7363,3380,10552
291330,201911,1793,4533,1473,3996,84,233,1085,2892,1169,3125
291340,201911,4248,10963,3429,9536,86,270,2612,7126,2698,7396
291345,201911,2958,8905,2675,8460,116,415,2226,7023,2342,7438
291350,201911,6881,17139,5328,15199,67,220,4566,13261,4633,13481
291360,201911,37174,85748,29175,75877,2958,7801,18819,49839,21777,57640
291370,201911,7866,21690,6965,20320,500,1588,5168,14833,5668,16421
291380,201911,3435,9408,3019,8820,107,432,2486,7194,2593,7626
291390,201911,13222,28495,10287,25233,418,1056,8515,20823,8933,21879
291400,201911,13785,35469,11324,31721,1568,3883,6691,20147,8259,24030
291410,201911,2881,7565,2192,6387,43,183,1612,4594,1655,4777
291420,201911,1932,4773,1497,4227,34,138,1286,3617,1320,3755
291430,201911,2821,7974,2423,7310,102,446,1901,5555,2003,6001
291440,201911,6364,18303,5426,16727,323,1074,4251,13084,4574,14158
291450,201911,9009,22671,7447,20864,82,144,6538,18911,6620,19055
291460,201911,15521,41276,13575,38347,671,2165,10261,28684,10932,30849
291465,201911,9105,22727,7168,20483,168,755,6110,17309,6278,18064
291470,201911,16081,36518,13412,33523,675,1538,10027,25726,10702,27264
291480,201911,41440,92341,30138,76606,3702,9759,15861,40210,19563,49969
291490,201911,5615,14026,4859,13129,148,483,4368,11729,4516,12212
291500,201911,5037,12301,4161,11132,77,332,3734,9919,3811,10251
291510,201911,4221,10513,3155,9160,59,313,2604,7493,2663,7806
291520,201911,4556,10389,3430,8891,164,473,2640,6778,2804,7251
291530,201911,2277,5265,1593,4351,298,741,915,2735,1213,3476
291535,201911,3360,9876,2987,9208,178,502,2286,7183,2464,7685
291540,201911,2271,5110,1570,4252,64,232,1301,3440,1365,3672
291550,201911,5613,12921,4374,11317,400,889,2996,7883,3396,8772
291560,201911,18929,43997,13358,36870,1235,3306,8360,23912,9595,27218
291570,201911,2422,5762,1904,5109,54,148,1550,4313,1604,4461
291580,201911,6269,16264,4905,14422,220,741,3653,10615,3873,11356
291590,201911,2063,5170,1782,4824,87,324,1531,4037,1618,4361
291600,201911,5152,12476,3825,10395,381,1131,2516,6625,2897,7756
291610,201911,5767,15220,5229,14609,94,356,4767,13281,4861,13637
291620,201911,3161,7022,2314,6076,105,272,1800,4808,1905,5080
291630,201911,3220,7283,2385,6188,225,664,1742,4430,1967,5094
291640,201911,15539,38656,11657,32948,1766,4831,5178,15315,6944,20146
291650,201911,9500,23773,8345,22383,573,1118,6976,19207,7549,20325
291660,201911,2073,5106,1490,4193,127,436,964,2535,1091,2971
291670,201911,2093,5473,1757,5000,102,254,1337,3854,1439,4108
291680,201911,4101,10120,3291,8914,295,817,2323,6254,2618,7071
291685,201911,4717,11204,3731,9941,224,451,2823,7819,3047,8270
291690,201911,4229,9307,2857,7327,213,449,2197,5656,2410,6105
291700,201911,8642,25042,7570,23125,345,1270,6131,18359,6476,19629
291710,201911,5294,12658,3908,10677,218,684,2835,7594,3053,8278
291720,201911,4373,13411,3636,11913,393,1392,2399,7664,2792,9056
291730,201911,6338,16283,5436,15084,269,818,4459,12305,4728,13123
291733,201911,2909,7391,2440,6755,69,192,1778,5156,1847,5348
291735,201911,2938,7691,2324,6620,81,218,1753,4959,1834,5177
291740,201911,3879,10018,2863,8184,97,286,2035,5692,2132,5978
291750,201911,19622,46870,15787,41169,1490,3844,10682,27987,12172,31831
291760,201911,10352,29971,8037,26124,2436,8965,2158,7008,4594,15973
291770,201911,7058,19083,5810,16859,386,1187,4267,12073,4653,13260
291780,201911,5104,13617,4576,12846,90,347,3981,11041,4071,11388
291790,201911,2653,7453,2408,7137,249,657,1791,5450,2040,6107
291800,201911,29084,73685,21571,62229,3400,9490,10799,32236,14199,41726
291810,201911,10758,25584,8866,23241,253,687,7581,19843,7834,20530
291820,201911,3828,10111,3308,9411,97,319,2627,7496,2724,7815
291830,201911,4394,10451,3650,9435,194,460,2896,7517,3090,7977
291835,201911,6437,19247,4979,16387,583,2029,3105,10341,3688,12370
291840,201911,47875,130850,41006,120262,4573,14316,28333,82668,32906,96984
291845,201911,2480,6495,1958,5838,116,368,1559,4695,1675,5063
291850,201911,3943,11255,3238,10062,276,801,2290,7313,2566,8114
291855,201911,2155,4310,1680,3772,41,103,1519,3407,1560,3510
291860,201911,2244,5858,1529,4460,44,130,1032,2890,1076,3020
291870,201911,1312,3295,868,2512,52,158,573,1622,625,1780
291875,201911,2838,8497,2436,7658,69,283,1798,5486,1867,5769
291880,201911,5582,15821,4765,14446,219,670,3603,10926,3822,11596
291890,201911,1597,3324,1030,2652,124,294,699,1801,823,2095
291900,201911,1173,2891,896,2447,21,91,704,1856,725,1947
291905,201911,2553,6455,2032,5605,83,286,1524,4050,1607,4336
291910,201911,2933,7433,2454,6858,58,212,2137,5987,2195,6199
291915,201911,7416,21027,6001,18575,241,860,4468,13888,4709,14748
291920,201911,26222,68774,22164,62968,2303,7080,15117,42079,17420,49159
291930,201911,2526,6852,2132,6287,258,778,1386,4096,1644,4874
291940,201911,3961,10114,2578,7732,191,579,1495,4424,1686,5003
291950,201911,9217,27709,7798,24930,328,1210,5378,17000,5706,18210
291955,201911,15375,38730,13639,36477,1169,3278,10573,28302,11742,31580
291960,201911,3082,8140,2528,7362,118,371,1977,5848,2095,6219
291970,201911,4478,11384,3747,10422,139,480,2830,7862,2969,8342
291980,201911,9868,27998,7737,24381,790,2372,4905,15742,5695,18114
291990,201911,2207,5763,1865,5366,22,93,1752,5049,1774,5142
291992,201911,3993,9673,3090,8470,235,561,2443,6801,2678,7362
291995,201911,2109,5722,1690,5083,49,221,1304,3809,1353,4030
292000,201911,2651,6232,2137,5603,92,368,1711,4427,1803,4795
292010,201911,5890,13616,4735,11957,196,601,3902,9625,4098,10226
292020,201911,4540,13178,3729,11696,206,787,2716,8249,2922,9036
292030,201911,1816,5550,1666,5276,80,287,1061,3298,1141,3585
292040,201911,4318,11195,3379,9794,231,618,2578,7636,2809,8254
292045,201911,3993,10494,2958,8959,42,114,2591,8026,2633,8140
292050,201911,6501,18289,5188,15900,255,918,3301,9935,3556,10853
292060,201911,11585,26832,10646,25658,541,1206,9194,21946,9735,23152
292070,201911,5826,15121,5106,14241,291,852,4382,12121,4673,12973
292080,201911,3179,7961,2590,7200,82,273,2289,6319,2371,6592
292090,201911,4559,9892,3238,8310,249,681,2462,6361,2711,7042
292100,201911,10720,26230,9078,24120,1025,2864,6153,16229,7178,19093
292105,201911,3476,8733,3018,8096,96,239,2448,6583,2544,6822
292110,201911,5988,14726,4170,11755,986,2819,1897,5344,2883,8163
292120,201911,6882,17657,5625,15528,355,1061,4252,11489,4607,12550
292130,201911,3386,8126,2763,7344,111,331,2165,5676,2276,6007
292140,201911,5125,12046,4236,10720,300,759,3367,8453,3667,9212
292145,201911,2344,6787,1959,6117,58,166,1497,4713,1555,4879
292150,201911,13807,37949,12046,35074,318,1260,9881,28337,10199,29597
292160,201911,3018,7366,2252,6376,54,153,1837,5379,1891,5532
292170,201911,8389,22290,6939,19869,387,1271,5156,14474,5543,15745
292180,201911,2836,7730,2039,6275,177,541,1271,3830,1448,4371
292190,201911,2941,7729,2475,7007,113,366,1901,5337,2014,5703
292200,201911,8226,20793,6064,17668,1022,3071,3231,9647,4253,12718
292205,201911,3918,10741,3340,9859,66,312,2935,8564,3001,8876
292210,201911,6449,15080,5178,13449,90,400,4639,11878,4729,12278
292220,201911,2136,5156,1873,4739,50,147,1482,3618,1532,3765
292225,201911,3212,9388,2804,8766,73,347,2365,7242,2438,7589
292230,201911,8650,20481,7691,19254,180,606,6581,16145,6761,16751
292240,201911,4762,13780,4097,12564,318,945,2823,8674,3141,9619
292250,201911,5437,14493,4856,13587,469,1273,3451,9702,3920,10975
292260,201911,3410,8916,3021,8406,108,288,2607,7257,2715,7545
292265,201911,3361,9164,2795,8292,72,321,2196,6358,2268,6679
292270,201911,4419,10054,3504,8962,134,317,2859,7320,2993,7637
292273,201911,2651,5740,2104,5060,61,110,1572,3994,1633,4104
292275,201911,1678,4331,1315,3828,61,167,987,2924,1048,3091
292280,201911,2634,6253,2108,5642,92,196,1772,4885,1864,5081
292285,201911,2580,6244,2025,5489,83,206,1620,4408,1703,4614
292290,201911,7413,19769,5880,17594,174,663,4779,14246,4953,14909
292300,201911,10292,26084,7980,23000,751,2346,5492,15774,6243,18120
292303,201911,2905,8329,2532,7732,77,212,2107,6464,2184,6676
292305,201911,2369,6331,2183,6066,46,218,1957,5330,2003,5548
292310,201911,6747,17016,5788,15837,156,538,5001,13517,5157,14055
292320,201911,6109,16633,4826,14253,241,782,3563,10260,3804,11042
292330,201911,2813,6106,2203,5419,102,226,1701,4339,1803,4565
292335,201911,4778,12289,4230,11500,239,574,3563,9748,3802,10322
292340,201911,5719,15848,4691,13873,221,662,3473,10168,3694,10830
292350,201911,2529,6766,2078,6152,77,284,1671,4949,1748,5233
292360,201911,4861,13049,4012,11574,245,815,2835,7936,3080,8751
292370,201911,10742,24729,9142,22588,138,478,8436,20500,8574,20978
292380,201911,6881,19169,6103,17770,423,1248,4614,13340,5037,14588
292390,201911,4440,8602,3240,7197,97,180,2847,6348,2944,6528
292400,201911,22232,63587,19135,58546,1785,5659,13174,40296,14959,45955
292405,201911,4177,10446,3503,9399,111,303,2862,7594,2973,7897
292410,201911,2173,5164,1855,4770,69,165,1642,4239,1711,4404
292420,201911,3555,10739,3220,10196,123,618,2734,8413,2857,9031
292430,201911,4857,14490,3660,12291,312,1086,2367,7919,2679,9005
292440,201911,8491,26916,7813,25867,137,705,6944,22875,7081,23580
292450,201911,3952,11358,3084,9631,98,395,2400,7445,2498,7840
292460,201911,4868,13378,3953,11805,366,1072,2821,8426,3187,9498
292465,201911,2608,6812,2181,6232,90,195,1497,4626,1587,4821
292467,201911,1873,5261,1659,4967,244,649,1135,3535,1379,4184
292470,201911,3009,7601,2308,6494,61,136,1798,5065,1859,5201
292480,201911,6373,15126,5074,13548,66,265,4577,12096,4643,12361
292490,201911,2092,5464,1728,4917,113,286,1286,3736,1399,4022
292500,201911,6558,17944,5243,15563,538,1676,3398,9953,3936,11629
292510,201911,12748,34347,9989,30092,518,1923,7165,21482,7683,23405
292520,201911,6957,17361,6112,16127,493,1367,4701,12274,5194,13641
292525,201911,5897,13976,4790,12725,109,296,4166,11180,4275,11476
292530,201911,27224,72581,20756,61581,5328,15926,7831,23866,13159,39792
292540,201911,4294,8049,3371,7049,115,193,3007,6317,3122,6510
292550,201911,8340,21745,6314,19260,465,1442,4557,14559,5022,16001
292560,201911,4283,10782,3669,9973,80,263,3024,8208,3104,8471
292570,201911,3665,9612,3072,8580,78,298,2576,6988,2654,7286
292575,201911,7023,19964,6400,19110,374,1096,5134,15470,5508,16566
292580,201911,7546,18976,6253,17063,139,465,5244,14154,5383,14619
292590,201911,7405,19694,6330,17855,239,783,5310,14656,5549,15439
292593,201911,2844,7001,2334,6142,71,174,1954,5112,2025,5286
292595,201911,5491,14572,4680,13569,158,526,3901,11216,4059,11742
292600,201911,11052,29905,9427,27404,315,883,7446,21707,7761,22590
292610,201911,4122,10763,3455,9582,201,471,2570,7236,2771,7707
292620,201911,6583,17779,5394,16356,123,299,4945,15246,5068,15545
292630,201911,8498,20778,6834,18109,654,1745,4495,11944,5149,13689
292640,201911,8169,24136,7106,22380,199,839,5026,15896,5225,16735
292650,201911,4531,11083,4042,10435,106,295,3677,9364,3783,9659
292660,201911,11399,30666,9647,28054,450,1452,7410,21485,7860,22937
292665,201911,2180,6444,1899,6078,70,202,1598,5191,1668,5393
292670,201911,3574,9598,2721,8002,119,386,1842,5319,1961,5705
292680,201911,3978,10527,3119,8983,206,547,2257,6375,2463,6922
292690,201911,2659,6847,1816,5447,199,562,1077,3390,1276,3952
292700,201911,9881,26823,8548,24776,756,2026,5835,17398,6591,19424
292710,201911,2463,7655,2268,7384,49,179,2030,6657,2079,6836
292720,201911,9040,21500,7600,19841,233,641,6036,16003,6269,16644
292730,201911,4494,10380,4218,10047,205,313,3718,9023,3923,9336
292740,201911,325015,789373,280652,723623,40652,105430,173678,444734,214330,550164
292750,201911,6213,16546,5396,15342,241,696,4130,11894,4371,12590
292760,201911,3936,11308,3405,10352,231,783,2491,7485,2722,8268
292770,201911,6069,16195,4839,14424,782,2426,2952,9020,3734,11446
292780,201911,2070,4205,1528,3509,41,139,1222,2659,1263,2798
292790,201911,4098,8721,3131,7668,157,411,2611,6406,2768,6817
292800,201911,11201,28065,9571,25587,322,934,7964,20978,8286,21912
292805,201911,3482,8443,2716,7416,111,344,2132,5753,2243,6097
292810,201911,10780,28305,8461,24687,220,931,6308,17822,6528,18753
292820,201911,7551,20622,5399,17055,479,1603,3689,11455,4168,13058
292830,201911,2917,6851,2473,6297,92,297,2102,5329,2194,5626
292840,201911,8834,23047,7464,21159,157,632,6466,17942,6623,18574
292850,201911,2487,6571,2073,5958,143,438,1453,4140,1596,4578
292860,201911,17111,37750,15267,35483,509,1258,13021,29851,13530,31109
292870,201911,17741,44235,15184,40550,963,2722,10231,26961,11194,29683
292880,201911,11086,30064,9440,27579,302,1244,7404,20887,7706,22131
292890,201911,6985,19409,6120,18125,206,854,5263,15414,5469,16268
292895,201911,2968,6412,2155,5186,88,220,1738,4127,1826,4347
292900,201911,2617,7082,2388,6714,63,252,1942,5292,2005,5544
292905,201911,4396,11387,3428,9955,153,519,2513,7198,2666,7717
292910,201911,4920,13337,4446,12657,233,677,3375,9521,3608,10198
292920,201911,9751,26723,9011,25639,262,995,7784,21722,8046,22717
292925,201911,5433,15281,4513,13636,225,691,3291,9784,3516,10475
292930,201911,6541,19250,5534,17302,475,1709,3489,10559,3964,12268
292935,201911,2416,6141,1876,5536,29,145,1676,4960,1705,5105
292937,201911,2988,7261,2581,6728,60,183,2277,5899,2337,6082
292940,201911,2910,7367,2294,6434,189,452,1655,4794,1844,5246
292950,201911,9659,24483,8394,22541,527,1299,6312,16858,6839,18157
292960,201911,5260,12671,4392,11448,130,361,3510,9022,3640,9383
292970,201911,3806,11030,3340,10313,86,418,2780,8587,2866,9005
292975,201911,4567,9732,4026,9115,150,272,3634,8327,3784,8599
292980,201911,3325,8020,2659,7017,90,278,2139,5529,2229,5807
292990,201911,11508,31258,9527,27743,663,2070,6954,19908,7617,21978
293000,201911,2589,6190,2207,5611,39,146,1742,4424,1781,4570
293010,201911,18107,46374,14447,40491,1964,5711,8799,24563,10763,30274
293015,201911,8148,24966,6360,21467,424,1566,4296,14624,4720,16190
293020,201911,9893,28623,8848,27115,129,629,7918,24364,8047,24993
293030,201911,5344,14143,4024,12112,103,353,2776,8560,2879,8913
293040,201911,4032,11037,3396,10145,70,269,2938,8768,3008,9037
293050,201911,21970,54522,19402,50734,977,2762,14719,37858,15696,40620
293060,201911,3449,9124,2798,7950,251,747,1934,5391,2185,6138
293070,201911,25259,61072,21359,55947,2148,5903,14997,39276,17145,45179
293075,201911,3435,10883,2984,10129,174,734,2361,7998,2535,8732
293076,201911,3624,8846,3239,8373,69,187,2839,7388,2908,7575
293077,201911,6131,16968,4878,14970,444,1486,3143,9860,3587,11346
293080,201911,4748,13977,4049,12788,100,454,3242,10034,3342,10488
293090,201911,3236,9385,2451,8082,204,704,1628,5379,1832,6083
293100,201911,5666,15207,4620,13323,215,672,3607,10245,3822,10917
293105,201911,3697,11680,3235,10729,228,801,2306,7566,2534,8367
293110,201911,2400,5968,1986,5348,64,239,1640,4294,1704,4533
293120,201911,4373,11940,3862,11107,114,316,3209,9221,3323,9537
293130,201911,3760,10312,3277,9670,81,322,2813,8217,2894,8539
293135,201911,30253,71304,22030,60023,3390,10026,10409,28482,13799,38508
293140,201911,2377,5296,2041,4874,66,151,1704,4057,1770,4208
293150,201911,5354,15972,4427,14204,356,1198,3042,9771,3398,10969
293160,201911,3832,9336,3258,8702,242,418,2713,7594,2955,8012
293170,201911,4786,10171,4125,9340,126,281,3568,8019,3694,8300
293180,201911,4320,12139,3533,10721,104,429,2787,8220,2891,8649
293190,201911,13995,38278,12255,35772,170,733,10777,31277,10947,32010
293200,201911,8216,20447,6613,17933,202,759,5277,13983,5479,14742
293210,201911,5240,13822,4432,12555,302,853,3374,9549,3676,10402
293220,201911,5042,13091,3700,10795,883,2560,1444,4336,2327,6896
293230,201911,3944,10124,2905,8613,211,701,1996,5972,2207,6673
293240,201911,4447,11737,3550,10277,72,192,2711,8110,2783,8302
293245,201911,3815,10303,3414,9731,153,506,2874,8057,3027,8563
293250,201911,5828,13593,4801,12276,154,395,4032,10277,4186,10672
293260,201911,4463,12077,3630,10785,133,425,2536,7527,2669,7952
293270,201911,7151,15897,5665,14289,414,648,4411,11917,4825,12565
293280,201911,4584,11998,3977,11150,249,611,3084,8713,3333,9324
293290,201911,14039,41633,12354,38938,1868,5963,7778,24897,9646,30860
293300,201911,5826,14086,4969,12821,296,754,3625,9375,3921,10129
293305,201911,4002,9737,3467,9049,43,126,3114,8091,3157,8217
293310,201911,2167,5516,1786,4896,50,151,1400,3774,1450,3925
293315,201911,4073,9788,3318,8636,184,437,2717,7063,2901,7500
293317,201911,2575,6154,2262,5712,155,310,1768,4511,1923,4821
293320,201911,11684,28700,10452,27291,284,792,9258,24053,9542,24845
293325,201911,1754,4403,1367,3872,186,528,864,2462,1050,2990
293330,201911,50162,147383,40763,130349,8278,27105,18461,59928,26739,87033
293340,201911,2227,6256,1842,5575,94,311,1296,3870,1390,4181
293345,201911,3436,9368,2725,8307,344,816,1814,5989,2158,6805
293350,201911,6675,18992,5773,17933,61,286,5277,16598,5338,16884
293360,201911,15522,38558,13082,35348,320,1330,11445,30320,11765,31650
310010,201911,933,2113,586,1627,45,162,210,526,255,688
310020,201911,2246,6302,1593,5093,346,1223,293,884,639,2107
310030,201911,1926,5483,1477,4679,224,777,909,2772,1133,3549
310040,201911,928,2436,735,2100,35,141,493,1319,528,1460
310050,201911,1504,4553,1282,4197,142,583,815,2562,957,3145
310060,201911,3200,9034,2760,8455,103,424,2251,6805,2354,7229
310070,201911,343,778,236,620,6,14,180,472,186,486
310080,201911,743,1971,502,1515,80,283,215,597,295,880
310090,201911,4639,12442,3760,10978,302,959,2707,7761,3009,8720
310100,201911,3348,9434,2799,8496,85,385,2242,6608,2327,6993
310110,201911,4690,12434,3603,10503,777,2458,1534,4275,2311,6733
310120,201911,639,1574,405,1190,47,163,238,636,285,799
310130,201911,372,976,310,882,32,122,218,585,250,707
310140,201911,258,737,181,602,38,145,71,209,109,354
310150,201911,5216,13884,3807,11216,541,1853,1752,4847,2293,6700
310160,201911,7461,18842,5237,15135,1049,3293,1833,5298,2882,8591
310163,201911,1015,3030,804,2616,193,714,259,771,452,1485
310170,201911,9005,23246,7133,20250,612,1792,5036,14254,5648,16046
310180,201911,1747,4368,1264,3569,153,482,765,2060,918,2542
310190,201911,2587,7607,2025,6567,463,1693,312,909,775,2602
310200,201911,1821,5449,1298,4372,216,833,560,1852,776,2685
310205,201911,1113,3089,828,2625,154,542,357,1117,511,1659
310210,201911,2638,7049,2120,6125,116,368,1554,4366,1670,4734
310220,201911,1177,3223,902,2717,100,336,591,1712,691,2048
310230,201911,2203,6191,1759,5316,233,793,1065,2998,1298,3791
310240,201911,899,2819,753,2553,50,195,533,1778,583,1973
310250,201911,1022,2744,811,2398,20,80,580,1683,600,1763
310260,201911,2862,7465,1734,5440,506,1855,434,1016,940,2871
310270,201911,2718,6774,2106,5933,100,360,1714,4800,1814,5160
310280,201911,2341,5514,1790,4706,293,812,982,2466,1275,3278
310285,201911,1863,5972,1544,5375,172,682,938,3222,1110,3904
310290,201911,1116,2942,900,2550,204,675,478,1201,682,1876
310300,201911,1454,4293,1237,3908,152,607,703,2057,855,2664
310310,201911,307,770,192,557,33,100,101,286,134,386
310320,201911,512,1329,335,1028,25,95,180,533,205,628
310330,201911,478,1122,281,771,42,139,114,272,156,411
310340,201911,7715,21093,6155,18410,908,2655,3020,9278,3928,11933
310350,201911,12327,29816,8173,22967,1620,4824,3458,9417,5078,14241
310360,201911,479,1100,352,934,11,33,250,658,261,691
310370,201911,1262,3951,1045,3526,217,799,333,1135,550,1934
310375,201911,829,2074,557,1668,87,273,285,845,372,1118
310380,201911,375,837,198,551,32,96,91,233,123,329
310390,201911,435,1315,345,1138,85,307,97,269,182,576
310400,201911,9577,23365,6631,18826,743,2458,3918,10800,4661,13258
310410,201911,863,2492,556,1906,96,353,195,622,291,975
310420,201911,4197,10786,2725,7900,389,1281,1051,2778,1440,4059
310430,201911,1478,4022,943,2999,202,727,326,917,528,1644
310440,201911,639,1663,433,1271,40,145,236,655,276,800
310445,201911,1321,3832,966,3120,46,167,694,2204,740,2371
310450,201911,4746,11919,3524,9949,153,577,2640,7197,2793,7774
310460,201911,1574,4152,1083,3228,191,618,349,985,540,1603
310470,201911,3793,8293,2917,7155,298,731,2071,5147,2369,5878
310480,201911,905,2373,689,1981,86,269,441,1236,527,1505
310490,201911,2819,7732,2165,6593,258,958,1164,3302,1422,4260
310500,201911,1371,3916,996,3252,177,664,502,1580,679,2244
310510,201911,2022,5316,1245,3835,250,870,447,1374,697,2244
310520,201911,1194,3103,854,2498,140,386,450,1309,590,1695
310530,201911,743,1904,417,1266,63,236,128,311,191,547
310540,201911,3057,8755,2510,7794,564,1844,1123,3353,1687,5197
310550,201911,1225,3157,830,2469,68,252,477,1336,545,1588
310560,201911,14411,37876,10109,30199,1654,5619,4013,10752,5667,16371
310570,201911,1052,2780,827,2460,62,228,584,1703,646,1931
310590,201911,4053,10846,3213,9296,219,741,1846,5035,2065,5776
310600,201911,1334,3955,1069,3416,156,569,548,1624,704,2193
310610,201911,478,1253,292,939,49,169,148,446,197,615
310620,201911,169866,433913,120924,344174,18906,62067,57080,145888,75986,207955
310630,201911,4352,11993,3441,10242,287,972,2190,6271,2477,7243
310640,201911,1012,3039,824,2652,183,640,325,986,508,1626
310650,201911,2413,6968,1722,5619,186,651,966,3055,1152,3706
310660,201911,1261,3437,1039,3151,36,132,877,2628,913,2760
310665,201911,1369,3558,1083,3141,31,123,899,2598,930,2721
310670,201911,53788,139973,44846,124320,4477,14373,30357,79851,34834,94224
310680,201911,729,1762,591,1563,15,60,486,1238,501,1298
310690,201911,1800,4777,1289,3897,115,404,717,2048,832,2452
310700,201911,491,1088,385,963,29,92,290,698,319,790
310710,201911,5376,15426,3809,13130,882,3521,570,1825,1452,5346
310720,201911,959,2307,741,2021,39,134,540,1422,579,1556
310730,201911,9625,26198,8209,23915,372,1407,6083,17305,6455,18712
310740,201911,5780,16065,3798,11832,650,2218,1265,3614,1915,5832
310750,201911,1210,2901,861,2385,119,369,414,1065,533,1434
310760,201911,547,1435,392,1205,22,70,215,671,237,741
310770,201911,1079,2970,732,2420,83,326,362,1105,445,1431
310780,201911,4271,10358,3538,9292,77,233,2826,7410,2903,7643
310790,201911,1798,5717,1539,5156,365,1305,257,789,622,2094
310800,201911,2185,6508,1548,5185,368,1452,102,281,470,1733
310810,201911,1149,2948,920,2510,45,138,647,1711,692,1849
310820,201911,1165,3023,682,2171,151,519,160,505,311,1024
310825,201911,2465,7686,1969,6823,79,471,1549,5158,1628,5629
310830,201911,1623,4681,1103,3593,221,831,452,1361,673,2192
310840,201911,1887,5168,1322,4196,363,1280,313,867,676,2147
310850,201911,1493,4100,1244,3749,47,247,960,2742,1007,2989
310855,201911,3144,8335,2408,7136,174,596,1677,4835,1851,5431
310860,201911,6875,19936,5460,17113,532,1787,3341,10522,3873,12309
310870,201911,1012,2406,759,2028,60,151,553,1491,613,1642
310880,201911,986,2949,759,2484,99,337,453,1435,552,1772
310890,201911,2288,6541,1422,4758,277,1002,210,590,487,1592
310900,201911,3881,10886,2555,7908,370,1193,1091,3123,1461,4316
310910,201911,1976,4945,1317,3831,112,398,246,636,358,1034
310920,201911,1875,4933,1411,4201,199,630,782,2277,981,2907
310925,201911,947,2620,751,2285,82,287,495,1432,577,1719
310930,201911,5683,15092,4010,12359,794,2523,1893,6022,2687,8545
310940,201911,6446,15668,5093,13628,204,731,3819,9851,4023,10582
310945,201911,1269,3327,985,2870,113,367,559,1592,672,1959
310950,201911,1884,5609,1196,4020,222,837,413,1223,635,2060
310960,201911,749,2001,406,1277,76,273,94,266,170,539
310970,201911,1132,3362,775,2580,201,718,148,454,349,1172
310980,201911,287,695,184,529,17,59,117,326,134,385
310990,201911,1258,3529,951,2972,168,549,468,1434,636,1983
311000,201911,3984,11205,2882,9305,707,2459,1177,3662,1884,6121
311010,201911,855,2540,680,2171,212,757,272,833,484,1590
311020,201911,1003,2613,625,1914,43,139,335,1009,378,1148
311030,201911,1579,3967,1063,3079,196,658,498,1326,694,1984
311040,201911,303,944,236,785,72,258,67,204,139,462
311050,201911,2696,6717,1995,5667,372,1195,981,2668,1353,3863
311060,201911,2979,7732,2085,5990,312,1038,812,2120,1124,3158
311070,201911,2234,5649,1582,4585,186,678,808,2189,994,2867
311080,201911,1060,2478,858,2148,44,158,659,1549,703,1707
311090,201911,1995,6385,1548,5539,347,1399,465,1627,812,3026
311100,201911,2191,6316,1278,4403,254,998,216,651,470,1649
311110,201911,3672,7566,1995,5201,373,1032,741,1973,1114,3005
311115,201911,1323,3098,1082,2765,69,185,866,2167,935,2352
311120,201911,6388,16828,4703,13699,717,2368,1725,4412,2442,6780
311130,201911,1873,4897,1392,4214,117,458,762,2222,879,2680
311140,201911,1360,3365,1019,2889,79,262,659,1836,738,2098
311150,201911,1520,4805,1176,4125,194,765,624,2115,818,2880
311160,201911,3591,10360,2453,8202,619,2343,731,2359,1350,4702
311170,201911,876,2245,684,1975,37,103,433,1314,470,1417
311180,201911,1321,2976,808,2198,155,453,363,977,518,1430
311190,201911,936,2570,675,2054,115,395,263,706,378,1101
311200,201911,1908,5189,1324,4039,279,934,452,1233,731,2167
311205,201911,863,2620,702,2290,43,198,429,1331,472,1529
311210,201911,1013,2950,874,2769,119,344,634,2060,753,2404
311220,201911,740,2079,607,1840,51,173,370,1063,421,1236
311230,201911,7614,22992,5638,18928,1002,3539,2110,7215,3112,10754
311240,201911,989,2610,751,2269,154,501,327,975,481,1476
311250,201911,960,2762,728,2316,180,545,289,901,469,1446
311260,201911,2515,6257,1551,4543,246,798,651,1755,897,2553
311265,201911,1301,3405,947,2800,44,174,659,1869,703,2043
311270,201911,2957,8824,2552,8136,164,716,1868,5683,2032,6399
311280,201911,1126,2903,493,1603,100,357,50,143,150,500
311290,201911,1834,5587,1667,5236,156,517,1132,3542,1288,4059
311300,201911,4656,13175,3786,11672,212,902,2957,8880,3169,9782
311310,201911,559,1564,466,1397,40,124,266,768,306,892
311320,201911,3089,9495,2597,8374,397,1482,1199,3535,1596,5017
311330,201911,4877,13022,3876,11349,439,1421,2158,6412,2597,7833
311340,201911,10128,28704,7872,24590,2187,7386,2028,5993,4215,13379
311350,201911,2262,5688,1551,4381,147,485,849,2143,996,2628
311360,201911,1119,2757,690,2059,205,687,214,587,419,1274
311370,201911,4542,11150,3291,9126,159,640,2140,5597,2299,6237
311380,201911,358,1110,263,912,68,241,103,368,171,609
311390,201911,1677,5165,1298,4623,561,2290,305,926,866,3216
311400,201911,1371,3813,979,3055,138,450,395,1117,533,1567
311410,201911,1572,4650,1288,4256,201,774,728,2396,929,3170
311420,201911,1441,4224,962,3202,172,628,213,577,385,1205
311430,201911,3685,9844,2355,7157,481,1494,707,2158,1188,3652
311440,201911,2528,7222,1797,5953,379,1498,563,1774,942,3272
311450,201911,1677,5072,1189,4130,306,1188,310,926,616,2114
311455,201911,979,2224,646,1730,168,458,244,676,412,1134
311460,201911,476,1485,311,1134,69,328,82,255,151,583
311470,201911,471,1489,310,1100,76,313,42,142,118,455
311480,201911,1073,2828,892,2558,57,162,686,1983,743,2145
311490,201911,229,673,173,562,35,138,79,224,114,362
311500,201911,420,1044,314,886,27,86,193,521,220,607
311510,201911,3090,8153,2033,6260,297,1022,823,2371,1120,3393
311520,201911,569,1653,505,1521,73,268,291,835,364,1103
311530,201911,8667,20221,5308,14726,1295,3977,1372,3637,2667,7614
311535,201911,769,2099,486,1514,78,262,169,480,247,742
311540,201911,500,1565,437,1447,86,309,269,873,355,1182
311545,201911,2038,5821,1738,5375,91,347,1332,4037,1423,4384
311547,201911,1460,3776,1259,3458,49,144,872,2442,921,2586
311550,201911,2682,7603,2098,6478,324,1137,893,2630,1217,3767
311560,201911,287,635,179,476,22,72,99,230,121,302
311570,201911,1750,4072,1225,3344,46,138,958,2659,1004,2797
311580,201911,2177,4039,1403,3126,138,288,954,2138,1092,2426
311590,201911,486,1290,389,1152,61,203,210,607,271,810
311600,201911,1757,3929,1481,3586,52,120,1280,3054,1332,3174
311610,201911,2222,7359,1817,6443,225,864,982,3444,1207,4308
311615,201911,3014,8753,2436,7757,128,490,1891,5898,2019,6388
311620,201911,435,1155,373,1079,11,42,310,889,321,931
311630,201911,1317,3640,1047,3099,88,290,691,1959,779,2249
311640,201911,554,1534,416,1279,62,223,197,562,259,785
311650,201911,1831,4783,1504,4265,128,413,1014,2792,1142,3205
311660,201911,2737,7816,1941,6261,358,1277,499,1373,857,2650
311670,201911,1507,3980,1079,3217,161,546,463,1379,624,1925
311680,201911,2117,6104,1557,5069,185,613,995,3230,1180,3843
311690,201911,585,1255,446,1080,41,88,324,825,365,913
311700,201911,2233,5380,1726,4661,30,142,1446,3783,1476,3925
311710,201911,1487,4278,1026,3414,244,893,392,1272,636,2165
311720,201911,391,1182,309,1027,23,94,177,572,200,666
311730,201911,3862,9847,2407,7096,724,2296,454,1353,1178,3649
311740,201911,839,2266,699,2093,32,86,610,1866,642,1952
311750,201911,3779,11474,3048,10150,433,1593,1718,5471,2151,7064
311760,201911,589,1692,483,1502,69,274,232,622,301,896
311770,201911,2005,5818,1540,4957,263,915,708,2175,971,3090
311780,201911,1257,3632,812,2705,174,653,232,677,406,1330
311783,201911,2206,6087,1775,5327,48,217,1408,4065,1456,4282
311787,201911,685,1979,494,1535,74,256,198,518,272,774
311790,201911,1452,3917,919,2931,247,867,247,748,494,1615
311800,201911,4742,14232,3776,12134,802,2761,644,1812,1446,4573
311810,201911,941,2885,735,2505,59,233,466,1558,525,1791
311820,201911,774,1916,564,1574,77,249,340,894,417,1143
311830,201911,8333,24098,5509,17893,1554,5441,653,2036,2207,7477
311840,201911,3391,8825,2783,7930,265,789,2019,5711,2284,6500
311850,201911,326,888,262,765,14,41,175,495,189,536
311860,201911,56002,142173,42034,118147,6409,19405,23133,62152,29542,81557
311870,201911,1884,5018,1232,3813,206,703,457,1276,663,1979
311880,201911,6215,16157,5169,14685,292,778,3887,11195,4179,11973
311890,201911,1584,3909,1219,3375,83,280,863,2277,946,2557
311900,201911,722,1891,531,1616,55,199,360,1067,415,1266
311910,201911,4190,10779,3115,9353,557,1668,1546,4752,2103,6420
311920,201911,2008,5470,1578,4823,116,327,989,3076,1105,3403
311930,201911,3477,8324,2474,6878,809,2419,733,1922,1542,4341
311940,201911,14341,38093,10353,30424,1522,4972,4753,13052,6275,18024
311950,201911,2160,5995,1587,4997,90,395,1031,3168,1121,3563
311960,201911,488,1217,390,1066,25,104,249,608,274,712
311970,201911,431,1404,290,1045,52,209,63,200,115,409
311980,201911,434,1180,218,741,27,98,66,222,93,320
311990,201911,548,1282,343,979,71,250,147,369,218,619
311995,201911,945,2638,468,1509,21,67,62,149,83,216
312000,201911,605,1612,497,1453,48,152,326,948,374,1100
312010,201911,916,2583,696,2191,53,190,426,1293,479,1483
312015,201911,1348,4013,1179,3722,61,290,924,2821,985,3111
312020,201911,1304,3992,993,3375,222,795,267,866,489,1661
312030,201911,2012,5007,1745,4702,25,100,1607,4309,1632,4409
312040,201911,739,2269,545,1850,66,240,254,850,320,1090
312050,201911,1184,3760,930,3242,211,852,275,850,486,1702
312060,201911,867,2138,561,1752,145,443,254,813,399,1256
312070,201911,861,2520,602,1996,58,212,301,950,359,1162
312080,201911,2679,6587,1974,5539,115,380,1260,3365,1375,3745
312083,201911,851,2233,627,1885,58,208,405,1160,463,1368
312087,201911,2390,6321,1937,5598,48,164,1524,4388,1572,4552
312090,201911,9563,25482,7259,21697,1141,3811,3499,10180,4640,13991
312100,201911,1496,4453,1118,3749,106,466,601,1935,707,2401
312110,201911,986,3089,811,2720,198,775,277,818,475,1593
312120,201911,776,2121,521,1667,155,575,159,421,314,996
312125,201911,1703,4421,1394,3965,122,403,1022,2790,1144,3193
312130,201911,954,2344,705,1929,55,163,294,740,349,903
312140,201911,707,2051,574,1783,120,419,255,725,375,1144
312150,201911,452,1281,378,1119,14,65,268,730,282,795
312160,201911,7976,22266,5906,18517,771,2827,2816,8309,3587,11136
312170,201911,889,2425,669,1985,40,148,441,1263,481,1411
312180,201911,1335,3629,1037,3037,155,485,514,1446,669,1931
312190,201911,592,1681,411,1316,75,265,123,371,198,636
312200,201911,4642,12563,3625,10920,1091,3284,1312,4036,2403,7320
312210,201911,1324,3040,933,2458,35,109,688,1773,723,1882
312220,201911,1710,5294,1457,4811,113,411,913,3007,1026,3418
312230,201911,12301,32312,7882,24043,1976,6716,1524,4025,3500,10741
312235,201911,1880,4888,1480,4265,86,318,1064,2978,1150,3296
312240,201911,676,2213,501,1829,113,463,136,473,249,936
312245,201911,2545,6750,2061,5998,63,213,1664,4813,1727,5026
312247,201911,913,2290,633,1861,123,387,316,934,439,1321
312250,201911,975,2593,614,1861,80,251,238,712,318,963
312260,201911,861,2404,675,2112,41,171,493,1486,534,1657
312270,201911,692,1900,522,1577,30,131,286,780,316,911
312280,201911,418,1226,315,1035,97,327,45,137,142,464
312290,201911,724,2160,573,1871,117,438,187,578,304,1016
312300,201911,966,2946,625,2091,163,593,116,319,279,912
312310,201911,807,2558,640,2203,111,415,288,955,399,1370
312320,201911,1865,4877,1320,3884,330,1009,290,835,620,1844
312330,201911,847,2521,663,2141,64,221,412,1298,476,1519
312340,201911,265,691,185,555,44,158,73,191,117,349
312350,201911,252,525,181,446,16,50,127,296,143,346
312352,201911,1611,4800,1410,4440,92,307,868,2893,960,3200
312360,201911,2518,7388,1794,5913,363,1301,523,1653,886,2954
312370,201911,1768,4730,1424,4133,194,629,797,2194,991,2823
312380,201911,2150,4864,1761,4374,8,30,1566,3849,1574,3879
312385,201911,1234,3416,927,2840,157,509,434,1306,591,1815
312390,201911,1860,5395,1362,4437,205,773,491,1437,696,2210
312400,201911,2795,8218,2266,7230,701,2380,709,2243,1410,4623
312410,201911,11337,31594,9130,27773,1649,5197,4918,14777,6567,19974
312420,201911,3627,10081,2994,8985,560,1829,1573,4590,2133,6419
312430,201911,7692,20592,6192,17886,422,1433,4282,12031,4704,13464
312440,201911,877,2843,670,2361,368,1351,73,227,441,1578
312450,201911,1130,3375,853,2874,251,908,282,976,533,1884
312460,201911,430,1136,290,918,36,127,151,491,187,618
312470,201911,472,1148,296,834,36,115,117,290,153,405
312480,201911,1063,2649,724,2141,100,311,347,984,447,1295
312490,201911,2052,5022,1535,4238,209,598,823,2216,1032,2814
312500,201911,937,2342,746,2061,47,167,508,1381,555,1548
312510,201911,3593,9639,2567,7680,690,1975,699,2133,1389,4108
312520,201911,162,467,129,407,34,114,52,160,86,274
312530,201911,587,1438,495,1323,15,54,436,1170,451,1224
312540,201911,1511,4319,992,3215,154,550,524,1634,678,2184
312550,201911,740,2009,551,1618,35,125,359,965,394,1090
312560,201911,1949,5014,1558,4409,72,231,1195,3391,1267,3622
312570,201911,2100,5273,1581,4609,448,1371,628,1845,1076,3216
312580,201911,605,1697,430,1321,58,210,201,564,259,774
312590,201911,1597,4732,1270,4068,92,413,774,2292,866,2705
312595,201911,1796,5451,1513,4949,281,871,883,3035,1164,3906
312600,201911,1080,2651,526,1661,102,383,127,403,229,786
312610,201911,6089,15536,3770,11091,566,1796,1309,3603,1875,5399
312620,201911,2513,6511,1799,5519,53,248,1434,4451,1487,4699
312630,201911,265,800,193,668,34,145,77,253,111,398
312640,201911,518,1433,346,1133,45,146,127,434,172,580
312650,201911,2065,5381,1383,4060,71,227,958,2683,1029,2910
312660,201911,1311,3230,970,2644,77,260,659,1697,736,1957
312670,201911,4807,12891,3958,11522,177,790,2841,7858,3018,8648
312675,201911,1221,3280,982,2904,57,199,782,2283,839,2482
312680,201911,1368,3900,1136,3533,60,271,922,2766,982,3037
312690,201911,2753,5961,2139,5214,60,168,1775,4320,1835,4488
312695,201911,945,2630,778,2341,36,97,594,1797,630,1894
312700,201911,2043,5435,1467,4373,151,525,844,2376,995,2901
312705,201911,1320,3311,1107,2968,21,74,968,2569,989,2643
312707,201911,1363,4021,1037,3424,68,330,649,2014,717,2344
312710,201911,6473,14874,3717,10471,986,2999,1032,3003,2018,6002
312720,201911,1048,2866,776,2412,100,341,474,1415,574,1756
312730,201911,1630,3891,1158,3233,91,296,677,1813,768,2109
312733,201911,1394,3681,1034,2999,40,157,702,1926,742,2083
312735,201911,622,1709,520,1512,68,226,331,857,399,1083
312737,201911,804,1854,534,1448,70,207,317,815,387,1022
312738,201911,612,1587,425,1259,43,146,228,636,271,782
312740,201911,424,1047,238,725,57,192,58,143,115,335
312750,201911,1410,4297,1111,3729,202,747,460,1438,662,2185
312760,201911,1799,5356,1247,4180,222,805,447,1430,669,2235
312770,201911,43304,104304,26000,74504,5593,17038,8554,23990,14147,41028
312780,201911,2413,7289,2026,6635,229,837,1307,4236,1536,5073
312790,201911,255,610,135,417,9,42,45,107,54,149
312800,201911,4877,13994,3680,11640,921,3090,1226,3770,2147,6860
312810,201911,1594,4237,1020,3271,248,894,347,993,595,1887
312820,201911,1737,4729,1378,4054,45,174,1022,2920,1067,3094
312825,201911,1322,3137,1124,2867,25,89,950,2366,975,2455
312830,201911,2780,7877,1550,5267,333,1259,371,1189,704,2448
312840,201911,1234,3471,936,2929,113,446,456,1335,569,1781
312850,201911,882,2166,605,1742,27,115,359,949,386,1064
312860,201911,1216,3094,796,2452,208,669,181,525,389,1194
312870,201911,6043,16433,3566,11520,625,2209,807,2474,1432,4683
312880,201911,1405,3541,1073,2980,40,152,618,1705,658,1857
312890,201911,2138,5526,1479,4348,109,321,758,2253,867,2574
312900,201911,1164,2991,929,2695,78,251,529,1654,607,1905
312910,201911,1582,2942,799,1895,139,281,330,759,469,1040
312920,201911,974,2661,653,2094,126,478,259,750,385,1228
312930,201911,2175,5464,1670,4710,365,1046,755,2121,1120,3167
312940,201911,933,2609,721,2282,82,315,353,1055,435,1370
312950,201911,3125,7829,1981,5915,525,1716,620,1749,1145,3465
312960,201911,1784,4783,1490,4323,77,204,1151,3428,1228,3632
312965,201911,1631,4644,1343,4173,118,401,919,2790,1037,3191
312970,201911,1219,3495,943,3031,160,610,499,1489,659,2099
312980,201911,22104,61643,17564,53281,3242,10861,8749,24887,11991,35748
312990,201911,453,1183,276,864,52,188,123,366,175,554
313000,201911,464,1332,342,1101,32,137,197,585,229,722
313005,201911,2494,7225,2082,6517,150,480,1487,4595,1637,5075
313010,201911,4732,13257,3764,11623,688,2345,2161,6489,2849,8834
313020,201911,928,2846,610,2096,107,398,111,323,218,721
313030,201911,1115,2633,734,2049,68,250,476,1250,544,1500
313040,201911,775,2409,618,2056,47,195,362,1139,409,1334
313050,201911,1703,4802,1173,3985,198,811,365,1098,563,1909
313055,201911,1865,5102,1660,4791,62,207,1398,3991,1460,4198
313060,201911,961,2340,645,1822,189,611,143,319,332,930
313065,201911,1612,4900,1395,4525,61,257,1049,3306,1110,3563
313070,201911,946,2498,700,2056,67,207,407,1167,474,1374
313080,201911,374,1038,259,797,51,183,93,240,144,423
313090,201911,4862,13220,4130,12006,389,1307,2690,7678,3079,8985
313100,201911,1328,3458,1010,2988,32,137,760,2182,792,2319
313110,201911,1453,3888,1020,3102,96,364,572,1606,668,1970
313115,201911,2421,7110,1953,6199,273,952,1018,3046,1291,3998
313120,201911,3683,8688,2666,7341,245,779,1685,4600,1930,5379
313130,201911,29459,77374,22142,63515,2509,8148,12354,33379,14863,41527
313140,201911,582,1302,349,957,27,80,229,626,256,706
313150,201911,1335,3780,964,3058,272,933,255,739,527,1672
313160,201911,1032,2624,783,2218,30,108,582,1604,612,1712
313170,201911,11080,32028,7686,25353,1378,4923,2923,8999,4301,13922
313180,201911,2132,5666,1483,4385,184,575,831,2411,1015,2986
313190,201911,4156,11973,2927,9414,544,1874,1003,3003,1547,4877
313200,201911,1067,3026,923,2777,18,78,779,2257,797,2335
313210,201911,3691,10843,2996,9605,371,1354,1787,5506,2158,6860
313220,201911,1721,4555,1101,3343,173,594,429,1141,602,1735
313230,201911,2965,8287,2425,7640,62,234,1996,6384,2058,6618
313240,201911,9308,22969,5562,16818,980,3389,2314,6379,3294,9768
313250,201911,6039,17745,4535,14609,802,2650,2038,6446,2840,9096
313260,201911,599,1591,410,1236,54,206,188,530,242,736
313270,201911,5537,14325,4391,12636,600,1772,2850,8325,3450,10097
313280,201911,439,1246,273,892,39,138,111,347,150,485
313290,201911,916,2878,680,2469,228,891,214,749,442,1640
313300,201911,1557,4200,1099,3371,293,958,232,613,525,1571
313310,201911,1064,3187,800,2601,126,487,210,579,336,1066
313320,201911,2112,5615,1468,4556,269,943,616,1900,885,2843
313330,201911,4004,10659,3025,9164,164,671,1963,5874,2127,6545
313340,201911,1341,3048,939,2479,88,243,653,1720,741,1963
313350,201911,2384,6812,1503,4756,191,681,559,1554,750,2235
313360,201911,1309,3265,847,2494,140,491,427,1177,567,1668
313370,201911,1342,3839,1110,3374,137,503,616,1723,753,2226
313375,201911,1657,4303,968,3009,183,628,205,599,388,1227
313380,201911,5823,14814,4035,11430,762,2386,1823,4615,2585,7001
313390,201911,826,2654,715,2466,49,227,470,1545,519,1772
313400,201911,3660,9086,2800,7890,166,522,2153,5948,2319,6470
313410,201911,1281,3373,963,2792,67,239,697,1971,764,2210
313420,201911,14882,33368,7149,20113,1623,5064,1008,2767,2631,7831
313430,201911,893,2667,666,2191,120,473,271,795,391,1268
313440,201911,6128,13338,3954,10464,343,970,2490,6536,2833,7506
313450,201911,616,1702,427,1305,76,249,148,390,224,639
313460,201911,2094,6082,1663,5386,346,1273,771,2358,1117,3631
313470,201911,2841,7327,2212,6403,269,769,1374,4038,1643,4807
313480,201911,956,2749,509,1710,79,286,132,401,211,687
313490,201911,2311,5555,1036,3264,316,1119,142,443,458,1562
313500,201911,431,1262,329,1024,41,126,121,358,162,484
313505,201911,9698,25923,8231,23930,344,1255,6605,19111,6949,20366
313507,201911,1453,3848,1180,3420,27,108,933,2649,960,2757
313510,201911,12818,35568,10108,30456,1250,4055,4936,14456,6186,18511
313520,201911,13863,39660,11034,34668,646,2440,8067,24762,8713,27202
313530,201911,520,1537,383,1234,39,138,151,439,190,577
313535,201911,2332,6430,1958,5717,247,647,1245,3632,1492,4279
313540,201911,752,2249,574,1811,113,367,241,705,354,1072
313545,201911,1161,3865,963,3447,154,569,513,1768,667,2337
313550,201911,1703,5231,1393,4490,328,1181,692,2123,1020,3304
313560,201911,2616,5210,1921,4361,59,111,1613,3675,1672,3786
313570,201911,925,2779,745,2433,176,599,309,948,485,1547
313580,201911,5480,14565,4118,12270,521,1669,2323,6988,2844,8657
313590,201911,944,2747,747,2453,208,725,318,1099,526,1824
313600,201911,3804,10399,3155,9364,98,408,2618,7625,2716,8033
313610,201911,985,2515,788,2167,96,281,484,1267,580,1548
313620,201911,5388,14421,4157,12160,583,1849,2300,6439,2883,8288
313630,201911,8460,20628,5756,16503,619,2051,3307,9250,3926,11301
313640,201911,1027,2415,616,1860,171,524,205,647,376,1171
313650,201911,1697,5132,1365,4569,90,362,900,3023,990,3385
313652,201911,753,2417,675,2241,114,413,414,1334,528,1747
313655,201911,1133,2910,887,2583,43,141,700,2021,743,2162
313657,201911,1220,3251,948,2814,43,174,697,1955,740,2129
313660,201911,872,2462,698,2131,89,329,407,1165,496,1494
313665,201911,4557,12328,3438,10247,427,1419,2054,5852,2481,7271
313670,201911,47290,116689,29082,85113,4508,14471,12519,34466,17027,48937
313680,201911,1009,2711,828,2429,64,215,538,1524,602,1739
313690,201911,792,2521,595,2129,142,551,161,547,303,1098
313695,201911,1740,4799,1326,4120,83,270,902,2789,985,3059
313700,201911,2984,9647,2557,9070,266,1004,1894,6705,2160,7709
313710,201911,1339,3127,944,2586,78,218,631,1741,709,1959
313720,201911,5257,14568,3628,11188,573,2020,1498,4173,2071,6193
313730,201911,1284,2936,951,2479,78,173,638,1650,716,1823
313740,201911,1604,5736,1288,4908,315,1357,221,728,536,2085
313750,201911,1900,5179,1447,4313,277,913,661,1840,938,2753
313753,201911,2062,4943,1352,3811,128,383,774,2111,902,2494
313760,201911,5010,13842,3636,11165,796,2645,1485,4276,2281,6921
313770,201911,3898,11053,3047,9649,204,698,2205,7022,2409,7720
313780,201911,4038,10859,2894,8895,249,917,799,2500,1048,3417
313790,201911,473,1487,416,1379,47,180,232,735,279,915
313800,201911,1363,3198,986,2640,131,408,523,1313,654,1721
313810,201911,1564,4015,1220,3522,51,202,922,2588,973,2790
313820,201911,16731,42136,10080,28259,1652,4875,3091,8251,4743,13126
313830,201911,368,1072,258,815,56,186,97,272,153,458
313835,201911,914,2717,737,2381,66,260,398,1211,464,1471
313840,201911,6676,17555,4762,14250,1207,3811,1015,3084,2222,6895
313850,201911,932,2303,733,2017,132,442,371,895,503,1337
313860,201911,2554,6944,1868,5592,302,1035,758,2095,1060,3130
313862,201911,1422,3022,640,1833,45,141,325,901,370,1042
313865,201911,2444,6595,2017,5882,99,307,1507,4309,1606,4616
313867,201911,1183,3620,987,3252,138,458,658,2185,796,2643
313868,201911,1685,5210,1375,4571,48,244,1058,3397,1106,3641
313870,201911,765,2092,550,1692,102,331,203,562,305,893
313880,201911,1500,4002,1096,3310,174,575,498,1346,672,1921
313890,201911,1977,4367,1457,3688,54,175,1064,2623,1118,2798
313900,201911,3909,11520,2748,9121,713,2618,677,2069,1390,4687
313910,201911,602,1804,445,1495,96,358,97,305,193,663
313920,201911,2900,9085,2411,8040,496,1642,1197,3994,1693,5636
313925,201911,1547,3992,1225,3395,185,484,778,2156,963,2640
313930,201911,4689,14221,3761,12510,282,1105,2462,8037,2744,9142
313940,201911,8461,24705,5914,20184,871,3563,1469,5456,2340,9019
313950,201911,5097,11503,3587,9581,434,1441,2119,5566,2553,7007
313960,201911,5435,13495,3558,10290,805,2604,1091,2863,1896,5467
313970,201911,1436,3936,1194,3512,18,60,755,2179,773,2239
313980,201911,1339,3512,867,2735,134,485,330,993,464,1478
313990,201911,1809,5872,1269,4582,354,1429,374,1186,728,2615
314000,201911,9404,24589,7760,21781,563,2014,5208,14298,5771,16312
314010,201911,1463,3557,1132,3091,52,176,833,2211,885,2387
314015,201911,1891,5262,1405,4413,192,736,730,2197,922,2933
314020,201911,479,1317,295,966,58,233,58,204,116,437
314030,201911,734,2118,576,1813,57,191,303,939,360,1130
314040,201911,628,1692,495,1430,73,239,268,740,341,979
314050,201911,1756,4728,1242,3760,160,559,637,1800,797,2359
314053,201911,1780,5317,1411,4576,268,862,714,2421,982,3283
314055,201911,2274,6135,1918,5578,47,179,1563,4542,1610,4721
314060,201911,1233,3314,908,2784,33,140,626,1890,659,2030
314070,201911,4464,12428,3447,10538,715,2179,1491,4462,2206,6641
314080,201911,2103,5576,1357,4216,187,699,556,1542,743,2241
314085,201911,2080,6017,1682,5382,250,841,925,2983,1175,3824
314090,201911,4326,12008,3674,10974,228,873,2344,7022,2572,7895
314100,201911,3133,7441,2388,6393,58,168,1822,4853,1880,5021
314110,201911,4392,12571,3542,10886,396,1437,2033,5854,2429,7291
314120,201911,827,1929,319,964,71,252,63,174,134,426
314130,201911,613,1594,363,1129,26,105,204,628,230,733
314140,201911,4550,13049,3515,10988,484,1620,1721,5249,2205,6869
314150,201911,1485,3739,1073,3010,92,263,709,1933,801,2196
314160,201911,2151,5807,1538,4657,217,721,645,1938,862,2659
314170,201911,936,2671,747,2290,48,172,463,1323,511,1495
314180,201911,5391,15124,4315,13354,382,1295,2533,7820,2915,9115
314190,201911,597,1507,402,1201,72,237,179,495,251,732
314200,201911,2855,8040,2312,7094,132,478,1657,4943,1789,5421
314210,201911,1970,5252,1536,4440,167,518,781,2201,948,2719
314220,201911,1293,3591,902,2897,194,722,333,975,527,1697
314225,201911,1074,3074,882,2766,78,221,631,2023,709,2244
314230,201911,749,1947,608,1769,70,230,394,1176,464,1406
314240,201911,1010,2772,771,2405,190,612,300,946,490,1558
314250,201911,506,1415,309,1002,47,151,119,351,166,502
314260,201911,922,2562,720,2265,154,525,396,1200,550,1725
314270,201911,3233,9242,2620,8273,89,368,1923,5991,2012,6359
314280,201911,3308,7683,2122,5830,255,783,1099,2846,1354,3629
314290,201911,4485,11665,3640,10142,302,873,2475,6761,2777,7634
314300,201911,1788,5149,1174,3833,252,907,375,1161,627,2068
314310,201911,4153,10980,2762,8539,892,2983,452,1248,1344,4231
314315,201911,912,3162,769,2849,55,268,526,1878,581,2146
314320,201911,2848,7812,1789,5754,334,1168,634,1968,968,3136
314330,201911,48090,134961,35562,112465,9804,32243,7453,24653,17257,56896
314340,201911,2232,5520,1263,3745,273,951,314,764,587,1715
314345,201911,1370,4138,1112,3664,152,525,646,2099,798,2624
314350,201911,854,2341,553,1799,113,398,128,362,241,760
314360,201911,569,1642,341,1136,50,181,105,318,155,499
314370,201911,699,1903,548,1671,30,116,397,1167,427,1283
314380,201911,1132,3100,723,2321,166,610,171,534,337,1144
314390,201911,12379,31898,7699,23072,1586,5088,2295,6200,3881,11288
314400,201911,3948,11812,2970,9910,777,2683,1074,3718,1851,6401
314410,201911,2693,7534,1812,5856,262,954,639,2157,901,3111
314420,201911,811,2001,590,1671,31,139,407,1070,438,1209
314430,201911,7258,18186,4983,14235,765,2322,2234,6077,2999,8399
314435,201911,1640,4463,1285,3841,53,195,936,2759,989,2954
314437,201911,912,2355,639,1877,63,211,314,905,377,1116
314440,201911,612,1761,426,1371,119,419,87,239,206,658
314450,201911,1353,3641,1122,3275,107,354,668,1882,775,2236
314460,201911,3214,9854,2261,7745,579,2106,503,1653,1082,3759
314465,201911,2185,6361,1855,5716,54,204,1384,4119,1438,4323
314467,201911,845,2282,703,2043,23,79,566,1593,589,1672
314470,201911,2116,6135,1673,5207,289,988,752,2180,1041,3168
314480,201911,6319,18253,4441,14216,766,2739,1545,4365,2311,7104
314490,201911,981,2696,720,2131,68,224,448,1262,516,1486
314500,201911,1661,4068,1178,3350,268,749,443,1297,711,2046
314505,201911,1993,4952,1610,4403,105,297,1151,3083,1256,3380
314510,201911,1825,4786,1249,3901,246,858,550,1689,796,2547
314520,201911,4699,14574,3313,11481,669,2563,411,1221,1080,3784
314530,201911,5428,17609,4836,16444,351,1482,3484,11562,3835,13044
314535,201911,2580,6717,2050,5927,99,354,1558,4458,1657,4812
314537,201911,1105,3184,840,2731,52,206,582,1855,634,2061
314540,201911,385,975,255,744,16,56,135,369,151,425
314545,201911,1803,4470,1584,4198,36,97,1345,3679,1381,3776
314550,201911,632,1570,469,1330,40,151,250,639,290,790
314560,201911,3935,12045,2863,9572,475,1773,982,2984,1457,4757
314570,201911,301,831,217,673,28,103,94,292,122,395
314580,201911,422,1268,319,1056,90,307,89,300,179,607
314585,201911,631,2003,469,1631,65,276,206,682,271,958
314587,201911,1976,5423,1483,4628,207,598,830,2661,1037,3259
314590,201911,3712,10264,2535,7970,368,1287,1046,3062,1414,4349
314600,201911,1829,5097,1041,3519,210,768,133,416,343,1184
314610,201911,8600,21883,5780,17693,1056,3739,2407,7294,3463,11033
314620,201911,2176,5169,1691,4539,43,155,1395,3682,1438,3837
314625,201911,1493,4204,1261,3879,36,216,1052,3163,1088,3379
314630,201911,5235,13549,4235,12197,117,487,3501,10067,3618,10554
314640,201911,635,1561,452,1264,63,211,243,627,306,838
314650,201911,819,1900,482,1367,53,173,244,599,297,772
314655,201911,1569,4325,1099,3469,174,538,530,1645,704,2183
314660,201911,334,778,215,560,11,22,130,323,141,345
314670,201911,1660,3813,1119,3028,22,74,720,1925,742,1999
314675,201911,1692,4537,1439,4108,85,298,1103,3036,1188,3334
314690,201911,2067,5821,1562,5032,448,1589,484,1539,932,3128
314700,201911,9897,28036,6231,20658,1234,4522,1756,5626,2990,10148
314710,201911,7495,21170,5227,16293,979,3322,1615,4428,2594,7750
314720,201911,2034,6035,1337,4536,293,1108,350,1127,643,2235
314730,201911,2077,5660,1439,4412,294,963,466,1338,760,2301
314740,201911,2814,7992,2175,6806,285,970,1109,3393,1394,4363
314750,201911,312,863,236,708,25,88,131,345,156,433
314760,201911,1793,5478,1126,3884,177,711,258,724,435,1435
314770,201911,1086,3194,542,1758,47,166,162,486,209,652
314780,201911,344,819,224,635,41,137,121,302,162,439
314790,201911,9845,26687,6526,20430,1500,5384,2057,5904,3557,11288
314795,201911,1435,3859,1199,3442,32,144,939,2577,971,2721
314800,201911,10587,26985,6032,18282,1151,3822,1345,3602,2496,7424
314810,201911,8305,22406,5864,18026,1517,4973,1872,5659,3389,10632
314820,201911,1119,2822,866,2434,54,210,549,1471,603,1681
314830,201911,1428,4397,1175,3892,234,847,544,1776,778,2623
314840,201911,860,2745,674,2428,55,278,471,1619,526,1897
314850,201911,1951,4710,1560,4200,38,128,1341,3625,1379,3753
314860,201911,3132,9407,2574,8312,237,927,1714,5369,1951,6296
314870,201911,6240,16112,4677,13965,295,970,3414,10225,3709,11195
314875,201911,1718,5193,1496,4900,106,294,1205,4014,1311,4308
314880,201911,837,2045,638,1739,30,93,400,1091,430,1184
314890,201911,417,1235,303,978,48,180,121,354,169,534
314900,201911,652,1785,494,1513,93,315,191,561,284,876
314910,201911,1601,4603,1168,3875,234,898,526,1607,760,2505
314915,201911,2168,6477,1808,5842,130,426,1196,3806,1326,4232
314920,201911,465,1205,295,937,8,28,195,627,203,655
314930,201911,5220,14978,3855,12373,685,2372,1491,4469,2176,6841
314940,201911,384,992,314,870,29,78,199,521,228,599
314950,201911,468,1199,294,898,27,110,149,408,176,518
314960,201911,790,1938,603,1620,27,86,443,1137,470,1223
314970,201911,847,2427,627,1973,124,428,266,761,390,1189
314980,201911,1386,3612,980,2993,197,693,415,1231,612,1924
314990,201911,2325,6749,1542,4925,328,1151,304,853,632,2004
314995,201911,1605,4487,1265,3879,50,211,831,2420,881,2631
315000,201911,1107,2868,784,2347,66,228,514,1499,580,1727
315010,201911,374,1051,272,863,43,164,131,383,174,547
315015,201911,2215,6338,1906,5807,187,642,1231,3688,1418,4330
315020,201911,755,2231,533,1717,72,293,220,626,292,919
315030,201911,565,1516,361,1119,83,256,78,225,161,481
315040,201911,789,2291,655,2013,87,290,404,1239,491,1529
315050,201911,1185,3067,825,2466,59,219,434,1257,493,1476
315053,201911,1094,2875,817,2376,49,156,482,1344,531,1500
315057,201911,1648,5127,1351,4560,144,488,904,3073,1048,3561
315060,201911,552,1681,393,1350,77,281,99,320,176,601
315070,201911,518,1362,347,1056,87,299,89,244,176,543
315080,201911,2759,8018,2081,6656,307,1049,1161,3581,1468,4630
315090,201911,788,2426,567,1980,90,342,206,685,296,1027
315100,201911,1215,3680,743,2576,141,558,310,961,451,1519
315110,201911,1699,4220,1236,3480,139,385,610,1756,749,2141
315120,201911,11442,27240,8208,22218,1191,3030,4250,11962,5441,14992
315130,201911,1339,3831,1077,3343,134,481,440,1291,574,1772
315140,201911,2870,8006,2164,6719,400,1372,1051,3036,1451,4408
315150,201911,4212,10239,2860,8006,459,1479,1316,3525,1775,5004
315160,201911,1615,4036,1028,3071,233,737,449,1318,682,2055
315170,201911,1393,4417,930,3283,224,852,196,665,420,1517
315180,201911,16288,39962,8111,24390,1154,3876,2433,6379,3587,10255
315190,201911,2083,4653,1604,4016,193,465,1168,2949,1361,3414
315200,201911,3710,10820,2635,8819,792,2844,642,2056,1434,4900
315210,201911,7741,20406,5256,15096,642,2008,2567,6710,3209,8718
315213,201911,1102,2905,935,2674,17,54,761,2155,778,2209
315217,201911,2669,7954,2035,6847,94,480,1392,4462,1486,4942
315220,201911,8007,21983,6260,18862,1249,3980,2573,7759,3822,11739
315230,201911,3089,7256,2567,6583,157,265,2001,5402,2158,5667
315240,201911,2376,7038,1972,6299,458,1531,979,3099,1437,4630
315250,201911,11583,31733,8017,24802,1336,4490,3368,9937,4704,14427
315260,201911,931,2611,471,1577,82,272,32,90,114,362
315270,201911,795,2317,539,1796,74,268,172,488,246,756
315280,201911,2841,7166,1606,4861,396,1303,251,754,647,2057
315290,201911,1165,2901,681,2117,200,696,176,522,376,1218
315300,201911,630,1528,407,1198,100,338,179,523,279,861
315310,201911,1267,3593,921,2914,73,256,504,1512,577,1768
315320,201911,665,1949,455,1523,64,257,196,605,260,862
315330,201911,743,2571,394,1585,67,306,117,422,184,728
315340,201911,3003,7355,2135,6077,197,615,1262,3563,1459,4178
315350,201911,1543,4244,1172,3649,174,624,644,1965,818,2589
315360,201911,1652,4947,1182,3921,174,621,478,1481,652,2102
315370,201911,440,1293,344,1092,62,184,143,442,205,626
315380,201911,177,524,131,413,31,96,26,56,57,152
315390,201911,1079,3116,817,2597,153,557,345,1000,498,1557
315400,201911,3908,10934,3047,9315,452,1448,1597,4702,2049,6150
315410,201911,2258,5255,1684,4415,463,1300,242,684,705,1984
315415,201911,1277,3520,1017,3121,212,762,415,1292,627,2054
315420,201911,1255,3642,809,2746,164,591,140,442,304,1033
315430,201911,3547,8664,2455,6971,432,1444,1054,2790,1486,4234
315440,201911,985,2657,779,2307,71,249,448,1240,519,1489
315445,201911,1957,4754,1381,3919,90,297,991,2760,1081,3057
315450,201911,2203,6207,1782,5533,240,703,1089,3412,1329,4115
315460,201911,34424,97706,28073,85877,4822,16494,14475,41577,19297,58071
315470,201911,506,1442,379,1166,29,105,231,677,260,782
315480,201911,1189,3459,805,2615,162,544,249,777,411,1321
315490,201911,2896,7263,1932,5715,289,877,686,1983,975,2860
315500,201911,495,1350,292,892,39,143,129,339,168,482
315510,201911,1214,3230,1030,2957,25,116,881,2472,906,2588
315520,201911,1039,2869,806,2462,58,213,589,1740,647,1953
315530,201911,571,1653,443,1413,136,483,198,591,334,1074
315540,201911,1351,3713,912,2863,101,376,395,1212,496,1588
315550,201911,1855,4806,1146,3522,248,852,288,868,536,1720
315560,201911,6176,18964,5190,17132,296,963,3452,11552,3748,12515
315570,201911,1936,5344,1565,4718,95,384,936,2713,1031,3097
315580,201911,2510,6067,1864,5031,288,915,728,1843,1016,2758
315590,201911,865,2282,669,1970,73,264,352,970,425,1234
315600,201911,2413,7702,1722,6311,260,906,905,3461,1165,4367
315610,201911,885,2270,642,1805,107,370,290,703,397,1073
315620,201911,422,1193,321,1030,43,153,201,659,244,812
315630,201911,901,2426,700,2090,134,418,289,793,423,1211
315640,201911,347,873,261,765,28,106,157,432,185,538
315645,201911,941,2457,622,1918,155,515,155,460,310,975
315650,201911,1715,4223,1353,3709,34,123,1113,2944,1147,3067
315660,201911,2409,5922,1771,4812,96,285,1267,3322,1363,3607
315670,201911,13296,36851,9979,30688,2026,6467,4385,12982,6411,19449
315680,201911,3000,8849,2170,7229,324,1233,1049,3309,1373,4542
315690,201911,3039,7475,1745,5238,386,1154,541,1756,927,2910
315700,201911,7641,21551,5679,17549,934,3086,2532,7450,3466,10536
315710,201911,1838,4621,1281,3748,44,208,905,2516,949,2724
315720,201911,4322,12114,3605,10797,168,708,2563,7342,2731,8050
315725,201911,1963,5341,1468,4431,135,396,994,3057,1129,3453
315727,201911,555,1443,402,1185,57,193,165,463,222,656
315730,201911,589,1851,510,1685,84,316,197,613,281,929
315733,201911,1249,3173,834,2414,128,449,316,862,444,1311
315737,201911,1111,3228,860,2719,35,145,603,1845,638,1990
315740,201911,865,2438,668,2022,85,303,405,1138,490,1441
315750,201911,1246,3349,971,2866,85,264,606,1801,691,2065
315760,201911,1127,2700,998,2532,48,134,842,2102,890,2236
315765,201911,1864,4982,1514,4528,25,87,1329,3971,1354,4058
315770,201911,939,2680,719,2366,281,1008,146,386,427,1394
315780,201911,27241,75591,22667,67356,1462,5399,15328,43498,16790,48897
315790,201911,3517,10929,2957,9830,371,1290,1733,5848,2104,7138
315800,201911,1209,4364,846,3352,142,630,231,811,373,1441
315810,201911,1299,3261,1063,2846,54,189,818,2080,872,2269
315820,201911,2569,7083,2062,6325,176,650,1401,4236,1577,4886
315830,201911,1079,3180,768,2548,77,284,303,961,380,1245
315840,201911,813,1981,523,1443,39,127,259,664,298,791
315850,201911,1114,3363,879,2932,174,630,429,1341,603,1971
315860,201911,468,1362,319,1079,75,272,89,272,164,544
315870,201911,449,1171,351,1019,26,88,241,655,267,743
315880,201911,1043,2755,685,2121,92,349,163,461,255,810
315890,201911,1604,4673,1270,4182,320,1139,621,1998,941,3137
315895,201911,5885,15980,4345,12915,434,1488,2273,6259,2707,7747
315900,201911,792,2057,678,1890,56,167,502,1358,558,1525
315910,201911,508,1451,425,1313,58,211,287,853,345,1064
315920,201911,1470,3794,787,2437,129,460,252,730,381,1190
315930,201911,1075,2458,694,1875,121,323,307,828,428,1151
315935,201911,780,2356,613,2042,116,411,217,722,333,1133
315940,201911,582,1648,457,1445,52,181,240,719,292,900
315950,201911,1144,3143,939,2815,92,269,706,2121,798,2390
315960,201911,4289,12214,2467,8393,798,3119,185,375,983,3494
315970,201911,621,1648,481,1461,61,213,317,961,378,1174
315980,201911,4182,9140,2199,5883,393,1117,773,1887,1166,3004
315990,201911,3562,9084,2733,7657,247,744,1598,4363,1845,5107
316000,201911,513,1360,383,1167,55,208,178,506,233,714
316010,201911,813,2153,589,1776,41,148,370,1032,411,1180
316020,201911,918,2824,734,2457,81,328,431,1359,512,1687
316030,201911,2719,7689,2027,6436,239,788,1270,4086,1509,4874
316040,201911,2383,6855,1709,5556,320,1159,394,1117,714,2276
316045,201911,2038,5349,1842,5105,74,166,1571,4472,1645,4638
316050,201911,360,1031,265,855,37,136,146,449,183,585
316060,201911,672,1731,492,1450,25,114,339,947,364,1061
316070,201911,5262,14836,4246,12851,749,2375,1967,5759,2716,8134
316080,201911,697,2185,523,1812,127,464,77,265,204,729
316090,201911,403,1206,280,937,37,147,136,398,173,545
316095,201911,1250,3891,996,3269,260,888,324,1044,584,1932
316100,201911,2413,7208,1675,5533,305,1089,592,1784,897,2873
316105,201911,845,2246,652,1954,41,141,451,1379,492,1520
316110,201911,13106,38555,10877,34738,859,3161,7315,23056,8174,26217
316120,201911,1120,3259,685,2186,123,409,192,505,315,914
316130,201911,1199,2709,745,1984,59,189,439,1136,498,1325
316140,201911,1144,3092,720,2299,105,372,361,1117,466,1489
316150,201911,1782,3960,1454,3539,181,556,596,1362,777,1918
316160,201911,1003,2791,807,2442,48,176,525,1528,573,1704
316165,201911,856,2140,640,1786,98,332,326,842,424,1174
316170,201911,1083,2746,801,2307,57,208,542,1494,599,1702
316180,201911,1281,3675,829,2710,141,545,152,452,293,997
316190,201911,2558,7305,1438,4598,215,704,523,1494,738,2198
316200,201911,3187,9256,2266,7524,561,1969,430,1422,991,3391
316210,201911,4145,12187,2929,9463,1100,3827,198,529,1298,4356
316220,201911,591,1808,385,1322,95,363,40,160,135,523
316225,201911,1514,3471,1117,2807,42,165,856,1997,898,2162
316230,201911,395,1082,293,908,30,100,172,537,202,637
316240,201911,5548,16154,4818,14883,370,1286,3638,11015,4008,12301
316245,201911,2901,9676,2571,9094,140,822,1926,6437,2066,7259
316250,201911,9820,24049,6763,19102,1508,4626,2315,6375,3823,11001
316255,201911,2934,8204,2539,7559,142,480,1881,5630,2023,6110
316257,201911,1292,3218,901,2520,137,392,457,1231,594,1623
316260,201911,1939,5103,1461,4292,113,363,795,2387,908,2750
316265,201911,1140,3088,885,2652,29,103,629,1829,658,1932
316270,201911,3564,11199,3009,9920,524,1848,1394,4368,1918,6216
316280,201911,2808,8254,2373,7395,337,1140,1301,3898,1638,5038
316290,201911,3439,9509,2705,8121,317,1128,1141,3301,1458,4429
316292,201911,4898,13178,3877,11427,474,1525,2552,7221,3026,8746
316294,201911,800,2378,577,1978,98,377,151,500,249,877
316295,201911,2860,8103,2326,7162,148,574,1600,4650,1748,5224
316300,201911,970,2889,798,2604,48,190,559,1805,607,1995
316310,201911,804,2119,496,1568,103,396,79,204,182,600
316320,201911,599,1692,448,1433,52,208,212,654,264,862
316330,201911,1040,2799,766,2299,50,204,554,1577,604,1781
316340,201911,1006,2786,731,2261,75,306,404,1164,479,1470
316350,201911,1242,3582,1032,3235,95,319,710,2206,805,2525
316360,201911,634,1678,501,1454,49,154,362,1016,411,1170
316370,201911,4838,13194,3528,10694,705,2453,1216,3238,1921,5691
316380,201911,1692,4051,1302,3496,48,112,948,2543,996,2655
316390,201911,808,2181,567,1742,227,788,96,264,323,1052
316400,201911,1126,3234,704,2356,118,438,236,707,354,1145
316410,201911,1073,3122,895,2843,65,212,691,2174,756,2386
316420,201911,1873,5209,1621,4879,51,197,1338,3945,1389,4142
316430,201911,863,2299,523,1652,94,337,160,476,254,813
316440,201911,705,2241,549,1964,124,509,110,367,234,876
316443,201911,535,1511,391,1232,99,349,79,229,178,578
316447,201911,1865,5110,1609,4681,33,126,1335,3812,1368,3938
316450,201911,2153,6596,1610,5450,215,775,959,3174,1174,3949
316460,201911,1011,2628,804,2289,138,433,483,1285,621,1718
316470,201911,6412,18562,4471,14393,773,2826,1693,5005,2466,7831
316480,201911,202,556,169,506,39,116,83,243,122,359
316490,201911,310,837,217,672,29,98,83,213,112,311
316500,201911,1124,3606,710,2560,149,583,154,530,303,1113
316510,201911,712,2339,560,2043,121,455,247,918,368,1373
316520,201911,1120,2840,864,2400,119,404,420,1066,539,1470
316530,201911,1059,2817,769,2287,88,343,379,992,467,1335
316540,201911,810,2158,635,1881,111,381,295,803,406,1184
316550,201911,1369,4045,1164,3638,65,241,875,2693,940,2934
316553,201911,3671,11107,2510,8261,447,1631,827,2457,1274,4088
316555,201911,2440,7953,2216,7639,115,419,1773,6173,1888,6592
316556,201911,555,1341,382,1047,25,77,225,574,250,651
316557,201911,982,3093,836,2828,319,1154,230,756,549,1910
316560,201911,331,939,223,764,58,245,60,169,118,414
316570,201911,1179,3490,971,3098,240,782,360,1145,600,1927
316580,201911,373,796,222,552,35,100,112,262,147,362
316590,201911,1289,3403,896,2608,167,443,467,1316,634,1759
316600,201911,942,2947,801,2639,131,465,413,1336,544,1801
316610,201911,562,1806,471,1666,50,224,285,969,335,1193
316620,201911,1984,5459,1698,5064,91,286,1276,3836,1367,4122
316630,201911,1550,4650,1237,4059,338,1115,480,1699,818,2814
316640,201911,137,363,104,311,18,60,47,121,65,181
316650,201911,1017,3288,808,2947,71,288,500,1858,571,2146
316660,201911,187,473,76,233,7,24,10,29,17,53
316670,201911,1789,4566,1292,3742,314,985,468,1318,782,2303
316680,201911,2167,5515,1627,4555,103,303,1251,3434,1354,3737
316690,201911,1251,3675,955,3083,182,647,425,1331,607,1978
316695,201911,1002,2933,819,2594,38,158,551,1715,589,1873
316700,201911,375,882,310,805,14,46,234,569,248,615
316710,201911,2959,9826,2215,8243,473,1868,849,3129,1322,4997
316720,201911,19873,55131,14188,43794,2674,8789,5778,16963,8452,25752
316730,201911,405,1141,319,968,43,145,161,446,204,591
316740,201911,676,2035,583,1877,65,253,364,1163,429,1416
316750,201911,377,1131,287,957,59,238,130,394,189,632
316760,201911,3578,11382,2851,9868,1125,4224,642,2093,1767,6317
316770,201911,1542,3619,1200,3153,24,82,1013,2693,1037,2775
316780,201911,533,1622,417,1389,151,565,64,188,215,753
316790,201911,688,1868,470,1426,110,351,131,358,241,709
316800,201911,6026,17194,4721,14758,457,1663,2501,7511,2958,9174
316805,201911,1011,2236,804,2011,66,184,619,1556,685,1740
316810,201911,637,1801,420,1325,82,300,201,585,283,885
316820,201911,311,752,156,463,8,31,72,202,80,233
316830,201911,685,1905,550,1678,74,273,340,986,414,1259
316840,201911,2725,7253,2179,6285,207,743,1436,3933,1643,4676
316850,201911,1929,5117,1346,4045,219,718,580,1689,799,2407
316860,201911,18384,48133,13461,40613,2266,7873,6150,18004,8416,25877
316870,201911,7308,20222,5342,16393,840,2889,2383,6756,3223,9645
316880,201911,789,2156,628,1929,135,460,279,815,414,1275
316890,201911,1095,2463,622,1811,102,372,343,892,445,1264
316900,201911,2165,5976,1639,4902,333,1106,535,1462,868,2568
316905,201911,523,1557,404,1317,101,365,159,524,260,889
316910,201911,860,2303,530,1707,137,492,46,134,183,626
316920,201911,1603,4098,1051,3201,203,671,419,1254,622,1925
316930,201911,7413,21618,5244,17557,1118,4042,1313,4242,2431,8284
316935,201911,3914,10744,2784,8568,500,1667,1127,3339,1627,5006
316940,201911,6406,19038,4802,15582,788,2845,1815,5473,2603,8318
316950,201911,1813,4295,1384,3691,52,164,1130,2957,1182,3121
316960,201911,5029,11472,3585,9400,377,1094,2357,6029,2734,7123
316970,201911,3544,10256,3058,9296,542,1721,1219,3544,1761,5265
316980,201911,665,2025,485,1666,153,588,73,256,226,844
316990,201911,10429,28832,7142,21845,1962,6426,975,2642,2937,9068
317000,201911,2545,7610,2239,7159,177,539,1636,5241,1813,5780
317005,201911,2556,7393,1999,6216,317,1033,1049,3184,1366,4217
317010,201911,23376,55073,13915,40465,3026,9569,5013,14967,8039,24536
317020,201911,62327,148884,34466,99627,6479,20444,10372,27571,16851,48015
317030,201911,640,1759,502,1566,19,85,391,1207,410,1292
317040,201911,10660,27318,7347,21575,1666,5217,2681,8013,4347,13230
317043,201911,840,1927,603,1594,62,169,419,1102,481,1271
317047,201911,1145,2775,776,2163,90,249,479,1299,569,1548
317050,201911,1164,3598,788,2697,109,375,326,988,435,1363
317052,201911,2314,6626,1836,5831,288,921,1104,3512,1392,4433
317057,201911,1716,4222,1238,3424,42,162,814,2192,856,2354
317060,201911,445,1181,265,803,37,130,117,317,154,447
317065,201911,1198,3527,962,3069,50,189,595,1761,645,1950
317070,201911,7353,20350,4981,15658,989,3523,1343,3932,2332,7455
317075,201911,887,2333,609,1822,104,353,240,649,344,1002
317080,201911,5911,14072,4294,11418,1206,3446,1357,3414,2563,6860
317090,201911,4385,13343,3894,12514,311,976,2832,9088,3143,10064
317100,201911,2554,6042,1607,4511,379,1127,592,1605,971,2732
317103,201911,1946,5682,1629,5149,105,530,1181,3512,1286,4042
317107,201911,1363,3683,1030,3016,62,248,641,1658,703,1906
317110,201911,710,1642,346,1067,49,180,113,357,162,537
317115,201911,1067,3073,893,2753,46,124,629,1954,675,2078
317120,201911,12176,34014,9445,29380,1176,4246,5241,15774,6417,20020
317130,201911,10519,24639,6283,17677,1100,3402,2100,5785,3200,9187
317140,201911,712,1869,544,1605,43,127,356,1085,399,1212
317150,201911,998,2397,736,2055,33,110,568,1550,601,1660
317160,201911,3564,8693,2290,6657,185,586,1267,3715,1452,4301
317170,201911,1835,4645,1258,3600,207,694,503,1234,710,1928
317180,201911,1836,5884,1340,4642,266,988,346,1126,612,2114
317190,201911,1224,3321,898,2800,102,323,522,1611,624,1934
317200,201911,4837,12832,3589,10614,1020,3272,688,1843,1708,5115
317210,201911,1157,2844,874,2459,31,117,643,1820,674,1937
317220,201911,251,779,208,686,54,177,74,261,128,438
320010,201911,4496,13220,3559,11323,388,1371,2280,7108,2668,8479
320013,201911,1740,4941,1105,3623,183,606,511,1717,694,2323
320016,201911,2993,7748,2313,6703,128,354,1824,5260,1952,5614
320020,201911,3819,10131,2761,8287,656,2130,985,3033,1641,5163
320030,201911,1551,4532,1044,3455,201,723,363,1131,564,1854
320035,201911,1795,5038,1458,4440,375,1269,638,1873,1013,3142
320040,201911,3828,11082,3110,9695,433,1475,1716,5162,2149,6637
320050,201911,1746,3989,1482,3599,209,608,865,2017,1074,2625
320060,201911,11550,32436,8449,26171,1355,4611,3921,11471,5276,16082
320070,201911,1438,4101,969,3121,183,660,338,1033,521,1693
320080,201911,5495,14319,3804,10926,835,2529,1371,3758,2206,6287
320090,201911,7952,21410,5168,15617,1190,3879,1898,5328,3088,9207
320100,201911,2720,7762,2156,6723,390,1340,1118,3424,1508,4764
320110,201911,1494,3750,1095,3085,178,538,546,1481,724,2019
320115,201911,1778,5813,1510,5348,651,2430,426,1577,1077,4007
320120,201911,19717,51322,13280,39514,2009,6521,5932,16888,7941,23409
320130,201911,42282,119650,34461,105164,4874,16310,19774,58580,24648,74890
320140,201911,2920,8442,2127,6779,352,1275,897,2812,1249,4087
320150,201911,13010,34265,8874,25991,2368,7491,1558,4122,3926,11613
320160,201911,5505,15712,4006,12767,680,2286,1863,5863,2543,8149
320170,201911,1441,4240,1046,3453,287,956,417,1423,704,2379
320180,201911,690,2215,552,1930,196,729,148,480,344,1209
320190,201911,2674,8657,2024,7140,486,1813,536,1806,1022,3619
320200,201911,1077,2987,775,2421,195,674,267,835,462,1509
320210,201911,4413,11358,3334,9429,548,1682,1768,4791,2316,6473
320220,201911,2539,6893,1877,5740,358,1209,872,2553,1230,3762
320225,201911,1332,4196,899,3128,336,1241,171,587,507,1828
320230,201911,4597,13020,3442,11038,837,2913,1318,4122,2155,7035
320240,201911,14659,38060,10700,31493,2586,8204,3797,10873,6383,19077
320245,201911,2972,9017,2355,7727,935,3190,469,1492,1404,4682
320250,201911,1955,5578,1265,3911,302,1036,349,979,651,2015
320255,201911,1681,5406,1470,5034,459,1580,697,2495,1156,4075
320260,201911,1048,3140,732,2355,177,653,204,550,381,1203
320265,201911,2399,7520,1955,6625,930,3327,350,1172,1280,4499
320270,201911,2187,6358,1619,5206,370,1283,653,2094,1023,3377
320280,201911,6417,17520,5065,15102,1178,3736,2090,6064,3268,9800
320290,201911,1318,3957,824,2729,228,821,200,615,428,1436
320300,201911,3434,10679,2752,9194,821,2956,599,1844,1420,4800
320305,201911,5008,14394,3851,12061,758,2541,1865,5633,2623,8174
320310,201911,1939,5459,1309,4088,243,805,570,1704,813,2509
320313,201911,2309,5898,1400,4087,296,977,340,911,636,1888
320316,201911,1408,4106,1178,3669,178,577,695,2167,873,2744
320320,201911,20969,55677,14499,44290,3449,10985,5383,16414,8832,27399
320330,201911,2917,8000,2239,6756,461,1377,1139,3510,1600,4887
320332,201911,5889,16617,4647,14372,1194,3944,2113,6496,3307,10440
320334,201911,1729,5046,1188,3894,261,1017,250,641,511,1658
320335,201911,1413,4188,905,2990,225,801,215,651,440,1452
320340,201911,4642,11905,3846,10680,493,1490,2237,6246,2730,7736
320350,201911,5129,12873,3510,9873,479,1428,1817,4900,2296,6328
320360,201911,1420,3640,1026,2883,126,338,515,1400,641,1738
320370,201911,2370,7581,1834,6371,571,2054,602,2070,1173,4124
320380,201911,2405,6584,1982,5871,250,792,1231,3571,1481,4363
320390,201911,7041,19387,5122,15464,1091,3467,2023,5764,3114,9231
320400,201911,3173,9146,2450,7619,690,2278,897,2681,1587,4959
320405,201911,4396,11770,3239,9762,565,1820,1469,4345,2034,6165
320410,201911,4726,12374,3518,10401,640,1867,1741,5362,2381,7229
320420,201911,2892,7719,2187,6529,696,2334,422,1199,1118,3533
320425,201911,2042,4900,1540,4073,90,266,1043,2673,1133,2939
320430,201911,2872,7260,2242,6074,311,947,1430,3685,1741,4632
320435,201911,2228,7031,1734,6038,613,2231,532,1872,1145,4103
320440,201911,1353,3756,961,2984,147,496,428,1279,575,1775
320450,201911,1593,4668,1229,3974,301,1092,528,1580,829,2672
320455,201911,3916,11947,2549,8661,670,2426,681,2150,1351,4576
320460,201911,2059,6184,1410,4733,349,1236,344,1082,693,2318
320465,201911,1194,3449,888,2839,133,456,480,1526,613,1982
320470,201911,3646,10160,2472,7628,590,1962,570,1576,1160,3538
320480,201911,1624,4584,1326,4060,223,784,728,2140,951,2924
320490,201911,20485,54251,14656,43707,2600,8525,6041,17643,8641,26168
320495,201911,1334,3675,901,2829,190,686,332,984,522,1670
320500,201911,51001,137367,40469,118566,5989,18956,23129,64882,29118,83838
320501,201911,4290,12472,3061,10209,867,3220,1039,3376,1906,6596
320503,201911,1968,5971,1367,4657,398,1466,445,1398,843,2864
320506,201911,2511,7547,1703,5728,521,1880,181,596,702,2476
320510,201911,9746,26772,7788,23255,926,3186,4750,13666,5676,16852
320515,201911,1701,4712,1282,3842,364,1185,411,1188,775,2373
320517,201911,2101,6445,1639,5457,547,1971,447,1450,994,3421
320520,201911,34561,90749,25169,74559,4634,15005,10537,30139,15171,45144
320530,201911,30113,80908,23228,68398,2368,8293,14285,39572,16653,47865
330010,201911,20988,56918,16908,49873,2547,7992,10427,30071,12974,38063
330015,201911,1484,3715,1134,3144,202,638,611,1605,813,2243
330020,201911,19977,50209,16922,45764,2333,7184,11930,31305,14263,38489
330022,201911,1904,5116,1427,4278,252,768,804,2392,1056,3160
330023,201911,4884,11766,3369,9547,614,1889,1745,4777,2359,6666
330025,201911,4935,12092,3232,9224,935,2865,996,2755,1931,5620
330030,201911,10286,27752,7612,23164,851,3001,4599,13337,5450,16338
330040,201911,14388,37884,11257,32362,1138,3708,7379,20317,8517,24025
330045,201911,83415,198662,68135,178870,5363,14178,53636,139606,58999,153784
330050,201911,2461,6575,1783,5408,383,1226,817,2353,1200,3579
330060,201911,4773,12836,3894,11293,789,2504,1720,4603,2509,7107
330070,201911,22375,57671,17962,50969,2972,8949,10361,29091,13333,38040
330080,201911,8732,22345,7414,20422,956,2778,5054,13742,6010,16520
330090,201911,3467,7275,2222,5567,140,381,1512,3761,1652,4142
330093,201911,2463,6099,1773,5063,128,393,1305,3713,1433,4106
330095,201911,1202,3454,915,2889,77,292,546,1579,623,1871
330100,201911,69480,186236,58494,169462,3819,13188,44064,125321,47883,138509
330110,201911,2032,5791,1682,5182,278,943,898,2671,1176,3614
330115,201911,2138,5353,1600,4555,243,779,947,2592,1190,3371
330120,201911,3527,8025,2564,6721,263,773,1692,4271,1955,5044
330130,201911,3951,10877,3244,9800,471,1487,2010,6037,2481,7524
330140,201911,3560,9398,2793,8244,422,1370,1727,4958,2149,6328
330150,201911,2148,5781,1623,4913,325,1046,748,2211,1073,3257
330160,201911,1348,3665,1016,3093,178,600,538,1553,716,2153
330170,201911,102104,259450,81897,231278,11504,32201,54206,154503,65710,186704
330180,201911,2068,5054,1565,4298,110,348,1045,2760,1155,3108
330185,201911,9598,24464,7939,22049,573,1929,6170,16637,6743,18566
330187,201911,4189,10795,3256,9287,455,1433,1908,5374,2363,6807
330190,201911,31702,78102,26824,71224,2044,5867,21046,55077,23090,60944
330200,201911,15467,40157,12591,36457,2544,7085,7829,23222,10373,30307
330205,201911,2037,5118,1537,4269,90,298,1054,2818,1144,3116
330210,201911,3348,8447,2387,6715,352,1109,1140,2957,1492,4066
330220,201911,11247,28469,7784,22471,1759,5619,2637,6996,4396,12615
330225,201911,3682,9484,2761,8035,216,756,1946,5493,2162,6249
330227,201911,17251,42066,14524,38639,650,1982,12377,32419,13027,34401
330230,201911,1680,3880,1172,3219,108,309,777,2107,885,2416
330240,201911,23433,61548,18827,53987,2578,8058,11970,33380,14548,41438
330245,201911,1669,4183,962,2928,194,629,346,1049,540,1678
330250,201911,36567,95250,30249,85688,5668,16321,17763,50378,23431,66699
330260,201911,4057,10244,3038,8804,371,1205,1975,5487,2346,6692
330270,201911,27416,59192,16312,42101,2826,7858,6946,17358,9772,25216
330280,201911,2370,6322,1744,5219,182,606,1025,2940,1207,3546
330285,201911,22008,53769,17261,46775,1551,4891,12367,32351,13918,37242
330290,201911,3650,9047,2907,8038,327,1025,1996,5350,2323,6375
330300,201911,5712,13652,4011,11099,339,1061,2686,7279,3025,8340
330310,201911,2393,6029,1754,4964,113,287,1194,3371,1307,3658
330320,201911,15946,38548,12283,33850,1493,4127,8801,24338,10294,28465
330330,201911,35179,78769,26882,67299,2623,7183,19192,46939,21815,54122
330340,201911,14415,36018,10259,29267,1714,5415,5135,13958,6849,19373
330350,201911,123122,292485,100623,264406,6981,19270,81080,211914,88061,231184
330360,201911,7510,18243,6389,16839,239,662,5389,14102,5628,14764
330370,201911,4748,13698,3469,11436,798,2715,1438,4909,2236,7624
330380,201911,5266,14344,3906,11878,736,2550,1872,5418,2608,7968
330385,201911,3909,11409,3164,10290,760,2697,1476,4771,2236,7468
330390,201911,25310,69663,19119,58462,2859,9919,10598,30590,13457,40509
330395,201911,3166,7948,2579,7150,168,526,1838,4980,2006,5506
330400,201911,3118,8435,2657,7670,156,579,1975,5384,2131,5963
330410,201911,2902,8003,2164,6667,416,1429,1013,2946,1429,4375
330411,201911,2762,7499,2123,6247,159,544,1481,4175,1640,4719
330412,201911,1480,4277,1186,3769,134,492,713,2123,847,2615
330414,201911,22940,58400,18271,51890,1733,5027,13113,36912,14846,41939
330415,201911,4026,10999,3073,9307,337,1052,1805,5471,2142,6523
330420,201911,10494,26155,6985,20284,941,3046,3413,9289,4354,12335
330430,201911,9307,22655,7830,20545,376,1223,6044,15325,6420,16548
330440,201911,2303,6279,1684,5226,306,1122,916,2695,1222,3817
330450,201911,1298,3789,1024,3299,140,481,532,1682,672,2163
330452,201911,15918,41036,12465,35611,1743,5525,7704,21312,9447,26837
330455,201911,546220,1308880,410975,1108076,61844,177162,254687,673767,316531,850929
330460,201911,1189,3250,872,2762,159,537,461,1420,620,1957
330470,201911,4806,12177,3438,10030,1092,3264,1084,3203,2176,6467
330475,201911,9118,24001,7300,21561,1220,4087,4565,13172,5785,17259
330480,201911,5929,15442,4963,14008,411,1288,3402,9335,3813,10623
330490,201911,112042,260425,90567,230760,10228,27432,64561,162260,74789,189692
330500,201911,6958,17526,5791,15890,643,1971,4127,11118,4770,13089
330510,201911,39095,98456,29139,84061,5442,16654,17033,48452,22475,65106
330513,201911,1245,3258,963,2836,211,680,480,1406,691,2086
330515,201911,2494,6679,1988,5917,417,1321,1038,3006,1455,4327
330520,201911,11092,29654,8930,26134,1237,4002,5380,15238,6617,19240
330530,201911,1664,4131,1184,3354,250,758,539,1491,789,2249
330540,201911,2902,7714,2180,6428,540,1652,902,2593,1442,4245
330550,201911,8665,23316,6687,20529,1997,6620,2562,7755,4559,14375
330555,201911,16327,35658,13446,32160,941,2565,10623,25404,11564,27969
330560,201911,4231,11413,3378,9940,525,1597,1976,5646,2501,7243
330570,201911,2763,7650,2249,6806,362,1184,1421,4232,1783,5416
330575,201911,5449,14232,4668,12851,313,986,3666,9729,3979,10715
330580,201911,15939,43304,11966,35863,2334,7526,5559,15919,7893,23445
330590,201911,1427,3923,1196,3612,219,664,758,2312,977,2976
330600,201911,11544,30788,9082,26711,1049,3475,5546,15877,6595,19352
330610,201911,9232,24794,7407,21865,641,2249,5087,14559,5728,16808
330615,201911,2072,5683,1565,4968,306,1008,954,3083,1260,4091
330620,201911,3894,11308,3050,9806,716,2492,1261,3798,1977,6290
330630,201911,24282,61553,18769,52615,1554,5156,13165,35438,14719,40594
350010,201911,2088,5418,996,3017,220,699,147,320,367,1019
350020,201911,677,1747,356,1097,46,136,148,415,194,551
350030,201911,3693,10424,2659,8517,674,2315,1008,3072,1682,5387
350040,201911,682,1994,381,1332,55,217,121,341,176,558
350050,201911,1158,2942,744,2181,175,589,242,574,417,1163
350055,201911,922,2422,680,2029,80,265,389,1084,469,1349
350060,201911,109,273,72,215,11,38,40,121,51,159
350070,201911,3481,9222,2101,6601,419,1472,624,1769,1043,3241
350075,201911,570,1713,409,1384,169,607,33,102,202,709
350080,201911,658,1719,395,1228,56,191,156,442,212,633
350090,201911,630,1492,353,991,73,226,138,351,211,577
350100,201911,2126,5760,1402,4413,121,463,825,2463,946,2926
350110,201911,477,1234,320,941,19,70,184,531,203,601
350115,201911,1288,3757,1036,3204,193,667,539,1517,732,2184
350120,201911,629,1476,317,875,38,121,154,379,192,500
350130,201911,3030,8125,2349,6850,419,1268,1130,3134,1549,4402
350140,201911,752,2149,474,1567,51,228,249,748,300,976
350150,201911,479,1478,385,1298,96,307,98,310,194,617
350160,201911,10918,27192,6965,20005,888,2952,4156,11258,5044,14210
350170,201911,1971,5786,1528,4781,289,948,640,1875,929,2823
350180,201911,1040,2576,500,1502,110,337,98,269,208,606
350190,201911,2839,8098,1923,6108,372,1367,791,2084,1163,3451
350200,201911,421,1190,326,1017,19,66,216,637,235,703
350210,201911,5457,12571,3556,9666,511,1493,2101,5491,2612,6984
350220,201911,2827,7733,1849,5780,421,1385,618,1731,1039,3116
350230,201911,975,2573,795,2301,163,511,415,1160,578,1671
350240,201911,671,1962,411,1343,86,278,117,364,203,642
350250,201911,2330,6927,1702,5809,624,2292,271,970,895,3262
350260,201911,789,1909,487,1373,54,163,300,821,354,984
350270,201911,4516,12298,3514,10350,558,1773,1810,4970,2368,6743
350275,201911,2359,6413,1844,5545,322,1094,1052,2961,1374,4055
350280,201911,18607,41714,10452,28309,1867,5382,3883,10096,5750,15478
350290,201911,3093,8565,2035,6346,391,1346,805,2313,1196,3659
350300,201911,645,1766,460,1397,72,233,228,639,300,872
350310,201911,829,2415,588,1890,106,412,231,655,337,1067
350315,201911,550,1440,351,1080,26,99,162,461,188,560
350320,201911,14010,36450,10224,29632,2303,7294,3619,9767,5922,17061
350330,201911,13864,34309,9583,25912,1148,3412,5908,15010,7056,18422
350335,201911,359,1019,265,835,33,118,134,397,167,515
350340,201911,1134,2922,650,2020,118,405,246,701,364,1106
350350,201911,748,1930,575,1736,75,272,326,953,401,1225
350360,201911,1078,3222,809,2640,224,732,238,774,462,1506
350370,201911,605,1528,409,1167,155,423,100,299,255,722
350380,201911,4333,11666,2809,8642,798,2451,652,2068,1450,4519
350390,201911,9623,25960,7360,21942,1791,5518,3055,8906,4846,14424
350395,201911,425,1089,206,659,25,72,69,198,94,270
350400,201911,7906,19751,5293,15312,1324,4119,1487,4138,2811,8257
350410,201911,9352,26324,6564,20753,1455,5095,2338,6795,3793,11890
350420,201911,686,1852,468,1410,85,284,113,306,198,590
350430,201911,640,1737,510,1515,70,252,308,812,378,1064
350440,201911,1847,4730,1463,4144,109,359,975,2690,1084,3049
350450,201911,6628,18365,5075,15601,1129,3776,2064,5910,3193,9686
350460,201911,1671,4358,807,2530,128,430,170,455,298,885
350470,201911,264,674,194,549,9,34,130,351,139,385
350480,201911,940,2418,559,1704,120,421,94,238,214,659
350490,201911,1855,4938,1284,3960,306,986,379,1074,685,2060
350500,201911,675,1815,500,1478,83,266,241,665,324,931
350510,201911,1113,2902,793,2296,102,347,449,1234,551,1581
350520,201911,2077,6446,1579,5408,251,974,708,2197,959,3171
350530,201911,2689,6778,1902,5258,221,675,1111,2868,1332,3543
350535,201911,1386,3854,1181,3549,171,583,728,2093,899,2676
350540,201911,1751,4423,1254,3635,176,547,744,2095,920,2642
350550,201911,8377,20798,5704,16258,631,2122,3295,8712,3926,10834
350560,201911,3877,11001,3028,9418,298,982,1852,5577,2150,6559
350570,201911,23648,66639,18655,56616,3694,12233,9090,26249,12784,38482
350580,201911,1921,5276,989,3192,263,934,159,410,422,1344
350590,201911,4742,13040,3377,9938,504,1679,1933,5225,2437,6904
350600,201911,36480,85002,21671,58545,3248,9723,10306,25466,13554,35189
350610,201911,6509,18026,4567,14052,859,2866,2042,5987,2901,8853
350620,201911,392,988,226,724,24,88,124,378,148,466
350630,201911,1433,3789,1029,3041,74,279,648,1776,722,2055
350635,201911,8096,20492,5980,17101,1046,3334,3341,8973,4387,12307
350640,201911,927,2526,470,1466,66,211,148,384,214,595
350650,201911,7819,21178,5118,15650,1045,3427,1774,5007,2819,8434
350660,201911,4542,11956,3417,10039,599,1768,1746,5110,2345,6878
350670,201911,1842,4895,1479,4356,154,490,991,2899,1145,3389
350680,201911,1116,2999,709,2225,158,505,265,804,423,1309
350690,201911,1242,3283,875,2638,143,469,478,1376,621,1845
350700,201911,4739,12075,3160,9560,570,1941,1395,3944,1965,5885
350710,201911,2728,7581,2246,6713,369,1283,1221,3405,1590,4688
350715,201911,828,2390,664,2068,70,287,343,965,413,1252
350720,201911,169,436,118,343,19,54,35,83,54,137
350730,201911,591,1613,477,1402,27,110,350,963,377,1073
350740,201911,1591,4357,1035,3167,199,637,312,887,511,1524
350745,201911,537,1409,300,917,27,95,151,432,178,527
350750,201911,9774,25683,7257,21181,1304,4340,3190,8283,4494,12623
350760,201911,13371,33789,9129,26261,2164,6784,3188,8249,5352,15033
350770,201911,942,2371,574,1718,43,142,350,1021,393,1163
350775,201911,661,1607,438,1247,47,140,206,567,253,707
350780,201911,1971,4951,1360,4031,251,833,480,1583,731,2416
350790,201911,1671,4507,1002,3240,201,705,244,645,445,1350
350800,201911,3227,9528,2738,8635,321,1130,1742,5330,2063,6460
350810,201911,2576,6455,2003,5609,256,739,1148,3223,1404,3962
350820,201911,898,2107,485,1363,52,170,230,596,282,766
350830,201911,827,2327,437,1445,75,237,128,361,203,598
350840,201911,2943,8775,2106,7084,520,1919,835,2550,1355,4469
350850,201911,6582,18654,4950,15551,1072,3644,2037,6171,3109,9815
350860,201911,3490,9505,2989,8774,138,508,2241,6471,2379,6979
350870,201911,2635,7508,1905,6294,279,1058,1000,3191,1279,4249
350880,201911,1222,3561,935,2970,224,732,282,862,506,1594
350890,201911,535,1383,330,959,49,160,125,332,174,492
350900,201911,6678,18362,4038,12536,1015,3416,1099,3093,2114,6509
350910,201911,864,2211,726,1980,95,283,503,1337,598,1620
350920,201911,11623,29179,9672,25880,477,1561,7742,19924,8219,21485
350925,201911,4379,12065,3071,9593,586,1951,1412,4062,1998,6013
350930,201911,1440,3722,952,2791,117,355,543,1557,660,1912
350940,201911,2181,5889,1682,5032,208,678,1028,2965,1236,3643
350945,201911,836,2351,613,1909,98,366,320,895,418,1261
350950,201911,83371,217294,62716,177055,8597,26724,37564,100804,46161,127528
350960,201911,6148,16926,4704,14145,587,2023,2797,7950,3384,9973
350970,201911,3468,10010,2498,8004,757,2695,452,1239,1209,3934
350980,201911,612,1694,480,1448,141,447,202,602,343,1049
350990,201911,1746,4983,1259,4152,304,1131,434,1323,738,2454
350995,201911,753,2372,668,2202,53,208,460,1453,513,1661
351000,201911,2775,7252,1912,5672,351,1131,702,1973,1053,3104
351010,201911,316,781,202,575,21,67,111,302,132,369
351015,201911,769,2318,607,1974,92,345,283,819,375,1164
351020,201911,8903,24540,6581,20456,1371,4385,3158,9550,4529,13935
351030,201911,2600,7796,2071,6707,318,1144,1111,3480,1429,4624
351040,201911,4822,12136,4001,10860,209,698,3245,8521,3454,9219
351050,201911,17304,42366,11628,33159,2409,7248,4876,13624,7285,20872
351060,201911,47174,119626,35474,99261,3999,12320,23348,63121,27347,75441
351070,201911,1463,3665,774,2422,194,655,129,388,323,1043
351080,201911,2697,6689,1907,5701,246,885,1212,3405,1458,4290
351090,201911,318,939,217,742,49,161,55,192,104,353
351100,201911,2452,6622,1512,4704,344,1124,419,1376,763,2500
351110,201911,5838,15041,3666,10905,647,2098,1538,4261,2185,6359
351120,201911,759,1971,498,1511,61,189,197,585,258,774
351130,201911,1093,2866,461,1493,92,309,95,290,187,599
351140,201911,1874,5423,1321,4299,289,1037,476,1389,765,2426
351150,201911,2108,6186,1350,4461,257,928,518,1538,775,2466
351160,201911,1095,3442,820,2779,183,655,237,712,420,1367
351170,201911,1364,3809,1177,3462,105,338,804,2283,909,2621
351190,201911,1009,2802,609,1949,114,376,210,608,324,984
351200,201911,1573,3803,1154,3166,94,291,789,2046,883,2337
351210,201911,1512,3759,880,2498,73,243,528,1403,601,1646
351220,201911,3182,9102,2695,8261,344,1082,1746,5311,2090,6393
351230,201911,1779,4898,1273,3977,250,892,555,1558,805,2450
351240,201911,2258,5803,1346,3830,285,849,550,1410,835,2259
351250,201911,1076,2862,607,1893,79,246,219,685,298,931
351260,201911,899,2310,630,1812,145,402,213,618,358,1020
351270,201911,394,1089,320,963,35,120,193,513,228,633
351280,201911,3792,10086,2821,8222,532,1643,1308,3638,1840,5281
351290,201911,1162,2972,771,2260,127,393,412,1162,539,1555
351300,201911,16141,44543,10660,33653,2032,6915,4352,13239,6384,20154
351310,201911,3250,8141,2394,6748,196,680,1681,4468,1877,5148
351320,201911,910,2672,641,2073,123,431,225,651,348,1082
351330,201911,481,1125,393,965,32,90,281,618,313,708
351340,201911,6286,18150,4948,15747,1229,4062,2120,6697,3349,10759
351350,201911,11399,29027,9391,25710,1076,3174,6779,17994,7855,21168
351360,201911,3752,10179,3065,9090,755,2398,1122,3093,1877,5491
351370,201911,2090,5906,1354,4333,350,1193,419,1206,769,2399
351380,201911,46629,114515,32201,88417,4516,13298,17774,46541,22290,59839
351385,201911,299,777,146,442,25,73,43,123,68,196
351390,201911,1366,3352,789,2462,130,476,440,1275,570,1751
351400,201911,923,2591,729,2189,133,399,433,1261,566,1660
351410,201911,2598,7329,1805,5727,321,1032,687,2120,1008,3152
351420,201911,361,865,179,535,29,76,97,281,126,357
351430,201911,923,2575,696,2185,69,221,448,1369,517,1590
351440,201911,3290,8778,2056,6132,378,1193,562,1424,940,2617
351450,201911,1697,4544,1064,3306,224,763,171,422,395,1185
351460,201911,804,2124,602,1768,151,438,321,931,472,1369
351470,201911,1172,3016,875,2503,89,298,543,1465,632,1763
351480,201911,2529,7492,1969,6482,370,1333,820,2522,1190,3855
351490,201911,1905,5492,1607,4916,82,337,1254,3661,1336,3998
351492,201911,336,930,271,782,11,37,185,522,196,559
351495,201911,187,489,133,376,14,35,69,190,83,225
351500,201911,36046,90440,26163,72954,4237,12674,14960,39675,19197,52349
351510,201911,12636,31724,8985,25194,1160,3700,5541,14810,6701,18510
351512,201911,475,1284,311,923,55,162,101,269,156,431
351515,201911,3235,7249,1827,4988,339,1011,524,1493,863,2504
351518,201911,2381,6058,1479,4388,202,687,809,2173,1011,2860
351519,201911,716,2000,402,1339,79,260,57,184,136,444
351520,201911,1162,2910,443,1394,55,188,176,488,231,676
351530,201911,347,938,188,586,25,80,74,175,99,255
351535,201911,1941,4698,1349,3686,211,637,696,1782,907,2419
351540,201911,2252,5688,1414,4182,323,1101,434,1106,757,2207
351550,201911,6561,16549,4285,12234,440,1484,2413,6345,2853,7829
351560,201911,432,1237,338,1052,85,301,97,271,182,572
351565,201911,193,562,150,484,32,118,43,126,75,244
351570,201911,19552,53415,14324,42276,1698,5428,8682,24414,10380,29842
351580,201911,258,661,144,437,13,42,64,198,77,240
351590,201911,503,1143,256,701,24,83,137,337,161,420
351600,201911,1323,3449,992,2847,94,304,629,1691,723,1995
351610,201911,761,1802,455,1251,30,97,249,635,279,732
351620,201911,21460,57970,15375,46845,2608,8974,6786,18554,9394,27528
351630,201911,25314,68031,19962,58463,3223,9932,12053,34244,15276,44176
351640,201911,16191,43456,12239,35865,1273,4259,8173,22931,9446,27190
351650,201911,383,1015,158,522,20,71,37,102,57,173
351660,201911,747,2134,442,1403,84,274,66,176,150,450
351670,201911,5397,14818,3668,10957,789,2368,1603,4482,2392,6850
351680,201911,425,1226,253,811,46,145,55,142,101,287
351685,201911,426,1244,334,1081,91,289,110,322,201,611
351690,201911,1029,2638,587,1726,95,313,238,630,333,943
351700,201911,1308,3325,922,2618,126,357,537,1454,663,1811
351710,201911,751,2020,499,1543,43,156,256,706,299,862
351720,201911,1414,3684,896,2746,149,494,336,976,485,1470
351730,201911,891,2352,730,2084,65,232,487,1324,552,1556
351740,201911,3530,8941,2702,7329,471,1378,1349,3379,1820,4757
351750,201911,1280,3409,772,2476,151,506,283,897,434,1403
351760,201911,3250,9207,2270,7132,493,1741,804,2265,1297,4006
351770,201911,1766,5294,1423,4601,286,965,718,2272,1004,3237
351780,201911,1320,3407,719,2193,117,412,236,678,353,1090
351790,201911,1318,3143,1021,2741,171,462,600,1630,771,2092
351800,201911,505,1178,239,675,22,60,88,212,110,272
351810,201911,1009,2652,799,2310,41,131,575,1576,616,1707
351820,201911,2478,7020,1680,5428,436,1548,357,1073,793,2621
351830,201911,4401,11965,3304,10001,327,1200,2026,5789,2353,6989
351840,201911,8233,23184,6114,19121,938,3263,3067,8978,4005,12241
351850,201911,1670,4516,1030,3228,191,691,328,868,519,1559
351860,201911,2761,8109,2109,6846,385,1336,1114,3624,1499,4960
351870,201911,23125,59854,17136,49671,4838,14341,6633,19665,11471,34006
351880,201911,116641,308812,84871,251792,21624,69760,34056,96051,55680,165811
351885,201911,890,2443,691,2079,77,273,437,1244,514,1517
351890,201911,735,1971,473,1518,116,378,70,192,186,570
351900,201911,1068,2893,817,2501,123,383,439,1343,562,1726
351905,201911,399,1106,256,811,20,70,100,273,120,343
351907,201911,21115,55734,15902,46153,1884,5969,10119,28286,12003,34255
351910,201911,1295,3423,877,2521,78,247,490,1278,568,1525
351920,201911,821,2182,590,1727,80,277,281,747,361,1024
351925,201911,855,2358,648,1954,93,306,316,882,409,1188
351930,201911,3179,8993,2842,8352,571,1686,1888,5472,2459,7158
351940,201911,1086,2856,767,2305,119,385,381,1117,500,1502
351950,201911,1586,3725,1125,3022,74,217,750,1954,824,2171
351960,201911,5221,13375,3705,10607,817,2498,1632,4339,2449,6837
351970,201911,6716,20350,5350,17855,884,3304,2905,9401,3789,12705
351980,201911,1050,2467,643,1795,82,261,365,943,447,1204
351990,201911,1407,3350,963,2661,67,251,445,1090,512,1341
352000,201911,2517,7290,2128,6468,266,939,1378,3908,1644,4847
352010,201911,2151,5885,1704,5102,440,1435,342,1055,782,2490
352020,201911,1438,3974,1083,3350,179,589,513,1494,692,2083
352030,201911,5408,14498,4201,12510,836,2752,2124,6097,2960,8849
352040,201911,2760,7521,1755,5402,277,925,603,1594,880,2519
352042,201911,3062,7555,1867,5537,379,1250,773,2212,1152,3462
352044,201911,2082,5610,1114,3698,192,707,234,701,426,1408
352050,201911,11773,31527,7162,22196,1825,6396,1202,3121,3027,9517
352060,201911,706,1927,500,1526,71,236,222,625,293,861
352070,201911,861,1757,536,1320,61,164,257,545,318,709
352080,201911,449,1133,265,762,30,94,102,260,132,354
352090,201911,1419,4212,1135,3597,142,536,511,1452,653,1988
352100,201911,3004,8546,2451,7487,569,1886,1136,3283,1705,5169
352110,201911,574,1718,431,1416,94,322,173,530,267,852
352115,201911,497,1389,404,1242,55,193,231,700,286,893
352120,201911,854,2585,675,2209,82,293,392,1189,474,1482
352130,201911,1881,5348,1205,3644,213,680,477,1341,690,2021
352140,201911,1253,3334,810,2449,142,465,368,1060,510,1525
352150,201911,818,2209,618,1855,94,300,382,1116,476,1416
352160,201911,984,2435,698,1999,84,285,379,1030,463,1315
352170,201911,2942,8033,2259,6620,362,1204,1264,3370,1626,4574
352180,201911,2544,6965,1935,5793,468,1561,563,1456,1031,3017
352190,201911,1176,3178,889,2724,150,458,430,1349,580,1807
352200,201911,355,1065,248,850,36,138,91,302,127,440
352210,201911,18971,45512,14660,39589,1144,3402,11134,29532,12278,32934
352215,201911,561,1489,483,1383,58,192,335,922,393,1114
352220,201911,17832,44958,11495,33385,2796,8554,4084,11232,6880,19786
352230,201911,12810,37750,9575,31434,2317,8510,3413,10325,5730,18835
352240,201911,10444,27296,7809,22708,1762,5757,3260,8650,5022,14407
352250,201911,23151,65220,18251,56340,3231,10621,10572,31937,13803,42558
352260,201911,4842,12331,3236,9125,486,1606,1842,4682,2328,6288
352265,201911,895,2534,784,2365,50,197,583,1702,633,1899
352270,201911,1437,4368,1039,3474,228,836,349,1089,577,1925
352280,201911,2397,6168,1805,5266,191,692,1042,2790,1233,3482
352290,201911,1135,3359,902,2873,139,497,455,1293,594,1790
352300,201911,902,2453,584,1770,85,298,302,837,387,1135
352310,201911,45198,120693,32520,97621,8256,25303,13788,41503,22044,66806
352320,201911,6303,16887,4731,13673,739,2387,2454,6427,3193,8814
352330,201911,2181,5828,1617,5012,316,1147,800,2303,1116,3450
352340,201911,5397,14311,3804,11373,655,2242,1870,5135,2525,7377
352350,201911,2125,6136,1644,5033,200,750,881,2398,1081,3148
352360,201911,1235,3309,1024,2928,90,319,763,2074,853,2393
352370,201911,1053,3031,903,2759,23,101,705,2095,728,2196
352380,201911,803,2228,596,1843,126,412,206,600,332,1012
352390,201911,15463,38086,10169,28707,1670,5126,5556,14799,7226,19925
352400,201911,3473,9643,2840,8421,553,1912,1599,4416,2152,6328
352410,201911,3138,8162,2333,6767,226,793,1410,3877,1636,4670
352420,201911,827,2028,566,1620,100,304,202,545,302,849
352430,201911,7550,19122,5253,14999,1240,3951,2299,6165,3539,10116
352440,201911,17342,47517,12687,38306,3121,9804,4831,14092,7952,23896
352450,201911,801,2045,383,1251,52,185,120,361,172,546
352460,201911,2912,8144,1936,6283,405,1457,729,2200,1134,3657
352470,201911,3293,8289,2350,6729,291,954,1311,3487,1602,4441
352480,201911,3573,8570,2270,6218,371,1153,1071,2665,1442,3818
352490,201911,707,2105,551,1795,102,355,254,778,356,1133
352500,201911,10317,26726,6719,19888,2934,9485,772,1324,3706,10809
352510,201911,3496,9477,2555,7830,584,1928,1112,3210,1696,5138
352520,201911,2601,6968,1991,5873,390,1313,1079,2870,1469,4183
352530,201911,9485,25196,5833,17751,1136,3888,1387,3476,2523,7364
352540,201911,532,1609,373,1232,64,225,113,339,177,564
352550,201911,970,2769,663,2143,135,473,198,566,333,1039
352560,201911,584,1627,434,1323,74,242,201,563,275,805
352570,201911,1976,5732,1246,4199,331,1194,148,436,479,1630
352580,201911,638,1649,515,1427,59,199,325,855,384,1054
352585,201911,255,741,185,597,16,67,102,290,118,357
352590,201911,12672,33376,8637,25548,2382,7646,3675,10066,6057,17712
352600,201911,1936,5272,1488,4399,191,626,875,2412,1066,3038
352610,201911,2987,8405,2195,6955,465,1654,887,2624,1352,4278
352620,201911,5641,14707,4270,12605,1278,3825,1608,4784,2886,8609
352630,201911,817,2067,605,1736,105,352,274,703,379,1055
352640,201911,2939,7654,2050,6071,223,676,1169,3327,1392,4003
352650,201911,575,1636,386,1192,56,200,145,418,201,618
352660,201911,1010,3032,799,2569,165,549,352,1093,517,1642
352670,201911,8791,24040,5405,17132,1514,5056,923,2828,2437,7884
352680,201911,3198,9609,2213,7271,355,1375,1083,3237,1438,4612
352690,201911,26577,67316,19850,55281,1545,5090,13520,35952,15065,41042
352700,201911,558,1389,398,1157,149,488,84,225,233,713
352710,201911,4908,12852,3381,9995,821,2682,1399,3806,2220,6488
352720,201911,7638,21184,5791,17564,2646,8114,973,2688,3619,10802
352725,201911,531,1332,272,801,18,52,130,365,148,417
352730,201911,2741,7832,2255,6684,328,1083,1345,3661,1673,4744
352740,201911,2235,5302,1625,4392,178,556,961,2461,1139,3017
352750,201911,399,1004,218,674,36,123,87,233,123,356
352760,201911,1625,4558,1187,3645,148,484,602,1812,750,2296
352770,201911,891,2402,576,1769,119,379,228,667,347,1046
352780,201911,624,1795,424,1387,79,260,122,391,201,651
352790,201911,431,1169,281,848,29,99,110,296,139,395
352800,201911,1251,3875,869,2970,247,893,120,345,367,1238
352810,201911,1098,2633,674,1857,84,241,394,1026,478,1267
352820,201911,508,1348,326,1030,72,234,70,240,142,474
352830,201911,573,1457,242,745,22,73,50,124,72,197
352840,201911,3807,11026,3071,9662,1064,3634,970,2925,2034,6559
352850,201911,10446,25842,6782,19779,1935,6118,2051,5375,3986,11493
352860,201911,1015,2804,706,2208,149,498,234,687,383,1185
352870,201911,887,2225,603,1622,40,133,404,1028,444,1161
352880,201911,1767,4183,1209,3196,170,475,735,1831,905,2306
352885,201911,299,852,220,709,26,90,123,376,149,466
352890,201911,686,1626,422,1089,46,134,240,553,286,687
352900,201911,17616,46197,11381,33730,1912,6071,5073,14059,6985,20130
352910,201911,439,1162,213,664,23,73,62,173,85,246
352920,201911,2654,6874,1885,5477,146,460,1258,3528,1404,3988
352930,201911,5579,15168,4008,12032,728,2380,1841,5129,2569,7509
352940,201911,21622,60111,15349,46500,3434,11379,5750,16387,9184,27766
352950,201911,474,1265,264,849,70,235,33,94,103,329
352960,201911,712,1933,364,1176,59,207,79,228,138,435
352965,201911,263,707,143,474,41,134,35,108,76,242
352970,201911,2950,7059,2209,5854,260,734,1422,3714,1682,4448
352980,201911,1389,3713,1066,3199,269,855,527,1534,796,2389
352990,201911,4055,11465,3167,9982,639,2222,1578,4769,2217,6991
353000,201911,452,1244,226,703,35,114,57,147,92,261
353010,201911,2461,6152,1562,4545,371,1209,598,1573,969,2782
353020,201911,3628,9447,1997,5979,293,994,698,1939,991,2933
353030,201911,4202,10850,2769,8207,690,2206,712,2025,1402,4231
353040,201911,620,1476,440,1203,58,172,260,665,318,837
353050,201911,5069,14754,3573,11608,722,2548,1572,4873,2294,7421
353060,201911,47761,122560,38628,107679,2848,9582,28621,76700,31469,86282
353070,201911,9237,26438,6316,20106,1312,4566,2376,6947,3688,11513
353080,201911,3958,11123,2634,8468,522,1890,1002,2822,1524,4712
353090,201911,546,1667,398,1339,36,129,229,747,265,876
353100,201911,296,807,123,400,25,85,32,84,57,169
353110,201911,7506,20543,5990,18267,1183,3678,3240,10106,4423,13784
353120,201911,395,1004,277,796,41,139,114,295,155,434
353130,201911,2364,5669,1481,4203,404,1261,474,1243,878,2504
353140,201911,2659,6651,1876,5228,134,444,1270,3332,1404,3776
353150,201911,1459,3634,1006,2889,200,604,438,1175,638,1779
353160,201911,556,1444,386,1159,70,236,163,448,233,684
353170,201911,504,1399,380,1214,84,303,166,503,250,806
353180,201911,9557,23698,7325,20037,725,2253,5387,14268,6112,16521
353190,201911,3193,8654,2492,7251,297,945,1524,4159,1821,5104
353200,201911,2002,5372,914,2993,152,544,211,623,363,1167
353205,201911,340,1042,281,904,54,190,133,420,187,610
353210,201911,959,2246,588,1621,32,106,378,1010,410,1116
353215,201911,386,1097,293,910,49,160,134,369,183,529
353220,201911,738,2014,423,1316,99,295,51,148,150,443
353230,201911,796,2235,625,1958,176,600,242,685,418,1285
353240,201911,2262,6207,1791,5357,251,857,1037,2954,1288,3811
353250,201911,1270,2853,740,1956,101,287,399,1001,500,1288
353260,201911,1124,2663,604,1778,94,312,284,793,378,1105
353270,201911,678,1737,553,1509,42,135,381,987,423,1122
353280,201911,708,1908,477,1466,101,317,147,417,248,734
353282,201911,1754,4979,1466,4429,171,578,884,2513,1055,3091
353284,201911,356,833,174,483,22,83,74,176,96,259
353286,201911,161,407,95,297,19,62,39,123,58,185
353290,201911,1521,4031,895,2744,135,427,311,880,446,1307
353300,201911,1791,4868,1280,3830,208,696,577,1548,785,2244
353310,201911,390,960,267,734,21,75,180,468,201,543
353320,201911,648,1622,541,1455,11,40,467,1251,478,1291
353325,201911,647,1908,423,1403,98,310,154,496,252,806
353330,201911,517,1325,326,946,43,130,172,460,215,590
353340,201911,2772,7539,1891,5803,420,1418,826,2368,1246,3786
353350,201911,3322,8746,2211,6447,493,1589,579,1434,1072,3023
353360,201911,577,1653,443,1406,56,185,240,752,296,937
353370,201911,545,1588,438,1411,33,108,307,948,340,1056
353380,201911,265,796,209,677,30,105,103,305,133,410
353390,201911,5625,14068,4014,11253,504,1576,2216,5856,2720,7432
353400,201911,414,1164,307,949,50,181,102,264,152,445
353410,201911,502,1359,379,1134,65,213,214,628,279,841
353420,201911,444,1207,256,779,59,166,20,51,79,217
353430,201911,2151,6041,1571,4945,372,1283,638,1859,1010,3142
353440,201911,63394,173300,44095,134685,7643,25191,22659,65380,30302,90571
353450,201911,380,981,250,751,38,136,117,318,155,454
353460,201911,3232,8819,2286,6903,167,612,1092,3181,1259,3793
353470,201911,7605,20148,5261,15692,924,3112,2156,5858,3080,8970
353475,201911,1391,3606,955,2712,146,461,472,1233,618,1694
353480,201911,1609,4324,1246,3670,70,259,846,2379,916,2638
353490,201911,1075,2858,669,2050,100,328,282,817,382,1145
353500,201911,1003,2358,744,1962,164,436,414,1094,578,1530
353510,201911,788,2397,541,1770,127,444,137,384,264,828
353520,201911,1077,2831,666,2058,87,305,300,854,387,1159
353530,201911,2404,6438,1818,5348,249,811,933,2552,1182,3363
353540,201911,2020,5550,1641,4924,272,860,931,2714,1203,3574
353550,201911,5754,15003,4493,12896,789,2407,2468,6794,3257,9201
353560,201911,2012,5574,1447,4644,450,1577,356,1038,806,2615
353570,201911,559,1429,407,1185,51,157,246,665,297,822
353580,201911,2001,5259,1533,4404,347,980,723,2031,1070,3011
353590,201911,701,1884,443,1361,102,342,164,500,266,842
353600,201911,1743,4347,1292,3538,157,427,694,1854,851,2281
353610,201911,542,1613,378,1283,86,349,105,324,191,673
353620,201911,2610,7077,1775,5519,363,1276,572,1578,935,2854
353625,201911,478,1167,299,853,21,66,195,549,216,615
353630,201911,1241,3917,997,3346,228,856,328,987,556,1843
353640,201911,1362,3529,1079,3092,151,459,612,1728,763,2187
353650,201911,8309,22427,5897,17579,653,2180,3412,9520,4065,11700
353657,201911,379,992,255,770,30,91,109,306,139,397
353660,201911,1243,2705,833,2118,342,848,231,581,573,1429
353670,201911,4010,11253,3039,9303,615,2093,1505,4261,2120,6354
353680,201911,653,1756,470,1478,87,291,255,766,342,1057
353690,201911,440,1111,173,533,13,38,29,75,42,113
353700,201911,1968,5231,1598,4574,131,428,1153,3170,1284,3598
353710,201911,4456,9894,2444,6341,230,638,1524,3582,1754,4220
353715,201911,436,1157,241,768,13,52,75,222,88,274
353720,201911,1894,5177,1441,4483,185,647,867,2637,1052,3284
353730,201911,4265,11473,3126,9305,489,1657,1505,4088,1994,5745
353740,201911,1979,5279,1338,4091,335,1115,440,1219,775,2334
353750,201911,797,2440,543,1927,134,503,95,365,229,868
353760,201911,12373,29318,9349,25029,1769,4887,5176,13483,6945,18370
353770,201911,714,2157,372,1259,65,239,57,163,122,402
353780,201911,5123,14531,3888,11990,828,2840,1740,4891,2568,7731
353790,201911,2506,7716,1788,6171,506,1974,375,1133,881,3107
353800,201911,17196,45892,13025,38856,2001,6358,7059,20948,9060,27306
353810,201911,1081,2932,700,2135,110,379,293,843,403,1222
353820,201911,1694,4685,1140,3524,257,847,367,1070,624,1917
353830,201911,623,1557,433,1238,75,225,193,519,268,744
353850,201911,1588,4490,1187,3688,281,900,408,1244,689,2144
353860,201911,2514,7110,1929,6007,469,1655,835,2341,1304,3996
353870,201911,28309,75285,19392,57344,2652,8863,10022,26972,12674,35835
353880,201911,2962,8337,2284,6990,193,701,1387,4071,1580,4772
353890,201911,2397,5349,1545,4113,146,404,1025,2612,1171,3016
353900,201911,719,2015,495,1560,90,314,190,557,280,871
353910,201911,2026,5798,1641,5149,214,803,1065,3241,1279,4044
353920,201911,1793,4979,1222,3846,282,1014,322,838,604,1852
353930,201911,4155,11090,2701,8396,536,1887,1011,2774,1547,4661
353940,201911,1085,3144,722,2370,143,486,243,732,386,1218
353950,201911,3014,8255,2329,7004,428,1422,1302,3606,1730,5028
353960,201911,722,1896,467,1396,93,302,181,507,274,809
353970,201911,685,1650,496,1365,42,124,325,861,367,985
353980,201911,14841,38114,11152,31354,927,2952,7779,21043,8706,23995
353990,201911,901,2214,520,1497,79,247,242,654,321,901
354000,201911,2459,5993,1289,3719,285,862,209,569,494,1431
354010,201911,344,902,244,736,37,125,136,394,173,519
354020,201911,3343,9394,2566,7701,674,2163,1014,2792,1688,4955
354025,201911,727,2007,451,1462,75,281,98,294,173,575
354030,201911,496,1103,251,687,50,145,115,306,165,451
354040,201911,804,1908,499,1375,28,96,350,925,378,1021
354050,201911,958,2729,650,2156,164,569,191,634,355,1203
354060,201911,3406,9732,2245,7207,538,1814,750,2218,1288,4032
354070,201911,3445,9338,2312,7100,434,1527,881,2279,1315,3806
354075,201911,2464,7253,1851,6065,237,916,1032,3276,1269,4192
354080,201911,1360,3747,876,2784,183,635,197,549,380,1184
354085,201911,411,877,318,758,1,3,231,512,232,515
354090,201911,1521,4328,1309,3875,99,310,987,2883,1086,3193
354100,201911,18662,51924,12696,41031,2892,10031,4816,15451,7708,25482
354105,201911,1526,3840,985,2822,131,375,446,1193,577,1568
354110,201911,484,1342,316,1021,51,173,105,344,156,517
354120,201911,1448,3917,928,2785,185,599,323,851,508,1450
354130,201911,5595,14815,3483,10635,935,3057,221,420,1156,3477
354140,201911,18904,46258,12017,33617,2189,6692,4959,12790,7148,19482
354150,201911,3027,7306,2198,5933,505,1395,855,2260,1360,3655
354160,201911,2947,8599,2125,6891,633,2202,592,1753,1225,3955
354165,201911,600,1810,444,1488,79,306,224,703,303,1009
354170,201911,1596,4501,1304,3914,83,304,835,2385,918,2689
354180,201911,406,1119,283,851,57,175,112,302,169,477
354190,201911,1446,4102,966,3077,72,265,396,1239,468,1504
354200,201911,844,2109,648,1790,79,232,401,1060,480,1292
354210,201911,723,1949,566,1674,41,145,407,1127,448,1272
354220,201911,3015,8231,2152,6452,405,1310,1023,2900,1428,4210
354230,201911,712,1801,547,1588,39,154,384,1047,423,1201
354240,201911,1561,4383,1002,3195,181,643,300,826,481,1469
354250,201911,502,1262,305,948,90,277,76,255,166,532
354260,201911,8080,21646,6001,17905,1312,4117,2427,7007,3739,11124
354270,201911,1025,3115,800,2664,196,636,298,977,494,1613
354280,201911,755,1935,628,1744,60,215,397,1024,457,1239
354290,201911,878,2800,723,2462,121,413,364,1272,485,1685
354300,201911,3537,10479,2972,9412,914,2882,1005,3171,1919,6053
354310,201911,647,1937,514,1659,124,421,183,554,307,975
354320,201911,896,2226,551,1611,74,260,223,580,297,840
354323,201911,457,1122,301,837,34,79,128,344,162,423
354325,201911,1215,3613,841,2794,151,504,326,1047,477,1551
354330,201911,8969,22949,5644,15971,729,2439,3238,8460,3967,10899
354340,201911,29719,76044,19473,57506,3461,11317,9299,26054,12760,37371
354350,201911,1165,3015,908,2553,96,293,615,1651,711,1944
354360,201911,597,1549,311,1044,56,193,56,180,112,373
354370,201911,978,2861,774,2515,133,459,427,1352,560,1811
354380,201911,722,1931,503,1561,92,356,121,303,213,659
354390,201911,13230,32297,8034,22919,1567,4715,2970,8045,4537,12760
354400,201911,1535,4969,1162,4065,210,790,406,1386,616,2176
354410,201911,5456,15048,3984,11967,921,2944,1667,4781,2588,7725
354420,201911,1456,3848,1043,3052,129,389,639,1801,768,2190
354425,201911,2626,6496,1802,5024,431,1214,740,2076,1171,3290
354430,201911,1536,4135,1167,3486,138,477,670,1859,808,2336
354440,201911,559,1498,336,1020,51,183,150,413,201,596
354450,201911,408,1069,212,693,36,123,56,160,92,283
354460,201911,880,2233,555,1642,80,249,295,841,375,1090
354470,201911,487,1235,297,836,21,71,147,365,168,436
354480,201911,1163,2654,739,1980,66,185,494,1266,560,1451
354490,201911,789,2375,554,1840,112,392,236,732,348,1124
354500,201911,1960,5604,1596,5031,494,1678,372,1184,866,2862
354510,201911,729,2064,566,1717,59,186,298,822,357,1008
354515,201911,314,937,226,743,39,137,89,283,128,420
354520,201911,6438,17922,4241,13013,634,2204,2307,6581,2941,8785
354530,201911,4149,12019,3101,9857,751,2436,1203,3785,1954,6221
354540,201911,1294,3465,922,2795,221,707,324,986,545,1693
354550,201911,521,1390,392,1123,53,161,223,599,276,760
354560,201911,2048,5058,1064,3084,151,452,525,1432,676,1884
354570,201911,1189,3001,449,1310,87,273,59,167,146,440
354580,201911,8905,23357,5569,16940,870,2905,2734,7910,3604,10815
354600,201911,1764,4851,1317,3968,151,526,832,2370,983,2896
354610,201911,403,1056,214,648,27,89,91,259,118,348
354620,201911,416,1219,258,892,45,176,91,275,136,451
354625,201911,317,876,170,560,31,122,35,83,66,205
354630,201911,1884,5693,1477,4835,532,1808,241,735,773,2543
354640,201911,3089,8988,2186,7088,372,1355,747,2241,1119,3596
354650,201911,866,2267,677,1944,58,166,424,1212,482,1378
354660,201911,3717,8768,1872,5570,185,660,874,2374,1059,3034
354670,201911,1059,2972,706,2243,153,533,256,727,409,1260
354680,201911,4866,13068,3728,11144,906,2803,1834,5603,2740,8406
354690,201911,516,1653,346,1244,81,303,96,338,177,641
354700,201911,877,2326,605,1789,90,289,294,815,384,1104
354710,201911,469,1274,314,962,44,152,135,367,179,519
354720,201911,320,773,129,385,44,140,25,72,69,212
354730,201911,9563,27065,6961,21929,1006,3479,3826,11613,4832,15092
354740,201911,312,866,120,423,21,86,18,60,39,146
354750,201911,2409,6323,1479,4512,271,879,611,1653,882,2532
354760,201911,1934,5342,1307,4105,327,1098,388,1122,715,2220
354765,201911,353,940,129,423,19,60,24,65,43,125
354770,201911,2292,5674,1626,4538,307,937,755,1953,1062,2890
354780,201911,53460,137453,39220,108393,4753,14681,23528,60849,28281,75530
354790,201911,985,2758,762,2373,94,325,445,1320,539,1645
354800,201911,2529,6637,1931,5630,499,1479,801,2211,1300,3690
354805,201911,1328,3067,869,2356,102,278,476,1172,578,1450
354810,201911,640,1858,342,1212,44,179,72,226,116,405
354820,201911,925,2698,648,2125,130,472,157,428,287,900
354830,201911,457,1137,273,791,55,166,89,243,144,409
354840,201911,904,2250,486,1414,42,138,280,766,322,904
354850,201911,20938,54877,14166,42259,1763,6069,8376,23419,10139,29488
354860,201911,1658,4702,1012,3298,195,697,309,890,504,1587
354870,201911,56143,142811,42479,116789,4989,15047,25631,66495,30620,81542
354880,201911,5700,14213,2561,7314,323,1064,912,2099,1235,3163
354890,201911,16802,42223,12691,35107,1782,5556,7381,19560,9163,25116
354900,201911,399,1027,248,758,42,136,62,172,104,308
354910,201911,5159,13822,2936,9573,682,2347,432,1342,1114,3689
354920,201911,444,1176,181,618,23,91,41,136,64,227
354925,201911,279,806,160,536,23,84,34,100,57,184
354930,201911,394,934,210,619,14,49,96,254,110,303
354940,201911,2166,6625,1473,5019,496,1815,250,773,746,2588
354950,201911,1417,3759,1108,3297,66,281,802,2233,868,2514
354960,201911,888,2383,668,2047,58,219,396,1140,454,1359
354970,201911,4093,11613,3117,9839,406,1403,1881,5742,2287,7145
354980,201911,31084,74394,19851,54554,2291,7503,11448,29090,13739,36593
354990,201911,60788,155941,44017,124557,4097,13259,27669,73892,31766,87151
354995,201911,2743,6352,2038,5389,198,652,1440,3595,1638,4247
355000,201911,1529,3897,1144,3318,182,609,531,1415,713,2024
355010,201911,3680,10107,2082,6663,707,2331,199,662,906,2993
355020,201911,3504,9993,2491,8137,655,2315,797,2469,1452,4784
355030,201911,1327981,3284182,916865,2462292,148110,435373,447245,1102886,595355,1538259
355040,201911,2799,7239,2196,6411,356,1025,1426,4216,1782,5241
355050,201911,939,2231,660,1787,185,534,248,620,433,1154
355060,201911,5871,16148,4239,12973,747,2616,2048,5657,2795,8273
355070,201911,8387,22014,6587,19006,778,2610,4116,11137,4894,13747
355080,201911,902,2616,534,1871,107,406,73,197,180,603
355090,201911,1102,3231,807,2693,220,708,217,767,437,1475
355100,201911,22211,58579,16864,50359,2882,9099,9977,29434,12859,38533
355110,201911,861,2412,610,1992,187,672,103,315,290,987
355120,201911,691,1820,479,1488,41,143,184,534,225,677
355130,201911,868,1906,385,1028,26,79,213,529,239,608
355140,201911,1764,4127,1480,3710,108,335,1198,2898,1306,3233
355150,201911,4278,11425,3326,9680,377,1220,2083,5797,2460,7017
355160,201911,1858,5173,1302,4135,325,1146,303,925,628,2071
355170,201911,9630,24938,7322,20932,1511,4636,3735,10305,5246,14941
355180,201911,2712,7396,1871,5915,412,1444,660,1889,1072,3333
355190,201911,1857,4896,1441,4241,331,1000,756,2334,1087,3334
355200,201911,825,2579,689,2354,184,705,280,879,464,1584
355210,201911,2810,7801,2167,6415,406,1370,1103,3049,1509,4419
355220,201911,43529,117025,33390,97017,8233,25390,13320,35610,21553,61000
355230,201911,1120,2818,582,1738,104,306,191,536,295,842
355240,201911,23529,62409,15832,46744,2317,7469,8267,23061,10584,30530
355250,201911,36361,98306,25790,77288,6559,20721,9449,26801,16008,47522
355255,201911,715,1807,369,1138,62,201,128,373,190,574
355260,201911,1402,3578,994,2848,135,472,574,1515,709,1987
355270,201911,1199,3557,885,2873,220,735,283,843,503,1578
355280,201911,28369,74010,19215,55915,3034,9488,8983,24656,12017,34144
355290,201911,859,2401,620,1946,141,417,246,747,387,1164
355300,201911,1213,3588,917,2967,173,600,297,917,470,1517
355310,201911,994,2729,726,2267,94,292,408,1283,502,1575
355320,201911,520,1381,375,1106,66,227,158,382,224,609
355330,201911,2506,6623,1877,5473,140,521,1361,3773,1501,4294
355340,201911,3907,8705,2980,7433,388,882,1851,4704,2239,5586
355350,201911,1307,3865,946,3114,214,732,319,1028,533,1760
355360,201911,1175,3026,877,2562,115,362,525,1505,640,1867
355365,201911,370,988,184,635,43,134,27,96,70,230
355370,201911,5425,13849,4076,11736,973,2613,1808,5712,2781,8325
355380,201911,2899,7875,2114,6335,405,1316,735,1906,1140,3222
355385,201911,1400,3729,1126,3305,109,400,706,1909,815,2309
355390,201911,781,2153,540,1601,115,374,224,603,339,977
355395,201911,1899,5282,1269,3989,212,714,442,1227,654,1941
355400,201911,8925,26085,6933,21962,1799,6450,2333,6537,4132,12987
355410,201911,21198,58239,13276,42770,3005,10630,3241,10293,6246,20923
355420,201911,632,2058,500,1781,142,568,125,417,267,985
355430,201911,3688,9405,2713,7646,701,1937,1196,3373,1897,5310
355440,201911,808,2223,469,1483,75,246,141,410,216,656
355450,201911,3189,8345,1965,5867,381,1196,766,2080,1147,3276
355460,201911,506,1247,305,901,38,132,150,408,188,540
355465,201911,378,1039,278,860,47,151,124,377,171,528
355470,201911,1095,2847,582,1789,172,574,166,454,338,1028
355475,201911,357,845,279,728,17,40,203,517,220,557
355480,201911,3649,10319,2968,9275,460,1642,1883,5663,2343,7305
355490,201911,949,2556,486,1524,38,131,249,722,287,853
355495,201911,760,2160,538,1753,70,255,196,601,266,856
355500,201911,6679,17477,3703,11341,582,1971,1185,3311,1767,5282
355510,201911,1303,3255,787,2326,112,382,324,847,436,1229
355520,201911,388,859,167,488,28,82,50,127,78,209
355530,201911,406,927,138,401,19,69,57,146,76,215
355535,201911,501,1380,371,1162,80,307,158,438,238,745
355540,201911,10153,26258,8206,23320,1391,4272,5025,13805,6416,18077
355550,201911,637,1906,517,1678,71,255,270,828,341,1083
355560,201911,1107,2882,569,1812,123,436,37,120,160,556
355570,201911,247,709,127,420,23,79,33,99,56,178
355580,201911,1205,2980,780,2245,144,464,334,895,478,1359
355590,201911,179,448,135,375,16,51,80,205,96,256
355600,201911,1463,3601,956,2727,198,606,404,1113,602,1719
355610,201911,1715,4313,1117,3222,137,433,557,1526,694,1959
355620,201911,4454,12138,3182,9545,379,1377,1705,4669,2084,6046
355630,201911,2268,6283,1514,4794,260,861,730,2264,990,3125
355635,201911,892,2626,641,2118,128,458,191,567,319,1025
355640,201911,2797,7940,1840,5956,370,1291,503,1542,873,2833
355645,201911,4222,11969,3056,9864,433,1495,1665,5269,2098,6764
355650,201911,6447,17595,5008,14894,1450,4454,1796,4814,3246,9268
355660,201911,1295,3400,866,2573,135,477,294,854,429,1331
355670,201911,3412,9297,2151,6374,280,1004,1082,2792,1362,3796
355680,201911,2907,8054,1138,3785,304,1057,124,425,428,1482
355690,201911,774,2323,477,1713,107,402,15,31,122,433
355695,201911,239,685,133,439,12,56,24,54,36,110
355700,201911,6969,20246,5525,16924,998,3176,2850,8254,3848,11430
355710,201911,8398,19895,5063,13697,824,2441,2210,5343,3034,7784
355715,201911,464,1215,234,726,52,175,45,116,97,291
355720,201911,1455,4185,1122,3555,185,629,592,1734,777,2363
355730,201911,919,2604,721,2198,146,483,308,852,454,1335
410010,201911,1229,3397,902,2699,198,651,183,513,381,1164
410020,201911,957,3038,736,2495,265,831,182,643,447,1474
410030,201911,1492,4209,1253,3820,181,622,650,1974,831,2596
410040,201911,11594,32636,8281,26146,1814,6104,2629,7716,4443,13820
410045,201911,857,2282,576,1760,82,285,198,567,280,852
410050,201911,2401,6083,1528,4485,306,986,456,1229,762,2215
410060,201911,2031,5896,1518,4794,359,1171,468,1427,827,2598
410070,201911,1796,4636,1243,3567,215,706,463,1209,678,1915
410080,201911,1370,3656,953,2851,189,593,354,1049,543,1642
410090,201911,1055,2778,906,2526,82,223,562,1633,644,1856
410100,201911,1839,5390,1187,3768,173,636,175,506,348,1142
410105,201911,471,1217,240,731,33,110,66,192,99,302
410110,201911,3056,7885,2050,5870,293,911,834,2249,1127,3160
410115,201911,543,1406,377,1108,53,173,136,381,189,554
410120,201911,2366,6985,2048,6451,515,1775,923,2820,1438,4595
410130,201911,1148,3150,983,2822,223,705,459,1213,682,1918
410140,201911,14113,34419,8203,23539,1607,4975,1910,4972,3517,9947
410150,201911,16224,38719,7342,20749,1250,3862,1650,4284,2900,8146
410160,201911,2868,8060,2276,6985,505,1708,792,2425,1297,4133
410165,201911,718,1939,594,1681,58,195,349,921,407,1116
410170,201911,2525,6610,1622,4625,373,1151,143,426,516,1577
410180,201911,14495,40886,10905,33186,1572,5195,5713,16256,7285,21451
410185,201911,420,1194,293,897,55,179,90,255,145,434
410190,201911,2232,5635,1574,4431,325,933,429,1167,754,2100
410200,201911,4896,11550,2565,7391,420,1414,493,1390,913,2804
410210,201911,3001,7596,1802,5345,299,1008,615,1588,914,2596
410220,201911,504,1293,314,934,46,152,63,183,109,335
410230,201911,1614,4373,1215,3529,165,568,668,1804,833,2372
410240,201911,4664,12622,3152,9632,836,2830,236,675,1072,3505
410250,201911,2569,6187,1832,4935,133,454,891,2322,1024,2776
410260,201911,1803,4576,1118,3272,202,613,477,1367,679,1980
410270,201911,455,1208,312,940,46,158,110,307,156,465
410275,201911,614,1751,395,1269,53,182,190,568,243,750
410280,201911,2252,6087,1458,4464,220,745,576,1635,796,2380
410290,201911,3104,8828,2060,6510,554,1773,563,1754,1117,3527
410300,201911,632,1608,495,1374,38,118,245,639,283,757
410302,201911,389,964,184,571,29,95,89,262,118,357
410304,201911,1180,3125,977,2745,123,338,568,1563,691,1901
410305,201911,1699,4154,1138,3316,139,443,678,1914,817,2357
410310,201911,2585,7470,1985,6205,374,1274,839,2582,1213,3856
410315,201911,706,1703,356,1109,129,401,79,241,208,642
410320,201911,1077,3020,700,2207,107,387,117,356,224,743
410322,201911,549,1475,273,828,27,95,132,365,159,460
410330,201911,1485,3691,1009,2756,170,506,297,801,467,1307
410335,201911,830,2277,638,1901,93,301,286,787,379,1088
410337,201911,797,1935,538,1425,54,145,230,577,284,722
410340,201911,459,1276,302,890,28,97,146,359,174,456
410345,201911,2348,6041,1197,3534,253,781,354,941,607,1722
410347,201911,685,1733,476,1337,48,166,149,406,197,572
410350,201911,1266,3224,876,2554,109,332,363,1006,472,1338
410360,201911,4229,10299,3229,8586,324,980,1935,4907,2259,5887
410370,201911,12436,34051,7790,22776,994,3213,3162,8162,4156,11375
410380,201911,1417,3677,1029,2920,140,438,390,1009,530,1447
410390,201911,2571,6697,1599,4842,404,1362,428,1172,832,2534
410395,201911,849,2488,680,2114,133,456,297,909,430,1365
410400,201911,5468,14713,4042,11988,676,2129,1817,5149,2493,7278
410405,201911,778,1899,581,1610,120,374,245,631,365,1005
410410,201911,1189,3231,1117,3126,169,579,692,1983,861,2562
410420,201911,8580,24374,6349,19761,1111,3831,2184,6084,3295,9915
410425,201911,2913,8351,1998,6428,348,1239,731,2133,1079,3372
410430,201911,12633,32095,8366,24023,1412,4427,2847,7695,4259,12122
410440,201911,2302,6990,1941,6282,303,1093,1012,3209,1315,4302
410442,201911,2143,6663,1753,5764,504,1663,527,1698,1031,3361
410445,201911,2225,6535,1661,5412,334,1217,408,1390,742,2607
410450,201911,1423,3605,994,2845,183,590,342,900,525,1490
410460,201911,1907,4736,1463,4050,176,521,700,1871,876,2392
410465,201911,2567,7570,1942,6284,363,1214,654,1989,1017,3203
410470,201911,1952,5510,1355,4326,378,1363,212,690,590,2053
410480,201911,36486,86931,18434,54133,3030,9983,3982,9953,7012,19936
410490,201911,10748,30196,7379,22971,1417,4764,2755,8111,4172,12875
410500,201911,1681,4580,1118,3432,248,901,317,826,565,1727
410510,201911,1904,4756,1219,3432,245,679,344,984,589,1663
410520,201911,3026,9632,2688,8926,879,2987,976,3292,1855,6279
410530,201911,1605,4036,730,2125,106,302,172,417,278,719
410540,201911,2518,6833,1743,5280,293,964,843,2486,1136,3450
410550,201911,6997,18904,4358,12932,781,2510,1158,2994,1939,5504
410560,201911,1405,3710,1016,2909,227,703,365,911,592,1614
410570,201911,2448,6816,1766,5547,499,1841,176,592,675,2433
410580,201911,24130,63444,17266,50575,3576,11081,7255,19836,10831,30917
410590,201911,1531,4426,979,3028,156,512,291,788,447,1300
410600,201911,1770,4817,1317,3917,280,795,477,1461,757,2256
410610,201911,711,1888,501,1478,56,196,221,626,277,822
410620,201911,2148,6396,1339,4423,291,1038,234,734,525,1772
410630,201911,2333,6270,1459,4410,286,973,271,666,557,1639
410640,201911,4593,10915,2881,7908,692,2183,384,1031,1076,3214
410645,201911,1023,2992,832,2727,267,895,350,1168,617,2063
410650,201911,2053,5709,1340,4191,288,977,466,1334,754,2311
410655,201911,903,2199,619,1671,24,81,322,824,346,905
410657,201911,596,1596,369,1129,57,209,144,374,201,583
410660,201911,3199,8331,1710,5012,309,956,418,1163,727,2119
410670,201911,1036,2607,594,1713,129,377,227,603,356,980
410680,201911,2620,7986,1833,5985,475,1563,354,1179,829,2742
410685,201911,554,1425,408,1166,97,320,164,413,261,733
410690,201911,120907,300618,75924,214724,12931,41546,27224,67316,40155,108862
410700,201911,2397,6144,1992,5502,282,811,1064,2839,1346,3650
410710,201911,807,2059,518,1522,73,217,240,684,313,901
410712,201911,616,1839,508,1604,127,438,183,550,310,988
410715,201911,831,2421,490,1630,80,276,161,507,241,783
410720,201911,3090,7949,2295,6353,318,1029,493,1287,811,2316
410725,201911,1063,2667,590,1749,118,368,88,216,206,584
410730,201911,609,1628,456,1330,102,348,92,256,194,604
410740,201911,930,2609,669,2118,94,327,268,827,362,1154
410750,201911,1728,4432,1347,3729,214,657,593,1549,807,2206
410752,201911,356,903,160,488,18,61,72,204,90,265
410753,201911,247,754,175,595,26,103,40,123,66,226
410754,201911,1092,2867,880,2533,61,165,605,1833,666,1998
410755,201911,568,1478,388,1115,58,183,169,427,227,610
410760,201911,3301,8617,2276,6748,598,2008,480,1296,1078,3304
410765,201911,12259,34939,9257,28817,1574,5385,1763,4941,3337,10326
410770,201911,1014,2439,680,1856,69,201,359,968,428,1169
410773,201911,1270,3416,1088,3118,115,372,675,1867,790,2239
410775,201911,1445,3672,1242,3361,74,217,784,2099,858,2316
410780,201911,623,1560,393,1091,62,183,99,273,161,456
410785,201911,715,1917,529,1575,89,295,187,551,276,846
410790,201911,691,1978,550,1691,159,532,64,145,223,677
410800,201911,3313,7443,2608,6351,49,169,1680,3986,1729,4155
410810,201911,370,1009,275,815,28,86,130,365,158,451
410820,201911,793,2271,391,1218,86,270,72,202,158,472
410830,201911,32061,79272,20801,59730,4531,14759,6962,18735,11493,33494
410832,201911,958,2525,751,2152,87,280,426,1133,513,1413
410840,201911,7707,19929,4386,13331,850,2795,1137,3105,1987,5900
410845,201911,1110,2878,852,2459,161,474,360,1022,521,1496
410850,201911,2210,6425,1898,5842,311,1043,930,2767,1241,3810
410855,201911,772,1948,485,1389,45,131,232,624,277,755
410860,201911,4254,11110,3367,9594,387,1203,1818,5082,2205,6285
410865,201911,1331,4023,1159,3663,146,526,685,2179,831,2705
410870,201911,1270,3449,1062,3100,70,222,734,2109,804,2331
410880,201911,4231,11705,2890,9094,500,1742,443,1524,943,3266
410890,201911,963,2728,687,2165,152,529,190,590,342,1119
410895,201911,964,3149,790,2738,261,968,146,476,407,1444
410900,201911,850,2269,547,1656,102,310,100,241,202,551
410910,201911,362,850,204,548,10,36,129,319,139,355
410920,201911,829,1984,542,1515,77,241,252,691,329,932
410930,201911,1572,4163,1099,3292,277,970,230,660,507,1630
410940,201911,21792,60508,15353,48368,3246,11279,4623,14310,7869,25589
410950,201911,1912,5624,1692,5272,54,196,1389,4265,1443,4461
410960,201911,6991,17854,4397,13226,1034,3441,1591,4671,2625,8112
410965,201911,982,2556,691,1996,88,284,387,1093,475,1377
410970,201911,3819,10399,2608,7998,603,2204,355,923,958,3127
410975,201911,1284,3270,945,2697,107,324,429,1230,536,1554
410980,201911,6837,17408,4187,12436,530,1756,1747,4833,2277,6589
410990,201911,1310,3278,848,2521,235,805,242,660,477,1465
411000,201911,590,1607,379,1183,51,182,111,301,162,483
411005,201911,405,1088,242,730,47,148,54,151,101,299
411007,201911,2219,6284,1790,5501,418,1338,620,1916,1038,3254
411010,201911,4152,12591,3202,10538,823,2936,360,1078,1183,4014
411020,201911,2250,6524,1815,5719,526,1735,509,1544,1035,3279
411030,201911,721,1795,472,1266,34,125,264,628,298,753
411040,201911,920,2337,429,1223,43,134,145,348,188,482
411050,201911,1801,5760,1463,4945,403,1456,224,653,627,2109
411060,201911,1768,4635,1100,3305,256,908,169,456,425,1364
411065,201911,367,981,241,740,36,122,99,288,135,410
411070,201911,6616,17288,5192,14796,752,2409,2492,6835,3244,9244
411080,201911,2112,5605,1621,4713,434,1419,327,900,761,2319
411090,201911,815,2150,507,1541,36,138,141,405,177,543
411095,201911,1531,3613,1013,2778,116,356,357,925,473,1281
411100,201911,1092,2852,719,2175,84,292,221,675,305,967
411110,201911,635,1646,260,818,35,93,18,41,53,134
411120,201911,1184,3389,941,2882,326,1133,208,556,534,1689
411125,201911,5007,14850,4377,13590,907,2851,2133,6840,3040,9691
411130,201911,680,1857,470,1435,85,238,182,582,267,820
411140,201911,2226,6922,1837,6040,545,1917,493,1580,1038,3497
411150,201911,3739,9741,2458,7045,516,1711,235,503,751,2214
411155,201911,957,2463,543,1661,72,211,230,665,302,876
411160,201911,353,820,227,634,32,102,47,137,79,239
411170,201911,707,2122,507,1639,107,329,170,543,277,872
411180,201911,5232,14074,3926,11656,621,2017,1780,4958,2401,6975
411190,201911,1552,4040,1136,3277,184,568,443,1186,627,1754
411200,201911,4871,13294,3250,10130,854,2896,593,1600,1447,4496
411210,201911,2851,6319,1806,4686,336,987,549,1309,885,2296
411220,201911,830,2195,591,1713,133,419,173,481,306,900
411230,201911,813,2194,557,1683,112,360,217,646,329,1006
411240,201911,1541,3762,921,2549,96,317,456,1153,552,1470
411250,201911,2148,5790,1561,4708,320,1111,483,1405,803,2516
411260,201911,320,867,198,611,23,61,75,215,98,276
411270,201911,1964,5364,1459,4317,239,734,676,1857,915,2591
411275,201911,1370,3195,900,2407,152,479,394,978,546,1457
411280,201911,1304,3565,836,2626,229,730,113,349,342,1079
411290,201911,762,2024,481,1460,47,133,244,761,291,894
411295,201911,1187,2994,847,2307,99,281,383,996,482,1277
411300,201911,1012,2516,610,1718,60,186,257,643,317,829
411310,201911,859,2034,642,1706,44,114,287,752,331,866
411320,201911,5236,13800,3704,10939,673,2086,1503,4006,2176,6092
411325,201911,1422,4049,1189,3627,198,594,672,2104,870,2698
411330,201911,3326,9051,2368,7260,548,1824,735,2254,1283,4078
411340,201911,822,2253,472,1458,66,225,167,492,233,717
411342,201911,989,2395,563,1550,97,281,238,633,335,914
411345,201911,1061,2776,777,2304,72,233,546,1616,618,1849
411350,201911,2567,7117,1597,5053,422,1449,202,598,624,2047
411360,201911,650,1590,459,1290,62,179,151,415,213,594
411370,201911,51243,126950,35677,99916,2724,9301,21213,55578,23937,64879
411373,201911,1350,3458,1077,3031,88,298,581,1649,669,1947
411375,201911,1078,2725,759,2112,124,360,287,754,411,1114
411380,201911,1108,2598,708,1820,38,112,418,986,456,1098
411390,201911,1538,4267,1155,3394,192,624,462,1185,654,1809
411400,201911,2213,5601,1665,4545,190,617,830,2141,1020,2758
411410,201911,2280,6358,1630,4908,354,1180,364,1060,718,2240
411420,201911,3972,9885,2050,6105,308,1037,369,841,677,1878
411430,201911,3348,9155,2498,7485,567,1851,893,2449,1460,4300
411435,201911,425,1207,259,836,49,148,81,223,130,371
411440,201911,2411,6931,1926,5960,398,1359,680,2073,1078,3432
411450,201911,2494,6655,1870,5607,256,752,1012,3076,1268,3828
411460,201911,3720,9833,2113,6549,399,1422,382,1099,781,2521
411470,201911,731,1913,516,1475,94,282,186,486,280,768
411480,201911,4456,12240,3140,9667,676,2435,981,2707,1657,5142
411490,201911,1615,4202,1216,3506,159,537,494,1277,653,1814
411500,201911,1297,3507,827,2476,144,483,171,440,315,923
411510,201911,2236,5809,1750,4933,393,1281,397,1142,790,2423
411520,201911,29927,73200,16228,46045,2043,6623,6061,15306,8104,21929
411530,201911,891,2365,530,1655,104,364,91,247,195,611
411535,201911,459,1341,236,778,29,105,48,122,77,227
411540,201911,2792,6882,1813,5031,213,689,869,2302,1082,2991
411545,201911,911,2643,746,2342,71,219,485,1536,556,1755
411550,201911,669,1725,463,1313,75,238,90,263,165,501
411560,201911,1894,5095,1050,3259,165,573,86,245,251,818
411570,201911,6920,16428,4410,12406,967,2954,851,2338,1818,5292
411573,201911,754,2056,629,1857,94,295,334,965,428,1260
411575,201911,1837,5093,1342,4065,275,879,308,916,583,1795
411580,201911,4422,10157,2441,7061,356,1250,446,1150,802,2400
411585,201911,631,1850,270,905,68,238,49,146,117,384
411590,201911,363,1035,246,770,21,76,132,360,153,436
411600,201911,286,729,171,541,39,125,54,164,93,289
411605,201911,1545,3582,899,2490,119,410,475,1291,594,1701
411610,201911,2392,5880,1660,4474,85,295,1068,2669,1153,2964
411620,201911,2793,7519,2354,6814,416,1274,1296,3710,1712,4984
411630,201911,730,1906,472,1408,73,252,153,402,226,654
411640,201911,465,1229,315,897,44,144,120,312,164,456
411650,201911,222,659,134,448,29,101,21,56,50,157
411660,201911,883,2239,617,1749,45,138,301,824,346,962
411670,201911,1295,3245,853,2329,97,287,394,995,491,1282
411680,201911,1467,3938,1086,3186,154,521,493,1406,647,1927
411690,201911,3533,9195,2608,7583,548,1657,787,2374,1335,4031
411695,201911,665,2041,405,1331,42,147,166,521,208,668
411700,201911,1595,4191,1006,3038,224,740,140,387,364,1127
411705,201911,1858,5818,1548,5276,309,1000,847,3110,1156,4110
411710,201911,1804,4640,1186,3429,295,875,191,548,486,1423
411720,201911,1074,2553,745,1952,129,359,309,751,438,1110
411721,201911,913,2361,663,1884,134,376,158,452,292,828
411722,201911,748,2051,388,1158,57,202,139,333,196,535
411725,201911,1145,3284,757,2484,173,600,166,565,339,1165
411727,201911,1473,4150,923,2932,217,723,159,466,376,1189
411729,201911,709,1730,431,1179,53,191,160,381,213,572
411730,201911,5168,13924,3825,11228,863,2683,1532,4386,2395,7069
411740,201911,535,1394,262,790,57,165,60,166,117,331
411745,201911,729,2085,462,1450,67,227,82,192,149,419
411750,201911,4939,13116,3411,10018,447,1419,1677,4614,2124,6033
411760,201911,6731,18153,5079,15205,1723,5315,997,3324,2720,8639
411770,201911,2957,8689,2068,6651,513,1765,289,846,802,2611
411780,201911,2819,8082,2350,7126,651,2080,789,2379,1440,4459
411790,201911,2801,6831,1426,4270,309,1037,196,490,505,1527
411800,201911,968,2734,664,2025,108,343,135,399,243,742
411810,201911,1527,4027,1094,3134,171,495,524,1432,695,1927
411820,201911,10801,31477,8615,27351,2280,7712,3504,10828,5784,18540
411830,201911,587,1431,400,1113,72,209,95,291,167,500
411840,201911,11634,31363,7400,22201,1304,4238,1937,5315,3241,9553
411845,201911,495,1429,239,786,30,118,44,138,74,256
411850,201911,7267,18800,4799,14322,1253,4160,748,1992,2001,6152
411860,201911,692,2001,497,1573,79,262,128,357,207,619
411870,201911,614,1837,415,1361,87,311,96,278,183,589
411880,201911,2138,5486,1531,4464,240,790,476,1349,716,2139
411885,201911,1040,2697,715,2094,89,294,249,687,338,981
411890,201911,1146,3056,728,2232,136,469,68,171,204,640
411900,201911,797,2235,451,1452,103,351,59,187,162,538
411910,201911,904,2698,632,2087,159,582,202,609,361,1191
411915,201911,15150,37423,9411,26791,1505,4796,3469,8800,4974,13596
411920,201911,1043,3167,865,2773,203,737,289,861,492,1598
411925,201911,468,1239,315,948,66,217,128,362,194,579
411930,201911,4967,15535,4129,13847,1785,6510,243,947,2028,7457
411940,201911,3249,9794,2454,7966,605,2063,744,2154,1349,4217
411950,201911,13162,36012,10591,31623,1667,5522,5863,16854,7530,22376
411960,201911,5742,15638,4537,13142,861,2782,1676,4540,2537,7322
411965,201911,412,1157,280,888,36,126,108,305,144,431
411970,201911,1049,2493,778,2109,157,399,316,984,473,1383
411980,201911,1448,3679,1021,2926,263,775,356,969,619,1744
411990,201911,37474,99406,23185,72104,4481,15289,7898,23266,12379,38555
411995,201911,2912,7406,2116,6111,616,1964,587,1592,1203,3556
412000,201911,1960,4503,1364,3486,37,112,963,2313,1000,2425
412010,201911,586,1838,408,1435,59,227,106,297,165,524
412015,201911,543,1531,440,1342,55,187,264,802,319,989
412020,201911,436,1209,252,816,36,144,110,338,146,482
412030,201911,610,1717,406,1317,68,227,110,353,178,580
412033,201911,828,2232,563,1657,63,187,200,523,263,710
412035,201911,767,2058,478,1515,56,214,257,769,313,983
412040,201911,578,1559,348,1071,53,170,70,210,123,380
412050,201911,1673,4230,1101,3151,218,703,274,779,492,1482
412060,201911,7012,21062,5753,18442,1576,5675,1567,4752,3143,10427
412065,201911,617,1720,423,1284,88,278,117,358,205,636
412070,201911,1119,2876,838,2318,112,332,342,885,454,1217
412080,201911,1974,5633,1194,3886,186,626,192,558,378,1184
412085,201911,282,690,85,269,10,25,14,33,24,58
412090,201911,5747,15026,4235,12171,1175,3535,1462,4259,2637,7794
412100,201911,1563,4377,1146,3582,339,1140,247,840,586,1980
412110,201911,847,2250,578,1688,80,243,207,577,287,820
412120,201911,1917,5638,1454,4678,287,1022,414,1160,701,2182
412125,201911,639,1817,446,1407,95,307,116,340,211,647
412130,201911,716,1852,485,1405,76,227,123,365,199,592
412135,201911,602,1596,257,772,36,111,89,247,125,358
412140,201911,1607,3973,1003,2859,191,663,201,519,392,1182
412150,201911,2726,7270,2267,6438,319,1044,1371,3660,1690,4704
412160,201911,947,2953,558,1915,104,385,99,306,203,691
412170,201911,4152,11653,3447,10442,712,2329,1425,3978,2137,6307
412175,201911,1292,3773,1054,3355,225,731,452,1461,677,2192
412180,201911,1636,4567,1150,3622,151,557,510,1461,661,2018
412190,201911,3342,8388,2420,6740,314,952,1099,3031,1413,3983
412200,201911,1715,5195,1211,3963,330,1168,198,590,528,1758
412210,201911,617,1527,348,1011,51,161,112,294,163,455
412215,201911,3328,9063,2617,7686,689,1954,1104,3635,1793,5589
412217,201911,920,2429,767,2168,58,180,502,1383,560,1563
412220,201911,5770,16219,4547,13860,1123,3426,1475,4733,2598,8159
412230,201911,2560,7669,2006,6542,360,1337,547,1536,907,2873
412240,201911,6714,17250,4113,12126,721,2322,1252,3395,1973,5717
412250,201911,1961,5040,1443,4079,339,988,351,951,690,1939
412260,201911,1199,3258,826,2442,146,436,240,685,386,1121
412265,201911,862,2404,689,2096,130,423,295,850,425,1273
412270,201911,909,2511,558,1743,75,265,214,594,289,859
412280,201911,429,1214,328,1036,66,218,98,284,164,502
412290,201911,969,2505,633,1872,97,307,196,552,293,859
412300,201911,1576,4138,1090,3222,244,754,248,743,492,1497
412310,201911,738,2033,603,1783,61,255,314,880,375,1135
412320,201911,809,2088,530,1528,67,245,184,527,251,772
412330,201911,1471,4003,969,2993,190,642,324,1019,514,1661
412340,201911,1116,3163,655,2112,108,388,114,350,222,738
412350,201911,2810,7398,1721,5208,354,1092,318,895,672,1987
412360,201911,249,684,162,497,5,24,90,257,95,281
412370,201911,814,2347,527,1719,109,399,43,150,152,549
412380,201911,1528,4199,1033,3148,282,893,141,489,423,1382
412382,201911,499,1253,313,923,45,155,120,307,165,462
412385,201911,2168,6027,1724,5155,542,1534,524,1729,1066,3263
412390,201911,2357,5840,1878,5095,322,878,746,2065,1068,2943
412395,201911,695,1994,463,1458,53,160,190,589,243,749
412400,201911,864,2327,607,1808,120,388,161,487,281,875
412402,201911,1901,4778,1261,3675,305,929,159,467,464,1396
412405,201911,2980,7950,1892,5777,489,1789,48,134,537,1923
412410,201911,5643,14993,4007,12130,765,2667,1262,3600,2027,6267
412420,201911,501,1313,316,929,24,85,143,365,167,450
412430,201911,547,1383,318,925,25,84,146,410,171,494
412440,201911,2667,7475,1732,5572,450,1550,281,907,731,2457
412450,201911,378,1128,242,761,43,128,21,45,64,173
412460,201911,1010,2708,784,2306,139,453,362,1044,501,1497
412470,201911,1511,4965,1212,4256,322,1172,283,995,605,2167
412480,201911,954,2578,591,1761,115,374,160,443,275,817
412490,201911,1229,3137,951,2605,119,342,502,1303,621,1645
412500,201911,1885,4844,1377,3842,303,825,383,1024,686,1849
412510,201911,1900,5883,1277,4223,289,1021,123,340,412,1361
412520,201911,1261,3314,645,1921,159,473,55,152,214,625
412530,201911,636,1691,451,1299,71,233,106,293,177,526
412535,201911,790,2060,519,1520,85,276,111,277,196,553
412540,201911,1190,3121,810,2351,83,306,272,821,355,1127
412545,201911,681,1758,453,1269,72,201,152,409,224,610
412550,201911,29866,80913,19890,60143,3450,11316,7607,21133,11057,32449
412555,201911,260,692,165,474,17,48,48,105,65,153
412560,201911,4672,13719,3349,10541,552,1907,1026,3233,1578,5140
412570,201911,4186,10832,2238,6896,521,1785,283,960,804,2745
412575,201911,953,2447,746,2064,74,231,427,1107,501,1338
412580,201911,1409,3737,950,2807,102,356,478,1342,580,1698
412590,201911,414,1092,210,664,33,117,16,39,49,156
412600,201911,1422,3973,1028,3142,171,602,404,1159,575,1761
412610,201911,766,2038,530,1525,52,155,269,700,321,855
412620,201911,1224,3264,892,2720,167,594,297,841,464,1435
412625,201911,8660,23215,5079,15795,735,2572,324,891,1059,3463
412627,201911,1117,3162,669,2187,134,459,184,594,318,1053
412630,201911,2843,8350,1987,6441,402,1330,621,1826,1023,3156
412635,201911,355,954,239,696,39,135,76,171,115,306
412640,201911,1008,2682,526,1605,64,194,141,399,205,593
412650,201911,1567,4373,1216,3618,225,745,444,1151,669,1896
412660,201911,2369,6127,1581,4578,259,799,475,1243,734,2042
412665,201911,370,962,273,771,46,138,123,332,169,470
412667,201911,1672,4420,1228,3533,172,543,509,1388,681,1931
412670,201911,785,1928,508,1441,90,307,161,405,251,712
412680,201911,1691,4592,1114,3418,151,523,422,1165,573,1688
412690,201911,929,2525,685,2018,105,325,278,783,383,1108
412700,201911,1999,5338,1620,4713,203,692,870,2440,1073,3132
412710,201911,5804,17212,4259,13762,853,3075,1196,3479,2049,6554
412720,201911,1187,3531,885,2832,138,469,182,495,320,964
412730,201911,2191,5935,1327,4071,245,831,401,1159,646,1990
412740,201911,1785,5016,1176,3701,217,768,164,534,381,1302
412750,201911,3793,10096,3128,9094,324,1115,2037,5599,2361,6714
412760,201911,2855,7830,2320,6890,419,1377,1227,3425,1646,4802
412770,201911,10188,25858,5120,15601,725,2322,1172,3053,1897,5375
412780,201911,1174,3122,847,2518,184,598,331,956,515,1554
412785,201911,1971,4955,1349,3829,164,480,806,2254,970,2734
412788,201911,1275,3628,1026,3150,282,867,430,1291,712,2158
412790,201911,1263,3355,650,2030,103,372,210,586,313,958
412795,201911,1288,3363,655,2000,103,355,131,372,234,727
412796,201911,2219,6507,1803,5642,379,1253,579,1707,958,2960
412800,201911,3362,8242,2204,6031,267,834,964,2357,1231,3191
412810,201911,11032,28158,6606,18980,839,2804,2460,6243,3299,9047
412820,201911,6360,17558,4390,13497,1051,3437,1278,3890,2329,7327
412830,201911,331,940,219,687,31,95,56,175,87,270
412840,201911,1779,4540,1228,3430,142,440,500,1321,642,1761
412850,201911,2802,7441,1993,5966,319,1015,802,2346,1121,3361
412853,201911,1552,3938,1270,3388,186,545,633,1511,819,2056
412855,201911,1196,3218,747,2224,142,487,229,644,371,1131
412860,201911,780,1949,526,1540,79,257,278,770,357,1027
412862,201911,685,1673,442,1254,79,231,190,525,269,756
412863,201911,1215,3723,1113,3549,168,548,720,2279,888,2827
412865,201911,718,1961,512,1555,123,387,151,470,274,857
412870,201911,869,2253,617,1836,169,571,119,361,288,932
412880,201911,798,2182,502,1553,95,322,79,215,174,537
420005,201911,436,1304,231,819,34,126,107,380,141,506
420010,201911,3277,8071,2106,6060,152,489,1530,4400,1682,4889
420020,201911,460,1436,278,973,47,190,59,169,106,359
420030,201911,83,279,57,222,17,72,16,62,33,134
420040,201911,512,1599,292,1085,47,189,26,81,73,270
420050,201911,697,1632,441,1171,55,178,270,641,325,819
420055,201911,170,497,88,298,17,70,33,94,50,164
420060,201911,105,295,57,173,11,40,17,36,28,76
420070,201911,693,2161,511,1740,119,428,185,613,304,1041
420075,201911,77,210,35,113,7,25,9,18,16,43
420080,201911,325,951,251,786,70,241,94,290,164,531
420090,201911,406,1280,228,825,54,212,50,170,104,382
420100,201911,1197,3211,985,2871,51,182,792,2272,843,2454
420110,201911,240,778,215,723,46,180,95,291,141,471
420120,201911,471,1309,300,925,59,208,125,331,184,539
420125,201911,324,1004,226,782,56,204,100,324,156,528
420127,201911,276,760,90,310,20,74,21,71,41,145
420130,201911,2772,7794,2041,6488,299,1175,1036,3068,1335,4243
420140,201911,3425,9347,2391,7526,662,2376,325,1008,987,3384
420150,201911,610,1586,402,1221,49,163,233,685,282,848
420160,201911,217,536,87,279,12,36,23,72,35,108
420165,201911,151,433,81,265,21,72,25,72,46,144
420170,201911,261,794,162,553,21,65,35,101,56,166
420180,201911,171,538,96,354,13,46,26,92,39,138
420190,201911,184,608,109,404,36,149,21,70,57,219
420195,201911,1331,3511,936,2831,291,1017,115,282,406,1299
420200,201911,3842,9590,2132,6314,309,1129,834,2069,1143,3198
420205,201911,1595,4344,1065,3294,165,525,583,1812,748,2337
420207,201911,1715,4538,1029,3190,198,705,412,1203,610,1908
420208,201911,308,874,179,634,36,140,76,262,112,402
420209,201911,133,449,82,291,22,87,24,84,46,171
420210,201911,2704,7011,1697,5352,351,1216,770,2368,1121,3584
420213,201911,744,2338,611,2060,134,494,302,996,436,1490
420215,201911,193,582,123,425,34,133,16,45,50,178
420220,201911,240,722,141,491,26,103,67,210,93,313
420230,201911,4654,12937,3456,10615,534,1767,1819,5402,2353,7169
420240,201911,12112,33459,7158,22150,945,3362,3533,9689,4478,13051
420243,201911,376,1087,301,936,46,155,173,514,219,669
420245,201911,1279,3366,861,2615,69,265,501,1441,570,1706
420250,201911,437,1266,365,1138,64,233,185,523,249,756
420253,201911,490,1217,341,993,36,113,193,566,229,679
420257,201911,164,430,104,319,23,81,52,152,75,233
420260,201911,1063,2864,751,2391,129,458,452,1418,581,1876
420270,201911,481,1277,221,671,33,112,82,246,115,358
420280,201911,1110,3304,807,2686,162,596,258,838,420,1434
420285,201911,77,202,41,124,8,36,10,23,18,59
420287,201911,447,1044,302,822,81,221,106,294,187,515
420290,201911,4150,11896,3062,9386,457,1643,1736,4858,2193,6501
420300,201911,6809,19371,3701,11984,739,2639,947,2734,1686,5373
420310,201911,820,1935,392,1101,50,148,193,493,243,641
420315,201911,769,2181,507,1674,113,398,210,700,323,1098
420320,201911,4413,12471,3218,10346,959,3418,753,2202,1712,5620
420325,201911,261,755,187,617,30,106,78,239,108,345
420330,201911,865,2610,552,1908,109,425,167,501,276,926
420340,201911,931,2647,667,2143,160,526,80,231,240,757
420350,201911,1236,3270,866,2573,77,265,582,1694,659,1959
420360,201911,2499,7140,1286,4365,252,936,130,423,382,1359
420370,201911,983,2709,765,2330,93,335,486,1412,579,1747
420380,201911,4293,11573,2796,8766,620,2105,979,2921,1599,5026
420390,201911,1064,2578,698,1796,119,384,323,580,442,964
420395,201911,933,2725,583,1972,97,381,72,188,169,569
420400,201911,862,2503,562,1827,102,378,188,571,290,949
420410,201911,491,1354,371,1109,39,134,241,687,280,821
420415,201911,276,847,205,686,54,201,76,257,130,458
420417,201911,610,1823,473,1537,128,418,166,554,294,972
420419,201911,139,497,100,388,41,167,6,20,47,187
420420,201911,10316,27094,6577,20152,1948,6687,1724,4776,3672,11463
420425,201911,629,1656,412,1233,40,144,192,553,232,697
420430,201911,2973,8163,1710,5356,398,1340,541,1521,939,2861
420435,201911,254,652,110,369,14,47,53,174,67,221
420440,201911,678,1909,424,1354,108,390,175,505,283,895
420445,201911,263,666,157,454,29,93,65,173,94,266
420450,201911,645,1912,456,1487,86,352,162,456,248,808
420455,201911,1914,4824,1358,3927,190,682,670,1808,860,2490
420460,201911,8470,22911,6165,18584,991,3310,3025,8742,4016,12052
420470,201911,590,1565,313,1010,63,235,72,194,135,429
420475,201911,61,159,25,80,7,23,2,6,9,29
420480,201911,5499,13694,3210,9736,676,2215,980,2967,1656,5182
420490,201911,346,1014,244,803,57,218,90,300,147,518
420500,201911,1368,3908,874,2919,152,552,365,1221,517,1773
420510,201911,163,466,82,273,12,51,24,69,36,120
420515,201911,41,104,26,72,1,1,12,35,13,36
420517,201911,731,2054,628,1867,49,142,475,1419,524,1561
420519,201911,284,678,191,541,23,71,105,310,128,381
420520,201911,305,822,138,475,25,93,12,39,37,132
420530,201911,765,2233,513,1689,95,364,177,507,272,871
420535,201911,212,616,80,270,14,52,37,118,51,170
420540,201911,32869,78472,19719,55669,3175,10048,6931,16525,10106,26573
420543,201911,208,624,156,495,21,67,85,262,106,329
420545,201911,1062,3158,783,2538,153,535,308,905,461,1440
420550,201911,3379,9189,2056,6831,377,1413,857,2869,1234,4282
420555,201911,291,845,196,641,28,105,106,327,134,432
420560,201911,401,1003,262,790,59,186,138,412,197,598
420570,201911,2039,5775,1524,4765,286,984,625,1855,911,2839
420580,201911,1754,4532,1177,3608,281,926,410,1260,691,2186
420590,201911,2817,7582,1555,4794,299,1082,396,913,695,1995
420600,201911,936,2764,706,2300,112,418,360,1130,472,1548
420610,201911,348,1022,185,640,45,161,61,218,106,379
420620,201911,640,1598,401,1198,97,299,159,468,256,767
420630,201911,832,2516,586,1896,82,300,338,1022,420,1322
420640,201911,489,1370,218,778,64,225,22,70,86,295
420650,201911,3248,8775,1848,5692,286,977,696,1837,982,2814
420660,201911,349,901,212,624,46,140,55,147,101,287
420665,201911,558,1470,341,1080,60,211,147,417,207,628
420670,201911,1309,3593,835,2649,134,514,328,911,462,1425
420675,201911,158,445,87,300,23,97,36,104,59,201
420680,201911,328,758,152,502,26,105,71,222,97,327
420690,201911,814,2490,468,1624,70,291,112,310,182,601
420700,201911,2687,7127,1971,5878,253,840,1068,3065,1321,3905
420710,201911,789,2302,579,1829,57,239,343,983,400,1222
420720,201911,1237,3429,856,2762,195,644,386,1201,581,1845
420730,201911,2726,7232,2017,6051,339,1097,1097,3169,1436,4266
420740,201911,531,1639,322,1152,101,376,32,128,133,504
420750,201911,1807,5345,1136,3733,195,752,440,1314,635,2066
420757,201911,76,183,36,114,4,8,17,53,21,61
420760,201911,344,1017,148,466,37,130,33,82,70,212
420765,201911,390,1170,198,673,26,107,90,296,116,403
420768,201911,1243,3618,1063,3303,146,441,762,2349,908,2790
420770,201911,426,1168,196,696,31,125,83,278,114,403
420775,201911,274,830,190,631,45,171,42,110,87,281
420780,201911,843,2326,486,1550,117,394,87,247,204,641
420785,201911,183,490,124,367,17,56,59,143,76,199
420790,201911,987,3083,715,2501,131,535,359,1191,490,1726
420800,201911,673,1696,303,935,80,280,68,198,148,478
420810,201911,1399,4460,1110,3844,327,1282,349,1018,676,2300
420820,201911,11059,27878,7651,22166,1509,4958,3503,9155,5012,14113
420830,201911,3291,8824,2351,7093,467,1551,979,2852,1446,4403
420840,201911,491,1460,221,814,69,280,24,79,93,359
420845,201911,2181,5662,1261,3968,233,875,504,1499,737,2374
420850,201911,1021,3368,613,2249,124,496,103,342,227,838
420860,201911,287,746,150,496,34,124,36,107,70,231
420870,201911,766,2102,566,1720,145,532,249,682,394,1214
420880,201911,921,2842,707,2404,152,599,256,812,408,1411
420890,201911,7482,20379,4303,13717,683,2422,1424,3933,2107,6355
420895,201911,157,462,94,302,21,71,29,95,50,166
420900,201911,1332,3344,760,2315,105,387,323,844,428,1231
420910,201911,26724,70715,15887,49271,2515,8894,6161,17006,8676,25900
420915,201911,522,1891,372,1452,59,230,190,753,249,983
420917,201911,329,821,165,461,25,73,81,230,106,303
420920,201911,76,207,23,86,0,0,4,10,4,10
420930,201911,16483,43247,11278,33898,2075,6896,4938,14025,7013,20921
420940,201911,2569,6358,1440,4368,369,1261,247,606,616,1867
420945,201911,129,378,98,304,25,93,39,101,64,194
420950,201911,311,895,161,534,24,97,39,111,63,208
420960,201911,975,2445,658,1880,117,409,277,676,394,1085
420970,201911,2280,6509,1490,4917,440,1506,265,894,705,2400
420980,201911,252,839,223,781,114,396,61,234,175,630
420985,201911,303,886,146,524,33,120,46,145,79,265
420990,201911,322,991,163,590,32,117,27,79,59,196
421000,201911,496,1550,327,1151,71,277,85,263,156,540
421003,201911,466,1085,135,394,11,35,26,62,37,97
421005,201911,58,162,46,145,10,32,24,74,34,106
421010,201911,3075,8518,2151,6778,459,1637,563,1570,1022,3207
421020,201911,366,1146,279,985,44,186,139,466,183,652
421030,201911,736,2279,559,1891,169,644,173,533,342,1177
421040,201911,692,1593,395,1143,33,106,238,679,271,785
421050,201911,957,2669,587,1800,116,388,193,521,309,909
421055,201911,161,444,76,243,11,40,33,92,44,132
421060,201911,558,1654,346,1136,70,257,137,400,207,657
421070,201911,589,1797,311,1083,76,289,71,235,147,524
421080,201911,473,1376,394,1214,48,171,244,748,292,919
421085,201911,362,1060,123,453,23,87,16,45,39,132
421090,201911,248,631,145,433,14,48,52,135,66,183
421100,201911,844,1890,326,978,98,338,67,166,165,504
421105,201911,1470,4079,992,3094,175,547,433,1293,608,1840
421110,201911,1018,2817,839,2555,28,78,614,1975,642,2053
421120,201911,860,2673,604,2068,94,359,202,638,296,997
421125,201911,266,700,189,554,69,224,65,153,134,377
421130,201911,4387,13040,3566,11379,883,3195,1760,5275,2643,8470
421140,201911,282,770,172,544,30,105,63,181,93,286
421145,201911,430,1220,267,862,58,212,116,344,174,556
421150,201911,551,1489,303,965,62,227,113,326,175,553
421160,201911,508,1365,350,1069,45,150,224,671,269,821
421165,201911,186,558,115,386,24,80,47,154,71,234
421170,201911,1056,2794,798,2391,141,406,474,1466,615,1872
421175,201911,1020,2573,607,1915,120,426,256,769,376,1195
421180,201911,364,945,194,604,36,142,72,202,108,344
421185,201911,305,826,197,594,27,89,114,341,141,430
421187,201911,277,845,161,539,30,102,50,155,80,257
421189,201911,350,1022,264,844,46,145,93,284,139,429
421190,201911,9731,26417,6198,19647,1226,4289,1958,5693,3184,9982
421200,201911,636,1900,507,1636,58,211,306,957,364,1168
421205,201911,174,468,129,392,27,94,64,181,91,275
421210,201911,1053,2757,613,1980,138,444,214,706,352,1150
421220,201911,1274,3948,975,3266,224,819,288,877,512,1696
421223,201911,347,980,211,703,52,167,94,317,146,484
421225,201911,878,2644,745,2400,135,489,431,1386,566,1875
421227,201911,904,2372,503,1566,87,300,216,674,303,974
421230,201911,586,1573,356,1143,69,248,118,373,187,621
421240,201911,262,800,108,406,14,63,17,63,31,126
421250,201911,1719,4429,1149,3491,161,551,590,1730,751,2281
421260,201911,161,483,42,168,11,49,11,42,22,91
421265,201911,596,1587,542,1518,8,28,506,1423,514,1451
421270,201911,386,1022,158,564,22,76,59,198,81,274
421280,201911,1610,4560,1175,3750,201,784,610,1799,811,2583
421290,201911,796,2180,418,1284,80,259,97,278,177,537
421300,201911,245,663,124,407,18,69,26,87,44,156
421310,201911,178,516,125,413,25,87,66,222,91,309
421315,201911,214,599,131,402,38,111,37,117,75,228
421320,201911,596,1771,275,917,41,140,43,98,84,238
421330,201911,586,1768,425,1421,79,301,126,403,205,704
421335,201911,342,1048,276,926,66,251,110,362,176,613
421340,201911,1250,3601,887,2880,176,639,343,1025,519,1664
421350,201911,1293,3406,832,2580,183,661,334,944,517,1605
421360,201911,2188,5990,1247,4023,245,966,455,1255,700,2221
421370,201911,516,1726,300,1133,61,245,77,252,138,497
421380,201911,752,2037,640,1841,83,281,397,1103,480,1384
421390,201911,174,469,58,194,13,39,19,49,32,88
421400,201911,281,899,189,682,34,135,89,305,123,440
421410,201911,207,550,79,280,14,55,21,68,35,123
421415,201911,190,580,99,331,25,81,22,63,47,144
421420,201911,475,1337,384,1157,36,122,239,692,275,814
421430,201911,110,342,81,273,8,31,25,75,33,106
421440,201911,598,1605,354,1143,79,246,145,462,224,708
421450,201911,415,1234,240,816,33,138,40,146,73,284
421460,201911,340,996,185,661,26,96,34,100,60,196
421470,201911,252,739,136,474,27,97,51,178,78,275
421480,201911,2657,7170,1668,5237,371,1383,622,1742,993,3125
421490,201911,110,353,64,225,6,24,20,49,26,73
421500,201911,2044,6079,1383,4686,383,1511,312,935,695,2446
421505,201911,282,820,238,749,35,124,152,458,187,582
421507,201911,393,1140,211,719,56,202,65,207,121,409
421510,201911,266,784,148,485,26,98,75,223,101,321
421520,201911,457,1210,270,781,32,108,163,440,195,548
421530,201911,296,918,166,603,36,163,42,126,78,289
421535,201911,378,1017,225,731,36,140,116,348,152,488
421540,201911,259,632,126,405,18,63,41,124,59,187
421545,201911,684,2035,501,1686,113,453,228,702,341,1155
421550,201911,1879,5195,1492,4592,271,884,830,2527,1101,3411
421555,201911,185,582,68,254,15,64,10,26,25,90
421560,201911,75,256,46,179,13,53,12,42,25,95
421565,201911,898,2348,593,1853,150,520,168,522,318,1042
421567,201911,433,1471,268,981,103,396,63,208,166,604
421568,201911,317,959,234,762,33,125,111,345,144,470
421569,201911,181,513,74,250,18,62,34,112,52,174
421570,201911,950,2601,663,2042,174,595,188,541,362,1136
421575,201911,261,782,194,609,33,120,82,219,115,339
421580,201911,3169,8911,2010,6425,377,1413,756,2052,1133,3465
421590,201911,134,426,101,341,36,132,26,74,62,206
421600,201911,507,1391,333,1032,78,259,93,242,171,501
421605,201911,709,1862,483,1482,90,248,231,745,321,993
421610,201911,974,2686,593,1937,112,395,174,554,286,949
421620,201911,3803,10151,2104,6917,479,1753,543,1692,1022,3445
421625,201911,167,470,64,211,13,42,13,43,26,85
421630,201911,2267,6039,1290,4044,236,873,401,1051,637,1924
421635,201911,233,639,149,452,22,74,84,233,106,307
421640,201911,667,1853,472,1535,95,342,182,585,277,927
421650,201911,2162,5979,1327,4362,309,1177,354,974,663,2151
421660,201911,8591,24250,5935,19032,932,3385,2473,7238,3405,10623
421670,201911,728,2106,493,1548,84,292,245,754,329,1046
421680,201911,948,2680,712,2237,192,657,315,890,507,1547
421690,201911,1218,3574,827,2719,157,595,304,994,461,1589
421700,201911,463,1415,253,895,47,177,82,269,129,446
421710,201911,212,671,90,306,21,76,25,79,46,155
421715,201911,99,281,75,225,16,44,50,144,66,188
421720,201911,1838,5091,1018,3279,255,913,280,775,535,1688
421725,201911,217,537,105,336,20,71,40,93,60,164
421730,201911,374,1077,197,582,24,77,101,283,125,360
421740,201911,610,1703,400,1248,112,356,91,252,203,608
421750,201911,838,1978,364,1086,78,256,142,392,220,648
421755,201911,157,423,87,259,14,58,43,108,57,166
421760,201911,852,2301,524,1686,92,333,172,469,264,802
421770,201911,2275,6130,1621,4952,416,1297,576,1882,992,3179
421775,201911,193,502,120,356,19,59,55,147,74,206
421780,201911,790,2379,499,1724,105,413,198,640,303,1053
421790,201911,738,1912,411,1318,96,323,191,600,287,923
421795,201911,198,554,129,389,26,95,43,113,69,208
421800,201911,2389,6611,1703,5307,235,857,932,2743,1167,3600
421810,201911,596,1663,398,1284,51,186,235,739,286,925
421820,201911,928,2726,499,1669,100,384,142,375,242,759
421825,201911,1281,3636,1132,3395,124,399,784,2292,908,2691
421830,201911,1943,5918,1586,5220,314,1123,710,2257,1024,3380
421835,201911,198,496,105,331,19,71,30,83,49,154
421840,201911,209,677,134,492,29,111,31,109,60,220
421850,201911,362,1033,192,667,45,174,60,161,105,335
421860,201911,303,871,170,592,22,90,56,175,78,265
421870,201911,3748,9580,2565,7303,483,1630,1192,3007,1675,4637
421875,201911,213,621,96,334,14,52,27,74,41,126
421880,201911,529,1507,340,1097,96,357,70,234,166,591
421885,201911,194,551,119,381,30,102,36,106,66,208
421890,201911,766,2385,561,1961,115,459,261,853,376,1312
421895,201911,390,1034,319,938,38,124,213,649,251,773
421900,201911,937,2422,627,1796,94,314,280,726,374,1040
421910,201911,288,857,194,650,38,145,52,156,90,301
421915,201911,371,1063,196,638,39,126,27,78,66,204
421917,201911,563,1353,308,1007,114,401,72,242,186,643
421920,201911,379,1184,268,949,115,433,71,244,186,677
421930,201911,2353,6005,1089,3487,273,983,255,705,528,1688
421935,201911,396,1274,310,1072,63,233,169,552,232,785
421940,201911,313,936,121,409,20,78,36,106,56,184
421950,201911,2917,7303,1446,4481,308,1070,346,935,654,2005
421960,201911,168,429,85,273,18,67,20,54,38,121
421970,201911,1791,4656,988,2997,214,752,337,872,551,1624
421985,201911,260,694,145,460,15,51,54,159,69,210
422000,201911,1756,4691,1394,4076,153,516,933,2694,1086,3210
430003,201911,525,1470,338,1106,67,243,138,437,205,680
430005,201911,265,707,166,526,33,115,80,240,113,355
430010,201911,1659,4132,1331,3594,145,436,942,2444,1087,2880
430020,201911,555,1288,413,1091,49,159,273,685,322,844
430030,201911,972,2316,522,1510,145,454,161,424,306,878
430040,201911,9590,23471,5403,15818,1414,4482,554,1762,1968,6244
430045,201911,506,1284,336,964,21,72,218,611,239,683
430047,201911,246,521,89,243,20,61,24,65,44,126
430050,201911,850,2179,469,1386,108,336,119,330,227,666
430055,201911,236,599,107,320,10,43,63,169,73,212
430057,201911,82,178,26,69,5,18,6,13,11,31
430060,201911,15743,42873,11944,36688,2597,8465,5392,16466,7989,24931
430063,201911,835,2351,649,1948,125,370,362,1084,487,1454
430064,201911,981,2745,716,2171,209,659,263,767,472,1426
430066,201911,99,217,71,173,5,12,55,125,60,137
430070,201911,694,1757,83,282,6,22,15,42,21,64
430080,201911,779,1931,458,1299,78,258,224,546,302,804
430085,201911,853,1979,508,1408,98,287,217,580,315,867
430087,201911,476,1231,380,1094,64,183,231,678,295,861
430090,201911,534,1369,163,515,14,56,57,166,71,222
430100,201911,646,1576,343,985,68,223,133,331,201,554
430105,201911,1053,2841,650,2138,126,477,299,952,425,1429
430107,201911,165,493,95,309,18,69,25,61,43,130
430110,201911,2060,5169,1470,4290,225,714,810,2312,1035,3026
430120,201911,1249,3735,758,2481,138,475,337,1109,475,1584
430130,201911,3260,7704,2383,6448,928,2511,441,1441,1369,3952
430140,201911,883,2474,603,1917,140,444,283,875,423,1319
430150,201911,541,1398,275,848,65,210,93,278,158,488
430155,201911,248,633,107,326,19,54,21,55,40,109
430160,201911,17947,43677,13805,37489,1818,5349,7745,20918,9563,26267
430163,201911,2608,6454,1739,5000,93,293,1210,3469,1303,3762
430165,201911,323,789,82,271,16,40,14,39,30,79
430170,201911,894,2366,303,1048,55,200,49,153,104,353
430175,201911,638,1952,521,1694,140,459,244,766,384,1225
430180,201911,631,1558,499,1333,64,174,344,903,408,1077
430185,201911,456,1100,263,743,60,166,70,168,130,334
430187,201911,654,1539,454,1272,73,223,226,666,299,889
430190,201911,1343,3626,1056,3150,233,761,478,1351,711,2112
430192,201911,132,357,47,138,7,20,10,25,17,45
430195,201911,381,1138,43,157,6,16,7,22,13,38
430200,201911,1061,3207,841,2799,274,932,250,863,524,1795
430205,201911,458,1228,392,1098,14,47,333,906,347,953
430210,201911,4607,11853,3017,8524,604,1826,977,2268,1581,4094
430215,201911,298,773,184,542,42,130,71,210,113,340
430220,201911,623,1534,155,530,27,114,32,82,59,196
430222,201911,172,498,121,381,11,42,48,146,59,188
430223,201911,228,616,181,530,20,65,119,341,139,406
430225,201911,15,28,10,20,1,2,9,18,10,20
430230,201911,1721,4880,1477,4499,140,455,1101,3326,1241,3781
430235,201911,280,814,180,579,44,161,56,157,100,318
430237,201911,510,1245,349,975,20,67,240,641,260,708
430240,201911,1101,2494,592,1630,76,256,325,824,401,1080
430245,201911,667,1969,508,1661,161,527,227,762,388,1289
430250,201911,872,2210,627,1816,219,708,40,89,259,797
430258,201911,111,300,84,247,7,17,46,145,53,162
430260,201911,605,1623,417,1250,61,187,233,690,294,877
430265,201911,200,579,135,451,27,94,41,134,68,228
430270,201911,2655,6739,2090,5814,388,1175,1227,3305,1615,4480
430280,201911,4898,11791,3307,8953,725,2002,1380,3664,2105,5666
430290,201911,2106,4958,1750,4531,54,184,1496,3777,1550,3961
430300,201911,8944,23341,6743,19360,1150,3606,3482,9785,4632,13391
430310,201911,10674,26824,6797,19363,928,2990,3216,8480,4144,11470
430320,201911,946,2509,496,1566,72,211,263,848,335,1059
430330,201911,625,1564,374,1045,64,194,176,435,240,629
430340,201911,699,1548,359,1014,51,155,207,561,258,716
430350,201911,6762,17812,4893,14266,910,2793,2481,6972,3391,9765
430355,201911,322,821,102,331,18,55,16,46,34,101
430360,201911,812,1950,517,1429,114,357,204,513,318,870
430367,201911,304,728,155,442,36,109,70,198,106,307
430370,201911,455,1225,197,611,41,129,48,131,89,260
430380,201911,656,1627,311,977,76,279,80,234,156,513
430390,201911,2911,7123,1557,4555,275,902,187,382,462,1284
430400,201911,1053,2256,808,1899,62,172,603,1349,665,1521
430410,201911,528,1280,352,983,49,156,216,580,265,736
430420,201911,2581,7215,1947,5779,538,1671,802,2259,1340,3930
430430,201911,591,1512,275,841,65,195,62,185,127,380
430435,201911,1440,3709,1072,3096,206,642,528,1523,734,2165
430440,201911,3575,10079,2637,8250,337,1209,1531,4695,1868,5904
430450,201911,6505,16690,5066,14078,714,2233,2794,7465,3508,9698
430460,201911,28521,73826,19960,59292,3857,12633,9315,26340,13172,38973
430461,201911,315,816,90,282,12,40,30,77,42,117
430462,201911,231,619,127,416,19,59,42,149,61,208
430463,201911,4982,13620,3650,11184,751,2556,1673,4907,2424,7463
430465,201911,414,1092,337,952,51,163,211,571,262,734
430466,201911,3864,9870,2979,8366,754,2185,1379,3670,2133,5855
430467,201911,478,1168,322,916,45,151,165,443,210,594
430468,201911,1262,3113,965,2662,93,274,600,1617,693,1891
430469,201911,625,1737,73,251,8,29,13,17,21,46
430470,201911,5282,13745,3410,10352,1031,3358,894,2556,1925,5914
430471,201911,499,1457,407,1282,66,228,221,661,287,889
430480,201911,739,1973,369,1163,52,178,80,229,132,407
430485,201911,165,448,59,195,15,44,8,26,23,70
430490,201911,387,1008,206,613,25,89,101,266,126,355
430495,201911,357,982,199,646,27,94,74,228,101,322
430500,201911,964,2531,648,1978,211,689,181,498,392,1187
430510,201911,23304,61502,16043,46806,2908,9645,6963,18524,9871,28169
430511,201911,320,949,117,405,15,59,16,45,31,104
430512,201911,916,2102,698,1778,174,442,252,652,426,1094
430513,201911,769,1937,348,1015,50,157,174,481,224,638
430515,201911,361,1021,251,788,34,97,127,400,161,497
430517,201911,1037,3228,767,2588,135,454,387,1335,522,1789
430520,201911,1243,3261,603,1839,107,355,130,351,237,706
430530,201911,978,2512,363,1142,68,203,91,279,159,482
430535,201911,3034,8006,2130,6308,310,956,1079,3099,1389,4055
430537,201911,317,1122,289,1032,22,68,234,837,256,905
430540,201911,554,1374,320,973,47,142,156,470,203,612
430543,201911,698,1293,389,931,61,117,187,493,248,610
430544,201911,630,1829,428,1355,100,313,186,585,286,898
430545,201911,2105,5564,1537,4656,300,927,761,2371,1061,3298
430550,201911,366,1028,232,734,44,137,83,255,127,392
430558,201911,108,244,43,119,5,10,12,33,17,43
430560,201911,337,756,137,414,16,52,44,130,60,182
430570,201911,736,1740,525,1417,95,295,275,696,370,991
430580,201911,847,2121,594,1719,143,449,261,727,404,1176
430583,201911,196,487,34,113,3,11,6,18,9,29
430585,201911,223,545,111,302,16,46,51,125,67,171
430587,201911,198,563,134,422,20,62,57,181,77,243
430590,201911,1365,3269,1129,2904,53,154,947,2401,1000,2555
430593,201911,18,63,12,41,1,3,6,19,7,22
430595,201911,409,979,86,281,5,21,23,56,28,77
430597,201911,399,1064,202,616,20,66,71,168,91,234
430600,201911,1795,4635,763,2251,147,472,222,615,369,1087
430605,201911,1103,3052,781,2407,112,413,341,992,453,1405
430607,201911,519,1236,410,1058,26,78,299,761,325,839
430610,201911,5434,13055,3520,10061,1026,3210,721,2094,1747,5304
430613,201911,254,592,65,182,9,28,17,38,26,66
430620,201911,567,1419,407,1105,53,164,238,600,291,764
430630,201911,415,1143,110,357,19,66,23,65,42,131
430632,201911,503,1349,210,655,24,80,98,290,122,370
430635,201911,517,1259,373,1011,45,127,264,709,309,836
430637,201911,441,1105,343,951,39,126,214,567,253,693
430640,201911,1005,2590,553,1651,77,240,196,554,273,794
430642,201911,335,928,244,713,45,126,132,363,177,489
430645,201911,163,385,54,150,13,39,14,41,27,80
430650,201911,1514,4496,1213,3980,317,1043,579,1984,896,3027
430655,201911,265,657,151,427,24,76,71,174,95,250
430660,201911,4809,12591,3560,10405,829,2603,1551,4449,2380,7052
430670,201911,620,1511,460,1228,27,73,290,780,317,853
430673,201911,532,1214,197,576,38,115,74,199,112,314
430675,201911,211,602,51,178,11,40,24,82,35,122
430676,201911,4450,11338,3434,9725,438,1387,2161,5941,2599,7328
430680,201911,898,2443,529,1655,159,517,128,382,287,899
430690,201911,2792,7668,2184,6541,738,2300,584,1685,1322,3985
430692,201911,206,636,152,541,10,45,110,387,120,432
430693,201911,964,2562,553,1703,107,392,144,398,251,790
430695,201911,456,1181,240,718,33,93,128,366,161,459
430697,201911,383,964,287,805,71,184,137,417,208,601
430700,201911,6399,16049,3389,10324,768,2500,527,1545,1295,4045
430705,201911,393,966,182,549,24,85,76,205,100,290
430710,201911,1621,3567,1117,2847,150,422,649,1622,799,2044
430720,201911,708,1700,351,1060,56,168,171,519,227,687
430730,201911,1012,2748,674,2104,97,281,356,1111,453,1392
430740,201911,579,1606,284,960,52,185,80,283,132,468
430745,201911,399,1081,217,664,37,130,72,185,109,315
430750,201911,1293,3358,898,2656,186,579,481,1370,667,1949
430755,201911,447,1095,272,735,18,57,158,393,176,450
430760,201911,1925,4861,1469,4130,361,1076,629,1695,990,2771
430770,201911,5886,14907,4443,12685,593,1905,2773,7656,3366,9561
430780,201911,1888,4654,1059,3203,225,731,383,1121,608,1852
430781,201911,430,1209,230,723,34,107,65,177,99,284
430783,201911,390,886,219,616,23,79,133,355,156,434
430786,201911,31,106,20,80,4,16,4,20,8,36
430790,201911,4193,10368,2793,7876,359,1196,1667,4368,2026,5564
430800,201911,739,1745,532,1410,38,104,354,932,392,1036
430805,201911,385,1034,229,692,24,87,144,402,168,489
430807,201911,389,902,185,516,15,50,93,237,108,287
430810,201911,741,1768,247,780,32,124,85,252,117,376
430820,201911,1263,3347,660,2151,141,481,162,520,303,1001
430825,201911,249,621,79,204,13,33,24,56,37,89
430830,201911,1623,4714,1292,4069,62,221,924,2876,986,3097
430840,201911,920,2388,672,1940,93,293,451,1261,544,1554
430843,201911,117,282,42,121,6,21,18,46,24,67
430845,201911,393,941,244,678,59,175,89,233,148,408
430850,201911,2258,5953,1514,4489,226,737,657,1949,883,2686
430860,201911,841,1913,392,1114,49,170,188,461,237,631
430865,201911,484,1224,359,1010,62,189,195,528,257,717
430870,201911,609,1598,244,785,38,141,80,227,118,368
430880,201911,1314,3077,863,2370,153,440,448,1191,601,1631
430885,201911,176,466,84,280,9,33,48,157,57,190
430890,201911,974,2463,621,1839,62,262,116,313,178,575
430900,201911,2886,6390,1927,4975,181,547,1241,3005,1422,3552
430905,201911,751,1919,450,1328,85,277,164,449,249,726
430910,201911,1447,3862,979,2886,158,549,464,1215,622,1764
430912,201911,484,1338,312,999,27,82,211,688,238,770
430915,201911,488,1502,350,1228,125,447,102,354,227,801
430920,201911,22499,57452,16771,47654,2418,7578,9987,27468,12405,35046
430925,201911,108,245,42,125,6,20,18,54,24,74
430930,201911,9837,23376,6009,17345,1174,3463,2462,7395,3636,10858
430940,201911,1010,2691,550,1654,159,503,120,279,279,782
430950,201911,713,1720,445,1233,38,133,271,675,309,808
430955,201911,253,668,68,216,16,47,18,46,34,93
430957,201911,179,614,164,576,27,99,98,340,125,439
430960,201911,1313,3145,730,2059,153,462,324,894,477,1356
430965,201911,1572,3762,1186,3150,65,193,930,2481,995,2674
430970,201911,364,904,175,512,28,85,85,223,113,308
430975,201911,477,1473,358,1185,76,265,167,535,243,800
430980,201911,373,861,202,572,30,98,91,230,121,328
430990,201911,546,1566,315,999,38,122,159,502,197,624
430995,201911,545,1414,386,1149,48,157,203,584,251,741
431000,201911,1309,3114,494,1477,89,291,36,91,125,382
431010,201911,1983,5106,1136,3630,215,742,187,507,402,1249
431020,201911,7951,17448,4529,12103,1055,3147,1510,3512,2565,6659
431030,201911,320,870,141,477,24,87,24,72,48,159
431033,201911,3401,8178,2043,5966,484,1449,700,2078,1184,3527
431036,201911,334,720,68,192,8,22,20,48,28,70
431040,201911,883,2275,556,1664,92,305,232,642,324,947
431041,201911,448,1031,321,847,26,64,193,505,219,569
431043,201911,370,890,178,561,37,128,82,257,119,385
431046,201911,109,283,43,133,3,8,11,33,14,41
431050,201911,1329,3264,935,2628,157,458,485,1371,642,1829
431053,201911,585,1608,299,975,66,242,92,272,158,514
431055,201911,570,1407,468,1253,46,114,345,919,391,1033
431057,201911,252,726,114,387,23,78,35,109,58,187
431060,201911,4985,13274,3318,10289,844,2825,811,2510,1655,5335
431065,201911,405,1039,280,830,51,156,113,327,164,483
431070,201911,426,1213,229,756,55,194,47,150,102,344
431075,201911,218,656,134,457,24,80,38,127,62,207
431080,201911,571,1575,370,1138,75,257,124,368,199,625
431085,201911,692,1850,435,1232,67,187,220,609,287,796
431087,201911,422,1189,333,1005,23,62,231,717,254,779
431090,201911,403,945,142,452,26,83,43,137,69,220
431100,201911,3228,7235,2203,5822,330,901,1088,2899,1418,3800
431110,201911,1358,3162,897,2359,273,728,335,835,608,1563
431112,201911,509,1483,417,1296,83,285,211,622,294,907
431113,201911,339,947,290,854,51,162,177,509,228,671
431115,201911,973,2785,739,2339,108,400,423,1258,531,1658
431120,201911,2228,6338,1496,4805,494,1783,342,964,836,2747
431123,201911,378,1062,235,750,43,121,132,440,175,561
431125,201911,980,2917,734,2401,274,876,238,831,512,1707
431127,201911,226,581,50,162,8,26,8,23,16,49
431130,201911,2907,7616,2085,6150,337,1138,1093,3099,1430,4237
431140,201911,4947,11750,2693,7407,347,1021,1181,2874,1528,3895
431142,201911,481,1300,346,1047,54,166,202,616,256,782
431150,201911,993,2687,683,2088,135,444,282,840,417,1284
431160,201911,670,1919,436,1398,75,265,139,439,214,704
431162,201911,503,1211,253,747,23,80,147,402,170,482
431164,201911,177,405,33,106,8,24,4,10,12,34
431170,201911,482,1359,329,1023,102,316,86,256,188,572
431171,201911,608,1448,490,1292,90,212,302,815,392,1027
431173,201911,398,1057,288,882,84,286,112,324,196,610
431175,201911,1091,2631,644,1841,112,332,227,615,339,947
431177,201911,692,1989,510,1677,135,484,266,854,401,1338
431179,201911,337,732,78,229,13,42,17,44,30,86
431180,201911,2168,5493,1250,3675,334,954,324,964,658,1918
431190,201911,430,1149,201,639,26,87,57,145,83,232
431198,201911,327,983,264,863,99,343,74,262,173,605
431200,201911,358,910,66,200,13,37,5,16,18,53
431205,201911,187,525,86,296,22,83,32,111,54,194
431210,201911,579,1489,459,1314,112,319,226,673,338,992
431213,201911,242,644,173,512,13,40,86,265,99,305
431215,201911,565,1344,231,679,28,91,109,298,137,389
431217,201911,154,410,100,309,6,25,60,167,66,192
431220,201911,566,1469,319,969,35,133,177,493,212,626
431225,201911,1498,3601,1113,2937,108,306,773,2048,881,2354
431230,201911,657,1904,481,1477,62,217,288,840,350,1057
431235,201911,150,379,20,66,2,5,3,14,5,19
431237,201911,307,992,255,868,47,172,133,438,180,610
431238,201911,27,69,21,55,6,14,7,17,13,31
431240,201911,3890,9906,2944,8353,505,1575,1549,4239,2054,5814
431242,201911,265,727,220,646,52,163,111,317,163,480
431244,201911,317,765,146,418,22,81,56,129,78,210
431245,201911,1245,2929,765,2075,84,244,393,1009,477,1253
431247,201911,221,598,107,341,21,74,28,72,49,146
431250,201911,1559,4045,1124,3419,250,776,571,1790,821,2566
431260,201911,222,624,131,433,20,90,47,139,67,229
431261,201911,222,704,180,629,18,73,92,306,110,379
431262,201911,371,1016,167,539,13,44,112,362,125,406
431265,201911,1487,3494,541,1594,65,232,193,480,258,712
431267,201911,258,699,142,421,4,18,101,267,105,285
431270,201911,2623,6069,1369,3904,342,1035,413,1195,755,2230
431275,201911,127,363,65,207,22,69,9,27,31,96
431280,201911,223,595,57,187,7,25,8,15,15,40
431290,201911,297,874,189,607,34,116,38,99,72,215
431295,201911,72,192,20,68,1,4,8,25,9,29
431300,201911,307,776,51,158,5,18,15,37,20,55
431301,201911,301,855,59,192,9,21,5,15,14,36
431303,201911,561,1499,315,955,25,86,140,396,165,482
431306,201911,2066,4876,1160,3322,173,550,464,1181,637,1731
431308,201911,25,78,23,74,10,35,10,31,20,66
431310,201911,506,1449,354,1092,41,143,167,480,208,623
431320,201911,580,1602,267,902,39,128,43,133,82,261
431330,201911,1595,3794,711,2100,170,582,229,585,399,1167
431333,201911,214,583,95,285,17,49,36,102,53,151
431335,201911,40,116,22,75,5,10,3,6,8,16
431337,201911,2506,6769,1777,5509,375,1305,844,2506,1219,3811
431339,201911,378,1001,270,796,76,236,114,324,190,560
431340,201911,18777,45869,12489,35011,2310,7092,5280,13835,7590,20927
431342,201911,432,947,314,779,14,38,280,688,294,726
431344,201911,387,995,216,648,8,29,129,365,137,394
431346,201911,244,605,86,277,15,53,28,92,43,145
431349,201911,654,1720,336,1003,85,251,124,365,209,616
431350,201911,3847,10120,2763,8176,419,1386,1415,4061,1834,5447
431360,201911,570,1374,276,795,77,229,81,232,158,461
431365,201911,1808,4416,1446,3913,123,383,1071,2878,1194,3261
431370,201911,4093,10289,2879,8210,708,2108,1268,3723,1976,5831
431380,201911,779,2129,632,1881,37,126,443,1310,480,1436
431390,201911,2421,5919,1387,4039,175,598,624,1577,799,2175
431395,201911,1199,3078,831,2496,193,601,359,1104,552,1705
431400,201911,327,923,162,521,31,92,36,110,67,202
431402,201911,817,1872,576,1496,75,209,375,940,450,1149
431403,201911,178,498,139,423,24,83,69,173,93,256
431405,201911,4293,11434,3238,9677,638,2143,1506,4228,2144,6371
431406,201911,498,1454,355,1137,81,242,175,578,256,820
431407,201911,456,1264,299,925,58,204,141,415,199,619
431410,201911,15865,40594,9934,29572,1575,5397,4734,13056,6309,18453
431413,201911,235,610,56,185,5,14,14,49,19,63
431415,201911,657,1611,390,1164,78,266,175,459,253,725
431417,201911,536,1190,354,914,50,149,201,510,251,659
431420,201911,1465,3411,1079,2844,175,479,560,1466,735,1945
431430,201911,520,1337,226,734,35,129,67,173,102,302
431440,201911,28251,67188,19434,52866,3547,10334,7444,19093,10991,29427
431442,201911,104,283,44,144,6,16,8,22,14,38
431445,201911,399,1142,121,413,18,57,10,32,28,89
431446,201911,280,819,193,637,39,137,93,292,132,429
431447,201911,647,1755,375,1163,76,254,136,425,212,679
431449,201911,719,1887,414,1227,78,217,173,512,251,729
431450,201911,2115,4465,1666,3831,93,221,1280,2855,1373,3076
431454,201911,33,104,29,95,6,19,10,35,16,54
431455,201911,585,1415,279,769,36,107,138,341,174,448
431460,201911,2727,6826,1924,5365,520,1524,538,1516,1058,3040
431470,201911,1385,3914,970,3011,182,572,433,1363,615,1935
431475,201911,252,712,36,145,4,18,5,16,9,34
431477,201911,394,1024,223,664,38,110,91,235,129,345
431478,201911,274,714,50,157,14,40,6,16,20,56
431480,201911,2976,7559,2244,6374,543,1587,1107,3147,1650,4734
431490,201911,104623,250273,79668,210930,6356,19846,57886,147199,64242,167045
431500,201911,483,1222,343,954,63,179,183,486,246,665
431505,201911,295,719,194,555,17,52,129,364,146,416
431507,201911,333,788,130,381,41,127,39,105,80,232
431510,201911,1483,3889,987,2897,219,708,372,1068,591,1776
431513,201911,216,488,115,314,9,22,79,214,88,236
431514,201911,91,235,58,174,4,11,41,120,45,131
431515,201911,463,1174,318,901,65,181,164,461,229,642
431517,201911,70,204,55,168,11,33,21,60,32,93
431520,201911,419,1032,153,493,26,93,58,157,84,250
431530,201911,3833,8070,2154,5699,534,1441,499,1320,1033,2761
431531,201911,202,517,121,353,11,38,56,148,67,186
431532,201911,533,1258,302,836,72,219,123,325,195,544
431535,201911,240,637,95,309,20,71,19,49,39,120
431540,201911,1777,5710,1648,5522,61,260,1335,4476,1396,4736
431545,201911,343,897,56,179,9,28,12,35,21,63
431550,201911,1927,5002,1467,4138,247,762,743,2011,990,2773
431555,201911,659,1495,401,1058,23,79,251,642,274,721
431560,201911,21005,51885,13571,39822,2787,8651,4460,13742,7247,22393
431570,201911,4560,11094,3503,9573,412,1291,2395,6275,2807,7566
431575,201911,222,571,164,466,35,87,47,131,82,218
431580,201911,556,1418,310,911,39,144,167,456,206,600
431590,201911,586,1623,431,1303,91,290,175,543,266,833
431595,201911,339,929,211,648,46,140,87,250,133,390
431600,201911,1250,2915,872,2390,230,685,325,929,555,1614
431610,201911,1315,3423,876,2582,137,383,453,1369,590,1752
431620,201911,439,1158,195,592,34,112,75,213,109,325
431630,201911,1266,3196,552,1681,102,345,198,540,300,885
431640,201911,5952,14794,5089,13651,562,1567,3649,9857,4211,11424
431642,201911,489,1180,306,833,24,67,168,418,192,485
431643,201911,353,878,146,428,18,49,49,138,67,187
431645,201911,1769,4065,1378,3505,77,247,1068,2666,1145,2913
431647,201911,226,575,79,231,9,28,15,36,24,64
431650,201911,125,334,81,254,10,36,41,116,51,152
431660,201911,860,2318,428,1399,72,272,114,340,186,612
431670,201911,1093,2634,683,1890,100,290,372,992,472,1282
431673,201911,228,573,77,265,14,44,15,50,29,94
431675,201911,538,1319,93,303,10,46,19,48,29,94
431680,201911,7053,18385,5026,14481,1237,3674,2118,6001,3355,9675
431690,201911,21535,53499,13791,39397,3042,9208,5178,14840,8220,24048
431695,201911,142,338,84,246,16,60,43,96,59,156
431697,201911,445,1064,326,876,50,124,184,512,234,636
431700,201911,1347,3524,1119,3100,159,419,671,1843,830,2262
431710,201911,11712,29127,8142,23819,1631,5019,3783,11351,5414,16370
431720,201911,5645,14460,3281,9623,854,2658,525,1350,1379,4008
431725,201911,23,61,17,51,5,14,7,21,12,35
431730,201911,3601,8897,2209,6578,525,1673,696,2195,1221,3868
431740,201911,4842,11704,3089,8625,896,2853,717,1672,1613,4525
431750,201911,7029,18234,5424,15666,1193,3707,2427,6882,3620,10589
431755,201911,310,837,62,218,6,20,12,43,18,63
431760,201911,5291,11908,3339,8828,343,1075,1998,4939,2341,6014
431770,201911,1794,4321,1404,3802,94,322,1055,2762,1149,3084
431775,201911,195,512,90,282,20,56,16,46,36,102
431780,201911,1919,4852,1204,3499,215,707,505,1400,720,2107
431790,201911,781,2134,544,1652,102,311,244,708,346,1019
431795,201911,229,589,100,304,22,69,30,87,52,156
431800,201911,7410,18307,4587,13643,1280,4319,557,1724,1837,6043
431805,201911,301,709,79,263,6,21,30,92,36,113
431810,201911,3174,7646,1967,5383,369,1070,841,2204,1210,3274
431820,201911,2087,5763,1642,5021,482,1533,574,1844,1056,3377
431830,201911,8524,18820,6142,15515,1585,4596,1997,5026,3582,9622
431840,201911,2475,6629,1962,5757,340,1004,1161,3418,1501,4422
431842,201911,610,1521,196,618,28,98,62,176,90,274
431843,201911,323,871,241,699,29,99,120,320,149,419
431844,201911,209,538,57,192,15,54,20,70,35,124
431845,201911,507,1345,350,1025,29,89,203,588,232,677
431846,201911,283,745,236,673,11,35,206,583,217,618
431848,201911,109,277,62,185,8,26,8,19,16,45
431849,201911,399,968,57,170,1,1,6,20,7,21
431850,201911,3915,10774,2966,8833,715,2297,926,2720,1641,5017
431860,201911,631,1562,353,1012,62,185,186,506,248,691
431861,201911,97,266,49,156,13,43,13,38,26,81
431862,201911,415,1315,336,1178,71,284,168,564,239,848
431870,201911,17433,45507,13917,39694,1867,5976,8261,22673,10128,28649
431880,201911,3881,10050,2675,7837,437,1473,1205,3360,1642,4833
431890,201911,4054,10348,2446,7210,749,2408,407,1307,1156,3715
431900,201911,953,2431,582,1717,86,298,298,815,384,1113
431910,201911,749,1803,236,668,52,146,64,141,116,287
431912,201911,438,1243,337,1061,68,225,203,633,271,858
431915,201911,1015,2586,800,2225,25,87,607,1640,632,1727
431920,201911,1148,2812,957,2547,30,86,817,2162,847,2248
431930,201911,644,1739,425,1335,123,349,199,651,322,1000
431935,201911,82,231,50,159,14,49,11,37,25,86
431936,201911,295,865,160,521,36,122,56,169,92,291
431937,201911,168,418,102,274,20,65,43,91,63,156
431940,201911,2829,6784,1597,4484,194,617,794,2123,988,2740
431950,201911,1716,4624,1384,4081,442,1306,535,1589,977,2895
431960,201911,2763,6894,1974,5427,577,1621,518,1422,1095,3043
431970,201911,419,1066,144,445,40,122,35,95,75,217
431971,201911,58,147,31,99,5,20,5,10,10,30
431973,201911,465,1500,381,1336,40,152,277,966,317,1118
431975,201911,106,221,19,66,4,17,3,7,7,24
431980,201911,995,2638,757,2224,168,520,340,959,508,1479
431990,201911,5632,13598,3607,10544,524,1782,1653,4589,2177,6371
432000,201911,10259,24936,7229,20057,1787,5033,3111,8710,4898,13743
432010,201911,1970,5010,1427,4011,217,688,820,2174,1037,2862
432020,201911,1726,4341,1070,3065,219,652,481,1299,700,1951
432023,201911,502,1203,245,692,39,119,116,290,155,409
432026,201911,994,2766,690,2178,176,553,239,740,415,1293
432030,201911,323,818,175,521,24,69,94,280,118,349
432032,201911,340,880,227,665,27,96,121,324,148,420
432035,201911,632,1801,545,1651,182,559,207,657,389,1216
432040,201911,1059,2383,338,1052,58,202,108,295,166,497
432045,201911,175,477,99,320,23,76,36,120,59,196
432050,201911,459,1206,334,971,80,230,135,408,215,638
432055,201911,629,1685,391,1209,134,443,86,237,220,680
432057,201911,226,598,162,439,31,76,70,180,101,256
432060,201911,448,1076,135,424,31,107,42,114,73,221
432065,201911,212,598,144,448,28,84,57,169,85,253
432067,201911,708,2065,595,1810,53,183,428,1256,481,1439
432070,201911,1666,4429,1040,3166,242,807,311,855,553,1662
432080,201911,4087,10031,3061,8301,566,1778,1401,3605,1967,5383
432085,201911,353,908,234,716,73,221,93,300,166,521
432090,201911,1273,3226,834,2402,167,528,417,1135,584,1663
432100,201911,931,2427,417,1324,81,280,75,189,156,469
432110,201911,2037,5523,1334,4197,325,1165,120,357,445,1522
432120,201911,2666,7391,2052,6286,427,1445,737,2177,1164,3622
432130,201911,2417,6355,1995,5720,629,1838,843,2461,1472,4299
432132,201911,182,509,106,343,19,65,46,124,65,189
432135,201911,975,2358,617,1709,36,116,448,1222,484,1338
432140,201911,1479,4498,1103,3740,153,561,677,2284,830,2845
432143,201911,1352,3585,1029,3068,74,241,681,2013,755,2254
432145,201911,1322,3498,735,2232,112,359,227,583,339,942
432146,201911,100,277,61,207,21,74,18,56,39,130
432147,201911,473,1390,280,950,91,330,65,193,156,523
432149,201911,412,1047,196,589,13,39,96,276,109,315
432150,201911,2840,7435,2033,5924,457,1499,732,2041,1189,3540
432160,201911,4976,13404,3603,11061,942,3144,1239,3618,2181,6762
432162,201911,266,579,33,92,6,13,5,14,11,27
432163,201911,127,321,24,70,0,0,3,6,3,6
432166,201911,571,1628,422,1306,71,233,146,407,217,640
432170,201911,1275,3443,773,2472,148,526,281,829,429,1355
432180,201911,2505,6153,1286,3775,253,800,440,1150,693,1950
432183,201911,352,1037,220,721,62,234,65,196,127,430
432185,201911,779,2013,439,1343,38,136,238,680,276,816
432190,201911,1679,4144,1049,3092,212,697,503,1391,715,2088
432195,201911,917,2288,572,1650,161,429,208,634,369,1063
432200,201911,3048,8023,2127,6471,375,1148,1137,3533,1512,4681
432210,201911,359,948,209,643,38,144,98,256,136,400
432215,201911,612,1790,548,1694,51,141,400,1257,451,1398
432218,201911,254,642,106,311,16,54,46,122,62,176
432220,201911,3469,8252,2554,6817,433,1222,1425,3737,1858,4959
432225,201911,84,243,60,189,14,47,30,95,44,142
432230,201911,686,1641,368,1042,54,163,154,393,208,556
432232,201911,482,1188,283,828,61,199,107,288,168,487
432234,201911,264,667,108,317,20,46,16,42,36,88
432235,201911,72,198,20,62,4,12,6,24,10,36
432237,201911,333,859,286,778,9,20,233,617,242,637
432240,201911,14315,36784,10407,31283,784,2679,6624,20657,7408,23336
432250,201911,4422,13346,3550,11619,995,3329,1399,4617,2394,7946
432252,201911,421,1020,250,709,37,112,125,342,162,454
432253,201911,944,2949,557,1936,145,535,35,114,180,649
432254,201911,684,1630,136,431,27,87,17,42,44,129
432255,201911,104,267,56,171,6,21,29,78,35,99
432260,201911,4519,11804,3215,9279,964,2864,925,2602,1889,5466
432270,201911,1726,4897,1328,4081,411,1377,249,720,660,2097
432280,201911,1154,2936,557,1699,89,295,210,546,299,841
432285,201911,170,501,24,75,0,0,4,9,4,9
432290,201911,330,942,167,542,56,184,35,78,91,262
432300,201911,24784,63934,18275,53072,2811,9160,10453,29184,13264,38344
432310,201911,765,2117,546,1703,51,161,368,1154,419,1315
432320,201911,207,479,67,195,9,33,25,64,34,97
432330,201911,207,476,59,181,7,19,14,40,21,59
432335,201911,196,556,62,226,6,27,12,37,18,64
432340,201911,315,754,127,401,12,39,44,128,56,167
432345,201911,635,1476,560,1382,21,58,446,1077,467,1135
432350,201911,331,879,172,561,31,109,67,210,98,319
432360,201911,223,665,42,144,3,12,17,54,20,66
432370,201911,299,743,189,554,16,53,127,362,143,415
432375,201911,467,1185,340,933,65,161,170,481,235,642
432377,201911,177,552,31,110,5,20,3,6,8,26
432380,201911,1554,4169,967,3057,171,611,487,1482,658,2093
500020,201911,2438,6372,1680,5027,198,682,980,2835,1178,3517
500025,201911,1214,2900,735,2041,63,189,417,1113,480,1302
500060,201911,7174,20349,4902,15683,628,2112,2897,9517,3525,11629
500070,201911,4099,10736,2802,8508,525,1635,1210,3769,1735,5404
500080,201911,1340,3377,854,2511,163,530,359,948,522,1478
500085,201911,1960,4877,1274,3739,297,920,625,1751,922,2671
500090,201911,1924,5211,1280,4065,234,769,481,1588,715,2357
500100,201911,3482,8924,2598,7448,462,1483,1230,3318,1692,4801
500110,201911,7354,19098,4589,14631,1055,3695,1359,5020,2414,8715
500124,201911,1963,5893,1554,5167,258,797,841,2941,1099,3738
500150,201911,1277,2925,769,2154,160,461,272,743,432,1204
500190,201911,4148,10249,2722,7933,659,1957,780,2246,1439,4203
500200,201911,2107,5053,1518,4060,170,484,931,2361,1101,2845
500210,201911,4458,11164,3175,9408,825,2477,1397,4227,2222,6704
500215,201911,1321,3774,907,2978,92,343,471,1542,563,1885
500220,201911,2400,6844,1503,5090,267,969,398,1299,665,2268
500230,201911,2066,4870,1505,4058,197,518,971,2593,1168,3111
500240,201911,3449,10378,2335,8015,391,1485,897,3175,1288,4660
500260,201911,3026,6504,1815,4795,258,676,943,2418,1201,3094
500270,201911,131991,311805,74577,211843,13395,41533,26681,71344,40076,112877
500280,201911,1213,3089,803,2428,100,319,476,1403,576,1722
500290,201911,3490,8197,1855,5490,345,1178,575,1512,920,2690
500295,201911,3132,7678,1826,5280,313,999,696,1748,1009,2747
500310,201911,906,1931,599,1539,98,203,304,818,402,1021
500315,201911,3446,9889,2708,8729,252,806,1866,6201,2118,7007
500320,201911,17637,48858,12047,39454,3181,10820,4178,14521,7359,25341
500325,201911,4126,9319,2790,7493,243,676,1820,4943,2063,5619
500330,201911,6596,15194,4191,11553,327,997,2348,6625,2675,7622
500345,201911,1963,4848,1236,3669,292,896,417,1208,709,2104
500348,201911,2340,6052,1778,5109,259,753,992,2911,1251,3664
500350,201911,1240,3386,645,2054,75,246,284,886,359,1132
500370,201911,23707,61898,15933,48782,2295,8002,8118,24744,10413,32746
500375,201911,2329,6175,1503,4464,316,1007,494,1388,810,2395
500380,201911,3373,8476,2227,6507,626,1949,577,1711,1203,3660
500390,201911,504,1098,309,845,53,166,180,488,233,654
500400,201911,1287,3338,810,2387,150,492,271,736,421,1228
500410,201911,2347,5904,1639,4809,173,506,968,2925,1141,3431
500430,201911,2520,6288,1647,4935,232,818,696,2175,928,2993
500440,201911,1094,2677,645,1952,88,296,244,798,332,1094
500450,201911,1378,3490,740,2264,150,494,163,476,313,970
500460,201911,3574,9702,2104,6759,382,1365,672,2143,1054,3508
500470,201911,2380,6494,1414,4469,434,1517,285,769,719,2286
500480,201911,2120,6403,1794,5869,162,571,1302,4342,1464,4913
500490,201911,965,2279,529,1610,123,450,147,441,270,891
500500,201911,4178,11328,2623,8738,954,3700,459,1548,1413,5248
500510,201911,672,1729,420,1239,28,98,254,730,282,828
500515,201911,1758,4410,1328,3730,142,445,854,2305,996,2750
500520,201911,2921,9494,2306,8284,640,2337,960,3605,1600,5942
500525,201911,838,2529,677,2274,61,222,412,1410,473,1632
500540,201911,4231,11026,2494,7935,684,2676,241,688,925,3364
500560,201911,5181,14519,4141,13136,285,980,3261,10469,3546,11449
500568,201911,4279,9377,2455,6662,583,1709,847,2298,1430,4007
500570,201911,7308,17231,4185,11762,826,2537,1384,3602,2210,6139
500580,201911,2923,7911,2145,6540,460,1467,1024,3100,1484,4567
500600,201911,2997,7533,2072,6115,439,1322,903,2756,1342,4078
500620,201911,7173,19250,4676,14389,1082,3484,1622,4874,2704,8358
500625,201911,482,1325,271,847,51,169,90,246,141,415
500627,201911,708,1852,409,1290,62,201,147,466,209,667
500630,201911,6252,14608,3455,9850,713,2216,1048,3012,1761,5228
500635,201911,2843,9056,2181,8161,176,719,1531,6171,1707,6890
500640,201911,1657,3662,1076,2870,41,135,737,1913,778,2048
500660,201911,16453,43888,11113,35648,3643,13066,2723,8977,6366,22043
500690,201911,2091,5777,1386,4666,553,2135,89,207,642,2342
500710,201911,2821,7736,2127,6476,640,2047,631,1811,1271,3858
500720,201911,4807,12252,2984,9183,687,2243,871,2720,1558,4963
500730,201911,917,2315,535,1615,69,185,194,599,263,784
500740,201911,4451,10662,2995,8297,389,1142,1596,4451,1985,5593
500750,201911,914,2361,581,1736,89,274,222,590,311,864
500755,201911,843,2250,443,1471,87,311,82,243,169,554
500769,201911,4733,11692,2398,7168,474,1599,382,883,856,2482
500770,201911,1443,3932,906,2955,170,623,305,982,475,1605
500780,201911,1214,3013,760,2225,162,518,215,598,377,1116
500790,201911,7264,19275,5560,16426,1113,3526,2841,8429,3954,11955
500793,201911,1894,4879,1271,3771,364,1167,360,973,724,2140
500795,201911,2510,6465,2049,5871,94,274,1752,5115,1846,5389
500797,201911,661,1684,435,1280,123,378,153,450,276,828
500800,201911,2823,6576,1726,4950,552,1846,219,689,771,2535
500830,201911,16973,43149,11215,32427,2309,7273,4331,11716,6640,18989
500840,201911,1345,3297,752,2144,86,247,317,859,403,1106
510010,201911,1813,4101,1160,3229,112,317,806,2266,918,2583
510020,201911,3417,8769,1739,5344,377,1241,367,1023,744,2264
510025,201911,6612,16458,3953,11921,610,2036,1561,4535,2171,6571
510030,201911,2267,5132,1452,3933,330,894,525,1424,855,2318
510035,201911,1173,3059,708,2306,80,280,426,1458,506,1738
510040,201911,2177,4938,1563,4127,149,396,990,2694,1139,3090
510050,201911,1998,4326,1284,3356,156,470,872,2204,1028,2674
510060,201911,1359,3459,961,2801,202,653,288,781,490,1434
510080,201911,1198,3162,755,2391,248,827,214,585,462,1412
510100,201911,648,1535,431,1181,51,145,229,605,280,750
510120,201911,249,472,136,339,3,12,106,268,109,280
510125,201911,2030,5085,1581,4408,174,644,810,2109,984,2753
510130,201911,1416,3573,961,2829,209,671,295,879,504,1550
510140,201911,2913,7685,1971,6468,731,2799,660,1981,1391,4780
510160,201911,1667,4332,1197,3708,168,492,845,2671,1013,3163
510170,201911,4408,11689,3164,9659,782,2474,1259,3943,2041,6417
510180,201911,13464,31031,7900,22521,1831,5660,2296,7468,4127,13128
510185,201911,1653,4379,1061,3515,435,1449,282,1175,717,2624
510190,201911,1923,5558,1230,4321,351,1355,222,827,573,2182
510250,201911,15132,39289,11591,34162,2197,6760,6224,19039,8421,25799
510260,201911,1968,8169,1577,7441,270,1379,937,4825,1207,6204
510263,201911,3043,8497,1772,5871,302,1122,209,605,511,1727
510267,201911,4569,13203,2600,8766,540,1925,312,1001,852,2926
510268,201911,1257,3090,928,2572,113,302,605,1662,718,1964
510269,201911,989,2730,597,1967,159,576,185,566,344,1142
510270,201911,2818,8137,1880,6381,357,1321,750,2487,1107,3808
510279,201911,1723,4499,1080,3363,219,758,452,1348,671,2106
510285,201911,1054,2824,720,2250,230,794,155,437,385,1231
510300,201911,3607,9180,2619,7819,406,1224,1509,4718,1915,5942
510305,201911,1435,3992,835,2807,182,639,194,729,376,1368
510310,201911,900,2252,595,1727,178,544,164,489,342,1033
510320,201911,3534,9008,2391,6967,545,1715,625,1845,1170,3560
510325,201911,4272,12718,3167,10697,924,3258,1003,3497,1927,6755
510330,201911,2703,8214,1784,6538,343,1281,666,2763,1009,4044
510335,201911,4477,13028,3297,11156,517,1868,1848,6429,2365,8297
510336,201911,458,1294,326,1079,61,193,150,537,211,730
510337,201911,1535,4586,1000,3596,398,1559,185,677,583,2236
510340,201911,88407,197157,51887,142684,13175,42706,14694,37252,27869,79958
510343,201911,1011,2785,671,2128,123,431,285,863,408,1294
510345,201911,1205,3453,883,2805,166,530,390,1199,556,1729
510350,201911,2746,7210,1709,5432,376,1241,664,2100,1040,3341
510360,201911,1828,3820,1132,2993,66,131,816,2303,882,2434
510370,201911,1695,4960,1193,4060,168,644,704,2436,872,3080
510380,201911,541,1365,282,892,58,212,100,305,158,517
510385,201911,1197,4059,853,3387,94,425,528,2164,622,2589
510390,201911,1149,3197,770,2674,230,782,309,1189,539,1971
510395,201911,717,1606,465,1236,27,73,276,785,303,858
510410,201911,4558,12821,3285,10495,631,2090,1753,5764,2384,7854
510420,201911,2246,4850,1514,3860,117,343,985,2504,1102,2847
510450,201911,477,1174,257,759,68,197,41,140,109,337
510452,201911,682,1922,461,1490,64,220,238,756,302,976
510454,201911,871,2451,652,2070,63,170,433,1453,496,1623
510455,201911,870,2461,613,1928,99,360,237,675,336,1035
510460,201911,1734,4283,1200,3478,95,333,777,2148,872,2481
510480,201911,4546,11070,2904,7978,571,1769,1144,3004,1715,4773
510490,201911,1668,4391,1217,3794,202,645,736,2320,938,2965
510500,201911,1521,3831,886,2744,167,549,309,963,476,1512
510510,201911,3290,9758,2377,8044,638,2398,713,2534,1351,4932
510515,201911,5200,13617,3235,9896,788,2649,775,2142,1563,4791
510517,201911,1012,2957,763,2517,240,887,137,389,377,1276
510520,201911,2080,4207,1145,3043,81,228,604,1711,685,1939
510523,201911,1010,2626,730,2143,155,433,387,1174,542,1607
510525,201911,6274,17486,4578,14110,781,2700,2087,6067,2868,8767
510530,201911,536,1380,381,1150,33,108,233,681,266,789
510550,201911,2373,7028,1660,5740,411,1487,695,2422,1106,3909
510558,201911,2120,5723,1510,4756,196,602,708,2399,904,3001
510560,201911,1616,4655,922,3241,199,777,244,919,443,1696
510562,201911,5076,13590,3510,10624,896,2952,1161,3619,2057,6571
510590,201911,3056,7622,2170,6473,179,579,1532,4626,1711,5205
510600,201911,1438,3281,899,2455,178,498,380,1047,558,1545
510610,201911,2724,6627,1811,5353,175,597,1122,3330,1297,3927
510615,201911,2452,6280,1578,4799,293,895,809,2544,1102,3439
510617,201911,923,2770,678,2359,105,435,407,1460,512,1895
510618,201911,1210,3238,803,2504,171,597,382,1157,553,1754
510619,201911,730,1862,450,1372,70,233,101,281,171,514
510620,201911,1340,3019,597,1839,157,583,35,72,192,655
510621,201911,1440,3893,852,2768,189,680,258,804,447,1484
510622,201911,4338,12327,2915,9211,1026,3449,425,1216,1451,4665
510623,201911,2567,6434,1729,5091,404,1446,485,1351,889,2797
510624,201911,1620,4094,665,2260,91,337,156,459,247,796
510625,201911,2744,6735,1401,4296,258,929,316,955,574,1884
510626,201911,1448,3505,865,2573,256,874,211,620,467,1494
510627,201911,585,1518,318,985,88,294,76,247,164,541
510628,201911,1486,3426,945,2677,194,583,376,1057,570,1640
510629,201911,1531,4437,1109,3634,235,834,398,1289,633,2123
510630,201911,3166,8930,1792,6229,427,1577,310,1169,737,2746
510631,201911,575,1390,400,1131,13,39,309,892,322,931
510637,201911,3233,7906,2274,6470,596,1881,640,1807,1236,3688
510642,201911,5186,15135,3954,13234,1038,3714,1623,5612,2661,9326
510645,201911,810,1718,473,1271,112,313,207,519,319,832
510650,201911,6918,17958,5474,16356,639,1736,3788,12384,4427,14120
510665,201911,1762,3919,1007,2689,139,395,436,1200,575,1595
510670,201911,413,883,231,615,24,66,133,363,157,429
510675,201911,5650,15763,3729,12093,1135,4025,581,1825,1716,5850
510677,201911,2030,5272,1359,4241,207,723,693,2112,900,2835
510680,201911,678,1781,373,1184,77,265,76,217,153,482
510682,201911,1542,4586,1106,3821,361,1389,241,804,602,2193
510685,201911,553,1610,390,1268,56,200,193,620,249,820
510700,201911,3885,9552,2692,7824,298,979,1893,5442,2191,6421
510704,201911,10315,24388,6477,17691,1374,4063,1775,4622,3149,8685
510706,201911,1914,5716,1330,4772,248,906,705,2732,953,3638
510710,201911,2560,6522,1623,4720,368,1127,549,1518,917,2645
510715,201911,572,1287,413,1071,40,117,196,514,236,631
510718,201911,2256,5106,1262,3781,439,1290,368,1389,807,2679
510719,201911,414,873,242,640,26,68,141,357,167,425
510720,201911,900,2135,569,1627,110,360,251,667,361,1027
510724,201911,737,2012,486,1543,80,279,239,731,319,1010
510726,201911,1097,2000,554,1326,61,163,287,682,348,845
510729,201911,593,1408,250,770,36,125,56,181,92,306
510730,201911,2838,6955,1871,5389,278,902,886,2475,1164,3377
510735,201911,1006,2923,754,2559,78,310,543,1833,621,2143
510740,201911,854,2103,516,1464,81,235,247,696,328,931
510757,201911,530,1689,418,1502,144,579,143,478,287,1057
510760,201911,40991,90935,23093,62830,5066,15807,7123,17661,12189,33468
510770,201911,4218,9578,2844,7875,263,692,1913,5547,2176,6239
510774,201911,334,880,223,678,38,117,108,333,146,450
510775,201911,599,1621,385,1261,89,327,81,249,170,576
510776,201911,434,1085,295,820,76,213,95,279,171,492
510777,201911,1516,4055,1065,3455,140,524,694,2212,834,2736
510779,201911,617,1656,463,1412,47,144,280,889,327,1033
510780,201911,3591,9336,2583,7878,604,1824,1157,3936,1761,5760
510785,201911,1973,5269,1108,3631,292,1022,179,660,471,1682
510787,201911,2494,7122,1604,5218,564,1928,177,563,741,2491
510788,201911,618,1463,414,1149,65,182,182,582,247,764
510790,201911,16529,43206,9446,29544,2065,7266,1455,3934,3520,11200
510792,201911,8387,22739,4959,16020,1043,3779,912,2651,1955,6430
510794,201911,1181,3192,760,2455,250,902,158,426,408,1328
510795,201911,7819,20859,4947,15516,1141,3970,1274,3899,2415,7869
510800,201911,1660,4325,1039,3239,377,1174,122,372,499,1546
510805,201911,1506,4200,981,3172,220,786,288,805,508,1591
510810,201911,636,1316,392,978,105,275,162,402,267,677
510820,201911,750,1440,400,990,25,79,209,523,234,602
510830,201911,828,2030,576,1693,52,142,402,1247,454,1389
510835,201911,550,1338,354,1049,45,146,199,575,244,721
510840,201911,49601,107705,33521,87717,6265,15534,17527,49981,23792,65515
510850,201911,1790,4291,973,2967,324,1127,98,230,422,1357
510860,201911,2270,6091,1393,4592,440,1682,128,406,568,2088
510880,201911,668,1923,489,1574,122,406,186,608,308,1014
510885,201911,530,1291,352,1032,63,212,122,349,185,561
510890,201911,619,1821,455,1535,101,367,207,689,308,1056
510895,201911,1217,3176,784,2454,177,655,320,916,497,1571
520005,201911,2345,6158,1797,5482,525,1617,781,2666,1306,4283
520010,201911,2143,6260,1506,4968,376,1395,429,1235,805,2630
520013,201911,2686,7004,1756,5274,386,1179,498,1626,884,2805
520015,201911,508,1284,356,1061,79,254,127,394,206,648
520017,201911,1079,2818,800,2382,102,327,518,1505,620,1832
520020,201911,385,890,287,762,29,101,207,521,236,622
520025,201911,32595,91595,27850,84861,2807,9365,20055,60666,22862,70031
520030,201911,5366,13916,4237,12305,342,1109,2953,8499,3295,9608
520050,201911,410,952,256,686,12,33,154,428,166,461
520055,201911,1584,3907,1037,2871,76,193,588,1577,664,1770
520060,201911,1405,3964,1014,3218,277,961,247,776,524,1737
520080,201911,1807,4654,1328,4007,246,754,628,2078,874,2832
520082,201911,867,2244,684,1929,76,202,371,1087,447,1289
520085,201911,794,2146,612,1843,112,352,288,824,400,1176
520090,201911,815,1604,552,1309,55,96,429,1058,484,1154
520110,201911,37447,101503,25443,81334,8144,29464,2059,5966,10203,35430
520120,201911,199,480,107,320,14,49,40,116,54,165
520130,201911,3558,8819,2747,7521,532,1499,1188,3289,1720,4788
520140,201911,39034,105717,26875,84437,9868,33509,3436,11095,13304,44604
520145,201911,544,1281,367,1019,64,201,200,507,264,708
520150,201911,610,1391,438,1165,81,214,236,641,317,855
520160,201911,773,1780,547,1429,102,246,258,713,360,959
520170,201911,4997,10126,3291,8154,192,532,2504,6083,2696,6615
520180,201911,2068,5761,1684,5188,328,1116,892,2699,1220,3815
520215,201911,1755,4248,1225,3410,310,936,446,1191,756,2127
520235,201911,587,1361,330,954,36,123,130,356,166,479
520250,201911,1457,3777,1031,3099,329,1073,231,716,560,1789
520260,201911,813,1903,494,1366,101,280,200,567,301,847
520280,201911,670,1679,499,1412,105,299,233,696,338,995
520310,201911,1103,2424,690,1809,164,488,261,709,425,1197
520320,201911,1610,4360,1202,3694,145,503,658,1972,803,2475
520330,201911,3747,10249,2673,8453,421,1611,1349,4147,1770,5758
520340,201911,2333,5217,1440,3956,178,451,844,2428,1022,2879
520350,201911,2779,6708,1975,5447,603,1756,745,2051,1348,3807
520355,201911,1746,4811,1231,3777,350,1170,369,1053,719,2223
520357,201911,730,1763,526,1457,38,100,390,1108,428,1208
520360,201911,671,1756,492,1453,151,469,135,430,286,899
520380,201911,1261,3156,735,2176,78,252,374,1029,452,1281
520390,201911,988,2173,566,1643,162,513,180,562,342,1075
520393,201911,513,1232,338,950,44,147,154,392,198,539
520396,201911,783,2054,650,1842,46,149,466,1280,512,1429
520400,201911,1581,3940,1190,3393,164,498,781,2245,945,2743
520410,201911,1876,4174,1071,2945,171,511,464,1225,635,1736
520420,201911,357,816,272,675,28,77,204,477,232,554
520425,201911,1376,3353,810,2351,211,633,221,619,432,1252
520430,201911,2179,4977,1148,3391,220,773,45,116,265,889
520440,201911,2927,7086,1711,4922,425,1337,454,1244,879,2581
520450,201911,11732,28259,7548,21678,2413,7536,1230,3620,3643,11156
520455,201911,655,1795,466,1499,123,426,134,439,257,865
520460,201911,976,2304,748,2007,83,195,583,1604,666,1799
520465,201911,765,1978,604,1750,93,300,400,1109,493,1409
520470,201911,2067,5429,1586,4780,408,1216,725,2365,1133,3581
520480,201911,883,2452,589,1946,187,619,131,480,318,1099
520485,201911,1545,4332,1278,3957,187,590,883,2712,1070,3302
520490,201911,3877,10722,2861,9121,983,3216,1045,3467,2028,6683
520495,201911,1530,3351,1147,2839,47,126,916,2259,963,2385
520500,201911,1272,3386,841,2553,198,655,334,1015,532,1670
520505,201911,708,1620,478,1314,68,193,287,784,355,977
520510,201911,7507,18877,4841,14658,1136,3844,1321,4269,2457,8113
520520,201911,1119,2876,816,2389,197,613,265,780,462,1393
520530,201911,1922,5690,1408,4807,461,1653,430,1591,891,3244
520540,201911,2756,7335,1635,5052,310,1029,367,1086,677,2115
520545,201911,918,2412,684,2027,148,427,264,804,412,1231
520547,201911,770,2091,605,1807,152,465,285,853,437,1318
520549,201911,12619,34383,10260,30766,1544,4894,6650,19843,8194,24737
520551,201911,4353,11902,3626,10832,408,1437,2540,7380,2948,8817
520552,201911,831,2146,680,1954,136,385,400,1217,536,1602
520570,201911,540,1202,351,937,92,218,130,392,222,610
520580,201911,2115,4957,1605,4335,110,353,1171,3106,1281,3459
520590,201911,1126,2909,767,2303,226,698,187,572,413,1270
520620,201911,7992,21714,6197,19061,1584,5008,2764,8743,4348,13751
520630,201911,687,1774,418,1280,70,216,78,238,148,454
520640,201911,2360,5846,1770,4826,437,1173,718,2031,1155,3204
520650,201911,849,2012,594,1640,98,265,298,872,396,1137
520660,201911,512,1225,245,740,52,179,60,172,112,351
520670,201911,902,2516,764,2323,75,245,494,1459,569,1704
520680,201911,687,1718,496,1417,86,231,249,736,335,967
520690,201911,342,803,229,638,68,175,67,211,135,386
520710,201911,397,954,273,737,9,21,193,510,202,531
520725,201911,1527,3617,1039,2821,127,391,644,1674,771,2065
520735,201911,716,1762,465,1347,105,291,164,517,269,808
520740,201911,2023,4624,1503,3992,263,651,833,2360,1096,3011
520750,201911,652,1597,453,1276,77,209,225,649,302,858
520753,201911,1299,3469,976,2849,190,584,387,1061,577,1645
520760,201911,1153,2587,1011,2409,37,68,917,2216,954,2284
520780,201911,1454,3428,1024,2824,104,310,506,1342,610,1652
520790,201911,3339,7911,2293,6250,293,792,1282,3669,1575,4461
520800,201911,15406,40154,11877,34995,1953,5944,6905,20911,8858,26855
520810,201911,1255,2676,893,2258,154,412,552,1456,706,1868
520815,201911,583,1729,410,1372,70,249,116,404,186,653
520830,201911,1821,3893,1258,3247,44,113,1032,2628,1076,2741
520840,201911,2450,6628,1961,5992,838,2748,525,1714,1363,4462
520850,201911,650,1685,453,1387,161,561,103,333,264,894
520860,201911,6183,16735,4500,14000,1152,3842,1670,5149,2822,8991
520870,201911,97877,228934,63948,177673,15259,45750,21677,58787,36936,104537
520880,201911,6398,18343,4885,15656,1156,3827,1792,5787,2948,9614
520890,201911,3755,9198,2503,7224,540,1666,1057,3064,1597,4730
520910,201911,4513,11455,2790,8389,710,2316,615,1838,1325,4154
520915,201911,673,1864,382,1198,62,211,128,388,190,599
520920,201911,4318,9808,2916,7968,366,1018,1659,4649,2025,5667
520929,201911,689,1606,474,1263,87,210,224,652,311,862
520940,201911,961,2555,742,2244,46,151,547,1624,593,1775
520945,201911,469,1058,375,920,23,51,272,653,295,704
520960,201911,995,2485,765,2102,134,352,462,1270,596,1622
520970,201911,2394,6694,1882,5843,493,1693,486,1603,979,3296
520980,201911,772,1890,552,1583,110,345,223,600,333,945
520990,201911,2940,7953,2338,7161,337,1024,1494,4643,1831,5667
520993,201911,1045,2471,692,1904,93,293,397,1042,490,1335
520995,201911,2217,5672,1649,4880,275,820,671,2038,946,2858
521000,201911,8227,21454,5407,16472,1176,3727,1641,4975,2817,8702
521010,201911,3626,9355,2655,7678,274,798,1532,4379,1806,5177
521015,201911,766,1906,518,1456,45,139,324,864,369,1003
521020,201911,3035,7847,1735,5277,515,1705,144,460,659,2165
521030,201911,480,1034,315,796,55,115,141,398,196,513
521040,201911,7487,18243,5426,15005,1127,3254,2322,6516,3449,9770
521056,201911,884,2346,683,2047,218,642,197,657,415,1299
521060,201911,941,2480,692,2029,51,147,364,1080,415,1227
521080,201911,1091,2386,536,1483,71,220,231,555,302,775
521090,201911,3195,8598,2096,6426,611,1993,256,818,867,2811
521100,201911,1728,4023,1207,3286,196,532,697,1914,893,2446
521120,201911,4611,10778,3212,9034,210,525,1622,5230,1832,5755
521130,201911,947,2149,550,1487,21,61,298,849,319,910
521140,201911,1202,3092,850,2460,120,362,401,1158,521,1520
521150,201911,12182,26716,7323,19797,1301,4086,3431,9326,4732,13412
521160,201911,615,1283,420,992,46,108,279,639,325,747
521170,201911,1022,2405,729,1955,62,182,499,1300,561,1482
521180,201911,6870,19238,5588,16982,968,3205,2819,8269,3787,11474
521190,201911,10244,25909,5711,18057,1469,4901,1156,3869,2625,8770
521200,201911,715,1769,475,1361,51,145,262,743,313,888
521205,201911,601,1504,451,1261,17,51,331,891,348,942
521210,201911,703,1778,389,1139,95,298,69,161,164,459
521220,201911,3646,9029,2323,6860,468,1558,732,2073,1200,3631
521225,201911,332,738,242,637,32,92,148,382,180,474
521230,201911,1256,3274,1118,3105,383,1063,559,1645,942,2708
521250,201911,29464,80088,22602,69897,8484,27426,6654,21880,15138,49306
521260,201911,568,1338,406,1074,55,148,231,599,286,747
521270,201911,1774,4507,1517,4194,85,220,1159,3209,1244,3429
521280,201911,1794,4816,1329,4036,326,1080,524,1608,850,2688
521290,201911,458,1087,311,894,44,150,183,511,227,661
521295,201911,1066,2319,824,2057,56,118,657,1715,713,1833
521300,201911,1846,4577,1432,3998,277,729,881,2531,1158,3260
521305,201911,687,1668,463,1314,56,150,274,781,330,931
521308,201911,4631,12470,3222,9773,322,975,1834,5473,2156,6448
521310,201911,8149,20854,5437,16213,1215,3936,2178,6213,3393,10149
521340,201911,408,957,286,768,21,60,202,527,223,587
521350,201911,2008,5166,1513,4406,149,518,1042,2902,1191,3420
521370,201911,1214,3106,710,2215,202,736,93,309,295,1045
521375,201911,1310,3226,878,2590,204,587,269,880,473,1467
521377,201911,1460,3107,1040,2586,76,141,844,2192,920,2333
521380,201911,6034,16114,3856,11981,413,1430,993,3261,1406,4691
521385,201911,631,1525,476,1321,63,165,269,809,332,974
521390,201911,681,1686,472,1363,144,461,168,501,312,962
521400,201911,2497,5764,1900,5034,219,584,1332,3611,1551,4195
521405,201911,1241,3197,903,2629,181,531,422,1218,603,1749
521410,201911,768,2046,582,1735,109,303,296,946,405,1249
521440,201911,1202,3054,836,2479,272,884,240,717,512,1601
521450,201911,3792,11387,2752,9306,711,2465,734,2586,1445,5051
521460,201911,5637,14986,3925,11913,1370,4309,856,2648,2226,6957
521470,201911,641,1737,374,1175,47,140,126,390,173,530
521480,201911,342,850,194,565,38,114,57,155,95,269
521483,201911,2419,5797,1636,4547,367,1078,630,1715,997,2793
521486,201911,1724,4067,1266,3424,76,222,931,2495,1007,2717
521487,201911,416,1004,288,822,52,160,138,402,190,562
521490,201911,873,2362,630,1954,40,149,449,1350,489,1499
521500,201911,2103,5281,1533,4348,102,359,1077,2963,1179,3322
521520,201911,723,1666,498,1334,79,228,211,564,290,792
521523,201911,11175,35005,9240,31765,2551,9564,2482,8806,5033,18370
521525,201911,1035,2369,753,1973,76,205,532,1380,608,1585
521530,201911,2253,5859,1274,3817,270,850,318,978,588,1828
521540,201911,818,2067,521,1567,72,251,243,762,315,1013
521550,201911,1414,3556,774,2295,144,476,206,636,350,1112
521560,201911,4364,11622,2968,9723,490,1870,1489,5083,1979,6953
521565,201911,613,1491,470,1294,74,190,288,783,362,973
521570,201911,3419,9183,2183,6820,431,1549,240,798,671,2347
521580,201911,498,1216,274,828,36,116,80,211,116,327
521590,201911,623,1490,459,1255,90,268,252,672,342,940
521600,201911,377,1032,230,721,40,106,86,272,126,378
521630,201911,1645,3612,973,2603,193,549,338,868,531,1417
521640,201911,1777,4203,1197,3347,268,814,397,1076,665,1890
521645,201911,548,1431,340,1051,79,216,117,368,196,584
521680,201911,1095,3341,826,2790,240,877,116,418,356,1295
521690,201911,508,1287,432,1174,60,176,260,693,320,869
521710,201911,3124,7853,1909,5792,351,1194,444,1270,795,2464
521720,201911,2183,5095,1413,3911,156,473,803,2218,959,2691
521730,201911,3500,9950,2638,8428,777,2832,635,1698,1412,4530
521740,201911,3823,10034,2841,8589,732,2391,1037,3267,1769,5658
521760,201911,14577,40310,11168,34996,2969,10213,4081,13221,7050,23434
521770,201911,2879,6987,1878,5296,585,1787,458,1291,1043,3078
521800,201911,6067,16515,4402,13720,1075,3455,1614,5469,2689,8924
521805,201911,496,1187,357,985,119,315,144,404,263,719
521810,201911,633,1492,430,1208,64,181,238,679,302,860
521830,201911,5317,14826,4217,13139,299,1146,3007,9175,3306,10321
521839,201911,659,1638,471,1312,85,264,232,574,317,838
521850,201911,5336,12694,3196,9316,563,1820,358,965,921,2785
521860,201911,1606,4231,1087,3311,191,630,349,1039,540,1669
521870,201911,666,1855,460,1455,101,355,114,318,215,673
521878,201911,640,1650,447,1281,65,220,230,597,295,817
521880,201911,18118,43896,11882,34312,3046,9311,4033,11873,7079,21184
521890,201911,2974,7765,1918,5830,545,1780,339,943,884,2723
521900,201911,1536,3623,885,2628,292,847,129,401,421,1248
521910,201911,1207,2577,755,2025,71,189,434,1229,505,1418
521920,201911,447,1259,323,1033,61,224,142,436,203,660
521925,201911,732,1933,535,1635,90,282,282,847,372,1129
521930,201911,5229,12708,3354,9771,886,2452,1264,4036,2150,6488
521935,201911,957,2315,638,1728,69,198,365,926,434,1124
521940,201911,1246,2813,812,2219,189,569,327,866,516,1435
521945,201911,526,1455,407,1243,93,288,208,653,301,941
521950,201911,736,1796,518,1457,128,384,226,589,354,973
521960,201911,704,1848,446,1347,52,172,239,671,291,843
521970,201911,2507,6177,1995,5567,149,409,1543,4361,1692,4770
521971,201911,731,1723,494,1375,130,351,142,397,272,748
521973,201911,1229,3218,941,2760,45,167,676,1934,721,2101
521975,201911,11660,30799,9530,27817,1499,4602,6036,17626,7535,22228
521980,201911,2511,5904,1894,5080,150,371,1425,3894,1575,4265
521990,201911,1059,2945,824,2534,159,493,362,1129,521,1622
522000,201911,2443,6643,1955,6002,234,717,1314,4146,1548,4863
522005,201911,332,806,248,682,51,134,121,347,172,481
522010,201911,3852,9468,2659,7527,650,1967,888,2448,1538,4415
522015,201911,922,2422,654,1993,167,499,250,788,417,1287
522020,201911,5272,12632,3438,9720,717,2142,1383,3975,2100,6117
522026,201911,667,1884,471,1504,81,275,163,503,244,778
522028,201911,429,1106,307,885,57,171,132,367,189,538
522040,201911,3019,6876,2127,5675,263,757,1424,3721,1687,4478
522045,201911,16912,47330,12189,38659,2946,10043,3285,10064,6231,20107
522050,201911,946,2488,638,1987,170,589,226,651,396,1240
522060,201911,2747,7301,1922,5912,174,546,1109,3529,1283,4075
522068,201911,1791,4658,1395,4175,145,389,1036,3177,1181,3566
522070,201911,606,1501,487,1318,19,59,405,1073,424,1132
522100,201911,684,1783,459,1412,58,198,244,730,302,928
522108,201911,919,2467,717,2164,54,240,566,1620,620,1860
522119,201911,1487,3767,1108,3259,182,561,594,1806,776,2367
522130,201911,384,950,264,783,43,125,149,475,192,600
522140,201911,16781,44835,11611,35578,3082,10133,3029,8835,6111,18968
522145,201911,792,1951,534,1562,131,365,228,685,359,1050
522150,201911,1037,2549,713,2015,200,556,206,615,406,1171
522155,201911,903,2281,694,1959,127,350,417,1196,544,1546
522157,201911,529,1325,442,1204,25,86,342,931,367,1017
522160,201911,5902,15318,3745,11335,1030,3378,291,953,1321,4331
522170,201911,2601,6663,1894,5606,316,961,1037,3086,1353,4047
522180,201911,442,1062,281,790,62,181,36,119,98,300
522185,201911,17309,43331,12162,36200,5010,16038,2712,8725,7722,24763
522190,201911,756,1829,505,1384,99,270,185,497,284,767
522200,201911,1649,4689,1044,3472,216,781,159,474,375,1255
522205,201911,1594,3740,1204,3209,116,343,845,2227,961,2570
522220,201911,1278,3217,926,2662,155,452,487,1439,642,1891
522230,201911,1112,2886,895,2573,205,713,448,1196,653,1909
530010,201911,167453,454848,134722,404437,21836,71523,76699,226143,98535,297666
110001,201912,3906,11017,2557,8432,607,2138,993,3295,1600,5433
110002,201912,11847,31334,8083,24691,2301,7429,2250,6910,4551,14339
110003,201912,613,1817,425,1417,104,377,106,335,210,712
110004,201912,10735,28525,6920,21440,1567,5221,1915,6062,3482,11283
110005,201912,2538,6604,1599,4952,362,1207,431,1443,793,2650
110006,201912,1750,4901,1048,3420,214,793,186,555,400,1348
110007,201912,1327,3387,812,2538,268,893,205,756,473,1649
110008,201912,3246,9158,2348,7760,270,871,1558,5447,1828,6318
110009,201912,4252,12075,2683,9123,637,2264,1019,3515,1656,5779
110010,201912,7237,23740,5272,19790,1159,4349,2521,10305,3680,14654
110011,201912,6591,17797,4449,13843,1635,5301,631,2057,2266,7358
110012,201912,14545,36842,8300,25512,2092,6785,789,2643,2881,9428
110013,201912,5255,15356,3760,12278,1570,5360,479,1714,2049,7074
110014,201912,3696,9955,2423,7503,630,2037,896,2737,1526,4774
110015,201912,5209,13658,2886,8981,713,2394,546,1559,1259,3953
110018,201912,3652,9278,2051,6415,419,1493,583,1775,1002,3268
110020,201912,74254,180169,51352,148039,11460,33844,21332,66659,32792,100503
110025,201912,4910,12029,3129,8918,669,2059,1354,3843,2023,5902
110026,201912,505,1320,347,1087,91,301,144,468,235,769
110028,201912,6574,16971,3900,12023,1048,3489,584,1775,1632,5264
110029,201912,1428,3492,796,2390,182,559,303,951,485,1510
110030,201912,12826,29767,7718,22164,1696,5642,1668,5046,3364,10688
110032,201912,2972,8574,1855,6146,578,1913,411,1437,989,3350
110033,201912,3639,11542,2791,9913,1017,3689,682,2698,1699,6387
110034,201912,3421,8137,2168,6395,678,2182,777,2407,1455,4589
110037,201912,1621,4845,1208,4097,281,951,564,1959,845,2910
110040,201912,2984,8423,2084,6727,609,2103,613,1904,1222,4007
110045,201912,5092,14773,3773,12348,1018,3576,1346,4431,2364,8007
110050,201912,1780,4892,1224,3896,488,1672,237,777,725,2449
110060,201912,765,2287,522,1741,201,714,81,271,282,985
110070,201912,1666,5259,1227,4264,406,1513,241,748,647,2261
110080,201912,6182,14481,4459,12435,535,1393,3081,9065,3616,10458
110090,201912,556,1483,386,1184,88,300,170,498,258,798
110092,201912,1158,3419,827,2783,140,483,424,1518,564,2001
110094,201912,2783,8353,2054,6958,875,3173,316,1072,1191,4245
110100,201912,1695,5065,1355,4391,388,1309,567,1853,955,3162
110110,201912,1711,4792,1150,3779,381,1287,267,928,648,2215
110120,201912,1263,3754,920,3077,237,839,296,969,533,1808
110130,201912,2660,6799,1638,4952,343,1158,591,1767,934,2925
110140,201912,2047,6140,1372,4716,348,1236,351,1246,699,2482
110143,201912,1318,3630,875,2722,290,889,153,485,443,1374
110145,201912,826,2222,522,1672,124,411,179,594,303,1005
110146,201912,443,1177,305,970,58,182,144,489,202,671
110147,201912,769,2000,455,1361,72,237,174,447,246,684
110148,201912,816,2281,445,1517,112,419,48,162,160,581
110149,201912,3035,8372,2064,6808,742,2538,445,1576,1187,4114
110150,201912,2647,6502,1711,5181,535,1752,461,1636,996,3388
110155,201912,688,2060,490,1589,116,394,170,521,286,915
110160,201912,1453,4584,1041,3641,316,1115,244,897,560,2012
110170,201912,2202,5721,1320,3978,258,813,673,1960,931,2773
110175,201912,1677,4772,1153,3844,192,690,504,1768,696,2458
110180,201912,1344,3763,892,2842,154,499,446,1415,600,1914
120001,201912,3178,9456,2593,8578,423,1440,1650,5604,2073,7044
120005,201912,1965,7547,1771,7260,164,737,1381,5758,1545,6495
120010,201912,5314,16110,4449,14749,449,1451,3179,10871,3628,12322
120013,201912,2210,7890,1967,7585,453,1678,1187,4902,1640,6580
120017,201912,2493,8858,2205,8398,351,1354,1444,5816,1795,7170
120020,201912,15076,59436,13812,56931,1153,5404,10735,44546,11888,49950
120025,201912,3102,8931,2479,8150,397,1285,1694,5745,2091,7030
120030,201912,6585,25953,6108,25066,428,2333,4747,19533,5175,21866
120032,201912,1666,7551,1576,7373,108,708,1289,5920,1397,6628
120033,201912,4092,15168,3829,14695,134,758,3321,12629,3455,13387
120034,201912,2642,9653,2238,8917,117,722,1845,7187,1962,7909
120035,201912,3640,14708,3435,14327,301,1479,2747,11486,3048,12965
120038,201912,2740,8835,2344,8182,554,2013,1241,4406,1795,6419
120039,201912,2005,8745,1863,8430,145,876,1473,6617,1618,7493
120040,201912,44149,140396,37699,129554,5565,20197,23360,81255,28925,101452
120042,201912,3364,12677,3057,12063,149,817,2522,9867,2671,10684
120043,201912,1387,5623,1262,5421,41,244,1141,4918,1182,5162
120045,201912,6147,16002,5331,15084,124,505,4863,13606,4987,14111
120050,201912,9381,33852,8527,32514,416,2173,7054,26937,7470,29110
120060,201912,9679,37266,8854,36003,411,2433,7653,30902,8064,33335
120070,201912,3153,10215,2721,9610,259,930,1937,7120,2196,8050
120080,201912,4273,14021,3800,13273,490,1831,2714,9648,3204,11479
130002,201912,3087,12260,2753,11761,194,885,2325,10071,2519,10956
130006,201912,2399,9033,1963,8228,192,875,1454,6113,1646,6988
130008,201912,2639,9250,2331,8785,72,386,1999,7510,2071,7896
130010,201912,3989,11587,3322,10814,81,259,3050,10045,3131,10304
130014,201912,3125,9406,2387,8163,426,1484,1446,5074,1872,6558
130020,201912,2725,10791,2467,10384,151,887,1975,8262,2126,9149
130030,201912,9990,32617,9060,31504,307,1055,8040,28418,8347,29473
130040,201912,3817,11497,3165,10600,180,637,2606,8803,2786,9440
130050,201912,7692,27986,6419,26333,180,916,5814,24064,5994,24980
130060,201912,7603,30227,6513,28779,463,2609,5331,23458,5794,26067
130063,201912,6338,20723,5649,19952,217,973,5106,18102,5323,19075
130068,201912,3757,13480,3170,12547,241,1336,2356,9166,2597,10502
130070,201912,7587,21517,6203,19980,308,986,5158,17062,5466,18048
130080,201912,6877,25521,6015,24491,270,1536,5023,20794,5293,22330
130083,201912,2760,9090,2452,8702,177,748,2085,7378,2262,8126
130090,201912,3469,10809,3073,10298,62,276,2675,9146,2737,9422
130100,201912,8019,24120,6830,22874,62,147,6412,22045,6474,22192
130110,201912,8633,24666,7058,22689,1039,2694,5133,17764,6172,20458
130115,201912,5379,16785,4616,15908,108,379,4056,14226,4164,14605
130120,201912,14416,50898,12689,48615,1133,4811,10286,39742,11419,44553
130130,201912,5295,17026,4072,15398,394,1656,2988,11285,3382,12941
130140,201912,7204,25371,6394,24435,207,1168,5591,21445,5798,22613
130150,201912,3692,13789,3461,13522,84,531,3157,12364,3241,12895
130160,201912,5077,18204,4356,17283,283,1281,3685,14796,3968,16077
130165,201912,3262,12387,3062,12129,130,581,2740,10946,2870,11527
130170,201912,11904,35083,9436,32168,740,2922,7526,25849,8266,28771
130180,201912,4512,14466,4269,14189,42,239,4115,13631,4157,13870
130185,201912,18579,45843,15120,42129,988,1782,12789,37616,13777,39398
130190,201912,19159,63458,15376,57730,1825,7125,10757,41655,12582,48780
130195,201912,2470,9010,2021,8438,73,400,1785,7474,1858,7874
130200,201912,2604,7368,2151,6763,107,423,1777,5549,1884,5972
130210,201912,1285,4884,1150,4725,104,614,913,3644,1017,4258
130220,201912,2312,8109,1997,7686,62,331,1748,6745,1810,7076
130230,201912,4567,19004,3969,18141,257,1575,3374,15399,3631,16974
130240,201912,12112,36409,9787,33286,202,1176,8732,29626,8934,30802
130250,201912,26420,79334,22600,74986,1708,5265,18130,62467,19838,67732
130255,201912,4363,14707,3794,13702,168,768,3066,11069,3234,11837
130260,201912,266175,747728,215561,672635,58885,194975,99023,316415,157908,511390
130270,201912,9230,33232,7647,30749,1189,4796,5062,21224,6251,26020
130280,201912,3538,14286,3237,13950,101,515,2990,13051,3091,13566
130290,201912,13335,45059,11479,42625,698,2807,9667,36571,10365,39378
130300,201912,4766,16674,4313,16043,155,862,3730,13815,3885,14677
130310,201912,6147,20989,5361,19923,324,1469,4474,16623,4798,18092
130320,201912,3499,11311,2925,10578,360,1281,2162,8067,2522,9348
130330,201912,4656,14928,3747,13789,221,982,3181,11703,3402,12685
130340,201912,23627,74576,20288,70719,1531,4752,16855,60805,18386,65557
130350,201912,3950,14472,3557,13965,147,826,3122,12163,3269,12989
130353,201912,7400,20255,5926,18361,852,2557,4144,13312,4996,15869
130356,201912,5235,16847,4343,15426,752,2628,2672,10002,3424,12630
130360,201912,3047,9742,2616,9195,95,393,2360,8268,2455,8661
130370,201912,5774,22634,5006,21539,296,1633,4088,17492,4384,19125
130380,201912,7093,29629,6575,28875,391,2262,5548,24109,5939,26371
130390,201912,5978,25188,5260,23953,581,3083,3783,17243,4364,20326
130395,201912,2337,7457,1989,6878,201,731,1500,5170,1701,5901
130400,201912,2740,8660,2345,8140,95,326,2089,7362,2184,7688
130406,201912,11124,39261,9381,37056,1684,6682,6380,26111,8064,32793
130410,201912,4181,14961,3544,13860,1077,4407,1591,6429,2668,10836
130420,201912,13662,48195,11415,45393,954,4853,8907,35557,9861,40410
130423,201912,4281,13653,3751,13045,183,874,3281,11250,3464,12124
130426,201912,2836,11169,2644,10926,74,422,2428,10077,2502,10499
130430,201912,4212,12012,3650,11259,267,984,2998,9101,3265,10085
130440,201912,4847,15224,4152,14393,111,467,3813,13312,3924,13779
140002,201912,2221,6574,1909,6180,95,370,1594,5175,1689,5545
140005,201912,3310,9155,2919,8703,140,363,2510,7670,2650,8033
140010,201912,55191,145896,43102,127740,11087,34417,17746,53975,28833,88392
140015,201912,3772,11388,3207,10693,218,724,2796,9452,3014,10176
140017,201912,4442,12497,3875,11781,277,813,3153,9829,3430,10642
140020,201912,5344,15745,4562,14684,252,1071,3698,11806,3950,12877
140023,201912,2463,7357,2006,6709,207,696,1502,5122,1709,5818
140028,201912,2092,5374,1761,4946,103,324,1412,3951,1515,4275
140030,201912,5287,13598,4660,12875,356,723,4002,11458,4358,12181
140040,201912,2530,10026,2308,9706,99,609,2058,8536,2157,9145
140045,201912,2600,9450,2183,8871,352,1227,1491,6524,1843,7751
140047,201912,6332,18136,5302,16623,637,2017,3752,11942,4389,13959
140050,201912,1441,4202,1199,3855,122,402,890,2918,1012,3320
140060,201912,1680,4462,1413,4068,122,331,1115,3279,1237,3610
140070,201912,1931,10083,1860,9923,126,861,1540,8137,1666,8998
150010,201912,45916,114486,41439,108685,967,2385,37020,96838,37987,99223
150013,201912,1997,5068,1623,4661,152,319,1255,3824,1407,4143
150020,201912,14431,43518,13350,42081,1346,3528,11020,35779,12366,39307
150030,201912,8885,33414,8076,32409,455,2049,6987,28228,7442,30277
150034,201912,4256,10547,3486,9562,245,620,2879,8055,3124,8675
150040,201912,16643,42900,14535,40564,1290,2061,11996,36473,13286,38534
150050,201912,7019,24643,6406,23805,140,635,5841,21943,5981,22578
150060,201912,22054,60230,17703,53652,2879,8945,11112,34398,13991,43343
150070,201912,6727,25296,5877,24265,227,1159,5227,21793,5454,22952
150080,201912,95544,213957,79380,191801,19216,50628,23747,69901,42963,120529
150085,201912,7602,22188,6883,21326,138,478,6437,20043,6575,20521
150090,201912,9886,36919,9286,35723,671,2720,7469,28897,8140,31617
150095,201912,5648,16705,4924,15781,271,634,4124,13779,4395,14413
150100,201912,2900,10224,2557,9630,201,691,1993,7645,2194,8336
150110,201912,4435,18365,4144,18023,207,982,3769,16481,3976,17463
150120,201912,8014,25256,7614,24769,280,762,6772,22711,7052,23473
150125,201912,753,2037,547,1750,103,395,320,995,423,1390
150130,201912,22704,66018,19573,61268,3280,9266,12960,42628,16240,51894
150140,201912,248595,579620,209052,524134,31959,77949,121923,318250,153882,396199
150145,201912,4379,13378,3679,12314,922,2801,2043,7528,2965,10329
150150,201912,16073,41562,14020,38902,612,1818,11666,32371,12278,34189
150157,201912,3508,9640,2817,8734,296,946,1989,6424,2285,7370
150160,201912,3036,9029,2813,8690,558,1633,1725,5560,2283,7193
150170,201912,24759,81238,21456,75591,4026,13328,13068,48954,17094,62282
150172,201912,4805,13248,3836,11887,265,765,2909,9307,3174,10072
150175,201912,1610,5115,1347,4599,239,859,780,2684,1019,3543
150178,201912,10551,28646,8706,26473,231,619,7708,23795,7939,24414
150180,201912,22280,79443,20230,77039,1073,3742,17708,68916,18781,72658
150190,201912,6764,22870,6274,22231,291,1291,5469,19263,5760,20554
150195,201912,5236,16870,4964,16453,79,424,4608,15118,4687,15542
150200,201912,5865,17193,5361,16633,64,178,5064,15835,5128,16013
150210,201912,26061,91495,24259,89017,1744,6490,20052,75337,21796,81827
150215,201912,7662,21774,6513,20071,1214,3651,3794,12224,5008,15875
150220,201912,12307,35060,10743,32813,1118,3323,7374,22968,8492,26291
150230,201912,12507,35576,10850,33377,1183,3286,7472,23986,8655,27272
150240,201912,32447,90483,26599,80217,7531,23090,8994,27645,16525,50735
150250,201912,4199,16284,3938,15961,621,2449,2978,12413,3599,14862
150260,201912,2772,9116,2499,8686,175,593,1953,6879,2128,7472
150270,201912,8833,25408,6158,20712,2023,7113,1722,6120,3745,13233
150275,201912,6854,22012,6266,21177,233,922,5436,18276,5669,19198
150276,201912,2318,6223,1967,5798,258,693,1350,4373,1608,5066
150277,201912,5287,13868,4236,12635,333,892,3258,10341,3591,11233
150280,201912,6803,27531,6563,27117,504,2057,5491,22979,5995,25036
150285,201912,3318,11637,2909,10984,246,976,2100,8052,2346,9028
150290,201912,10636,28978,9604,27857,305,680,8671,25745,8976,26425
150293,201912,9575,23713,7114,20431,1039,2971,4263,12860,5302,15831
150295,201912,8018,21471,5699,18324,1901,6520,1945,7066,3846,13586
150300,201912,2391,7153,2135,6818,44,163,1933,6193,1977,6356
150304,201912,4157,12393,3378,11154,627,1960,2032,7017,2659,8977
150307,201912,6205,19969,5706,19140,356,1171,4641,15755,4997,16926
150309,201912,6270,19059,5004,16825,922,3035,2786,9769,3708,12804
150310,201912,7339,29003,6975,28553,217,1226,6187,25548,6404,26774
150320,201912,9533,26024,8676,24793,419,1289,6701,19065,7120,20354
150330,201912,14160,45612,13002,43735,1310,4119,9814,33991,11124,38110
150340,201912,2578,7513,2273,7055,343,996,1566,4989,1909,5985
150345,201912,8126,23883,7307,22791,435,1422,6213,19473,6648,20895
150350,201912,9130,23081,8355,22068,744,1447,6843,18635,7587,20082
150360,201912,24368,67743,19403,61317,2027,5474,13546,45400,15573,50874
150370,201912,10789,33008,8831,30356,1002,2962,6423,23636,7425,26598
150375,201912,3498,14253,3152,13725,253,1220,2626,11532,2879,12752
150380,201912,11214,28695,9183,26008,141,510,8068,22898,8209,23408
150390,201912,8121,32388,7253,30995,1115,4174,5087,23040,6202,27214
150400,201912,6446,23396,6171,22868,283,1121,5349,19893,5632,21014
150405,201912,9320,24576,8139,23141,495,1150,6537,19215,7032,20365
150410,201912,1936,6183,1629,5649,205,642,1062,3771,1267,4413
150420,201912,41518,115850,31534,100694,8949,29843,10632,39202,19581,69045
150430,201912,8498,24888,7741,23891,865,2040,6037,19480,6902,21520
150440,201912,5645,18277,5144,17536,752,2295,3627,12899,4379,15194
150442,201912,26135,62882,21383,56767,2336,6145,14675,39734,17011,45879
150445,201912,6380,19689,5593,18464,214,752,4775,15793,4989,16545
150450,201912,5078,21901,4711,21389,366,1851,4021,18233,4387,20084
150460,201912,8478,27824,7741,26875,253,1045,6601,23716,6854,24761
150470,201912,21796,56384,19381,53618,396,1052,18180,50372,18576,51424
150475,201912,4891,15519,4234,14513,175,662,3506,12146,3681,12808
150480,201912,13787,44748,12318,42535,2243,7060,8120,29934,10363,36994
150490,201912,8390,29090,7708,28236,270,1172,6838,25179,7108,26351
150495,201912,5271,18155,5040,17813,117,603,4584,16084,4701,16687
150497,201912,2959,9360,2358,8294,546,1957,1198,4529,1744,6486
150500,201912,3307,8535,2922,7974,252,610,2276,6231,2528,6841
150503,201912,4871,12683,3327,10609,1005,3410,1052,3847,2057,7257
150506,201912,10397,31173,8701,28854,1866,5443,5388,19770,7254,25213
150510,201912,9921,36213,8577,33655,1178,4393,5725,23540,6903,27933
150520,201912,7125,27597,6794,27178,236,1386,6092,24287,6328,25673
150530,201912,12566,42769,10863,40280,1594,4767,7727,30630,9321,35397
150540,201912,5032,13795,4261,12630,226,622,3549,10567,3775,11189
150543,201912,7384,19816,5990,18049,507,1560,4562,14325,5069,15885
150548,201912,10313,32094,9269,30675,309,1158,8139,27006,8448,28164
150549,201912,2010,6024,1720,5627,40,173,1482,4849,1522,5022
150550,201912,20012,59009,16635,53423,3969,12939,7375,25314,11344,38253
150553,201912,26773,78803,21048,68599,6465,21494,7331,25675,13796,47169
150555,201912,1914,5097,1468,4391,138,338,1015,3166,1153,3504
150560,201912,1847,5663,1626,5220,265,820,966,3224,1231,4044
150563,201912,2455,7550,2054,6834,452,1573,1120,3730,1572,5303
150565,201912,4372,14034,3853,13200,115,513,3152,10891,3267,11404
150570,201912,6274,20139,5864,19556,258,1007,5088,16909,5346,17916
150580,201912,10556,41641,9176,40088,644,3240,7435,33567,8079,36807
150590,201912,8077,27893,6944,26514,191,1114,6260,23797,6451,24911
150600,201912,9731,32244,9028,31365,229,892,8312,29073,8541,29965
150610,201912,2886,8580,2575,8065,101,397,2146,6658,2247,7055
150611,201912,3226,9102,2843,8551,92,354,2502,7447,2594,7801
150613,201912,13773,38007,10284,31940,1913,6317,5032,15587,6945,21904
150616,201912,3420,9402,2451,7773,608,1999,1018,3198,1626,5197
150618,201912,6949,20201,5575,18040,528,1641,3571,12179,4099,13820
150619,201912,6364,18013,5258,16422,174,646,4405,13802,4579,14448
150620,201912,6716,22192,5762,20571,675,2311,3984,14651,4659,16962
150630,201912,6231,16912,5669,16201,444,1189,4671,13521,5115,14710
150635,201912,4737,13104,3942,11798,554,1590,2542,7838,3096,9428
150640,201912,2242,6574,2038,6328,32,93,1899,5988,1931,6081
150650,201912,11729,32722,10210,30213,3087,8608,4458,14408,7545,23016
150655,201912,5904,16795,5305,15910,212,651,4571,13691,4783,14342
150658,201912,4475,12680,3483,11163,550,1856,2105,7086,2655,8942
150660,201912,5791,16591,5134,15639,458,1313,3605,11254,4063,12567
150670,201912,8451,19661,6572,17524,665,1475,5141,14398,5806,15873
150680,201912,68572,201445,51877,174840,12588,41591,23510,88650,36098,130241
150690,201912,3074,8229,2647,7724,109,244,2349,7032,2458,7276
150700,201912,6219,18427,5555,17561,356,963,4396,14290,4752,15253
150710,201912,3811,12714,3452,12122,263,934,2635,9429,2898,10363
150715,201912,5056,14590,4138,13164,320,997,3234,10427,3554,11424
150720,201912,6920,24716,6408,23890,448,1826,5296,19903,5744,21729
150730,201912,12092,36869,10452,34496,1236,4229,7761,26240,8997,30469
150740,201912,3988,11201,3506,10435,309,786,2642,8016,2951,8802
150745,201912,5175,14676,4113,13080,820,2759,2639,8445,3459,11204
150746,201912,1639,5034,1487,4800,83,271,1216,3933,1299,4204
150747,201912,4860,15575,4251,14540,726,2228,2829,10133,3555,12361
150750,201912,3704,11588,3080,10612,225,828,2345,8287,2570,9115
150760,201912,12123,35583,10968,34025,1556,4425,7704,24626,9260,29051
150770,201912,6356,22903,6002,22488,200,637,5461,21074,5661,21711
150775,201912,922,2620,714,2324,130,464,378,1240,508,1704
150780,201912,4602,13743,4067,13106,147,432,3661,12058,3808,12490
150790,201912,5667,16204,4864,15335,224,547,3961,13692,4185,14239
150795,201912,13847,43291,12136,40569,3076,9729,6859,24419,9935,34148
150796,201912,3816,9399,3302,8783,186,468,2804,7545,2990,8013
150797,201912,4039,12570,3453,11689,141,388,2932,10074,3073,10462
150800,201912,13523,42333,12206,40604,1484,4645,9243,31707,10727,36352
150803,201912,7109,22923,6654,22211,359,1195,5656,19019,6015,20214
150805,201912,3522,10827,2952,9975,232,793,2274,7803,2506,8596
150808,201912,6136,17452,4414,14567,1730,6245,605,2242,2335,8487
150810,201912,21081,55498,15766,49014,3382,10796,7951,27020,11333,37816
150812,201912,5474,15458,4767,14260,434,1352,3480,10224,3914,11576
150815,201912,9533,28247,7961,26314,630,2095,6514,21847,7144,23942
150820,201912,12132,33248,10181,30795,1108,2881,7761,24506,8869,27387
150830,201912,11624,43014,10878,42087,431,1971,9424,37235,9855,39206
150835,201912,2385,7948,2028,7297,370,1306,1138,4161,1508,5467
150840,201912,7599,21633,5951,18878,998,3381,3247,10205,4245,13586
160005,201912,1171,3257,1038,3071,59,213,880,2600,939,2813
160010,201912,2450,6459,2297,6289,20,106,2229,6030,2249,6136
160015,201912,2695,8015,2421,7660,73,252,2216,7025,2289,7277
160020,201912,2058,6714,1809,6397,174,595,1421,5152,1595,5747
160021,201912,1087,4242,993,4122,65,376,805,3280,870,3656
160023,201912,1252,4458,1095,4190,111,384,775,3124,886,3508
160025,201912,1877,5633,1788,5528,12,41,1747,5417,1759,5458
160027,201912,9051,25102,8063,23854,620,1735,6523,19665,7143,21400
160030,201912,70062,200410,56108,181452,12139,36915,30572,108527,42711,145442
160040,201912,5688,19519,5129,18792,82,394,4774,17596,4856,17990
160050,201912,4877,15003,3797,13485,1453,4911,1329,5818,2782,10729
160053,201912,3715,11655,3391,11258,238,696,2819,9634,3057,10330
160055,201912,901,2652,869,2615,29,91,809,2432,838,2523
160060,201912,24442,65851,19795,60500,957,3110,15843,50379,16800,53489
160070,201912,2781,10512,2486,10041,209,825,1941,8108,2150,8933
160080,201912,3341,10729,3003,10340,36,190,2792,9684,2828,9874
170025,201912,623,1651,443,1381,80,253,227,719,307,972
170030,201912,1208,3679,913,3130,147,493,449,1577,596,2070
170035,201912,1471,3826,1050,3139,100,336,623,1873,723,2209
170040,201912,1874,5371,1461,4782,95,386,893,3028,988,3414
170070,201912,1823,4287,1275,3588,73,249,754,2178,827,2427
170100,201912,2464,7061,2009,6301,195,572,1280,4108,1475,4680
170105,201912,718,2105,476,1567,118,347,170,574,288,921
170110,201912,907,2804,679,2360,124,461,286,988,410,1449
170130,201912,1327,3974,923,3188,176,659,443,1554,619,2213
170190,201912,1350,3864,908,3121,315,1120,164,735,479,1855
170200,201912,1890,4625,1154,3379,214,654,394,1162,608,1816
170210,201912,24969,68012,18616,57264,6590,22015,2099,7507,8689,29522
170215,201912,1327,3547,1069,3198,44,179,841,2509,885,2688
170220,201912,5909,18446,4904,16577,1319,4256,2033,7495,3352,11751
170230,201912,1240,3723,903,3042,267,913,174,639,441,1552
170240,201912,2656,7458,2004,6392,147,568,1389,4298,1536,4866
170255,201912,4019,11698,2795,9391,508,1735,1242,4288,1750,6023
170270,201912,980,2359,631,1863,31,88,384,1126,415,1214
170290,201912,2909,8610,2458,8029,112,367,1936,6524,2048,6891
170300,201912,1980,5396,1582,4799,185,566,1047,3228,1232,3794
170305,201912,656,1805,521,1572,62,218,264,781,326,999
170307,201912,936,3228,737,2819,102,426,408,1569,510,1995
170310,201912,1590,3996,1074,3134,169,534,500,1456,669,1990
170320,201912,1040,2694,770,2256,70,220,485,1438,555,1658
170330,201912,920,2827,827,2677,43,192,681,2165,724,2357
170360,201912,486,1331,333,1063,26,86,211,635,237,721
170370,201912,1284,3462,909,2820,290,871,223,814,513,1685
170380,201912,1768,5134,1291,4372,110,432,729,2554,839,2986
170382,201912,544,1629,436,1434,36,161,313,980,349,1141
170384,201912,1593,5708,1284,5085,256,1067,645,2587,901,3654
170386,201912,884,2444,534,1750,75,292,184,569,259,861
170388,201912,607,1733,418,1392,62,239,184,611,246,850
170389,201912,1019,3198,844,2900,43,163,632,2221,675,2384
170390,201912,1708,3959,1248,3390,58,137,1011,2836,1069,2973
170410,201912,558,1657,393,1336,28,127,244,811,272,938
170460,201912,375,979,288,833,44,123,175,524,219,647
170510,201912,895,2641,638,2161,42,179,407,1333,449,1512
170550,201912,6656,17868,4739,14671,1223,4066,1100,3675,2323,7741
170555,201912,1353,3730,1037,3227,72,233,533,1712,605,1945
170560,201912,1040,2926,758,2521,68,263,471,1665,539,1928
170600,201912,1324,3563,1063,3172,221,525,602,1949,823,2474
170610,201912,1683,4507,1199,3762,76,261,748,2342,824,2603
170625,201912,419,1155,252,794,40,124,81,250,121,374
170650,201912,1264,3782,969,3270,148,508,527,1855,675,2363
170700,201912,3399,10009,2489,8259,511,1747,1094,3711,1605,5458
170710,201912,1553,4108,1152,3432,159,516,701,2089,860,2605
170720,201912,1772,4470,1372,3870,74,158,986,2907,1060,3065
170730,201912,1025,2831,751,2376,142,415,359,1212,501,1627
170740,201912,2090,6951,1765,6320,180,705,1251,4449,1431,5154
170755,201912,898,2510,604,1971,52,200,296,929,348,1129
170765,201912,1196,3076,807,2453,156,473,357,1139,513,1612
170770,201912,1814,5313,1472,4765,171,535,970,3233,1141,3768
170820,201912,3379,10218,2689,8909,503,1755,1307,4422,1810,6177
170825,201912,946,2290,752,2013,80,219,534,1426,614,1645
170830,201912,1398,3781,1142,3371,88,274,834,2465,922,2739
170900,201912,2679,8579,2233,7918,184,680,1746,6281,1930,6961
170930,201912,3690,10274,2773,8517,648,2092,941,2882,1589,4974
170950,201912,11227,31192,7510,24295,2153,7859,909,3165,3062,11024
170980,201912,441,1194,349,1046,15,68,250,706,265,774
171050,201912,1602,5106,1379,4706,53,270,1140,3845,1193,4115
171070,201912,1367,3939,1148,3609,297,950,495,1804,792,2754
171090,201912,1041,2601,828,2287,78,217,557,1526,635,1743
171110,201912,566,1530,392,1207,58,193,187,516,245,709
171150,201912,1100,2746,634,1928,71,246,378,1127,449,1373
171180,201912,770,2133,495,1589,79,234,208,677,287,911
171190,201912,1758,5955,1495,5483,253,1005,870,3292,1123,4297
171195,201912,813,2624,649,2316,93,389,390,1364,483,1753
171200,201912,533,1518,398,1273,75,255,180,570,255,825
171215,201912,362,1020,285,884,43,146,187,564,230,710
171240,201912,753,2519,611,2230,35,176,409,1466,444,1642
171245,201912,656,1989,497,1642,51,197,299,941,350,1138
171250,201912,1040,2721,732,2255,142,467,348,1079,490,1546
171270,201912,448,1626,341,1391,72,313,136,592,208,905
171280,201912,855,2616,655,2246,67,226,373,1333,440,1559
171320,201912,4032,11402,3087,9725,643,2034,1175,3874,1818,5908
171330,201912,2715,7437,2055,6287,397,1170,976,3097,1373,4267
171360,201912,1429,4143,1116,3678,83,308,803,2692,886,3000
171370,201912,669,1712,510,1482,53,149,338,993,391,1142
171380,201912,1466,4150,1205,3764,105,315,852,2740,957,3055
171395,201912,953,2668,648,2075,62,233,383,1194,445,1427
171420,201912,1896,5666,1353,4558,231,862,611,2058,842,2920
171430,201912,1044,3107,850,2731,60,215,574,1781,634,1996
171488,201912,2323,6931,1791,6014,286,978,921,3192,1207,4170
171500,201912,997,2486,747,2098,37,107,563,1582,600,1689
171510,201912,788,2623,677,2401,42,191,472,1658,514,1849
171515,201912,466,1220,321,974,30,110,191,548,221,658
171525,201912,678,1984,523,1724,29,126,308,962,337,1088
171550,201912,334,975,237,806,29,117,140,455,169,572
171570,201912,1119,3423,919,3059,130,443,533,1816,663,2259
171575,201912,1816,4844,1136,3596,131,442,499,1566,630,2008
171610,201912,5830,16358,4269,13621,918,3279,1190,4031,2108,7310
171620,201912,2663,7531,2214,6880,119,468,1761,5460,1880,5928
171630,201912,974,2610,766,2316,111,340,506,1568,617,1908
171650,201912,2090,6036,1564,5089,393,1382,472,1654,865,3036
171660,201912,2352,5996,1569,4666,238,668,813,2456,1051,3124
171665,201912,1310,3653,986,3119,164,596,465,1485,629,2081
171670,201912,1899,5095,1426,4311,207,687,788,2368,995,3055
171700,201912,1217,3501,877,2875,106,333,482,1611,588,1944
171720,201912,804,2068,615,1769,52,179,438,1231,490,1410
171750,201912,1281,3638,861,2864,224,768,105,445,329,1213
171780,201912,1239,3148,872,2613,91,297,582,1704,673,2001
171790,201912,1407,4681,1126,4081,224,829,507,1900,731,2729
171800,201912,737,2039,537,1731,70,278,301,955,371,1233
171820,201912,11150,31465,8082,26039,2017,6712,2536,8762,4553,15474
171830,201912,1498,4906,1243,4430,107,494,796,2800,903,3294
171840,201912,752,2006,581,1723,26,79,389,1152,415,1231
171845,201912,597,1524,425,1269,54,194,248,727,302,921
171850,201912,857,2924,723,2612,69,337,508,1766,577,2103
171855,201912,1029,3145,854,2819,74,253,525,1698,599,1951
171865,201912,385,1212,302,1062,53,207,145,480,198,687
171870,201912,806,2275,559,1807,66,231,287,933,353,1164
171875,201912,1284,3797,1012,3348,45,200,758,2488,803,2688
171880,201912,1166,3606,1013,3396,39,140,805,2744,844,2884
171884,201912,826,2344,597,1958,114,428,219,758,333,1186
171886,201912,1420,3954,988,3203,288,1045,194,634,482,1679
171888,201912,723,2044,490,1596,31,120,315,997,346,1117
171889,201912,398,1223,317,1067,76,277,123,414,199,691
171890,201912,1171,3259,851,2744,183,557,456,1507,639,2064
171900,201912,532,1852,369,1430,78,294,150,602,228,896
172000,201912,564,1711,464,1516,44,157,266,846,310,1003
172010,201912,1048,3656,879,3291,77,328,523,1905,600,2233
172015,201912,372,1312,271,1096,68,280,109,458,177,738
172020,201912,2586,7507,2274,7089,167,590,1696,5415,1863,6005
172025,201912,726,2011,520,1664,38,143,359,1144,397,1287
172030,201912,1235,3652,1039,3342,49,191,805,2580,854,2771
172049,201912,1301,3165,855,2528,170,477,464,1470,634,1947
172065,201912,1475,3639,1120,3204,104,220,893,2728,997,2948
172080,201912,2329,6896,1864,6070,106,404,1223,3955,1329,4359
172085,201912,461,1262,298,909,54,158,107,309,161,467
172090,201912,4013,10176,3037,8884,125,411,2294,6744,2419,7155
172093,201912,476,1409,336,1163,25,113,188,620,213,733
172097,201912,638,1692,444,1354,55,170,212,657,267,827
172100,201912,49278,122488,33016,95889,6176,19839,11376,33807,17552,53646
172110,201912,1609,5849,1373,5464,139,568,992,4162,1131,4730
172120,201912,4991,14766,3865,12925,523,1833,2161,7454,2684,9287
172125,201912,310,854,232,726,21,62,122,376,143,438
172130,201912,646,1600,510,1378,25,89,357,893,382,982
172208,201912,2514,6240,2002,5573,189,468,1425,4056,1614,4524
172210,201912,2703,6960,2033,6092,356,1141,1125,3488,1481,4629
210005,201912,19212,55416,14578,47650,4279,14535,5485,18780,9764,33315
210010,201912,1948,6007,1751,5747,74,326,1508,4959,1582,5285
210015,201912,3348,10000,2966,9499,106,305,2591,8397,2697,8702
210020,201912,7455,17417,6374,16159,81,237,5911,15031,5992,15268
210030,201912,4843,15969,4476,15419,210,937,3840,13190,4050,14127
210040,201912,1828,4380,1646,4156,26,44,1541,3930,1567,3974
210043,201912,6340,17994,5268,16547,485,1464,3930,12668,4415,14132
210047,201912,6765,20963,5444,19171,143,732,4692,16478,4835,17210
210050,201912,2261,7664,1748,6700,172,753,1213,4627,1385,5380
210055,201912,1882,6058,1693,5763,68,279,1416,4830,1484,5109
210060,201912,7228,26613,6374,25041,736,3046,4475,18032,5211,21078
210070,201912,7191,20452,6726,19839,39,159,6389,18843,6428,19002
210080,201912,4278,14586,4048,14315,39,233,3806,13541,3845,13774
210083,201912,5693,16189,4638,15066,45,234,4389,14267,4434,14501
210087,201912,3061,8348,2650,7813,111,264,2280,6893,2391,7157
210090,201912,9400,29466,8712,28240,524,1442,7349,24069,7873,25511
210095,201912,6337,20594,5835,19990,211,931,4982,17466,5193,18397
210100,201912,6845,20865,6105,19683,318,1098,4968,16091,5286,17189
210110,201912,3016,10099,2774,9801,59,352,2535,8892,2594,9244
210120,201912,23176,64294,19142,58948,2018,5255,12918,42245,14936,47500
210125,201912,4389,11812,3828,11136,767,1757,2731,8535,3498,10292
210130,201912,4457,11707,3652,10686,168,376,3097,9169,3265,9545
210135,201912,1473,4450,1262,4108,64,198,1014,3351,1078,3549
210140,201912,18428,49153,14010,43383,2659,7978,7873,25670,10532,33648
210150,201912,4426,10671,3887,9928,131,357,3376,8513,3507,8870
210160,201912,16680,49093,14378,46103,1325,4480,10162,33679,11487,38159
210170,201912,15150,47386,14072,45981,754,2298,12333,40542,13087,42840
210173,201912,2285,8694,2092,8335,63,392,1861,7407,1924,7799
210177,201912,3471,9449,3021,8909,111,194,2709,8267,2820,8461
210180,201912,1444,3925,1270,3703,24,77,1157,3362,1181,3439
210190,201912,5275,14605,4493,13481,77,380,3863,11375,3940,11755
210193,201912,1296,3800,1144,3561,35,149,898,2845,933,2994
210197,201912,2066,6542,1894,6298,143,495,1548,5216,1691,5711
210200,201912,7664,24727,6805,23291,433,1641,5454,18640,5887,20281
210203,201912,7038,20882,6014,19512,419,1409,4896,16146,5315,17555
210207,201912,3773,9564,2990,8704,145,338,2483,7424,2628,7762
210210,201912,8185,26498,7503,25560,133,804,6793,23000,6926,23804
210215,201912,2392,7661,2045,7145,49,266,1822,6365,1871,6631
210220,201912,6200,21332,5855,20803,190,1217,5120,17767,5310,18984
210230,201912,5249,15898,4705,15085,387,996,3932,12913,4319,13909
210232,201912,11536,36174,9412,32967,1590,5603,5811,21729,7401,27332
210235,201912,3426,10196,2961,9564,74,322,2623,8483,2697,8805
210237,201912,2729,9065,2357,8622,32,195,2179,7972,2211,8167
210240,201912,2616,8292,2394,7898,87,352,2060,6714,2147,7066
210250,201912,5634,17216,5116,16564,74,429,4592,14841,4666,15270
210255,201912,2510,7751,2101,6986,300,1012,1310,4325,1610,5337
210260,201912,5530,16554,4849,15548,224,835,4173,13342,4397,14177
210270,201912,4806,13395,4283,12731,107,486,3795,11204,3902,11690
210275,201912,3603,9052,3162,8512,57,124,2881,7854,2938,7978
210280,201912,5556,15977,4426,14192,271,1108,3179,10026,3450,11134
210290,201912,7233,19637,6463,18662,130,410,5930,17122,6060,17532
210300,201912,33413,90652,27202,81841,1862,5854,19831,61545,21693,67399
210310,201912,3091,7947,2705,7375,124,283,2353,6456,2477,6739
210312,201912,2720,7002,2377,6615,41,176,2197,6043,2238,6219
210315,201912,2970,8334,2507,7805,61,168,2292,7269,2353,7437
210317,201912,4139,13154,3737,12680,113,608,3346,11262,3459,11870
210320,201912,19116,58179,17363,55863,439,2150,15327,48954,15766,51104
210325,201912,3569,10248,3072,9602,81,250,2743,8726,2824,8976
210330,201912,24787,70352,20135,64167,6219,17952,9328,34522,15547,52474
210340,201912,10147,29990,9000,28397,732,2301,6872,22272,7604,24573
210350,201912,9397,27076,8172,25553,167,586,7226,22735,7393,23321
210355,201912,4299,14511,3765,13671,105,509,3201,11720,3306,12229
210360,201912,13528,42549,12043,40338,607,2784,9270,30549,9877,33333
210370,201912,10873,24456,8399,21831,246,441,7668,20403,7914,20844
210375,201912,3353,8854,2485,7692,661,2066,1130,3866,1791,5932
210380,201912,5579,14334,4784,13384,231,565,4083,11510,4314,12075
210390,201912,2594,9204,2385,8838,129,616,1988,7330,2117,7946
210400,201912,4541,13915,3984,13215,144,465,3545,11918,3689,12383
210405,201912,7085,19121,5660,17051,1091,3045,3140,10110,4231,13155
210407,201912,1971,6561,1630,5924,87,389,1308,4685,1395,5074
210408,201912,2514,9447,2340,9177,147,722,1892,7430,2039,8152
210409,201912,3807,13181,3457,12683,107,617,2863,10527,2970,11144
210410,201912,3433,10520,2888,9619,152,604,2184,7222,2336,7826
210420,201912,3907,12438,3508,11755,206,609,2939,9968,3145,10577
210430,201912,2272,6663,2029,6358,80,227,1790,5662,1870,5889
210440,201912,4388,11896,3848,11198,71,266,3534,10217,3605,10483
210450,201912,2449,7239,2095,6699,89,305,1725,5495,1814,5800
210455,201912,4312,11374,3218,9975,956,2988,1504,4896,2460,7884
210460,201912,3711,10638,3141,9903,80,347,2756,8623,2836,8970
210462,201912,1633,5000,1383,4584,40,166,1121,3727,1161,3893
210465,201912,2642,7757,2296,7271,56,230,1990,6292,2046,6522
210467,201912,5855,18935,5148,18010,309,1251,4266,15073,4575,16324
210470,201912,2101,5467,1433,4512,84,196,1093,3577,1177,3773
210480,201912,16471,48293,13547,44687,1201,3580,9919,35171,11120,38751
210490,201912,3732,9429,2985,8373,64,196,2593,7291,2657,7487
210500,201912,6252,24322,5756,23433,368,1827,4706,19043,5074,20870
210510,201912,6027,19934,5276,19105,125,554,4706,17320,4831,17874
210515,201912,3737,10970,3255,10430,108,390,2836,9191,2944,9581
210520,201912,2599,7412,2303,7035,79,271,2021,6136,2100,6407
210530,201912,53849,130791,41386,112266,6774,22916,11273,38892,18047,61808
210535,201912,3106,10553,2880,10206,118,458,2422,8670,2540,9128
210540,201912,14727,42677,12195,39126,1418,4252,8587,28716,10005,32968
210542,201912,6563,15287,5262,13856,322,539,4362,12253,4684,12792
210545,201912,2221,6945,2086,6722,44,194,1836,5829,1880,6023
210547,201912,3547,12825,3105,11941,318,1197,2240,8871,2558,10068
210550,201912,6289,18898,4944,16797,337,1338,3631,12590,3968,13928
210560,201912,3561,10903,3171,10272,121,395,2646,8528,2767,8923
210565,201912,1472,4880,1220,4498,64,341,958,3553,1022,3894
210570,201912,10693,29136,9439,27611,300,873,8357,24828,8657,25701
210580,201912,3013,8062,2493,7429,154,307,1999,6259,2153,6566
210590,201912,4348,12984,3755,12211,71,383,3316,10759,3387,11142
210592,201912,2605,7746,2400,7402,26,128,2145,6549,2171,6677
210594,201912,2513,6798,1912,5857,86,238,1419,4500,1505,4738
210596,201912,2521,9016,2254,8475,115,500,1806,6834,1921,7334
210598,201912,1842,5405,1685,5163,37,158,1512,4588,1549,4746
210600,201912,3107,8250,2467,7333,89,208,1994,6052,2083,6260
210610,201912,2660,7583,2294,7133,59,290,1961,6056,2020,6346
210620,201912,2718,7399,2256,6841,53,152,2057,6349,2110,6501
210630,201912,3065,10323,2780,9860,119,609,2295,8014,2414,8623
210632,201912,4433,14364,3925,13625,231,1021,3087,10617,3318,11638
210635,201912,1772,6278,1657,6077,125,435,1347,5052,1472,5487
210637,201912,2402,7998,2088,7533,155,678,1565,5706,1720,6384
210640,201912,4616,16487,4319,16088,93,507,3844,14212,3937,14719
210650,201912,7445,21259,6743,20349,59,280,6261,18930,6320,19210
210660,201912,8242,24409,7239,22791,262,1036,6262,19473,6524,20509
210663,201912,2579,7592,2370,7346,131,329,2033,6466,2164,6795
210667,201912,1904,6272,1754,6052,41,167,1586,5531,1627,5698
210670,201912,4466,15244,4072,14627,127,632,3529,12590,3656,13222
210675,201912,5090,13826,4331,12821,207,496,3641,11024,3848,11520
210680,201912,4366,10928,3653,10047,124,219,3269,9199,3393,9418
210690,201912,7748,23800,6572,22480,252,1128,5766,19815,6018,20943
210700,201912,2688,7452,2145,6712,143,418,1619,5271,1762,5689
210710,201912,4980,15621,4347,14715,114,619,3796,12708,3910,13327
210720,201912,2912,9612,2632,9262,56,345,2369,8259,2425,8604
210725,201912,1332,4496,1136,4184,43,185,818,3130,861,3315
210730,201912,1195,3176,994,2893,52,137,824,2405,876,2542
210735,201912,4668,13774,3950,12805,191,606,3370,11166,3561,11772
210740,201912,5197,14044,4515,13274,110,379,3774,11076,3884,11455
210745,201912,4446,12134,4090,11661,123,351,3721,10609,3844,10960
210750,201912,23082,58916,19961,54990,1619,4201,14052,40755,15671,44956
210760,201912,5999,15839,5059,14831,30,68,4817,14243,4847,14311
210770,201912,6182,15944,5306,14933,54,233,4983,13951,5037,14184
210780,201912,7299,23295,6384,21755,552,1714,4984,17339,5536,19053
210790,201912,4406,13763,3948,13151,216,575,3160,11167,3376,11742
210800,201912,4938,13089,4191,12092,61,244,3794,10820,3855,11064
210805,201912,3957,14480,3772,14209,111,633,3356,12529,3467,13162
210810,201912,4955,14382,4499,13791,283,614,3775,11964,4058,12578
210820,201912,6965,19835,5781,17926,689,2218,3474,11102,4163,13320
210825,201912,6766,20991,6117,20133,250,850,5289,17633,5539,18483
210830,201912,7799,21997,7102,21122,407,918,6095,18636,6502,19554
210840,201912,3235,8606,2866,8090,59,212,2551,7079,2610,7291
210845,201912,6544,17741,5872,17001,20,74,5679,16498,5699,16572
210850,201912,5939,20272,4964,18792,254,1262,3884,14749,4138,16011
210860,201912,20999,54449,17429,49947,759,1924,14079,42340,14838,44264
210870,201912,7259,19041,5774,17339,210,603,5028,15196,5238,15799
210880,201912,4321,13285,3892,12780,190,720,3219,10588,3409,11308
210890,201912,3952,11674,3532,11177,230,608,2894,9457,3124,10065
210900,201912,4526,13294,3430,11241,1366,4786,548,2010,1914,6796
210905,201912,1995,5523,1652,5071,49,89,1506,4733,1555,4822
210910,201912,7320,22086,6073,20068,847,2832,3918,13095,4765,15927
210920,201912,3266,10739,2823,10135,75,434,2519,8956,2594,9390
210923,201912,1460,4477,1260,4140,60,217,948,3132,1008,3349
210927,201912,5296,16647,4631,15865,202,723,3902,13613,4104,14336
210930,201912,2491,8620,2172,7991,182,746,1614,5919,1796,6665
210940,201912,4058,11482,3767,11134,115,464,3437,10036,3552,10500
210945,201912,6302,18382,5660,17615,236,705,4792,15228,5028,15933
210950,201912,5185,14615,3971,12903,609,1587,2618,9209,3227,10796
210955,201912,1561,4975,1338,4579,134,472,944,3289,1078,3761
210960,201912,9045,27056,7752,25103,1290,3872,4915,16711,6205,20583
210970,201912,1314,4034,1037,3558,58,232,808,2706,866,2938
210975,201912,1688,5373,1503,5075,72,260,1201,4063,1273,4323
210980,201912,10278,23483,8956,22113,93,208,8461,20979,8554,21187
210990,201912,15903,45344,12508,40827,724,2633,9432,31330,10156,33963
211000,201912,14617,42872,12144,39898,655,2389,9817,33247,10472,35636
211003,201912,5625,16882,4709,15766,132,522,4068,13917,4200,14439
211010,201912,6504,23442,5840,22619,93,483,5283,20776,5376,21259
211020,201912,8197,23998,7144,22766,221,921,6072,19726,6293,20647
211023,201912,1988,6521,1862,6352,90,360,1576,5330,1666,5690
211027,201912,2998,9714,2853,9479,160,504,2492,8261,2652,8765
211030,201912,3950,10910,3511,10371,244,549,2855,8694,3099,9243
211040,201912,4565,16558,4229,15957,120,728,3761,14060,3881,14788
211050,201912,9257,23966,8363,22808,111,348,7704,20990,7815,21338
211060,201912,6992,21214,6381,20394,128,524,5867,18734,5995,19258
211065,201912,2162,6081,1780,5590,79,238,1473,4749,1552,4987
211070,201912,7682,24570,6516,22771,518,1825,5058,17897,5576,19722
211080,201912,1273,3570,1009,3149,35,188,773,2268,808,2456
211085,201912,2026,5797,1721,5381,77,184,1498,4820,1575,5004
211090,201912,3184,8802,2851,8386,42,187,2625,7672,2667,7859
211100,201912,6770,17202,6240,16550,49,152,5738,15291,5787,15443
211102,201912,3024,10483,2771,10109,130,615,2407,8689,2537,9304
211105,201912,2366,7545,1955,6781,176,625,1398,4816,1574,5441
211107,201912,4591,14584,3887,13533,138,623,3188,11340,3326,11963
211110,201912,5941,16395,4568,14282,387,1152,3326,10600,3713,11752
211120,201912,44283,109516,37092,101179,4964,12499,23805,69395,28769,81894
211125,201912,2096,6185,1753,5666,38,158,1474,4777,1512,4935
211130,201912,196578,468167,171885,436035,24889,62103,76612,221748,101501,283851
211140,201912,4985,14818,4327,13928,216,633,3655,11836,3871,12469
211150,201912,9383,25677,7922,23766,347,993,6649,20063,6996,21056
211153,201912,2529,7367,2013,6733,276,983,1323,4646,1599,5629
211157,201912,1085,3472,897,3128,35,186,655,2247,690,2433
211160,201912,4050,11636,3192,10361,158,596,2361,7556,2519,8152
211163,201912,1676,5292,1531,5086,24,124,1376,4621,1400,4745
211167,201912,1538,4921,1436,4755,30,138,1321,4342,1351,4480
211170,201912,6476,15917,6019,15387,51,174,5732,14583,5783,14757
211172,201912,2443,6720,2085,6174,102,315,1708,4911,1810,5226
211174,201912,2865,8319,2598,8014,46,235,2397,7357,2443,7592
211176,201912,4274,12223,3285,10755,157,664,2611,8503,2768,9167
211178,201912,4681,10914,3983,10148,36,160,3774,9529,3810,9689
211180,201912,3974,13211,3679,12767,207,783,3131,10884,3338,11667
211190,201912,3049,9057,2584,8353,34,203,2254,7210,2288,7413
211195,201912,1349,3874,1150,3571,47,116,975,3090,1022,3206
211200,201912,2107,6042,1674,5466,211,667,1166,3893,1377,4560
211210,201912,6374,19443,5752,18614,257,1039,4951,15890,5208,16929
211220,201912,37027,93512,30058,84895,2902,7764,22118,64099,25020,71863
211223,201912,5155,13674,4306,12531,389,1132,3211,9397,3600,10529
211227,201912,1761,5862,1586,5611,34,163,1411,5065,1445,5228
211230,201912,7448,21834,6496,20371,401,1103,5211,16669,5612,17772
211240,201912,8185,26070,7720,25462,149,803,7126,23232,7275,24035
211245,201912,6939,17607,6225,16862,85,212,6012,16319,6097,16531
211250,201912,13259,41265,11925,39509,613,2497,9851,32305,10464,34802
211260,201912,7939,25877,7101,24735,199,905,6392,22335,6591,23240
211270,201912,10538,33607,9014,31497,389,1775,7344,25751,7733,27526
211280,201912,12833,35541,11329,33658,950,2270,9020,27984,9970,30254
211285,201912,1759,5860,1533,5528,154,614,1040,3860,1194,4474
211290,201912,7483,22541,6736,21528,179,772,5816,18481,5995,19253
211300,201912,7950,22578,7049,21300,173,599,6213,18648,6386,19247
211400,201912,11480,32853,9313,29811,1051,3350,6291,21130,7342,24480
220005,201912,1841,4884,1655,4614,39,155,1391,3796,1430,3951
220010,201912,1487,4247,1218,3763,31,123,932,2851,963,2974
220020,201912,3501,9923,3028,9218,159,580,2441,7332,2600,7912
220025,201912,2254,5135,1908,4608,24,63,1593,3728,1617,3791
220027,201912,1257,3209,1077,2973,17,57,912,2464,929,2521
220030,201912,3321,8437,3094,8124,82,249,2728,7055,2810,7304
220040,201912,7174,21806,6247,19982,1443,4264,3315,11120,4758,15384
220045,201912,1476,4537,1207,4068,35,182,966,3196,1001,3378
220050,201912,4712,12911,3989,11928,74,366,3628,10676,3702,11042
220060,201912,2413,5079,2024,4632,26,68,1907,4338,1933,4406
220070,201912,2514,6341,2139,5801,76,159,1761,4794,1837,4953
220080,201912,718,2033,604,1864,25,104,519,1571,544,1675
220090,201912,1797,4337,1477,3885,21,70,1217,3315,1238,3385
220095,201912,640,1635,606,1599,25,40,547,1454,572,1494
220100,201912,1368,3773,1089,3318,52,183,864,2563,916,2746
220105,201912,1997,6244,1735,5716,127,459,1310,4305,1437,4764
220110,201912,3427,9469,3183,9025,41,207,2838,7931,2879,8138
220115,201912,2699,7869,2476,7552,69,256,2246,6779,2315,7035
220117,201912,1357,3288,1040,2841,14,61,868,2322,882,2383
220120,201912,12791,34498,11610,32967,91,324,10919,30944,11010,31268
220130,201912,1097,2982,923,2742,16,85,827,2422,843,2507
220140,201912,2058,4341,1741,3960,115,296,1505,3350,1620,3646
220150,201912,6387,19063,5867,18193,131,653,4935,14962,5066,15615
220155,201912,1128,3281,892,2841,29,107,637,1991,666,2098
220157,201912,1053,2587,888,2334,21,85,717,1816,738,1901
220160,201912,2780,7803,2392,7109,34,167,1986,5793,2020,5960
220170,201912,1554,4105,1298,3724,13,68,1169,3305,1182,3373
220173,201912,2099,5872,1613,4976,39,178,1333,3975,1372,4153
220177,201912,1994,5671,1885,5547,11,39,1854,5461,1865,5500
220180,201912,1117,2771,900,2395,3,15,696,1729,699,1744
220190,201912,6766,17200,5613,15597,352,1098,4233,11795,4585,12893
220191,201912,1471,4535,1323,4283,68,262,976,3054,1044,3316
220192,201912,1881,5052,1435,4253,28,101,1184,3444,1212,3545
220194,201912,1683,4859,1489,4527,54,206,1221,3650,1275,3856
220196,201912,1983,5195,1784,4885,27,120,1517,4069,1544,4189
220198,201912,1290,3558,1074,3281,7,30,988,3047,995,3077
220200,201912,5154,14807,4438,13871,132,517,3739,11675,3871,12192
220202,201912,2169,6100,1849,5571,31,163,1582,4679,1613,4842
220205,201912,2524,7194,2236,6692,50,214,1881,5526,1931,5740
220207,201912,788,2344,638,2088,62,213,402,1318,464,1531
220208,201912,1655,5148,1348,4537,159,589,799,2620,958,3209
220209,201912,1590,4517,1369,4142,25,118,1110,3310,1135,3428
220210,201912,1673,4173,1418,3770,12,57,1213,3156,1225,3213
220211,201912,1571,4072,1445,3896,20,74,1253,3404,1273,3478
220213,201912,1762,4721,1502,4243,34,123,1219,3339,1253,3462
220217,201912,2098,6376,1975,6241,36,107,1845,5900,1881,6007
220220,201912,10414,27251,8516,24285,531,1353,5877,17448,6408,18801
220225,201912,1049,2734,842,2471,8,44,774,2240,782,2284
220230,201912,5775,14254,4909,13056,166,417,4222,11248,4388,11665
220240,201912,2913,8551,2646,8072,113,374,2136,6524,2249,6898
220245,201912,1678,4043,1285,3547,10,53,1171,3250,1181,3303
220250,201912,3032,8431,2647,7934,20,107,2460,7331,2480,7438
220253,201912,1620,4415,1394,4027,65,231,1164,3249,1229,3480
220255,201912,1865,4519,1563,4072,37,170,1312,3278,1349,3448
220260,201912,4208,13051,3682,12092,163,631,2959,9670,3122,10301
220265,201912,1282,4140,1155,3959,36,177,936,3131,972,3308
220270,201912,6318,19905,5892,19121,223,1047,4904,15368,5127,16415
220271,201912,1483,3787,1276,3504,30,115,1121,3065,1151,3180
220272,201912,1767,5077,1564,4701,66,206,1163,3399,1229,3605
220273,201912,1222,3495,1009,3099,44,174,768,2304,812,2478
220275,201912,2295,5492,1758,4744,30,99,1545,4176,1575,4275
220277,201912,2140,5405,1819,4913,26,83,1544,4078,1570,4161
220280,201912,1621,3835,1332,3442,30,110,1139,2893,1169,3003
220285,201912,1455,3681,1215,3395,14,61,1105,3053,1119,3114
220290,201912,6292,18059,4916,16099,351,1285,3596,11979,3947,13264
220300,201912,1972,5718,1583,5196,40,243,1309,4237,1349,4480
220310,201912,3078,8243,2361,7399,42,207,1972,6139,2014,6346
220320,201912,3029,8950,2314,7571,97,436,1776,5629,1873,6065
220323,201912,1620,4776,1275,4206,60,239,1043,3384,1103,3623
220325,201912,1269,3742,1072,3408,26,129,877,2739,903,2868
220327,201912,1500,4279,1299,3945,49,207,1076,3171,1125,3378
220330,201912,4350,10519,3599,9595,61,192,3232,8532,3293,8724
220335,201912,1708,5113,1516,4871,30,103,1360,4372,1390,4475
220340,201912,1853,4871,1419,4142,61,206,973,2742,1034,2948
220342,201912,1138,3354,1003,3149,44,205,790,2435,834,2640
220345,201912,3144,7054,2418,6014,13,45,2191,5419,2204,5464
220350,201912,3353,8602,2663,7556,139,420,1880,5322,2019,5742
220360,201912,1228,3146,960,2700,16,56,773,2146,789,2202
220370,201912,8733,25174,7876,23795,178,777,6884,20482,7062,21259
220375,201912,1608,4564,1419,4333,5,18,1344,4130,1349,4148
220380,201912,1510,3586,1199,3129,14,43,1051,2698,1065,2741
220385,201912,840,2004,663,1684,8,25,577,1448,585,1473
220390,201912,9862,25931,7461,22116,1930,5604,2860,9300,4790,14904
220400,201912,1493,3551,1127,2998,23,64,873,2262,896,2326
220410,201912,1171,3211,926,2786,49,150,753,2221,802,2371
220415,201912,810,2077,674,1856,19,56,540,1464,559,1520
220420,201912,1985,5466,1580,4698,49,138,1235,3625,1284,3763
220430,201912,2507,6765,2349,6527,82,265,1998,5480,2080,5745
220435,201912,1742,4495,1491,4127,38,133,1219,3299,1257,3432
220440,201912,2415,7571,2064,7002,113,473,1703,5662,1816,6135
220450,201912,2484,6453,2008,5855,71,251,1684,4916,1755,5167
220455,201912,1320,4047,1246,3944,16,81,1103,3473,1119,3554
220460,201912,970,2376,895,2282,35,88,770,1941,805,2029
220465,201912,2347,7278,2060,6823,182,616,1511,5093,1693,5709
220470,201912,3481,9645,3090,9026,84,233,2490,7182,2574,7415
220480,201912,2647,6923,2103,6015,155,379,1444,4133,1599,4512
220490,201912,2454,6201,2112,5752,28,139,1859,4975,1887,5114
220500,201912,2653,6950,2367,6492,48,182,1965,5203,2013,5385
220510,201912,2547,7219,1979,6191,89,268,1551,4880,1640,5148
220515,201912,1643,3974,1489,3752,29,51,1308,3281,1337,3332
220520,201912,4935,12816,4416,12073,102,295,3848,10444,3950,10739
220525,201912,1325,3335,1135,3092,10,47,1039,2792,1049,2839
220527,201912,1336,3723,1133,3424,13,53,969,2982,982,3035
220530,201912,1438,3576,1224,3299,31,98,1127,2998,1158,3096
220535,201912,805,2254,750,2181,42,145,601,1723,643,1868
220540,201912,3252,10369,3046,9987,119,435,2575,8385,2694,8820
220545,201912,1384,4243,1275,4063,66,262,1050,3299,1116,3561
220550,201912,8586,26248,7589,24564,500,1751,5692,18258,6192,20009
220551,201912,1404,4019,1214,3680,27,116,998,2957,1025,3073
220552,201912,1598,4623,1293,4079,32,160,1026,3113,1058,3273
220553,201912,1709,4477,1406,4061,58,130,1126,3362,1184,3492
220554,201912,875,2335,632,1917,46,106,410,1238,456,1344
220555,201912,2243,6750,2017,6429,46,214,1652,5359,1698,5573
220556,201912,1213,3528,1037,3172,61,243,730,2131,791,2374
220557,201912,1613,4922,1354,4400,65,249,987,3117,1052,3366
220558,201912,1387,3598,1068,3147,20,81,921,2683,941,2764
220559,201912,1679,4281,1415,3867,7,24,1137,3139,1144,3163
220560,201912,1759,3963,1404,3505,36,69,1269,3186,1305,3255
220570,201912,7262,21657,6567,20665,462,1471,5167,16338,5629,17809
220580,201912,6989,19195,6379,18202,87,318,5769,16320,5856,16638
220585,201912,1995,6317,1682,5737,44,154,1372,4725,1416,4879
220590,201912,1321,3614,1077,3239,76,227,776,2331,852,2558
220595,201912,2508,6855,2256,6512,23,105,2019,5769,2042,5874
220600,201912,1396,3117,1160,2814,94,123,961,2412,1055,2535
220605,201912,1632,4739,1374,4277,21,125,1107,3342,1128,3467
220610,201912,2745,8094,2571,7849,31,138,2387,7269,2418,7407
220620,201912,7970,24583,7285,23650,193,998,6578,21070,6771,22068
220630,201912,360,1074,272,907,25,85,175,590,200,675
220635,201912,1608,5126,1417,4709,53,256,1057,3409,1110,3665
220640,201912,2521,6930,2135,6364,81,317,1724,5067,1805,5384
220650,201912,2085,5722,1763,5207,35,135,1425,4178,1460,4313
220660,201912,2665,8300,2265,7615,93,472,1853,6060,1946,6532
220665,201912,1242,3759,1038,3417,36,197,844,2692,880,2889
220667,201912,1593,4994,1416,4658,61,248,1144,3734,1205,3982
220669,201912,1663,5053,1587,4935,60,279,1373,4163,1433,4442
220670,201912,2202,5769,1739,5108,20,89,1502,4394,1522,4483
220672,201912,3223,7921,2581,7148,116,377,2248,6158,2364,6535
220675,201912,1234,3381,1104,3141,36,112,912,2569,948,2681
220680,201912,2667,7313,2538,7122,99,246,2319,6528,2418,6774
220690,201912,1548,4125,1362,3841,78,233,1066,2997,1144,3230
220695,201912,874,2440,810,2321,21,66,700,1999,721,2065
220700,201912,9801,24250,7793,21438,350,1031,5972,16271,6322,17302
220710,201912,890,2471,658,2024,27,99,496,1487,523,1586
220720,201912,2133,5032,1916,4738,16,62,1658,4039,1674,4101
220730,201912,1304,3665,1092,3302,16,89,926,2731,942,2820
220735,201912,974,2260,731,1878,12,43,629,1564,641,1607
220740,201912,1392,3629,1087,3234,34,96,908,2736,942,2832
220750,201912,3862,9800,3356,9064,203,468,2891,7849,3094,8317
220755,201912,1267,3143,1034,2783,26,95,834,2179,860,2274
220760,201912,3103,8670,2686,8103,89,301,2368,7208,2457,7509
220770,201912,22029,66450,18422,60107,5785,19845,6483,21799,12268,41644
220775,201912,1134,2926,1029,2792,12,52,987,2658,999,2710
220777,201912,1639,4153,1239,3533,31,74,940,2683,971,2757
220779,201912,1318,3303,1130,3033,21,64,976,2604,997,2668
220780,201912,5529,14068,4811,12959,217,706,3917,10275,4134,10981
220785,201912,1477,3270,1296,3033,8,20,1253,2918,1261,2938
220790,201912,10059,28714,9014,27205,231,1097,7547,22440,7778,23537
220793,201912,919,2407,715,2041,14,35,591,1708,605,1743
220795,201912,1388,3590,1225,3368,16,59,1091,3006,1107,3065
220800,201912,17770,39948,14852,35990,640,1532,11449,27514,12089,29046
220810,201912,2975,8298,2494,7430,50,159,2060,6073,2110,6232
220820,201912,5172,13415,4423,12325,302,732,3292,9163,3594,9895
220830,201912,7288,19319,6492,18204,234,791,5415,14957,5649,15748
220840,201912,12308,37760,10183,33319,2361,7392,4694,16051,7055,23443
220850,201912,3134,9686,2777,9236,65,351,2454,8135,2519,8486
220855,201912,679,1736,584,1591,14,50,522,1407,536,1457
220860,201912,1010,2528,861,2288,20,76,765,1999,785,2075
220865,201912,2502,6603,1930,5619,94,330,1416,4003,1510,4333
220870,201912,2950,8286,2427,7596,41,206,2219,6904,2260,7110
220880,201912,5289,12513,4544,11589,80,295,4162,10485,4242,10780
220885,201912,1393,4269,1141,3845,58,239,911,3098,969,3337
220887,201912,1540,3354,1257,2981,11,32,1174,2756,1185,2788
220890,201912,1419,4356,1218,4030,50,175,999,3343,1049,3518
220900,201912,2042,4864,1683,4387,30,73,1474,3810,1504,3883
220910,201912,1520,4183,1274,3820,49,158,1052,3146,1101,3304
220915,201912,959,2583,736,2157,6,23,568,1607,574,1630
220920,201912,1350,4421,1152,4148,69,320,938,3360,1007,3680
220930,201912,1669,4567,1417,4195,24,78,1301,3831,1325,3909
220935,201912,1068,3063,850,2607,25,98,577,1670,602,1768
220937,201912,1394,3725,1185,3393,26,90,945,2668,971,2758
220940,201912,1518,4280,1194,3685,39,142,903,2746,942,2888
220945,201912,437,1523,371,1371,21,123,269,951,290,1074
220950,201912,1428,3303,899,2455,16,58,722,1894,738,1952
220955,201912,1604,4152,1335,3680,38,118,1114,3017,1152,3135
220960,201912,817,2076,607,1724,11,43,453,1227,464,1270
220965,201912,1771,4861,1537,4517,21,130,1326,3794,1347,3924
220970,201912,1881,4553,1373,3780,38,98,1135,3089,1173,3187
220975,201912,697,2043,592,1908,16,93,522,1616,538,1709
220980,201912,1163,3270,1026,3078,35,133,861,2553,896,2686
220985,201912,1215,3209,1057,2968,44,142,847,2301,891,2443
220987,201912,1450,4322,1241,3937,53,224,1000,3120,1053,3344
220990,201912,1699,4680,1488,4364,18,104,1251,3605,1269,3709
220995,201912,1093,3324,869,2909,39,138,634,2111,673,2249
220997,201912,2411,7129,2203,6794,48,227,1979,6019,2027,6246
221000,201912,4425,12185,3905,11385,100,475,3306,9451,3406,9926
221005,201912,1484,3924,1348,3695,28,136,1165,3067,1193,3203
221010,201912,1202,2781,955,2474,24,64,830,2096,854,2160
221020,201912,1509,4599,1394,4382,20,87,1072,3322,1092,3409
221030,201912,1624,4068,1383,3767,26,81,1195,3279,1221,3360
221035,201912,1505,3941,1286,3643,20,32,1125,3281,1145,3313
221037,201912,647,1822,537,1623,8,27,377,1100,385,1127
221038,201912,530,1488,406,1251,16,56,278,850,294,906
221039,201912,864,2359,738,2145,19,84,607,1692,626,1776
221040,201912,4010,12044,3491,11107,149,543,2772,8787,2921,9330
221050,201912,3880,10243,3386,9608,66,255,3038,8560,3104,8815
221060,201912,8481,23415,6938,20981,250,721,5651,17189,5901,17910
221062,201912,1156,3759,977,3450,40,190,787,2728,827,2918
221063,201912,1051,2948,877,2687,67,235,659,1985,726,2220
221065,201912,2593,6728,2280,6163,22,96,1994,5287,2016,5383
221070,201912,3239,10185,2651,8951,286,958,1669,5729,1955,6687
221080,201912,3545,8674,2836,7606,59,230,2338,6150,2397,6380
221090,201912,1410,3648,1139,3174,10,43,978,2655,988,2698
221093,201912,1345,3801,1234,3580,119,339,849,2419,968,2758
221095,201912,898,2331,745,2088,8,25,620,1705,628,1730
221097,201912,821,2155,626,1798,21,66,465,1282,486,1348
221100,201912,112026,300373,92801,267261,10514,32233,60117,168435,70631,200668
221110,201912,9892,29445,9031,28326,160,832,8058,24982,8218,25814
221120,201912,4786,13225,4228,12311,179,554,3642,10565,3821,11119
221130,201912,5235,13782,3829,11016,768,2091,1839,5362,2607,7453
221135,201912,1608,4308,1435,4072,41,145,1267,3577,1308,3722
221140,201912,1333,3147,1113,2857,11,38,991,2485,1002,2523
221150,201912,1103,2725,839,2250,23,100,656,1630,679,1730
221160,201912,742,1832,640,1696,17,32,526,1396,543,1428
221170,201912,987,2840,896,2674,23,72,766,2277,789,2349
230010,201912,3155,8204,2502,7072,47,160,1978,5478,2025,5638
230015,201912,2989,9757,2610,8979,178,716,1814,6189,1992,6905
230020,201912,12925,40808,12052,39440,356,1512,10145,32900,10501,34412
230030,201912,13034,32653,10878,29804,194,589,9529,26059,9723,26648
230040,201912,4467,11594,3686,10317,63,295,3052,8403,3115,8698
230050,201912,2795,8702,2070,6943,323,1034,919,3012,1242,4046
230060,201912,2343,6398,1856,5521,40,179,1467,4271,1507,4450
230070,201912,3892,10397,3110,8863,146,448,2161,6084,2307,6532
230075,201912,9126,29508,8297,28034,469,2026,6598,21896,7067,23922
230080,201912,3092,6432,2321,5476,6,25,2116,5000,2122,5025
230090,201912,4286,10614,3577,9456,154,414,2856,7496,3010,7910
230100,201912,18046,47302,15877,44267,1211,3520,11267,31417,12478,34937
230110,201912,12875,38243,10792,34040,1760,5496,5699,18068,7459,23564
230120,201912,7348,19971,6426,18429,503,1323,4730,13754,5233,15077
230125,201912,3118,8282,2514,7290,79,286,1933,5528,2012,5814
230130,201912,5705,17571,4589,15094,318,1126,3110,10041,3428,11167
230140,201912,3435,10297,2901,9187,108,431,2203,6799,2311,7230
230150,201912,1590,4744,1308,4098,208,559,761,2485,969,3044
230160,201912,6541,17023,5583,15522,207,738,4483,12187,4690,12925
230170,201912,6185,17617,5043,15259,306,932,3649,10837,3955,11769
230180,201912,1658,4574,1386,4052,23,100,1113,3147,1136,3247
230185,201912,4308,12357,3610,11174,243,836,2684,8277,2927,9113
230190,201912,13101,38259,10971,34262,1519,4954,6148,19050,7667,24004
230195,201912,5311,15606,4786,14633,343,1052,3651,11123,3994,12175
230200,201912,4999,13752,4174,12159,140,459,3201,9132,3341,9591
230205,201912,4067,12308,3565,11495,178,662,2666,8506,2844,9168
230210,201912,10426,25053,8716,22701,348,1129,6847,17510,7195,18639
230220,201912,13914,34901,12158,32334,603,1654,10011,26332,10614,27986
230230,201912,6827,20659,6076,19082,397,1265,4474,13988,4871,15253
230240,201912,12921,34508,11182,31541,283,1163,9227,25476,9510,26639
230250,201912,8919,25213,8363,24338,240,874,6656,18782,6896,19656
230260,201912,14653,44023,12621,40300,1611,5056,7308,23738,8919,28794
230270,201912,7455,20329,5663,16909,462,1373,3781,11328,4243,12701
230280,201912,20509,54712,16516,47890,494,2082,13047,36415,13541,38497
230290,201912,4795,13363,3990,11816,279,737,2994,8863,3273,9600
230300,201912,4807,12902,4348,12251,94,298,3788,10569,3882,10867
230310,201912,4666,13265,3891,11878,142,603,2792,8280,2934,8883
230320,201912,7767,22307,6523,20009,265,1084,4958,14870,5223,15954
230330,201912,4757,12944,3729,10948,158,529,2770,7960,2928,8489
230340,201912,3608,11238,3039,10075,273,946,2022,6637,2295,7583
230350,201912,17833,49272,15645,45945,891,3053,10366,30629,11257,33682
230360,201912,2842,7689,2241,6607,146,423,1485,4341,1631,4764
230365,201912,3055,7606,2506,6771,45,232,2117,5647,2162,5879
230370,201912,58869,164245,49721,150139,7627,23297,29075,89146,36702,112443
230380,201912,6428,17864,5010,15193,127,512,3670,10915,3797,11427
230390,201912,3372,10021,2901,9252,102,456,2230,7016,2332,7472
230393,201912,3179,9529,2525,8184,85,457,1926,5988,2011,6445
230395,201912,5898,16028,5109,14667,337,904,3552,10208,3889,11112
230400,201912,5588,15439,4913,14291,113,575,3920,11037,4033,11612
230410,201912,14539,42739,11833,37648,943,3241,7955,25191,8898,28432
230420,201912,28402,78475,22846,68450,2818,8774,12777,38029,15595,46803
230423,201912,4714,13969,4077,12683,89,382,3282,10037,3371,10419
230425,201912,5573,17205,5038,16073,410,1383,3573,11343,3983,12726
230426,201912,2730,7190,1959,5675,29,105,1470,4176,1499,4281
230427,201912,1879,5286,1301,4044,68,236,873,2594,941,2830
230428,201912,9730,26072,8364,23952,1142,3289,4913,13933,6055,17222
230430,201912,4932,13917,3852,12023,156,559,2924,8962,3080,9521
230435,201912,5722,15041,4758,13359,549,1505,2995,8417,3544,9922
230440,201912,412128,1026657,338534,915168,36001,103036,213864,570769,249865,673805
230445,201912,4298,11423,3425,9876,180,510,2338,6608,2518,7118
230450,201912,3620,10464,3128,9704,249,976,2245,6749,2494,7725
230460,201912,2150,5968,1852,5490,64,252,1531,4516,1595,4768
230465,201912,4001,11243,3376,10061,100,413,2512,7197,2612,7610
230470,201912,11240,37132,10042,34859,859,3444,7140,24354,7999,27798
230480,201912,1422,4129,1181,3684,84,326,837,2510,921,2836
230490,201912,2494,6965,2074,6175,164,537,1303,3675,1467,4212
230495,201912,5806,17203,5064,15861,375,1411,3325,10294,3700,11705
230500,201912,9291,29910,8344,28164,283,1148,6750,22700,7033,23848
230510,201912,1633,4996,1230,4098,186,662,593,1941,779,2603
230520,201912,4595,12983,3928,11767,331,925,2735,8204,3066,9129
230523,201912,15143,44799,11875,37672,2720,8555,3205,10761,5925,19316
230526,201912,3808,10783,3178,9662,172,530,2331,7104,2503,7634
230530,201912,5385,16776,4496,15031,303,1143,3229,10697,3532,11840
230533,201912,4363,10604,3620,9401,92,271,3001,7670,3093,7941
230535,201912,5299,14752,4464,13318,220,669,3150,9490,3370,10159
230540,201912,16265,44161,13900,40595,265,1064,11512,33215,11777,34279
230550,201912,20736,55279,16492,47892,1496,4476,10407,29983,11903,34459
230560,201912,8109,19832,6335,16949,52,231,5513,14564,5565,14795
230565,201912,3036,8486,2514,7513,82,348,1888,5521,1970,5869
230570,201912,3514,8913,2965,8173,73,236,2462,6743,2535,6979
230580,201912,10864,28228,9251,25897,334,1003,7671,21273,8005,22276
230590,201912,8963,25579,7355,22574,408,1470,5381,15942,5789,17412
230600,201912,3661,9566,2826,8048,88,271,1952,5590,2040,5861
230610,201912,6664,18389,5839,16989,449,1289,4580,13255,5029,14544
230620,201912,2098,5675,1566,4612,122,384,960,2751,1082,3135
230625,201912,7796,22323,6470,19809,1935,6158,1760,5793,3695,11951
230630,201912,10730,31992,9234,28903,1559,4619,5188,16676,6747,21295
230640,201912,27894,84162,25000,79479,1332,5290,19670,61518,21002,66808
230650,201912,5171,14133,4365,12697,140,598,3485,9849,3625,10447
230655,201912,9337,31630,8739,30555,622,2291,6905,24329,7527,26620
230660,201912,6084,18089,4921,15983,156,825,3970,12620,4126,13445
230670,201912,6165,14727,4460,11948,127,426,3597,9389,3724,9815
230680,201912,2620,7199,2206,6449,133,386,1582,4645,1715,5031
230690,201912,7083,21055,6118,19098,410,1424,3858,11820,4268,13244
230700,201912,9839,25305,8102,22125,321,900,6065,16187,6386,17087
230710,201912,6721,21221,5807,19276,569,1979,3972,12963,4541,14942
230720,201912,1942,5699,1543,4869,119,361,1027,3160,1146,3521
230725,201912,3894,11826,3458,10987,385,1347,1952,6119,2337,7466
230730,201912,56488,153902,43812,133822,9802,32276,14498,46350,24300,78626
230740,201912,6088,16883,5132,15327,129,486,4119,12211,4248,12697
230750,201912,8476,22653,6979,20144,170,653,5495,15378,5665,16031
230760,201912,11201,29628,9728,27353,548,1800,7269,19935,7817,21735
230763,201912,4733,13119,3935,11618,124,568,3142,8967,3266,9535
230765,201912,40561,110665,33302,98546,5317,16343,16334,47921,21651,64264
230770,201912,25501,63366,21246,57618,2222,6126,13973,37941,16195,44067
230780,201912,6198,21992,5651,20695,781,2912,3333,12477,4114,15389
230790,201912,2958,8611,2629,8053,111,491,1968,5860,2079,6351
230800,201912,8005,25456,7009,23398,807,2947,4242,13888,5049,16835
230810,201912,11646,34631,10306,32420,414,1549,7889,24332,8303,25881
230820,201912,3335,10954,2751,9574,254,1077,1674,5534,1928,6611
230830,201912,7615,20717,6401,18640,148,627,5253,14902,5401,15529
230835,201912,4240,10150,3182,8424,78,238,2639,6854,2717,7092
230837,201912,3140,9643,2673,8782,110,524,2138,6799,2248,7323
230840,201912,9002,26473,7695,24274,758,2286,5513,17561,6271,19847
230850,201912,9512,27645,7941,24485,361,1307,5663,17214,6024,18521
230860,201912,5182,13264,4271,11908,63,225,3756,10392,3819,10617
230870,201912,16561,40455,14068,36297,388,1092,11486,29248,11874,30340
230880,201912,2104,6433,1907,6094,49,273,1501,4649,1550,4922
230890,201912,4597,14696,4159,13805,336,1229,2975,9685,3311,10914
230900,201912,3009,8692,2544,7760,183,643,1705,5069,1888,5712
230910,201912,3033,8187,2440,7220,60,284,1978,5809,2038,6093
230920,201912,4582,12949,3831,11729,146,594,2988,8913,3134,9507
230930,201912,6505,18253,5400,16208,304,910,3762,11279,4066,12189
230940,201912,7830,20275,6760,18624,199,533,5680,15540,5879,16073
230945,201912,6521,18759,5560,16869,325,1140,3917,11696,4242,12836
230950,201912,6335,15853,5572,14825,115,265,4882,13089,4997,13354
230960,201912,12982,37933,11430,34987,1783,5441,5839,18073,7622,23514
230970,201912,13561,36122,11188,32336,1772,5129,6143,17961,7915,23090
230980,201912,2710,7916,2350,7269,366,1088,1443,4594,1809,5682
230990,201912,1690,4775,1399,4180,70,289,961,2742,1031,3031
231000,201912,2471,6582,2018,5693,79,208,1477,4068,1556,4276
231010,201912,3427,8108,2716,6874,45,164,2346,5763,2391,5927
231020,201912,8073,25629,7151,23722,1318,4054,4013,13861,5331,17915
231025,201912,7481,20785,6485,19141,748,2167,4470,13306,5218,15473
231030,201912,7319,21791,5662,18261,910,2857,2971,9596,3881,12453
231040,201912,2963,8615,2570,7884,115,367,1993,6027,2108,6394
231050,201912,11793,30554,9311,26049,662,1815,6861,18721,7523,20536
231060,201912,2816,7995,2438,7372,63,229,1994,6000,2057,6229
231070,201912,7931,22995,6644,20700,732,2327,4207,13017,4939,15344
231080,201912,3995,11418,3397,10420,131,567,2572,7742,2703,8309
231085,201912,6750,16447,5305,14691,213,557,4118,11383,4331,11940
231090,201912,4410,11541,3216,9191,106,425,2240,6153,2346,6578
231095,201912,2276,6796,1773,5676,140,457,1180,3760,1320,4217
231100,201912,3128,9089,2568,8024,127,462,1933,5971,2060,6433
231110,201912,3534,10463,3213,9863,120,455,2421,7289,2541,7744
231120,201912,2235,6576,1846,5886,83,310,1293,4077,1376,4387
231123,201912,1915,4949,1564,4336,70,168,1156,3192,1226,3360
231126,201912,5454,15068,4307,12856,242,733,3158,9292,3400,10025
231130,201912,21035,54310,17451,49679,1042,3808,12795,35668,13837,39476
231135,201912,4129,11595,3408,10199,152,527,2445,7167,2597,7694
231140,201912,16741,47053,13257,40771,602,2519,9277,27770,9879,30289
231150,201912,5688,15618,4342,13013,702,2145,1953,5976,2655,8121
231160,201912,6189,18825,5395,17329,805,2465,3067,10116,3872,12581
231170,201912,4397,12913,3568,11281,192,705,2457,7492,2649,8197
231180,201912,14324,40837,11498,34740,3163,9273,3926,12278,7089,21551
231190,201912,3850,10843,3158,9563,71,320,2443,7198,2514,7518
231195,201912,4850,14720,4001,12957,215,827,2920,9307,3135,10134
231200,201912,7794,24447,6684,22133,222,1119,5253,16807,5475,17926
231210,201912,4828,14188,4067,12883,190,726,3048,9430,3238,10156
231220,201912,12019,31379,9123,25799,404,1250,6753,18376,7157,19626
231230,201912,9327,29676,8162,27578,467,1889,5991,20201,6458,22090
231240,201912,11519,33742,10041,30874,1550,4670,6018,18703,7568,23373
231250,201912,2106,5440,1346,3744,100,283,821,2224,921,2507
231260,201912,3216,9167,2766,8434,269,794,1876,5865,2145,6659
231270,201912,6451,16866,5214,14800,147,560,3942,10934,4089,11494
231280,201912,1688,5297,1546,5032,89,306,1162,3750,1251,4056
231290,201912,37563,112394,30965,98590,5221,16518,14375,45456,19596,61974
231300,201912,4044,11255,3134,9397,218,702,2052,6029,2270,6731
231310,201912,7259,18973,5742,16138,492,1400,3890,10705,4382,12105
231320,201912,7790,21433,6015,18229,90,440,4705,14035,4795,14475
231325,201912,2520,6678,2015,5883,164,418,1341,3999,1505,4417
231330,201912,9588,28827,7812,25220,1406,4359,4148,13935,5554,18294
231335,201912,5806,15204,4861,13684,83,360,4262,11852,4345,12212
231340,201912,17342,54044,15386,50489,1365,4528,10995,36463,12360,40991
231350,201912,15814,43020,14290,40863,319,1121,12740,36049,13059,37170
231355,201912,4401,13128,3910,12212,247,833,2987,9233,3234,10066
231360,201912,7417,22448,6376,20603,278,1045,4984,16023,5262,17068
231370,201912,2191,6005,1718,5156,35,117,1325,3945,1360,4062
231375,201912,4413,13664,4000,12971,135,600,3318,10639,3453,11239
231380,201912,5997,16242,5405,15429,183,492,4402,12743,4585,13235
231390,201912,3369,9831,2992,9189,142,550,2183,6506,2325,7056
231395,201912,3934,11649,3230,10509,433,1414,1893,6231,2326,7645
231400,201912,9476,27239,7962,24414,282,1177,6056,18166,6338,19343
231410,201912,14696,45734,13178,43167,599,2326,10592,34192,11191,36518
240010,201912,2507,6700,1920,5591,196,620,1157,3279,1353,3899
240020,201912,12324,34746,10297,31118,658,2466,6835,20239,7493,22705
240030,201912,2886,7110,2617,6696,97,289,2246,5670,2343,5959
240040,201912,813,2323,654,2020,33,126,464,1367,497,1493
240050,201912,3202,8599,2614,7520,46,135,2039,5768,2085,5903
240060,201912,1382,3718,1136,3265,26,92,925,2600,951,2692
240070,201912,2154,6277,1953,5861,190,613,1423,4147,1613,4760
240080,201912,2899,7817,2368,6835,55,213,1831,5178,1886,5391
240090,201912,2258,5561,1816,4794,18,55,1520,3959,1538,4014
240100,201912,10008,24802,7891,20882,229,739,6174,15738,6403,16477
240110,201912,4512,12827,3810,11534,195,712,2761,8176,2956,8888
240120,201912,3385,9239,2581,8284,198,723,1801,5899,1999,6622
240130,201912,3621,7574,3007,6771,28,96,2754,6094,2782,6190
240140,201912,1833,5457,1547,4905,167,567,1040,3264,1207,3831
240145,201912,6631,18520,5389,16326,841,2602,3021,9221,3862,11823
240150,201912,898,2647,803,2446,55,200,614,1807,669,2007
240160,201912,1431,4343,1191,3880,48,225,882,2878,930,3103
240165,201912,970,2655,792,2304,41,135,630,1799,671,1934
240170,201912,2420,6599,2026,5879,192,642,1368,3840,1560,4482
240180,201912,3012,8895,2364,7580,556,1694,1092,3710,1648,5404
240185,201912,1208,3848,1090,3653,57,235,897,2960,954,3195
240190,201912,1029,3037,891,2803,22,98,748,2360,770,2458
240200,201912,10827,27927,8587,24019,872,2663,4926,13439,5798,16102
240210,201912,2990,7551,2563,6906,29,147,2162,5637,2191,5784
240220,201912,7341,22009,6525,20701,359,1575,5048,15676,5407,17251
240230,201912,5876,14995,4684,12956,197,550,3718,10279,3915,10829
240240,201912,1848,5305,1116,3500,119,404,425,1162,544,1566
240250,201912,2877,7654,2538,7164,104,310,2109,5932,2213,6242
240260,201912,14156,41710,12157,38248,1720,5136,7508,24699,9228,29835
240270,201912,2250,6702,1938,6181,100,316,1432,4659,1532,4975
240280,201912,1681,4289,1419,3869,50,129,1139,3062,1189,3191
240290,201912,1184,3443,957,2941,29,126,666,1918,695,2044
240300,201912,2188,5655,1542,4421,73,236,1006,2808,1079,3044
240310,201912,8561,22670,6703,19268,883,2684,3502,9878,4385,12562
240320,201912,2026,5518,1439,4344,32,146,1104,3163,1136,3309
240325,201912,30257,81596,23339,69219,4362,13388,9877,29591,14239,42979
240330,201912,1728,4710,1289,3857,48,172,888,2535,936,2707
240340,201912,1989,4605,1614,4021,66,155,1308,3196,1374,3351
240350,201912,2113,5476,1910,5250,22,79,1730,4761,1752,4840
240360,201912,8533,23825,7570,22270,875,2589,5222,15587,6097,18176
240370,201912,1906,5075,1469,4167,73,217,1022,2831,1095,3048
240375,201912,898,2265,738,1967,28,101,595,1533,623,1634
240380,201912,2262,6418,1630,4995,135,400,968,2917,1103,3317
240390,201912,989,2458,662,1823,30,82,421,1078,451,1160
240400,201912,1394,3477,1086,2922,34,130,768,1950,802,2080
240410,201912,578,1756,477,1532,45,182,297,892,342,1074
240420,201912,4556,16073,3987,14775,468,2092,2338,8433,2806,10525
240430,201912,3353,8790,2792,7748,180,569,2046,5486,2226,6055
240440,201912,2586,5673,2155,5061,149,306,1714,4008,1863,4314
240450,201912,4513,12267,3494,10337,357,1107,2061,5846,2418,6953
240460,201912,2881,8236,2606,7791,260,831,2000,5941,2260,6772
240470,201912,3600,10832,2728,9014,455,1423,1430,4921,1885,6344
240480,201912,555,1532,372,1135,28,87,175,517,203,604
240485,201912,2115,5970,1716,5204,137,425,1169,3556,1306,3981
240490,201912,1638,4183,1273,3510,75,179,950,2636,1025,2815
240500,201912,2145,5779,1855,5294,85,247,1525,4329,1610,4576
240510,201912,1682,4377,1475,4076,72,266,1221,3274,1293,3540
240520,201912,1378,3451,1074,3029,45,158,825,2294,870,2452
240530,201912,2118,6137,1902,5777,106,314,1537,4658,1643,4972
240540,201912,2282,5709,1972,5217,65,145,1710,4512,1775,4657
240550,201912,694,1979,629,1854,21,90,507,1435,528,1525
240560,201912,3280,8556,2758,7845,302,776,1991,5752,2293,6528
240570,201912,2761,7260,1797,5088,269,791,734,1934,1003,2725
240580,201912,8112,23583,7147,21796,566,1681,5686,17411,6252,19092
240590,201912,712,1878,606,1696,13,46,463,1265,476,1311
240600,201912,1784,4820,1298,3801,46,156,873,2471,919,2627
240610,201912,4247,11495,3565,10234,134,456,2694,7573,2828,8029
240615,201912,1183,3141,932,2653,65,211,649,1750,714,1961
240620,201912,1874,5263,1574,4718,89,256,1247,3701,1336,3957
240630,201912,2068,5937,1855,5566,136,323,1303,4035,1439,4358
240640,201912,930,2515,728,2161,26,102,545,1593,571,1695
240650,201912,4032,11106,3474,10045,186,554,2690,7670,2876,8224
240660,201912,3075,7892,2708,7410,55,172,2443,6684,2498,6856
240670,201912,2445,6863,1960,5857,142,441,1268,3680,1410,4121
240680,201912,1639,4343,1292,3751,54,165,984,2787,1038,2952
240690,201912,985,2485,769,2111,16,69,614,1608,630,1677
240700,201912,2413,6999,1962,6147,66,246,1528,4701,1594,4947
240710,201912,16239,42101,13453,37203,1812,4883,8244,22822,10056,27705
240720,201912,5198,12908,4471,11852,388,1094,3255,8498,3643,9592
240725,201912,1124,3212,856,2661,30,102,571,1724,601,1826
240730,201912,2151,6067,1782,5339,65,230,1360,3989,1425,4219
240740,201912,1832,4901,1466,4197,45,174,1083,2931,1128,3105
240750,201912,2186,7219,1814,6424,281,1102,945,3370,1226,4472
240760,201912,1562,3763,1084,3031,51,89,843,2420,894,2509
240770,201912,3199,8827,2679,8062,119,443,2158,6396,2277,6839
240780,201912,4999,13614,3972,11896,511,1549,2437,7427,2948,8976
240790,201912,855,2428,697,2121,12,50,524,1554,536,1604
240800,201912,45959,111975,35252,95314,4844,13503,18006,48626,22850,62129
240810,201912,87364,228650,73453,204928,9905,28050,45488,125304,55393,153354
240820,201912,5789,17298,4960,15780,661,2098,3095,9978,3756,12076
240830,201912,8726,25015,7775,23559,260,1142,6384,19059,6644,20201
240840,201912,1133,2825,889,2413,32,82,629,1638,661,1720
240850,201912,1321,3607,934,2776,41,130,543,1548,584,1678
240860,201912,1244,3375,931,2801,16,73,695,1990,711,2063
240870,201912,1125,2863,841,2354,136,387,458,1293,594,1680
240880,201912,1277,4022,1118,3702,86,358,863,2786,949,3144
240890,201912,4488,12259,3342,10020,461,1495,1698,4868,2159,6363
240895,201912,2657,8328,2406,7951,124,429,2105,6967,2229,7396
240910,201912,3280,8996,2779,8075,59,222,2284,6522,2343,6744
240920,201912,836,2332,694,2090,58,167,403,1261,461,1428
240930,201912,3716,8479,3057,7674,195,283,2314,6085,2509,6368
240933,201912,1781,4322,1446,3818,44,177,1245,3228,1289,3405
240940,201912,6160,15216,4771,12817,442,1223,3062,7983,3504,9206
240950,201912,998,2982,861,2724,29,125,694,2144,723,2269
240960,201912,684,2090,606,1925,30,114,470,1460,500,1574
240970,201912,1842,4736,1475,4117,58,211,1205,3250,1263,3461
240980,201912,3214,9656,2878,9036,129,541,2314,7111,2443,7652
240990,201912,2574,7304,2272,6701,259,856,1600,4516,1859,5372
241000,201912,934,2477,740,2111,32,80,538,1523,570,1603
241010,201912,2788,8911,2529,8345,166,666,1866,6035,2032,6701
241020,201912,2079,5603,1507,4428,160,466,949,2756,1109,3222
241025,201912,1733,4976,1360,4259,48,209,977,3004,1025,3213
241030,201912,2514,7813,1987,6689,223,779,1290,4310,1513,5089
241040,201912,2300,7264,2031,6807,100,440,1628,5412,1728,5852
241050,201912,1313,3642,1060,3169,37,138,796,2313,833,2451
241060,201912,728,2064,639,1870,24,84,457,1283,481,1367
241070,201912,651,1778,566,1631,14,53,441,1219,455,1272
241080,201912,1133,3200,839,2604,7,29,625,1914,632,1943
241090,201912,2019,5870,1623,5188,50,254,1279,4011,1329,4265
241100,201912,1154,3259,900,2712,63,202,601,1757,664,1959
241105,201912,1004,3055,807,2666,257,836,258,884,515,1720
241110,201912,928,2631,690,2113,33,115,459,1348,492,1463
241120,201912,7632,21557,6434,19422,967,2852,3737,11605,4704,14457
241140,201912,3307,8727,2589,7271,165,472,1873,5121,2038,5593
241142,201912,766,2064,554,1642,27,97,324,898,351,995
241150,201912,5943,15520,5236,14332,155,533,4290,11513,4445,12046
241160,201912,1156,3102,934,2693,140,402,584,1642,724,2044
241170,201912,1318,3373,1128,3042,30,121,943,2429,973,2550
241180,201912,1021,2645,732,2087,88,253,382,1050,470,1303
241190,201912,1118,2952,914,2542,17,68,668,1783,685,1851
241200,201912,19050,50112,16277,45613,2621,7317,9436,26525,12057,33842
241210,201912,1407,3786,988,2938,120,385,570,1640,690,2025
241220,201912,8745,25990,7560,23953,1809,5656,3501,11589,5310,17245
241230,201912,2903,7680,2544,7111,95,326,2133,5844,2228,6170
241240,201912,1185,3327,690,2203,57,191,319,1016,376,1207
241250,201912,5299,15458,4244,13444,166,775,3112,9446,3278,10221
241255,201912,2146,6817,1862,6187,110,478,1382,4459,1492,4937
241260,201912,4872,12760,3779,10897,87,369,2978,8381,3065,8750
241270,201912,1771,5119,1447,4477,114,398,1017,3110,1131,3508
241280,201912,2191,5500,1874,4918,65,181,1574,4058,1639,4239
241290,201912,3415,8359,2538,6911,73,279,2020,5322,2093,5601
241300,201912,1435,3852,1121,3270,37,129,779,2209,816,2338
241310,201912,2098,5279,1777,4818,15,63,1504,4104,1519,4167
241320,201912,1002,3207,825,2852,95,397,522,1775,617,2172
241330,201912,1768,4589,1362,4057,19,90,1173,3472,1192,3562
241335,201912,3219,8986,2832,8257,105,351,2353,6772,2458,7123
241340,201912,1558,4435,1193,3659,253,808,498,1488,751,2296
241350,201912,2019,5837,1773,5386,97,332,1357,4057,1454,4389
241355,201912,1298,3507,1050,3035,18,62,820,2338,838,2400
241360,201912,2078,5387,1536,4258,46,139,1107,2954,1153,3093
241370,201912,1352,3722,1036,3061,50,172,724,2035,774,2207
241380,201912,621,1761,476,1458,73,203,244,765,317,968
241390,201912,2746,8095,2426,7606,182,524,1869,5925,2051,6449
241400,201912,3519,9794,3120,9163,157,504,2535,7370,2692,7874
241410,201912,2376,7076,1899,6076,338,1101,972,3115,1310,4216
241415,201912,1656,4899,1342,4277,63,237,940,2920,1003,3157
241420,201912,2238,7212,1899,6599,453,1727,899,3090,1352,4817
241430,201912,587,1617,397,1174,23,79,254,724,277,803
241440,201912,7414,23111,6594,21656,354,1387,5216,16903,5570,18290
241445,201912,1109,2840,981,2675,24,53,880,2462,904,2515
241450,201912,2608,6554,2231,5946,381,853,1476,4057,1857,4910
241460,201912,3662,9944,2950,8437,181,574,2100,5850,2281,6424
241470,201912,1430,3748,1141,3325,26,95,942,2732,968,2827
241475,201912,1198,3393,909,2823,22,114,660,1940,682,2054
241480,201912,2884,9038,2360,7893,718,2353,797,2962,1515,5315
241490,201912,653,1559,520,1370,23,68,361,923,384,991
241500,201912,812,2320,719,2200,7,31,655,2010,662,2041
250010,201912,2573,7650,2109,6695,60,245,1530,4725,1590,4970
250020,201912,1581,4297,1102,3346,29,77,808,2421,837,2498
250030,201912,6892,18937,6051,17603,507,1547,4532,12991,5039,14538
250040,201912,4071,12523,3497,11450,219,838,2512,8066,2731,8904
250050,201912,3580,9681,3231,9181,100,403,2676,7517,2776,7920
250053,201912,1171,3339,1057,3156,73,239,766,2276,839,2515
250057,201912,658,2358,614,2289,8,33,547,2089,555,2122
250060,201912,5452,14305,4918,13631,304,795,4012,11191,4316,11986
250070,201912,3963,11131,3387,10106,44,188,2697,7842,2741,8030
250073,201912,755,2015,607,1783,6,25,496,1410,502,1435
250077,201912,2235,6019,1656,5051,64,221,1234,3738,1298,3959
250080,201912,4829,12132,4126,11210,67,309,3566,9531,3633,9840
250090,201912,3246,8014,2835,7458,53,165,2445,6302,2498,6467
250100,201912,3639,11161,3294,10505,172,630,2583,8046,2755,8676
250110,201912,4889,13668,4376,12910,272,988,3413,9835,3685,10823
250115,201912,682,1787,486,1483,9,49,344,1036,353,1085
250120,201912,1827,5372,1521,4842,32,154,1193,3758,1225,3912
250130,201912,5466,15093,4605,13851,75,404,3849,11398,3924,11802
250135,201912,1161,3214,1027,2988,24,98,898,2587,922,2685
250140,201912,2254,6659,2093,6450,124,549,1768,5323,1892,5872
250150,201912,4846,15095,4340,14209,150,666,3472,11144,3622,11810
250153,201912,1418,3713,1168,3333,27,82,947,2660,974,2742
250157,201912,1717,5123,1529,4753,64,266,1218,3718,1282,3984
250160,201912,3905,9745,3113,8657,32,142,2763,7646,2795,7788
250170,201912,1834,4696,1623,4385,27,106,1401,3726,1428,3832
250180,201912,20006,48680,17065,44843,783,2478,13216,33805,13999,36283
250190,201912,4090,10953,3404,9894,347,999,2298,6554,2645,7553
250200,201912,1923,5175,1632,4751,56,189,1368,3972,1424,4161
250205,201912,838,2599,715,2391,19,91,594,1960,613,2051
250210,201912,1569,4776,1411,4516,52,265,1122,3513,1174,3778
250215,201912,1533,4245,1268,3845,71,242,773,2319,844,2561
250220,201912,663,1870,535,1668,31,119,356,1070,387,1189
250230,201912,1577,3582,1127,2901,23,69,907,2263,930,2332
250240,201912,2289,6925,1999,6388,42,198,1664,5222,1706,5420
250250,201912,4585,12724,3956,11796,84,295,3350,9980,3434,10275
250260,201912,1709,4757,1414,4250,43,128,1122,3341,1165,3469
250270,201912,1203,3613,1070,3449,67,230,801,2666,868,2896
250280,201912,3260,9168,2875,8565,98,301,2295,6806,2393,7107
250290,201912,1610,4227,1351,3852,25,75,1063,3044,1088,3119
250300,201912,5500,14677,4963,14046,199,894,4103,11156,4302,12050
250310,201912,1134,3120,940,2791,35,124,727,2118,762,2242
250320,201912,11585,26363,9943,24440,272,781,8795,21305,9067,22086
250330,201912,2337,6546,1938,6008,106,347,1559,4803,1665,5150
250340,201912,1096,2795,963,2615,7,19,879,2364,886,2383
250350,201912,4035,11235,3577,10489,157,408,2845,8568,3002,8976
250355,201912,1981,5989,1761,5684,29,161,1575,5041,1604,5202
250360,201912,1766,4900,1575,4629,42,154,1300,3796,1342,3950
250370,201912,13173,34282,10817,30691,275,1055,8958,25007,9233,26062
250375,201912,1196,3090,951,2789,6,18,885,2627,891,2645
250380,201912,1607,4162,1467,3981,28,127,1272,3323,1300,3450
250390,201912,1785,4589,1496,4118,97,252,1174,3214,1271,3466
250400,201912,70569,172682,49996,140359,13700,40817,15145,44328,28845,85145
250403,201912,1716,4821,1529,4593,69,356,1175,3368,1244,3724
250407,201912,1204,3053,968,2703,59,132,703,1997,762,2129
250410,201912,607,1632,526,1498,6,14,437,1225,443,1239
250415,201912,1825,5187,1603,4822,35,157,1372,4102,1407,4259
250420,201912,1203,3389,1082,3225,23,93,964,2845,987,2938
250430,201912,6305,15485,5306,14117,136,447,4370,11379,4506,11826
250435,201912,1542,4254,1232,3712,13,60,942,2802,955,2862
250440,201912,4599,12117,3928,11273,68,210,3475,9964,3543,10174
250450,201912,1799,4822,1493,4402,26,108,1234,3633,1260,3741
250460,201912,7425,20026,6537,18708,327,1019,5274,14992,5601,16011
250470,201912,1544,3983,1270,3562,51,166,984,2706,1035,2872
250480,201912,4138,11053,3509,10310,24,89,3142,9340,3166,9429
250485,201912,718,1635,521,1352,35,70,379,951,414,1021
250490,201912,5179,12293,4591,11609,175,533,4038,10015,4213,10548
250500,201912,1982,5476,1748,5073,73,237,1414,4093,1487,4330
250510,201912,5495,13743,4701,12692,83,233,4125,11218,4208,11451
250520,201912,1849,5003,1568,4594,133,430,1106,3209,1239,3639
250523,201912,2245,5504,1985,5174,72,308,1650,4154,1722,4462
250527,201912,1682,4317,1510,4117,25,70,1327,3655,1352,3725
250530,201912,632,1626,533,1495,6,17,464,1299,470,1316
250535,201912,1350,3957,1223,3705,29,135,993,2906,1022,3041
250540,201912,3021,6862,2467,6241,70,122,2166,5573,2236,5695
250550,201912,769,2471,668,2278,24,98,502,1677,526,1775
250560,201912,1703,4681,1490,4359,40,153,1250,3566,1290,3719
250570,201912,2636,7912,2245,7192,81,319,1761,5525,1842,5844
250580,201912,1061,2738,934,2558,45,162,781,2094,826,2256
250590,201912,832,2315,725,2154,20,81,605,1790,625,1871
250600,201912,8249,20951,6858,19143,278,868,5667,15663,5945,16531
250610,201912,3042,8452,2701,7948,125,473,2234,6458,2359,6931
250620,201912,757,2027,636,1808,12,50,479,1330,491,1380
250625,201912,2543,7319,2257,6843,44,230,1896,5572,1940,5802
250630,201912,10085,28090,8115,24519,873,2689,5210,15382,6083,18071
250640,201912,3340,9259,3021,8839,70,342,2609,7448,2679,7790
250650,201912,957,2323,795,2099,16,55,687,1772,703,1827
250660,201912,1566,3898,1315,3559,40,116,1094,2876,1134,2992
250670,201912,2334,7292,2117,6897,44,199,1836,5866,1880,6065
250680,201912,5941,13555,5246,12761,78,284,4798,11476,4876,11760
250690,201912,6871,15568,5845,14268,105,277,5173,12467,5278,12744
250700,201912,4321,12102,3746,11217,421,1254,2629,7801,3050,9055
250710,201912,4468,12760,3823,11865,301,1051,2739,8475,3040,9526
250720,201912,2760,7309,2472,6902,36,178,2163,5950,2199,6128
250730,201912,4142,10951,3600,10235,102,418,3009,8296,3111,8714
250740,201912,1980,4939,1603,4438,93,243,1238,3420,1331,3663
250750,201912,102857,254425,86776,231623,7248,21085,62558,163372,69806,184457
250760,201912,2349,6030,2035,5521,88,268,1618,4272,1706,4540
250770,201912,4010,12105,3586,11529,366,1204,2597,8372,2963,9576
250780,201912,1737,4671,1437,4116,60,209,1096,3057,1156,3266
250790,201912,2466,7328,2122,6800,160,635,1421,4427,1581,5062
250800,201912,2479,6549,2128,5983,88,184,1733,4908,1821,5092
250810,201912,1269,3389,1010,3007,20,49,865,2586,885,2635
250820,201912,1971,5514,1818,5342,36,150,1656,4830,1692,4980
250830,201912,5761,17198,4735,15142,259,1027,3276,10138,3535,11165
250840,201912,775,2431,655,2193,15,58,486,1636,501,1694
250850,201912,1790,5375,1594,5027,30,154,1316,4038,1346,4192
250855,201912,944,2767,815,2544,59,201,614,1903,673,2104
250860,201912,3126,9262,2574,8298,445,1523,1489,4783,1934,6306
250870,201912,1037,2847,860,2547,36,132,703,2055,739,2187
250880,201912,1608,4130,1314,3702,85,263,992,2774,1077,3037
250890,201912,10037,26538,8894,24954,441,1889,7044,18717,7485,20606
250900,201912,2795,7836,2393,7090,60,241,2020,5835,2080,6076
250905,201912,2387,6800,2177,6487,47,181,1963,5839,2010,6020
250910,201912,6030,14892,4932,13625,83,294,4212,11716,4295,12010
250915,201912,2124,4976,1506,4306,23,58,1319,3859,1342,3917
250920,201912,3559,9000,3089,8264,326,763,2257,6032,2583,6795
250930,201912,2225,5974,2007,5682,60,237,1721,4771,1781,5008
250933,201912,1168,3469,1027,3213,22,117,778,2354,800,2471
250937,201912,706,1894,573,1671,21,73,433,1281,454,1354
250939,201912,1726,4629,1495,4321,65,210,1167,3345,1232,3555
250940,201912,3916,10569,3433,9924,27,101,3013,8703,3040,8804
250950,201912,1687,4312,1350,3887,23,99,1132,3211,1155,3310
250960,201912,1103,3225,960,2990,25,137,780,2333,805,2470
250970,201912,8338,21514,7249,19765,251,802,5907,15761,6158,16563
250980,201912,2493,6614,2220,6194,38,159,1884,5117,1922,5276
250990,201912,2019,6130,1673,5498,58,267,1242,4030,1300,4297
251000,201912,2043,5755,1644,5071,38,166,1330,4061,1368,4227
251010,201912,2626,7378,2364,6976,21,91,2150,6333,2171,6424
251020,201912,1655,4474,1485,4210,31,140,1294,3586,1325,3726
251030,201912,1000,2653,813,2303,34,95,570,1589,604,1684
251040,201912,1847,5266,1551,4749,42,200,1234,3741,1276,3941
251050,201912,1072,2909,897,2567,47,156,643,1780,690,1936
251060,201912,1074,2304,803,1963,7,29,651,1544,658,1573
251065,201912,468,1274,366,1092,14,38,252,730,266,768
251070,201912,718,1874,610,1720,9,34,517,1431,526,1465
251080,201912,18557,47704,15098,42459,1784,5284,9843,27643,11627,32927
251090,201912,2753,7915,2314,7115,55,196,1869,5705,1924,5901
251100,201912,799,2550,708,2379,29,115,527,1697,556,1812
251110,201912,1704,4568,1429,4083,44,120,1093,3095,1137,3215
251120,201912,7183,20314,6040,18870,264,1020,4773,14810,5037,15830
251130,201912,3929,8774,3455,8238,72,186,3109,7373,3181,7559
251140,201912,4240,11851,3806,11242,75,315,3182,9273,3257,9588
251150,201912,2677,7738,2389,7281,111,448,1930,5735,2041,6183
251160,201912,2105,6185,1827,5785,53,228,1553,4825,1606,5053
251170,201912,1552,4234,1351,3962,37,132,1166,3401,1203,3533
251180,201912,2619,7036,2148,6376,169,513,1450,4263,1619,4776
251190,201912,4368,11354,4002,10929,46,244,3626,9697,3672,9941
251200,201912,4339,12705,3840,12052,81,347,3352,10543,3433,10890
251203,201912,941,3061,863,2891,23,106,656,2133,679,2239
251207,201912,1077,2964,828,2543,21,107,578,1724,599,1831
251210,201912,7475,19182,5993,17186,253,632,4588,13344,4841,13976
251220,201912,1188,2886,912,2508,51,128,713,1984,764,2112
251230,201912,4625,12800,3959,11655,126,483,3131,8975,3257,9458
251240,201912,3646,9958,3028,8933,132,395,2287,6599,2419,6994
251250,201912,10143,27376,8881,25257,762,2314,6518,17939,7280,20253
251260,201912,483,1389,439,1315,12,62,347,998,359,1060
251270,201912,4264,13254,3799,12616,110,448,3117,10544,3227,10992
251272,201912,1356,3684,1212,3482,43,165,1004,2801,1047,2966
251274,201912,906,2506,717,2166,58,190,484,1392,542,1582
251275,201912,1219,3398,1038,3113,36,167,792,2285,828,2452
251276,201912,1325,3566,1154,3344,32,171,930,2594,962,2765
251278,201912,579,1621,512,1517,42,106,371,1122,413,1228
251280,201912,2256,6156,1987,5733,50,194,1650,4670,1700,4864
251290,201912,5892,13989,5343,13303,149,518,4663,11194,4812,11712
251300,201912,841,2488,754,2356,7,35,647,2009,654,2044
251310,201912,2760,7917,2391,7330,53,268,1889,5650,1942,5918
251315,201912,1704,5358,1558,5093,77,240,1166,3763,1243,4003
251320,201912,1626,4284,1133,3424,30,99,846,2522,876,2621
251330,201912,2085,4832,1697,4370,20,72,1545,4002,1565,4074
251335,201912,1048,3127,933,2945,24,103,809,2488,833,2591
251340,201912,3696,8969,2927,7923,115,356,2214,5919,2329,6275
251350,201912,1068,3095,947,2893,30,132,780,2325,810,2457
251360,201912,1813,5110,1454,4606,20,93,1247,3951,1267,4044
251365,201912,712,1963,560,1657,8,26,431,1260,439,1286
251370,201912,23136,61774,19822,57037,2382,7069,12715,36965,15097,44034
251380,201912,1205,3431,1048,3161,19,108,873,2540,892,2648
251385,201912,739,1914,566,1599,17,53,423,1152,440,1205
251390,201912,6421,18769,5621,17466,479,1578,3688,11421,4167,12999
251392,201912,984,2679,811,2413,25,114,627,1817,652,1931
251394,201912,611,1804,498,1601,22,90,373,1174,395,1264
251396,201912,699,1873,590,1687,17,46,407,1140,424,1186
251398,201912,940,2389,661,1901,14,61,496,1387,510,1448
251400,201912,1218,3013,976,2671,28,102,769,2031,797,2133
251410,201912,1465,3481,1191,3080,17,74,1015,2533,1032,2607
251420,201912,1920,5063,1546,4627,43,160,1200,3558,1243,3718
251430,201912,1531,4693,1358,4401,33,160,1165,3761,1198,3921
251440,201912,1132,3173,909,2738,38,102,715,2173,753,2275
251445,201912,1535,4336,1410,4149,35,146,1185,3405,1220,3551
251450,201912,4473,13179,3969,12422,84,377,3288,10175,3372,10552
251455,201912,871,2649,786,2490,23,100,607,1885,630,1985
251460,201912,885,2540,772,2362,18,67,641,1956,659,2023
251465,201912,433,1279,364,1140,4,17,274,846,278,863
251470,201912,1167,3229,866,2602,64,211,510,1446,574,1657
251480,201912,981,2601,802,2284,20,88,615,1669,635,1757
251490,201912,1883,4959,1480,4400,51,163,1091,3230,1142,3393
251500,201912,1957,5484,1777,5239,30,109,1609,4733,1639,4842
251510,201912,2653,7956,2168,6958,121,450,1454,4548,1575,4998
251520,201912,945,2491,713,2057,61,170,475,1338,536,1508
251530,201912,14622,35084,11798,31529,112,612,10407,27282,10519,27894
251540,201912,2876,8411,2580,7853,85,311,2118,6335,2203,6646
251550,201912,3718,8898,2934,7899,93,208,2456,6641,2549,6849
251560,201912,571,1711,495,1593,62,211,337,1047,399,1258
251570,201912,931,2630,752,2272,20,90,589,1722,609,1812
251580,201912,1935,4589,1715,4259,47,187,1483,3536,1530,3723
251590,201912,1583,4000,1336,3706,59,181,1082,2906,1141,3087
251593,201912,885,2611,801,2472,78,254,520,1564,598,1818
251597,201912,2109,5922,1896,5638,20,94,1668,4896,1688,4990
251600,201912,6430,17376,5623,16115,165,542,4647,13108,4812,13650
251610,201912,3249,9197,2757,8287,250,686,1907,5815,2157,6501
251615,201912,1241,3100,993,2718,24,63,791,2110,815,2173
251620,201912,18670,43364,14348,38057,123,407,12152,32731,12275,33138
251630,201912,4695,11009,3733,9673,199,547,2865,7322,3064,7869
251640,201912,2126,5850,1882,5454,34,167,1620,4565,1654,4732
251650,201912,4010,10699,3472,9988,122,391,2965,8488,3087,8879
251660,201912,3493,10427,3054,9647,80,378,2524,7810,2604,8188
251670,201912,4052,11476,3576,10803,48,250,3174,9486,3222,9736
251675,201912,654,1863,578,1769,73,228,386,1187,459,1415
251680,201912,2561,6809,2097,6188,42,152,1691,4993,1733,5145
251690,201912,3160,8879,2644,7952,87,278,1982,5871,2069,6149
251700,201912,2045,5907,1729,5510,42,194,1461,4571,1503,4765
251710,201912,783,2036,520,1484,44,156,303,839,347,995
251720,201912,1313,3706,1058,3251,22,98,810,2411,832,2509
251740,201912,607,1709,483,1473,41,146,339,989,380,1135
260005,201912,29940,63026,24371,55804,1643,3764,18762,42054,20405,45818
260010,201912,10121,26592,8327,23700,471,1419,4979,14253,5450,15672
260020,201912,6813,16020,5790,14546,112,499,4832,11933,4944,12432
260030,201912,6707,17281,5628,15675,148,464,4552,12590,4700,13054
260040,201912,7740,20233,6376,18155,482,1327,4391,12710,4873,14037
260050,201912,13854,36033,11479,33399,168,756,10484,30531,10652,31287
260060,201912,4010,10097,3406,9106,185,461,2706,7196,2891,7657
260070,201912,10501,26545,8985,24322,364,1249,7171,18919,7535,20168
260080,201912,6601,15034,5764,13898,118,385,4819,11371,4937,11756
260090,201912,4726,12195,4186,11455,504,1388,2897,7944,3401,9332
260100,201912,3056,8259,2547,7497,59,275,2066,5984,2125,6259
260105,201912,4985,13552,4444,12832,140,509,3706,10552,3846,11061
260110,201912,22418,61755,19848,58004,998,3417,16264,46772,17262,50189
260120,201912,14643,39189,12152,35383,1540,4409,7573,22398,9113,26807
260130,201912,3038,7899,2717,7422,208,597,2023,5405,2231,6002
260140,201912,13017,29656,11135,27359,596,1623,9260,22427,9856,24050
260150,201912,3612,8388,3081,7728,84,254,2692,6668,2776,6922
260160,201912,6566,17130,5481,15762,91,350,4897,14189,4988,14539
260170,201912,19417,46756,16383,42582,985,2572,12917,33196,13902,35768
260180,201912,3471,9270,2985,8605,80,301,2545,7215,2625,7516
260190,201912,18505,37183,15443,33581,171,478,13588,28885,13759,29363
260200,201912,11170,26730,9539,24638,440,1028,7983,20808,8423,21836
260210,201912,11863,33482,9977,30410,324,1278,7915,23904,8239,25182
260220,201912,10363,25036,9536,23961,163,560,8387,20710,8550,21270
260230,201912,10717,26379,9302,24477,200,670,7809,20148,8009,20818
260240,201912,2685,8032,2327,7339,124,438,1789,5584,1913,6022
260250,201912,2195,5780,1902,5331,130,300,1435,4018,1565,4318
260260,201912,12966,33830,11478,31498,404,1374,9037,24243,9441,25617
260270,201912,4159,10188,3632,9531,142,539,3001,7694,3143,8233
260280,201912,12782,38491,11418,36552,479,2058,9633,30377,10112,32435
260290,201912,39898,102119,34203,93584,3724,10403,23046,62713,26770,73116
260300,201912,9721,26160,8368,24284,219,955,6970,20130,7189,21085
260310,201912,5005,12969,4399,12185,293,780,3411,9545,3704,10325
260320,201912,7710,22143,6498,20050,264,841,5260,16204,5524,17045
260330,201912,2530,7786,2214,7126,69,270,1767,5536,1836,5806
260340,201912,2058,5490,1757,5022,31,143,1485,4139,1516,4282
260345,201912,24972,65418,20796,59136,3164,9597,10910,30366,14074,39963
260350,201912,5448,12891,4708,12018,86,239,4161,10564,4247,10803
260360,201912,2506,6542,2264,6094,44,207,1576,4154,1620,4361
260370,201912,5582,15974,4781,14609,239,855,3660,11061,3899,11916
260380,201912,4952,14709,4207,13456,157,588,3128,9872,3285,10460
260390,201912,4462,13400,3688,11789,207,688,2509,7836,2716,8524
260392,201912,3409,10861,3029,10372,123,730,2409,8243,2532,8973
260400,201912,17421,40776,15016,37593,497,1442,11753,28327,12250,29769
260410,201912,72480,176823,55337,152216,9920,28740,25032,70485,34952,99225
260415,201912,4518,12261,3881,11172,70,289,3146,8907,3216,9196
260420,201912,12867,26692,10846,24427,116,337,9979,22232,10095,22569
260430,201912,2786,8602,2360,7766,108,429,1664,5438,1772,5867
260440,201912,3701,9700,3242,8962,77,286,2692,7281,2769,7567
260450,201912,5742,14512,5139,13748,306,662,4184,11387,4490,12049
260460,201912,5254,15686,4455,14237,495,1750,2628,8219,3123,9969
260470,201912,4955,12996,4161,12064,91,220,3778,11132,3869,11352
260480,201912,4000,10626,3334,9663,209,779,2319,6709,2528,7488
260490,201912,5357,12320,4722,11367,44,165,4261,10070,4305,10235
260500,201912,6171,15513,5271,14216,460,1173,3680,10019,4140,11192
260510,201912,9641,23865,8052,21652,124,483,7078,18844,7202,19327
260515,201912,4222,11605,3241,9711,140,429,2159,6280,2299,6709
260520,201912,17322,40126,15079,37186,847,2068,12151,29564,12998,31632
260530,201912,9822,28018,8357,25752,165,786,7099,21551,7264,22337
260540,201912,7207,15602,6347,14501,174,393,5657,12812,5831,13205
260545,201912,52,158,20,79,2,7,5,15,7,22
260550,201912,3050,8491,2490,7548,119,491,1668,4929,1787,5420
260560,201912,6036,15360,5060,13945,133,532,4201,11327,4334,11859
260570,201912,7754,21085,6773,19739,406,1285,5293,15454,5699,16739
260580,201912,4501,10652,4008,9991,22,82,3667,9112,3689,9194
260590,201912,6749,15613,5623,14341,219,550,4681,12037,4900,12587
260600,201912,30672,79673,24782,70438,1148,3649,18589,51898,19737,55547
260610,201912,7216,18733,6462,17737,403,1215,4809,13049,5212,14264
260620,201912,16116,42104,14037,39048,1331,4159,10061,27366,11392,31525
260630,201912,2411,6450,1943,5697,33,141,1562,4465,1595,4606
260640,201912,21255,48606,17826,44604,835,2122,14257,35360,15092,37482
260650,201912,6042,15892,4772,14322,155,637,4047,12052,4202,12689
260660,201912,7179,18908,6118,17480,159,696,5189,14478,5348,15174
260670,201912,2195,5730,1805,5133,75,189,1342,3773,1417,3962
260680,201912,27513,65966,22983,59362,1653,4546,16031,40582,17684,45128
260690,201912,3599,9278,2916,8231,103,387,2275,6347,2378,6734
260700,201912,6050,17424,5663,16960,23,77,5490,16549,5513,16626
260710,201912,1352,3590,1171,3337,40,150,896,2558,936,2708
260720,201912,22725,57953,19817,53848,2100,5918,13969,37473,16069,43391
260730,201912,7565,21978,6597,20598,286,1078,5450,16721,5736,17799
260740,201912,1343,3771,1114,3406,9,53,882,2751,891,2804
260750,201912,7048,19432,5899,17964,114,387,5235,16178,5349,16565
260760,201912,5663,13439,4837,12434,193,549,3948,10165,4141,10714
260765,201912,7904,22924,6857,21455,417,1753,4830,14760,5247,16513
260770,201912,3851,9863,3208,8778,107,364,2526,6810,2633,7174
260775,201912,5269,14018,4625,13006,204,751,3568,9687,3772,10438
260780,201912,3614,10695,3197,10015,288,1082,2056,6218,2344,7300
260790,201912,119214,268027,98204,239910,15174,36039,60391,147512,75565,183551
260795,201912,3027,7809,2574,7191,97,331,1976,5537,2073,5868
260800,201912,5434,12616,4803,11720,137,439,4214,9920,4351,10359
260805,201912,3636,10309,3032,9222,165,594,2250,6702,2415,7296
260810,201912,6624,17864,5769,16217,497,1339,4114,11342,4611,12681
260820,201912,4417,10425,3881,9777,117,410,3192,7880,3309,8290
260825,201912,2943,8759,2533,8034,109,398,1868,5845,1977,6243
260830,201912,4293,12452,3561,11119,467,1301,2242,7197,2709,8498
260840,201912,4205,10956,3734,10288,218,559,3077,8493,3295,9052
260845,201912,4242,11268,3776,10440,231,634,2831,7752,3062,8386
260850,201912,4917,13589,4074,11927,347,1084,2657,7532,3004,8616
260860,201912,3523,9892,2951,8892,95,339,2354,6903,2449,7242
260870,201912,4543,10896,3878,10078,77,307,3437,8763,3514,9070
260875,201912,6948,17278,5643,15313,589,1611,3841,10403,4430,12014
260880,201912,9884,27565,8522,25160,508,1509,6628,19570,7136,21079
260890,201912,13213,33976,11394,31123,636,1897,8233,21949,8869,23846
260900,201912,5315,15042,4378,13634,321,1129,2891,8900,3212,10029
260910,201912,3176,8711,2742,8036,98,323,2156,6269,2254,6592
260915,201912,5177,15156,4519,14356,55,282,4125,13092,4180,13374
260920,201912,3328,8285,2802,7699,89,251,2370,6560,2459,6811
260930,201912,3715,11679,3146,10631,184,748,2329,7675,2513,8423
260940,201912,14609,35089,12654,32254,962,2480,9447,23676,10409,26156
260950,201912,6752,18164,5437,15834,375,1274,3463,9628,3838,10902
260960,201912,69150,155821,55191,137396,6210,16023,34789,85146,40999,101169
260970,201912,5473,14489,4842,13622,217,544,3680,10397,3897,10941
260980,201912,4554,13231,4010,12539,61,213,3639,11491,3700,11704
260990,201912,18107,49991,15195,46004,871,2962,11703,35084,12574,38046
261000,201912,16266,38495,13620,35015,406,1456,10870,27218,11276,28674
261010,201912,2417,6273,2105,5851,75,193,1827,5100,1902,5293
261020,201912,6185,16738,5225,15052,208,748,4202,11609,4410,12357
261030,201912,4085,11708,3495,10710,135,555,2753,8183,2888,8738
261040,201912,5211,15271,4168,13217,166,679,3085,9543,3251,10222
261050,201912,7812,20399,7065,19202,454,956,5270,14383,5724,15339
261060,201912,14126,35375,12277,33086,296,993,10177,27119,10473,28112
261070,201912,63124,137967,52004,123034,2824,6658,39589,91640,42413,98298
261080,201912,6544,15854,5947,15077,137,335,5467,13822,5604,14157
261090,201912,18820,44981,16655,42169,309,1112,14419,35841,14728,36953
261100,201912,8335,23138,7167,21387,522,1681,5178,15449,5700,17130
261110,201912,62933,176179,52194,156916,7952,24998,29815,88971,37767,113969
261120,201912,3791,9386,3226,8611,93,236,2763,7394,2856,7630
261130,201912,7355,17959,6423,16677,136,400,5642,14529,5778,14929
261140,201912,3613,8343,3211,7810,170,456,2575,6148,2745,6604
261150,201912,5373,13981,4705,12973,79,307,4093,11138,4172,11445
261153,201912,1886,5656,1602,5104,61,229,1090,3477,1151,3706
261160,201912,208788,487471,167963,429601,41297,108624,69256,179578,110553,288202
261170,201912,6068,15136,5354,14045,342,830,4254,11079,4596,11909
261180,201912,9648,24100,8404,22433,445,1223,6099,16250,6544,17473
261190,201912,4590,13498,4080,12630,215,895,3135,9391,3350,10286
261200,201912,3392,7834,3013,7314,135,364,2507,5951,2642,6315
261210,201912,1935,4637,1620,4199,61,187,1359,3453,1420,3640
261220,201912,13857,39115,11390,34454,1427,4660,6521,19360,7948,24020
261230,201912,4093,11666,3412,10698,59,247,2817,8898,2876,9145
261240,201912,5319,13345,4626,12237,257,697,3806,9920,4063,10617
261245,201912,3589,10119,3001,9074,78,362,2370,6931,2448,7293
261247,201912,2917,8738,2401,7776,142,521,1653,5290,1795,5811
261250,201912,21965,50312,18861,46618,1666,3719,14348,36310,16014,40029
261255,201912,4071,11965,3297,10464,140,614,2419,7416,2559,8030
261260,201912,12892,34517,11065,32157,349,1458,9455,27064,9804,28522
261270,201912,4284,10800,3758,10105,169,528,3132,8262,3301,8790
261280,201912,2564,7141,2244,6590,71,265,1782,5097,1853,5362
261290,201912,2946,7640,2477,7088,72,294,2001,5752,2073,6046
261300,201912,12196,34309,10242,30896,608,2191,7314,21573,7922,23764
261310,201912,8825,22539,7471,20635,685,2129,5385,14445,6070,16574
261320,201912,6019,17001,5217,15638,90,401,4337,12777,4427,13178
261330,201912,6004,14670,5378,13830,133,474,4663,11750,4796,12224
261340,201912,4235,12017,3657,11239,157,578,2956,8982,3113,9560
261350,201912,8790,25516,7770,23796,123,581,6350,19088,6473,19669
261360,201912,8284,20023,6974,18149,232,723,5538,13959,5770,14682
261370,201912,22930,57736,19205,52501,2134,5780,12368,33961,14502,39741
261380,201912,4040,12189,3550,11325,452,1555,2317,7268,2769,8823
261390,201912,16532,47027,13803,42505,1206,4054,9082,27723,10288,31777
261400,201912,4632,14686,3980,13284,159,733,2968,9617,3127,10350
261410,201912,9552,23970,7818,21236,527,1470,6025,16035,6552,17505
261420,201912,7379,22203,6656,21294,801,2961,4633,14693,5434,17654
261430,201912,3477,9766,2894,8836,66,278,2393,7187,2459,7465
261440,201912,1463,4348,1219,3871,40,197,874,2638,914,2835
261450,201912,15119,40769,13336,37935,220,837,10983,31185,11203,32022
261460,201912,7557,20794,6643,19377,179,685,5472,15766,5651,16451
261470,201912,4228,10482,3682,9762,27,140,3140,8309,3167,8449
261480,201912,5087,15597,4362,14350,204,842,3363,10782,3567,11624
261485,201912,5071,14322,4314,13104,369,1217,3001,8964,3370,10181
261500,201912,5872,15103,5104,14048,373,914,3552,10120,3925,11034
261510,201912,1899,5653,1626,5190,64,241,1212,3917,1276,4158
261520,201912,2387,7300,2143,6785,82,292,1530,4852,1612,5144
261530,201912,11668,34393,9393,30086,979,3758,4699,14462,5678,18220
261540,201912,8131,23272,7269,22002,1070,3224,4126,13076,5196,16300
261550,201912,3642,9689,3133,8881,222,697,2236,6206,2458,6903
261560,201912,7870,23301,6768,21641,321,1207,5105,16340,5426,17547
261570,201912,3503,9390,2774,8195,206,730,1902,5482,2108,6212
261580,201912,6671,17585,5810,16426,123,577,5157,14352,5280,14929
261590,201912,2679,6858,2131,6077,71,224,1596,4504,1667,4728
261600,201912,5093,12977,4250,11698,332,824,2920,8283,3252,9107
261610,201912,2277,6333,1823,5529,89,329,1255,3761,1344,4090
261618,201912,2549,6387,2204,5877,63,191,1775,4676,1838,4867
261620,201912,4167,11734,3801,11193,890,2349,2286,7111,3176,9460
261630,201912,6401,17857,5379,15918,364,1292,3588,10184,3952,11476
261640,201912,37374,83761,31734,76701,1748,3513,24108,59714,25856,63227
261650,201912,4172,10335,3569,9534,155,497,2656,7033,2811,7530
270010,201912,4334,14550,3720,13486,167,954,2902,10228,3069,11182
270020,201912,3908,9813,3399,9159,146,505,2883,7584,3029,8089
270030,201912,33056,90267,27670,81571,3738,10816,18146,53613,21884,64429
270040,201912,10945,29383,9366,27511,370,1477,7726,22413,8096,23890
270050,201912,5586,12813,4735,11853,202,482,4151,10436,4353,10918
270060,201912,2093,5367,1735,4953,112,298,1408,4060,1520,4358
270070,201912,4646,13056,4028,12177,153,581,3357,9937,3510,10518
270080,201912,1437,3919,1192,3498,42,131,909,2552,951,2683
270090,201912,1814,5512,1609,5120,70,300,1300,4011,1370,4311
270100,201912,5545,14732,4780,13600,168,649,3909,10862,4077,11511
270110,201912,3273,7723,2612,6937,133,341,2062,5700,2195,6041
270120,201912,2837,7675,2447,7152,74,320,2061,5927,2135,6247
270130,201912,5132,13224,4427,12382,132,435,3783,10584,3915,11019
270135,201912,2018,4841,1703,4487,53,165,1525,4001,1578,4166
270140,201912,9783,22660,7785,19869,315,1127,6163,14920,6478,16047
270150,201912,2730,8145,2504,7821,6,40,2366,7365,2372,7405
270160,201912,6142,16723,5209,15641,57,347,4817,14353,4874,14700
270170,201912,3421,9968,2873,9200,191,896,2142,6576,2333,7472
270180,201912,2273,6979,2058,6700,42,207,1833,5914,1875,6121
270190,201912,1653,4909,1463,4668,39,197,1268,4006,1307,4203
270200,201912,2408,7298,2067,6818,116,458,1510,4905,1626,5363
270210,201912,5740,13541,4904,12599,84,348,4489,11336,4573,11684
270220,201912,1446,3808,1132,3366,205,631,636,1863,841,2494
270230,201912,9342,25966,7660,23334,664,2262,5382,16162,6046,18424
270235,201912,5803,17834,4997,16526,134,618,4059,13239,4193,13857
270240,201912,10743,29308,8591,26320,843,2893,6139,18690,6982,21583
270250,201912,2791,7047,2416,6513,193,511,1875,5059,2068,5570
270255,201912,4502,12881,3470,10975,114,469,2597,8070,2711,8539
270260,201912,5657,16617,5116,15720,107,545,4445,13299,4552,13844
270270,201912,1051,2737,877,2518,117,344,624,1776,741,2120
270280,201912,3966,9412,3133,8362,473,769,2183,6280,2656,7049
270290,201912,7562,24027,6751,22662,196,918,5762,19115,5958,20033
270300,201912,4199,10967,3268,9945,155,439,2517,7828,2672,8267
270310,201912,7013,19557,6003,18016,127,647,5074,14797,5201,15444
270320,201912,5552,16174,4796,14739,471,1506,3360,10087,3831,11593
270330,201912,3884,12673,3422,11974,268,1091,2591,9010,2859,10101
270340,201912,1623,4426,1400,4130,54,173,1162,3383,1216,3556
270350,201912,1833,4395,1497,3986,155,464,1037,2773,1192,3237
270360,201912,2574,6504,2282,6171,71,193,2090,5652,2161,5845
270370,201912,1374,4288,1243,4035,44,212,1015,3231,1059,3443
270375,201912,3113,7224,2577,6626,19,52,2420,6239,2439,6291
270380,201912,5480,15600,4581,14399,619,1916,2914,9511,3533,11427
270390,201912,1203,3019,982,2761,24,104,804,2248,828,2352
270400,201912,6276,16645,5233,15026,228,707,4079,11521,4307,12228
270410,201912,4614,13344,3980,12344,171,614,3280,10092,3451,10706
270420,201912,5549,16405,4976,15560,129,629,4286,13123,4415,13752
270430,201912,138857,332145,108626,292971,21867,61304,50859,138724,72726,200028
270440,201912,4792,12915,4116,12081,92,415,3544,10249,3636,10664
270450,201912,6938,18753,6107,17748,244,903,5119,14836,5363,15739
270460,201912,3796,8361,3264,7737,121,280,2954,6940,3075,7220
270470,201912,11153,31091,9627,28866,723,2399,7268,21732,7991,24131
270480,201912,2950,7839,2498,7186,109,434,2010,5626,2119,6060
270490,201912,961,2676,830,2512,50,172,663,1978,713,2150
270500,201912,4937,15125,4365,14186,297,1118,3347,10726,3644,11844
270510,201912,5630,14979,4752,13828,343,1386,3535,9794,3878,11180
270520,201912,3823,11013,2987,9537,642,2128,1213,3998,1855,6126
270530,201912,1228,3546,1046,3263,53,155,751,2367,804,2522
270540,201912,2183,6336,1883,5945,64,305,1622,5011,1686,5316
270550,201912,6741,17404,5379,15892,580,1404,4022,12355,4602,13759
270560,201912,2997,7830,2593,7283,147,473,2061,5713,2208,6186
270570,201912,4169,11719,3512,10710,114,405,2836,8556,2950,8961
270580,201912,2300,6487,2073,6153,95,290,1779,5232,1874,5522
270590,201912,1617,4834,1486,4664,17,91,1400,4365,1417,4456
270600,201912,2755,8490,2480,8065,52,275,2184,6998,2236,7273
270610,201912,3708,9636,3162,8909,79,297,2805,7814,2884,8111
270620,201912,1187,3686,1082,3478,34,156,917,2861,951,3017
270630,201912,17522,42846,15031,39365,602,1927,12545,32069,13147,33996
270640,201912,5401,15496,4655,14298,163,656,3773,11324,3936,11980
270642,201912,2506,8056,2213,7570,159,687,1679,5601,1838,6288
270644,201912,3616,9002,2932,8097,265,658,2206,6233,2471,6891
270650,201912,3127,9226,2737,8661,385,1309,1882,5882,2267,7191
270660,201912,2048,5153,1677,4624,80,305,1255,3386,1335,3691
270670,201912,16204,37554,13427,34142,427,1331,11359,28220,11786,29551
270680,201912,5449,13161,4832,12473,125,185,4511,11799,4636,11984
270690,201912,8987,22364,7398,20365,617,1634,5610,15457,6227,17091
270700,201912,529,1573,459,1457,30,127,338,1054,368,1181
270710,201912,5508,16607,4900,15682,231,981,3949,12363,4180,13344
270720,201912,3479,10375,3061,9653,66,373,2680,8265,2746,8638
270730,201912,8176,18183,7159,17063,238,496,5649,14841,5887,15337
270740,201912,2365,6200,2084,5865,96,338,1726,4757,1822,5095
270750,201912,5658,15049,4929,14094,103,455,4299,12216,4402,12671
270760,201912,3305,9345,2856,8732,56,293,2401,7237,2457,7530
270770,201912,20986,51103,16550,45631,2557,6401,10322,29930,12879,36331
270780,201912,1738,5021,1590,4804,104,379,1272,3770,1376,4149
270790,201912,1565,4433,1302,4047,102,349,912,2797,1014,3146
270800,201912,10789,29707,9620,28041,360,1354,8184,23366,8544,24720
270810,201912,3287,9365,2562,8114,178,679,1789,5555,1967,6234
270820,201912,1679,5005,1399,4531,55,254,1083,3422,1138,3676
270830,201912,5218,12429,4204,11175,171,571,3387,8839,3558,9410
270840,201912,8246,24456,7334,23169,191,1079,6411,19647,6602,20726
270850,201912,9049,21524,8003,20262,650,1894,6591,16339,7241,18233
270860,201912,12911,30021,10514,27220,390,1264,8735,22173,9125,23437
270870,201912,2125,6025,1754,5405,223,701,1166,3638,1389,4339
270880,201912,8159,24356,7252,22972,232,999,5971,18557,6203,19556
270890,201912,2768,7535,2328,6899,182,576,1628,4787,1810,5363
270895,201912,3065,9570,2792,9203,79,418,2453,7921,2532,8339
270900,201912,1794,4621,1342,3886,40,119,1049,3022,1089,3141
270910,201912,3914,11379,3345,10441,109,411,2659,8175,2768,8586
270915,201912,9304,26833,7510,23800,672,2505,5075,15661,5747,18166
270920,201912,5179,16138,4654,15238,175,851,3786,11965,3961,12816
270930,201912,17315,40422,13365,35783,1887,4582,8998,25066,10885,29648
270940,201912,6479,17211,5547,16077,194,940,4479,12583,4673,13523
280010,201912,674,1857,533,1554,15,61,379,991,394,1052
280020,201912,4783,12229,4058,11072,501,1254,2692,7440,3193,8694
280030,201912,74496,175673,57565,151436,12613,33390,25357,69199,37970,102589
280040,201912,2959,8298,2573,7705,254,819,1714,5061,1968,5880
280050,201912,3912,11129,3354,10219,564,1793,1977,5999,2541,7792
280060,201912,5640,14952,4457,13104,808,2516,2173,6591,2981,9107
280067,201912,6906,17258,5831,15621,322,895,4243,11130,4565,12025
280070,201912,1956,5791,1811,5549,116,362,1488,4509,1604,4871
280100,201912,3966,10613,3302,9527,329,1000,2288,6546,2617,7546
280110,201912,1378,3745,1196,3468,20,92,1047,2959,1067,3051
280120,201912,7553,21916,6699,20527,754,2160,4896,15303,5650,17463
280130,201912,9130,21449,7944,19732,445,1170,6399,15760,6844,16930
280140,201912,5560,13291,4856,12345,216,625,4088,10273,4304,10898
280150,201912,4040,10108,3481,9386,258,671,2786,7508,3044,8179
280160,201912,1245,3559,1028,3179,100,342,686,2060,786,2402
280170,201912,5240,13749,4652,12958,239,664,3725,10375,3964,11039
280190,201912,1240,2760,1053,2502,53,133,837,1939,890,2072
280200,201912,1297,3384,1046,3006,92,320,745,2083,837,2403
280210,201912,16358,41213,14144,37969,1579,4415,9024,24140,10603,28555
280220,201912,1772,4741,1504,4368,41,207,1235,3543,1276,3750
280230,201912,4185,10551,3512,9567,275,677,2537,6928,2812,7605
280240,201912,3363,8953,3010,8420,59,309,2559,6922,2618,7231
280250,201912,873,2174,693,1896,53,175,455,1190,508,1365
280260,201912,2129,5200,1884,4900,37,100,1732,4517,1769,4617
280270,201912,2320,6422,2040,5972,114,381,1705,4896,1819,5277
280280,201912,4230,12592,3742,11874,468,1306,2628,8689,3096,9995
280290,201912,17985,47544,15316,43732,1356,4191,10283,29510,11639,33701
280300,201912,11634,28579,10096,26910,287,859,7688,22113,7975,22972
280310,201912,1366,3512,1120,3086,32,112,844,2254,876,2366
280320,201912,8661,23415,7457,21585,848,2514,4998,14233,5846,16747
280330,201912,4671,11589,3912,10501,275,754,2860,7586,3135,8340
280340,201912,5545,11545,4618,10535,217,391,3998,9259,4215,9650
280350,201912,25847,60853,22368,56146,1180,3193,17494,43107,18674,46300
280360,201912,5812,16156,5021,14792,779,2321,2927,8691,3706,11012
280370,201912,2198,5420,1792,4728,59,159,1418,3660,1477,3819
280380,201912,984,2699,825,2474,71,229,553,1652,624,1881
280390,201912,3671,9106,3020,8046,136,357,2394,6321,2530,6678
280400,201912,3927,9963,3343,9143,506,1235,2023,5817,2529,7052
280410,201912,2253,6271,1781,5463,200,651,1036,3098,1236,3749
280420,201912,4374,11678,3966,11137,81,304,3608,10058,3689,10362
280430,201912,2052,5021,1785,4664,67,257,1438,3618,1505,3875
280440,201912,4272,11506,3720,10663,163,573,3105,8671,3268,9244
280445,201912,2289,5795,2024,5324,50,160,1549,3899,1599,4059
280450,201912,10371,23770,8976,21886,853,1677,6527,16443,7380,18120
280460,201912,6900,16421,6202,15425,380,909,5208,12818,5588,13727
280470,201912,1700,4849,1453,4398,60,222,1066,3141,1126,3363
280480,201912,41910,101863,35947,93427,2891,8186,25735,65399,28626,73585
280490,201912,3684,10485,3170,9596,103,452,2430,7101,2533,7553
280500,201912,991,2370,830,2149,35,132,698,1759,733,1891
280510,201912,2563,6582,2193,6033,82,312,1678,4489,1760,4801
280520,201912,1613,4120,1405,3837,66,178,1120,3019,1186,3197
280530,201912,2565,6396,2174,5845,303,690,1512,4167,1815,4857
280540,201912,9062,24261,8172,22942,255,908,7113,19646,7368,20554
280550,201912,6688,15608,5416,13780,215,758,4380,10710,4595,11468
280560,201912,7110,19965,6640,19249,138,541,5823,16669,5961,17210
280570,201912,6520,15849,5250,14208,215,701,3903,10446,4118,11147
280580,201912,5612,15132,4802,13889,553,1488,3349,9796,3902,11284
280590,201912,2956,6646,2488,6102,113,421,1950,4565,2063,4986
280600,201912,3625,9678,3170,9012,167,535,2252,6385,2419,6920
280610,201912,2489,6122,2234,5740,138,353,1819,4633,1957,4986
280620,201912,5414,13333,4568,12202,417,929,3201,8887,3618,9816
280630,201912,3832,10862,3467,10330,173,614,2795,8235,2968,8849
280640,201912,2405,6438,2110,6096,64,194,1871,5409,1935,5603
280650,201912,1199,3140,947,2756,97,322,682,1904,779,2226
280660,201912,3513,7862,3009,7250,168,365,2549,6173,2717,6538
280670,201912,19813,44609,16957,40905,897,2325,13548,32314,14445,34639
280680,201912,2809,6726,2384,6116,224,413,1712,4464,1936,4877
280690,201912,929,2324,763,2090,32,103,593,1590,625,1693
280700,201912,1154,2906,982,2643,25,98,776,2043,801,2141
280710,201912,15271,34334,12802,31500,496,1019,10913,27388,11409,28407
280720,201912,2679,6070,2190,5488,68,214,1525,3991,1593,4205
280730,201912,1055,2715,933,2512,45,142,714,1862,759,2004
280740,201912,14216,34702,11993,31283,770,2154,8542,21750,9312,23904
280750,201912,3600,10070,3118,9213,177,597,2247,6511,2424,7108
280760,201912,6376,17116,5513,15768,560,1476,3678,10810,4238,12286
290010,201912,3188,6680,2062,4909,8,28,1685,3822,1693,3850
290020,201912,5456,14425,4907,13707,350,691,4112,11871,4462,12562
290030,201912,4459,10406,3615,9463,164,418,3056,8046,3220,8464
290035,201912,5243,11442,4257,10157,396,631,3314,8266,3710,8897
290040,201912,4255,10341,3577,9525,119,307,2826,7843,2945,8150
290050,201912,2045,6538,1703,5805,127,510,1131,3756,1258,4266
290060,201912,1321,3189,951,2586,73,242,628,1675,701,1917
290070,201912,37067,81396,31629,74491,1847,4586,24316,56570,26163,61156
290080,201912,5448,15955,4621,14702,462,1618,3206,10271,3668,11889
290090,201912,2171,4174,1536,3497,19,58,1399,3157,1418,3215
290100,201912,9958,26072,7993,23060,1297,3523,4342,13057,5639,16580
290110,201912,5248,13893,4634,12876,351,1019,3302,9085,3653,10104
290115,201912,3998,11560,3332,10378,224,762,2478,7644,2702,8406
290120,201912,6581,16286,5488,14769,142,492,4684,12392,4826,12884
290130,201912,4732,11450,3683,10090,160,472,2867,7814,3027,8286
290135,201912,4279,10025,3439,8626,207,530,2631,6407,2838,6937
290140,201912,4531,11960,3508,10571,101,403,2957,8813,3058,9216
290150,201912,2494,6466,2127,5998,144,418,1626,4581,1770,4999
290160,201912,3238,7605,2846,7056,324,691,2157,5411,2481,6102
290170,201912,3392,8617,2980,8155,114,319,2640,7279,2754,7598
290180,201912,2993,8178,2432,7236,82,299,1971,5813,2053,6112
290190,201912,4195,11965,3662,11240,150,662,2990,8995,3140,9657
290195,201912,2422,5925,1892,5203,29,154,1585,4309,1614,4463
290200,201912,4151,11486,3352,10150,215,727,2522,7562,2737,8289
290205,201912,3385,8709,2974,8106,131,476,2328,6126,2459,6602
290210,201912,13443,37108,11731,34492,941,2492,8881,26649,9822,29141
290220,201912,2843,7095,2483,6634,123,346,2037,5400,2160,5746
290225,201912,3326,7065,2565,6253,163,282,2144,5335,2307,5617
290230,201912,2504,6584,2261,6296,32,104,2023,5608,2055,5712
290240,201912,3696,9320,2951,8362,82,292,2482,6996,2564,7288
290250,201912,4053,11767,3394,10795,123,426,2736,8852,2859,9278
290260,201912,5388,13364,4381,11924,178,635,3586,9496,3764,10131
290265,201912,3483,10221,2784,8854,161,606,2039,6396,2200,7002
290270,201912,11289,38231,10525,36884,548,2420,8375,29000,8923,31420
290280,201912,6078,18209,5215,16497,306,1091,3726,11618,4032,12709
290290,201912,9980,29028,7983,25284,805,2782,5217,16258,6022,19040
290300,201912,4301,11628,3139,9405,164,547,2237,6659,2401,7206
290310,201912,1577,3926,1268,3539,66,274,963,2595,1029,2869
290320,201912,24800,64758,19408,56349,4316,12325,9138,27867,13454,40192
290323,201912,3808,10278,3275,9458,100,318,2602,7464,2702,7782
290327,201912,4192,12139,3533,10853,264,763,2478,7569,2742,8332
290330,201912,2211,4628,1713,4082,46,81,1516,3647,1562,3728
290340,201912,5736,14479,4403,12817,478,1435,3123,9232,3601,10667
290350,201912,4816,13324,3947,11846,271,832,2813,8472,3084,9304
290360,201912,5065,13291,4415,12435,130,384,3818,10781,3948,11165
290370,201912,5279,12793,3858,10922,174,419,2839,8184,3013,8603
290380,201912,5703,15074,4739,13740,118,308,4056,11958,4174,12266
290390,201912,14770,41489,12162,37430,1283,3841,7993,25022,9276,28863
290395,201912,2848,8278,2274,7267,70,334,1748,5472,1818,5806
290400,201912,3807,10152,3022,8854,85,368,2305,6556,2390,6924
290405,201912,4625,13533,3884,12227,299,991,2680,8571,2979,9562
290410,201912,5776,15802,4417,13565,113,547,3345,9954,3458,10501
290420,201912,2995,8383,2437,7484,72,269,1877,5704,1949,5973
290430,201912,3162,8695,2564,7745,240,767,1701,5079,1941,5846
290440,201912,2821,7102,1986,5780,40,129,1405,4167,1445,4296
290450,201912,3430,8857,2677,7724,149,441,2001,5774,2150,6215
290460,201912,11906,33379,9916,29593,2021,6142,4482,13259,6503,19401
290470,201912,4564,11281,3353,9582,381,1199,1902,5497,2283,6696
290475,201912,6551,18958,5455,16992,113,581,4379,13314,4492,13895
290480,201912,1789,4525,1460,4040,86,293,1004,2648,1090,2941
290485,201912,4559,13298,4000,12493,116,588,3376,10328,3492,10916
290490,201912,9312,21791,8210,20276,532,1216,6420,16003,6952,17219
290500,201912,4003,12056,3031,9880,539,1830,1339,4250,1878,6080
290510,201912,3483,8657,2873,7856,73,260,2460,6654,2533,6914
290515,201912,3757,10254,3201,9492,50,145,2840,8591,2890,8736
290520,201912,11502,32749,8783,27424,535,1841,5428,16666,5963,18507
290530,201912,4979,14225,4186,12907,133,502,3510,10779,3643,11281
290540,201912,3476,9171,3094,8707,71,236,2832,7937,2903,8173
290550,201912,4345,11303,3728,10576,12,59,3429,9839,3441,9898
290560,201912,6541,16921,4926,14501,422,1521,3242,9190,3664,10711
290570,201912,44619,109610,39528,103027,2500,6739,31692,81930,34192,88669
290580,201912,7966,23213,6849,21572,645,2017,4926,15870,5571,17887
290590,201912,7090,21823,5967,19801,141,583,4825,16053,4966,16636
290600,201912,18855,52355,16557,48596,705,2211,13227,38752,13932,40963
290610,201912,2543,7978,1961,6763,94,401,1366,4652,1460,5053
290620,201912,6571,18341,5601,16710,211,620,4671,13886,4882,14506
290630,201912,9273,22467,7305,19853,586,1558,5614,15370,6200,16928
290640,201912,2768,7172,2101,6180,79,244,1543,4553,1622,4797
290650,201912,13001,32650,11490,30878,2651,6826,6897,19401,9548,26227
290660,201912,3704,9499,3065,8570,51,134,2302,6677,2353,6811
290670,201912,6719,18680,5647,16897,386,1105,4315,13044,4701,14149
290680,201912,10815,30059,9051,27431,203,1098,7431,21990,7634,23088
290682,201912,4787,12434,4111,11504,132,327,3472,9796,3604,10123
290685,201912,3415,7728,2442,6338,184,462,1548,4266,1732,4728
290687,201912,6682,18046,5358,15829,710,2016,3390,10255,4100,12271
290689,201912,2847,7968,2187,6749,125,375,1610,4988,1735,5363
290690,201912,5708,14698,4562,13039,343,1063,3276,9204,3619,10267
290700,201912,2621,7162,2298,6738,72,245,1906,5609,1978,5854
290710,201912,8397,23579,7094,21753,154,653,5987,18337,6141,18990
290720,201912,18973,51733,17085,48812,947,3064,13504,37986,14451,41050
290730,201912,7180,17097,6096,15814,299,623,4759,12499,5058,13122
290740,201912,1044,2833,781,2390,38,147,625,1907,663,2054
290750,201912,11251,28084,9649,25434,687,1959,7060,18005,7747,19964
290755,201912,2113,5936,1681,5132,94,296,1164,3569,1258,3865
290760,201912,3836,11135,3051,9625,200,582,2037,6585,2237,7167
290770,201912,2631,8474,2370,8151,52,276,1998,6910,2050,7186
290780,201912,8376,20615,7139,18950,278,620,5602,15147,5880,15767
290790,201912,4709,12860,4057,11951,162,478,3379,10089,3541,10567
290800,201912,7237,14995,5104,12470,316,744,3766,9261,4082,10005
290810,201912,5547,14502,4372,12748,117,377,3273,9696,3390,10073
290820,201912,4890,13157,4358,12369,180,533,3297,9491,3477,10024
290830,201912,4591,10415,4072,9752,34,101,3560,8401,3594,8502
290840,201912,17208,45605,14707,41675,1909,4492,9423,28291,11332,32783
290850,201912,6621,16052,5929,15296,258,656,5024,13086,5282,13742
290860,201912,6126,17646,5315,16682,228,742,4467,14293,4695,15035
290870,201912,4866,13354,3647,11065,121,418,2573,7721,2694,8139
290880,201912,1407,3515,1101,3106,63,176,776,2242,839,2418
290890,201912,9307,18779,8287,17616,174,391,7743,16364,7917,16755
290900,201912,2348,6167,1743,5134,96,263,1100,3205,1196,3468
290910,201912,5174,12367,3900,10441,45,153,3284,8700,3329,8853
290920,201912,5121,12875,4632,12293,48,108,4363,11663,4411,11771
290930,201912,7844,21836,6217,18978,194,880,4832,14279,5026,15159
290940,201912,3771,10504,3076,9496,163,639,2420,7463,2583,8102
290950,201912,1499,3751,1207,3319,64,183,845,2327,909,2510
290960,201912,5553,14539,4924,13733,164,438,4146,11568,4310,12006
290970,201912,3481,10148,2809,8934,117,429,2124,6748,2241,7177
290980,201912,12404,29734,10305,26446,822,2288,6371,15838,7193,18126
290990,201912,9525,25374,8299,23372,274,1107,6928,18842,7202,19949
291000,201912,3409,8879,2650,7916,127,382,2157,6521,2284,6903
291005,201912,15498,38032,13532,35418,1165,2900,10608,27765,11773,30665
291010,201912,2991,9077,2396,7811,115,435,1584,5023,1699,5458
291020,201912,1279,3150,1016,2659,23,78,742,1840,765,1918
291030,201912,2511,6103,1716,4711,106,275,1077,2880,1183,3155
291040,201912,5446,15018,4545,13728,176,696,3541,10640,3717,11336
291050,201912,7768,20434,6640,18820,698,2208,4706,13071,5404,15279
291060,201912,6007,18480,5128,17258,330,1397,3863,12903,4193,14300
291070,201912,15938,42976,13201,38575,447,1589,10666,30892,11113,32481
291072,201912,24682,63466,17515,50857,3305,9901,7491,21965,10796,31866
291075,201912,5362,13351,4759,12406,111,308,3946,10072,4057,10380
291077,201912,1584,4134,1222,3500,42,101,868,2483,910,2584
291080,201912,96419,245727,75287,215121,23612,69035,19830,60567,43442,129602
291085,201912,5675,14329,4744,12905,198,626,3955,10673,4153,11299
291090,201912,2010,3741,1445,3111,37,82,1187,2527,1224,2609
291100,201912,3215,7042,2204,5819,115,328,1677,4365,1792,4693
291110,201912,6010,17811,5063,16171,334,1372,3776,11589,4110,12961
291120,201912,7748,18951,6533,17387,325,942,4968,13153,5293,14095
291125,201912,2202,3871,1621,3222,114,168,1258,2580,1372,2748
291130,201912,3209,9198,2350,7468,80,368,1713,5240,1793,5608
291140,201912,4822,13076,3473,10558,429,1148,2169,6621,2598,7769
291150,201912,2442,5327,1898,4712,6,22,1780,4397,1786,4419
291160,201912,5242,14298,4276,12856,406,1261,2802,8367,3208,9628
291165,201912,2158,5909,1627,4889,40,174,1170,3375,1210,3549
291170,201912,21094,53368,17516,47259,959,2835,11454,30379,12413,33214
291180,201912,6222,14511,4534,12173,292,744,3467,9344,3759,10088
291185,201912,3127,8437,2728,7780,91,280,2091,5944,2182,6224
291190,201912,7685,18911,6321,17115,325,1008,4952,13333,5277,14341
291200,201912,2778,7665,2037,6246,98,337,1244,3681,1342,4018
291210,201912,6973,15153,5277,13170,145,483,3934,9838,4079,10321
291220,201912,4081,11612,3654,10948,192,714,2860,8439,3052,9153
291230,201912,4477,9656,3409,8477,44,100,3045,7650,3089,7750
291240,201912,4304,11022,3667,9954,68,228,3129,8358,3197,8586
291250,201912,3462,10163,2675,8711,166,538,1719,5616,1885,6154
291260,201912,1448,3381,1188,3042,35,106,959,2459,994,2565
291270,201912,5351,14023,4151,12219,626,1815,2621,7889,3247,9704
291280,201912,2540,6294,1888,5327,133,438,1218,3327,1351,3765
291290,201912,5975,15721,4604,13553,355,1127,3161,9223,3516,10350
291300,201912,3879,10406,2943,8853,113,408,2243,6621,2356,7029
291310,201912,5107,13671,4316,12198,108,367,3630,10073,3738,10440
291320,201912,6247,17327,4784,14582,1112,3163,2293,7432,3405,10595
291330,201912,1802,4557,1477,4007,85,241,1085,2891,1170,3132
291340,201912,4285,11067,3446,9598,87,272,2625,7179,2712,7451
291345,201912,2981,8936,2689,8478,117,415,2237,7038,2354,7453
291350,201912,6920,17187,5347,15229,67,218,4581,13285,4648,13503
291360,201912,37730,86614,29486,76467,2960,7735,19028,50290,21988,58025
291370,201912,7926,21824,6995,20403,505,1593,5160,14782,5665,16375
291380,201912,3479,9470,3042,8856,106,428,2499,7217,2605,7645
291390,201912,13275,28588,10300,25280,425,1067,8504,20808,8929,21875
291400,201912,13922,35715,11396,31872,1564,3863,6728,20237,8292,24100
291410,201912,2899,7602,2206,6414,41,170,1621,4615,1662,4785
291420,201912,1943,4792,1506,4243,33,133,1296,3640,1329,3773
291430,201912,2833,7999,2426,7320,96,424,1910,5588,2006,6012
291440,201912,6411,18388,5457,16786,321,1085,4274,13113,4595,14198
291450,201912,9060,22727,7474,20896,82,148,6554,18923,6636,19071
291460,201912,15644,41538,13660,38541,684,2196,10281,28713,10965,30909
291465,201912,9205,22854,7217,20554,158,715,6159,17400,6317,18115
291470,201912,16286,36777,13548,33699,694,1541,10101,25830,10795,27371
291480,201912,41923,93208,30462,77242,3660,9601,16049,40592,19709,50193
291490,201912,5660,14070,4880,13154,146,468,4386,11760,4532,12228
291500,201912,5075,12350,4187,11163,75,324,3761,9957,3836,10281
291510,201912,4250,10548,3175,9186,57,304,2628,7536,2685,7840
291520,201912,4574,10411,3435,8898,166,473,2642,6785,2808,7258
291530,201912,2293,5293,1603,4366,304,751,911,2729,1215,3480
291535,201912,3399,9944,3017,9260,178,490,2305,7228,2483,7718
291540,201912,2281,5118,1575,4254,62,222,1310,3458,1372,3680
291550,201912,5659,13010,4406,11385,409,899,3011,7921,3420,8820
291560,201912,19098,44408,13448,37112,1251,3339,8340,23827,9591,27166
291570,201912,2435,5787,1910,5130,55,144,1552,4333,1607,4477
291580,201912,6306,16331,4928,14469,218,729,3668,10655,3886,11384
291590,201912,2070,5182,1786,4833,81,307,1543,4066,1624,4373
291600,201912,5200,12557,3850,10433,366,1083,2541,6665,2907,7748
291610,201912,5794,15229,5240,14601,91,344,4774,13270,4865,13614
291620,201912,3177,7048,2321,6093,104,269,1808,4825,1912,5094
291630,201912,3238,7309,2393,6192,223,646,1748,4438,1971,5084
291640,201912,15743,39085,11787,33245,1767,4819,5208,15360,6975,20179
291650,201912,9580,23857,8397,22435,578,1116,7015,19241,7593,20357
291660,201912,2078,5110,1492,4194,128,433,965,2537,1093,2970
291670,201912,2108,5498,1763,5005,99,246,1340,3852,1439,4098
291680,201912,4127,10171,3300,8941,296,823,2319,6240,2615,7063
291685,201912,4760,11295,3755,10002,227,454,2839,7857,3066,8311
291690,201912,4252,9340,2875,7349,212,442,2214,5677,2426,6119
291700,201912,8700,25163,7598,23200,335,1240,6147,18393,6482,19633
291710,201912,5355,12748,3938,10729,218,689,2864,7642,3082,8331
291720,201912,4419,13503,3662,11961,392,1385,2416,7691,2808,9076
291730,201912,6407,16376,5480,15149,269,823,4504,12379,4773,13202
291733,201912,2924,7417,2447,6777,67,186,1778,5158,1845,5344
291735,201912,2946,7708,2330,6628,85,220,1748,4942,1833,5162
291740,201912,3899,10050,2873,8193,99,287,2064,5779,2163,6066
291750,201912,19826,47287,15941,41498,1505,3854,10753,28146,12258,32000
291760,201912,10480,30262,8124,26339,2439,8950,2196,7118,4635,16068
291770,201912,7103,19154,5843,16904,381,1173,4301,12123,4682,13296
291780,201912,5133,13669,4598,12884,90,344,4007,11098,4097,11442
291790,201912,2662,7477,2413,7154,240,639,1803,5487,2043,6126
291800,201912,29378,74276,21722,62595,3420,9538,10771,32119,14191,41657
291810,201912,10806,25641,8896,23279,256,675,7602,19882,7858,20557
291820,201912,3848,10127,3317,9418,98,315,2629,7490,2727,7805
291830,201912,4429,10486,3664,9445,189,446,2915,7542,3104,7988
291835,201912,6484,19356,5024,16501,577,2019,3156,10473,3733,12492
291840,201912,48505,132164,41439,121258,4606,14376,28624,83268,33230,97644
291845,201912,2513,6548,1977,5869,116,368,1579,4732,1695,5100
291850,201912,3957,11276,3243,10070,270,791,2300,7329,2570,8120
291855,201912,2168,4314,1681,3767,41,107,1519,3398,1560,3505
291860,201912,2261,5883,1541,4480,45,134,1042,2914,1087,3048
291870,201912,1327,3321,873,2522,51,152,579,1634,630,1786
291875,201912,2872,8589,2456,7719,67,270,1806,5522,1873,5792
291880,201912,5607,15838,4782,14454,231,685,3608,10916,3839,11601
291890,201912,1634,3371,1044,2679,126,295,703,1807,829,2102
291900,201912,1190,2918,905,2466,18,80,713,1878,731,1958
291905,201912,2558,6455,2033,5599,82,287,1529,4053,1611,4340
291910,201912,2957,7477,2471,6895,56,202,2151,6032,2207,6234
291915,201912,7469,21157,6034,18671,242,856,4506,14033,4748,14889
291920,201912,26607,69552,22426,63532,2300,7043,15296,42453,17596,49496
291930,201912,2546,6888,2147,6317,252,757,1404,4144,1656,4901
291940,201912,3973,10122,2579,7727,197,595,1505,4458,1702,5053
291950,201912,9324,27970,7875,25137,320,1179,5424,17112,5744,18291
291955,201912,15612,39248,13814,36909,1217,3380,10672,28560,11889,31940
291960,201912,3110,8180,2549,7390,119,364,1984,5854,2103,6218
291970,201912,4525,11446,3772,10463,138,473,2848,7889,2986,8362
291980,201912,9920,28149,7770,24478,799,2403,4922,15799,5721,18202
291990,201912,2240,5815,1886,5406,21,92,1774,5092,1795,5184
291992,201912,4047,9764,3124,8535,242,570,2456,6822,2698,7392
291995,201912,2112,5746,1689,5087,47,218,1308,3826,1355,4044
292000,201912,2663,6265,2135,5614,98,391,1664,4298,1762,4689
292010,201912,5935,13711,4761,12025,195,597,3913,9648,4108,10245
292020,201912,4553,13220,3737,11721,207,791,2720,8263,2927,9054
292030,201912,1836,5605,1678,5312,81,290,1065,3313,1146,3603
292040,201912,4360,11261,3398,9825,224,604,2599,7670,2823,8274
292045,201912,4004,10516,2964,8976,40,108,2600,8051,2640,8159
292050,201912,6556,18389,5229,15977,249,897,3337,10009,3586,10906
292060,201912,11658,26926,10662,25671,512,1169,9226,21946,9738,23115
292070,201912,5843,15150,5112,14254,289,845,4392,12140,4681,12985
292080,201912,3190,7964,2598,7203,83,273,2291,6312,2374,6585
292090,201912,4607,9934,3256,8304,251,678,2470,6345,2721,7023
292100,201912,10851,26470,9178,24330,1006,2791,6245,16461,7251,19252
292105,201912,3493,8756,3030,8118,99,242,2454,6597,2553,6839
292110,201912,6006,14740,4175,11750,1004,2862,1884,5297,2888,8159
292120,201912,6959,17809,5683,15651,360,1070,4289,11569,4649,12639
292130,201912,3417,8184,2785,7389,107,324,2188,5723,2295,6047
292140,201912,5140,12084,4240,10734,310,785,3356,8430,3666,9215
292145,201912,2372,6833,1977,6148,59,167,1512,4745,1571,4912
292150,201912,13941,38192,12111,35199,326,1264,9910,28390,10236,29654
292160,201912,3050,7405,2260,6383,52,145,1844,5394,1896,5539
292170,201912,8471,22459,7007,20021,376,1238,5223,14635,5599,15873
292180,201912,2861,7785,2052,6308,174,525,1275,3844,1449,4369
292190,201912,2980,7801,2503,7063,111,366,1932,5393,2043,5759
292200,201912,8359,21065,6133,17820,1035,3096,3246,9665,4281,12761
292205,201912,3929,10769,3341,9874,66,314,2938,8582,3004,8896
292210,201912,6480,15129,5194,13483,85,379,4655,11918,4740,12297
292220,201912,2151,5180,1878,4752,51,148,1476,3601,1527,3749
292225,201912,3233,9431,2820,8804,72,337,2372,7264,2444,7601
292230,201912,8693,20561,7715,19303,174,586,6606,16206,6780,16792
292240,201912,4806,13888,4129,12651,318,952,2840,8705,3158,9657
292250,201912,5492,14583,4899,13658,450,1213,3495,9781,3945,10994
292260,201912,3426,8907,3020,8378,103,284,2614,7246,2717,7530
292265,201912,3379,9200,2808,8320,73,325,2198,6366,2271,6691
292270,201912,4444,10103,3519,9000,126,301,2878,7371,3004,7672
292273,201912,2675,5785,2121,5096,58,105,1581,4014,1639,4119
292275,201912,1686,4350,1319,3843,61,167,988,2926,1049,3093
292280,201912,2638,6254,2106,5636,90,187,1774,4894,1864,5081
292285,201912,2604,6277,2044,5519,85,201,1637,4451,1722,4652
292290,201912,7473,19862,5907,17637,173,658,4798,14278,4971,14936
292300,201912,10371,26231,8026,23089,759,2329,5520,15848,6279,18177
292303,201912,2926,8375,2545,7767,83,218,2112,6484,2195,6702
292305,201912,2383,6353,2192,6083,45,213,1964,5337,2009,5550
292310,201912,6790,17085,5821,15896,160,543,5019,13547,5179,14090
292320,201912,6146,16727,4846,14313,244,790,3576,10306,3820,11096
292330,201912,2817,6124,2207,5437,104,231,1704,4353,1808,4584
292335,201912,4806,12362,4247,11558,233,548,3577,9805,3810,10353
292340,201912,5762,15930,4710,13904,224,660,3485,10199,3709,10859
292350,201912,2549,6813,2088,6180,82,295,1672,4947,1754,5242
292360,201912,4893,13105,4034,11606,240,793,2852,7980,3092,8773
292370,201912,10799,24868,9176,22693,138,468,8461,20596,8599,21064
292380,201912,6936,19250,6139,17817,421,1234,4638,13360,5059,14594
292390,201912,4485,8656,3276,7239,101,181,2873,6374,2974,6555
292400,201912,22450,64061,19266,58882,1831,5775,13202,40386,15033,46161
292405,201912,4213,10508,3536,9455,107,293,2893,7642,3000,7935
292410,201912,2181,5184,1848,4765,68,164,1639,4245,1707,4409
292420,201912,3562,10758,3223,10205,121,612,2735,8412,2856,9024
292430,201912,4900,14560,3676,12306,309,1066,2385,7961,2694,9027
292440,201912,8539,27018,7836,25935,139,706,6967,22959,7106,23665
292450,201912,4005,11484,3112,9709,94,369,2414,7481,2508,7850
292460,201912,4909,13445,3974,11836,368,1060,2833,8442,3201,9502
292465,201912,2633,6860,2202,6275,90,195,1512,4657,1602,4852
292467,201912,1892,5315,1673,5012,242,649,1146,3566,1388,4215
292470,201912,3034,7658,2319,6525,60,136,1802,5078,1862,5214
292480,201912,6406,15180,5089,13582,72,277,4589,12129,4661,12406
292490,201912,2111,5495,1742,4942,119,294,1292,3748,1411,4042
292500,201912,6627,18095,5277,15641,524,1629,3432,10025,3956,11654
292510,201912,13036,35187,10137,30556,530,1933,7172,21485,7702,23418
292520,201912,7004,17448,6142,16192,489,1344,4723,12320,5212,13664
292525,201912,5946,14084,4808,12801,106,280,4178,11246,4284,11526
292530,201912,28044,74844,21219,62989,5368,16028,7972,24266,13340,40294
292540,201912,4330,8096,3394,7081,113,188,3033,6354,3146,6542
292550,201912,8427,21933,6386,19433,466,1429,4594,14672,5060,16101
292560,201912,4333,10845,3711,10026,83,262,3055,8267,3138,8529
292570,201912,3667,9620,3063,8561,74,287,2567,6972,2641,7259
292575,201912,7068,20050,6431,19174,372,1099,5159,15510,5531,16609
292580,201912,7578,19038,6259,17087,140,463,5244,14167,5384,14630
292590,201912,7443,19772,6341,17881,243,798,5312,14652,5555,15450
292593,201912,2860,7024,2346,6158,71,175,1962,5122,2033,5297
292595,201912,5523,14636,4696,13615,156,526,3918,11258,4074,11784
292600,201912,11129,30058,9475,27516,313,901,7476,21769,7789,22670
292610,201912,4164,10862,3485,9671,199,462,2591,7301,2790,7763
292620,201912,6596,17793,5394,16358,122,291,4945,15252,5067,15543
292630,201912,8573,20935,6868,18191,668,1781,4494,11928,5162,13709
292640,201912,8216,24227,7137,22446,195,818,5057,15990,5252,16808
292650,201912,4539,11104,4045,10447,113,315,3673,9360,3786,9675
292660,201912,11516,30864,9723,28202,460,1480,7443,21531,7903,23011
292665,201912,2196,6469,1902,6086,70,202,1600,5186,1670,5388
292670,201912,3587,9628,2729,8019,117,379,1853,5342,1970,5721
292680,201912,4003,10573,3131,9003,209,553,2258,6376,2467,6929
292690,201912,2670,6865,1819,5457,199,561,1080,3392,1279,3953
292700,201912,9958,26974,8607,24892,765,2030,5864,17468,6629,19498
292710,201912,2464,7665,2267,7392,47,171,2029,6668,2076,6839
292720,201912,9090,21573,7628,19890,233,638,6039,16004,6272,16642
292730,201912,4529,10417,4245,10075,207,315,3740,9046,3947,9361
292740,201912,329635,798525,283733,730455,40848,105616,175269,447958,216117,553574
292750,201912,6239,16619,5412,15401,241,689,4134,11939,4375,12628
292760,201912,3948,11317,3412,10352,233,782,2494,7488,2727,8270
292770,201912,6145,16332,4886,14531,784,2407,3004,9163,3788,11570
292780,201912,2075,4203,1530,3501,40,139,1225,2653,1265,2792
292790,201912,4111,8745,3133,7679,156,413,2612,6414,2768,6827
292800,201912,11271,28195,9612,25667,318,926,7992,21024,8310,21950
292805,201912,3508,8495,2732,7457,106,328,2145,5790,2251,6118
292810,201912,10878,28472,8503,24765,214,918,6341,17864,6555,18782
292820,201912,7590,20686,5424,17096,459,1530,3732,11567,4191,13097
292830,201912,2921,6857,2477,6303,91,295,2103,5328,2194,5623
292840,201912,8886,23126,7481,21196,154,619,6479,17977,6633,18596
292850,201912,2521,6662,2099,6036,145,443,1464,4176,1609,4619
292860,201912,17278,37969,15402,35671,472,1153,13194,30140,13666,31293
292870,201912,17941,44645,15337,40904,947,2658,10345,27220,11292,29878
292880,201912,11166,30232,9493,27710,298,1232,7431,20943,7729,22175
292890,201912,7076,19625,6191,18313,205,853,5326,15583,5531,16436
292895,201912,2983,6425,2157,5183,85,212,1739,4123,1824,4335
292900,201912,2644,7148,2409,6773,61,250,1958,5335,2019,5585
292905,201912,4418,11424,3443,9976,148,497,2529,7232,2677,7729
292910,201912,4965,13448,4486,12762,229,655,3397,9591,3626,10246
292920,201912,9798,26800,9046,25707,265,1013,7796,21728,8061,22741
292925,201912,5475,15366,4529,13672,233,713,3291,9786,3524,10499
292930,201912,6603,19361,5580,17382,480,1688,3525,10654,4005,12342
292935,201912,2444,6177,1885,5550,28,144,1685,4971,1713,5115
292937,201912,3005,7259,2593,6720,62,185,2282,5873,2344,6058
292940,201912,2923,7398,2304,6459,189,457,1659,4797,1848,5254
292950,201912,9751,24680,8459,22701,529,1283,6343,16939,6872,18222
292960,201912,5296,12744,4412,11490,132,360,3525,9053,3657,9413
292970,201912,3843,11103,3367,10368,88,418,2790,8599,2878,9017
292975,201912,4583,9739,4037,9118,145,264,3650,8339,3795,8603
292980,201912,3339,8043,2664,7030,92,280,2141,5534,2233,5814
292990,201912,11586,31479,9540,27848,665,2053,6939,19933,7604,21986
293000,201912,2620,6242,2226,5645,39,145,1757,4458,1796,4603
293010,201912,18279,46718,14566,40747,1953,5650,8869,24717,10822,30367
293015,201912,8218,25155,6402,21586,422,1558,4324,14734,4746,16292
293020,201912,9980,28756,8912,27216,141,648,7962,24431,8103,25079
293030,201912,5380,14193,4041,12136,107,369,2777,8552,2884,8921
293040,201912,4070,11103,3422,10198,72,279,2955,8798,3027,9077
293050,201912,22163,54866,19528,50978,985,2767,14756,37905,15741,40672
293060,201912,3478,9191,2813,7989,248,739,1950,5435,2198,6174
293070,201912,25559,61600,21554,56363,2128,5859,15165,39633,17293,45492
293075,201912,3457,10938,2993,10160,174,731,2368,8030,2542,8761
293076,201912,3641,8871,3254,8398,68,185,2853,7411,2921,7596
293077,201912,6181,17083,4907,15039,447,1486,3158,9894,3605,11380
293080,201912,4769,14008,4064,12807,98,448,3257,10061,3355,10509
293090,201912,3271,9465,2480,8146,207,705,1639,5411,1846,6116
293100,201912,5707,15293,4644,13379,211,662,3638,10335,3849,10997
293105,201912,3720,11761,3250,10790,230,805,2313,7596,2543,8401
293110,201912,2413,5988,1990,5352,66,236,1644,4309,1710,4545
293120,201912,4390,11970,3874,11137,118,320,3211,9237,3329,9557
293130,201912,3775,10326,3282,9668,83,326,2815,8208,2898,8534
293135,201912,30832,72431,22407,60919,3461,10177,10562,28848,14023,39025
293140,201912,2388,5313,2048,4887,62,144,1712,4071,1774,4215
293150,201912,5433,16170,4466,14317,349,1174,3070,9847,3419,11021
293160,201912,3862,9368,3272,8718,244,414,2723,7607,2967,8021
293170,201912,4811,10223,4127,9365,132,306,3542,7964,3674,8270
293180,201912,4329,12175,3529,10722,104,423,2771,8191,2875,8614
293190,201912,14068,38393,12299,35843,168,721,10810,31326,10978,32047
293200,201912,8284,20579,6625,17968,205,764,5277,13991,5482,14755
293210,201912,5262,13883,4448,12605,298,831,3390,9603,3688,10434
293220,201912,5112,13225,3722,10839,879,2545,1456,4346,2335,6891
293230,201912,3960,10144,2915,8625,213,709,1991,5943,2204,6652
293240,201912,4489,11825,3578,10352,74,192,2721,8151,2795,8343
293245,201912,3842,10345,3429,9755,151,493,2890,8087,3041,8580
293250,201912,5908,13740,4840,12358,155,387,4052,10324,4207,10711
293260,201912,4503,12166,3648,10838,142,452,2533,7530,2675,7982
293270,201912,7205,15948,5689,14307,412,642,4428,11941,4840,12583
293280,201912,4597,12043,3988,11189,246,608,3083,8722,3329,9330
293290,201912,14209,41951,12465,39165,1833,5824,7899,25216,9732,31040
293300,201912,5865,14166,4996,12886,292,747,3638,9389,3930,10136
293305,201912,4059,9808,3494,9086,43,123,3134,8114,3177,8237
293310,201912,2178,5535,1796,4915,48,147,1411,3800,1459,3947
293315,201912,4116,9855,3350,8686,189,433,2736,7097,2925,7530
293317,201912,2604,6194,2285,5741,154,305,1792,4540,1946,4845
293320,201912,11808,28917,10522,27450,287,809,9305,24150,9592,24959
293325,201912,1768,4424,1370,3876,188,533,863,2462,1051,2995
293330,201912,51394,150319,41574,132526,8308,27122,18874,61037,27182,88159
293340,201912,2239,6266,1840,5564,93,309,1298,3868,1391,4177
293345,201912,3475,9427,2745,8341,343,807,1828,6019,2171,6826
293350,201912,6695,19039,5775,17946,62,298,5269,16563,5331,16861
293360,201912,15635,38738,13146,35445,321,1323,11510,30434,11831,31757
310010,201912,942,2129,600,1646,46,160,225,553,271,713
310020,201912,2242,6290,1588,5077,346,1223,291,880,637,2103
310030,201912,1942,5508,1483,4688,228,790,907,2760,1135,3550
310040,201912,929,2431,734,2093,34,137,493,1316,527,1453
310050,201912,1508,4556,1283,4193,141,572,814,2556,955,3128
310060,201912,3206,9050,2761,8463,100,419,2249,6804,2349,7223
310070,201912,348,783,238,622,6,14,181,471,187,485
310080,201912,743,1958,504,1507,79,275,218,599,297,874
310090,201912,4662,12503,3769,11005,297,952,2716,7782,3013,8734
310100,201912,3367,9505,2798,8528,79,359,2252,6677,2331,7036
310110,201912,4724,12495,3627,10546,776,2434,1544,4311,2320,6745
310120,201912,640,1573,405,1188,46,160,238,636,284,796
310130,201912,374,980,310,884,32,122,218,587,250,709
310140,201912,264,755,187,620,37,141,77,228,114,369
310150,201912,5288,14031,3847,11285,532,1821,1790,4940,2322,6761
310160,201912,7582,19126,5310,15325,1053,3291,1866,5386,2919,8677
310163,201912,1019,3037,805,2618,192,707,260,778,452,1485
310170,201912,9110,23513,7203,20435,606,1786,5074,14337,5680,16123
310180,201912,1773,4418,1277,3594,161,510,766,2057,927,2567
310190,201912,2587,7612,2026,6569,461,1685,311,920,772,2605
310200,201912,1830,5467,1301,4378,213,827,565,1865,778,2692
310205,201912,1126,3119,840,2656,150,530,366,1138,516,1668
310210,201912,2651,7063,2121,6119,115,364,1555,4365,1670,4729
310220,201912,1191,3263,908,2737,101,342,596,1728,697,2070
310230,201912,2234,6258,1780,5367,233,794,1077,3024,1310,3818
310240,201912,912,2841,760,2568,49,190,537,1788,586,1978
310250,201912,1026,2753,812,2403,21,84,578,1677,599,1761
310260,201912,2881,7505,1739,5453,500,1828,443,1045,943,2873
310270,201912,2730,6791,2114,5946,99,353,1724,4830,1823,5183
310280,201912,2360,5543,1798,4721,283,786,989,2478,1272,3264
310285,201912,1876,5996,1551,5394,174,685,945,3252,1119,3937
310290,201912,1125,2957,904,2554,208,689,477,1193,685,1882
310300,201912,1468,4339,1245,3937,151,610,710,2082,861,2692
310310,201912,308,768,191,553,34,101,99,281,133,382
310320,201912,512,1329,335,1028,25,95,180,533,205,628
310330,201912,480,1128,281,773,41,135,113,272,154,407
310340,201912,7804,21244,6225,18541,896,2602,3070,9383,3966,11985
310350,201912,12439,30040,8244,23146,1633,4858,3502,9537,5135,14395
310360,201912,483,1110,354,939,11,33,250,658,261,691
310370,201912,1269,3966,1048,3534,217,800,334,1138,551,1938
310375,201912,832,2076,558,1666,86,266,288,850,374,1116
310380,201912,382,851,200,555,32,96,92,234,124,330
310390,201912,436,1314,346,1136,84,303,97,267,181,570
310400,201912,9748,23783,6738,19144,747,2474,3978,10957,4725,13431
310410,201912,879,2529,562,1928,93,345,200,639,293,984
310420,201912,4265,10972,2770,8039,386,1269,1074,2850,1460,4119
310430,201912,1506,4096,965,3063,207,737,336,941,543,1678
310440,201912,643,1675,433,1275,39,143,233,649,272,792
310445,201912,1350,3896,968,3127,47,169,694,2207,741,2376
310450,201912,4776,11968,3536,9975,150,562,2645,7198,2795,7760
310460,201912,1594,4196,1093,3258,192,621,353,997,545,1618
310470,201912,3810,8312,2924,7163,284,696,2080,5171,2364,5867
310480,201912,919,2396,699,1996,84,258,449,1250,533,1508
310490,201912,2831,7754,2169,6604,252,944,1173,3325,1425,4269
310500,201912,1375,3920,996,3249,181,679,499,1566,680,2245
310510,201912,2038,5340,1253,3843,248,858,453,1386,701,2244
310520,201912,1212,3143,866,2529,139,383,455,1322,594,1705
310530,201912,757,1924,425,1273,58,216,138,332,196,548
310540,201912,3074,8805,2526,7841,568,1858,1122,3341,1690,5199
310550,201912,1230,3170,832,2481,63,233,480,1344,543,1577
310560,201912,14637,38427,10256,30610,1630,5529,4112,11036,5742,16565
310570,201912,1059,2792,835,2473,63,227,590,1715,653,1942
310590,201912,4074,10913,3221,9333,215,729,1853,5064,2068,5793
310600,201912,1337,3959,1074,3422,156,567,548,1624,704,2191
310610,201912,481,1266,293,948,51,185,148,446,199,631
310620,201912,172623,440266,122726,348636,18944,62068,58214,148608,77158,210676
310630,201912,4428,12196,3478,10348,293,989,2204,6312,2497,7301
310640,201912,1028,3086,836,2691,179,625,336,1022,515,1647
310650,201912,2423,6976,1728,5619,182,633,973,3069,1155,3702
310660,201912,1268,3452,1039,3153,36,132,876,2627,912,2759
310665,201912,1389,3612,1093,3173,30,117,900,2606,930,2723
310670,201912,54565,141695,45415,125679,4480,14315,30797,80929,35277,95244
310680,201912,735,1773,595,1569,18,67,488,1242,506,1309
310690,201912,1881,4965,1324,3993,114,399,734,2084,848,2483
310700,201912,491,1079,384,953,29,93,289,687,318,780
310710,201912,5433,15565,3852,13256,879,3515,583,1854,1462,5369
310720,201912,968,2330,749,2043,39,134,546,1439,585,1573
310730,201912,9729,26392,8279,24047,363,1351,6139,17428,6502,18779
310740,201912,5872,16308,3855,12001,648,2209,1286,3669,1934,5878
310750,201912,1225,2932,869,2406,119,367,419,1080,538,1447
310760,201912,557,1447,397,1209,24,77,213,659,237,736
310770,201912,1088,2994,738,2437,85,336,360,1095,445,1431
310780,201912,4326,10445,3553,9352,74,224,2842,7474,2916,7698
310790,201912,1808,5744,1550,5187,362,1297,248,757,610,2054
310800,201912,2224,6620,1569,5249,363,1435,104,286,467,1721
310810,201912,1161,2970,931,2532,44,135,653,1721,697,1856
310820,201912,1170,3035,685,2180,152,526,161,504,313,1030
310825,201912,2487,7721,1983,6846,76,451,1565,5199,1641,5650
310830,201912,1650,4751,1125,3659,225,845,459,1385,684,2230
310840,201912,1911,5230,1341,4251,364,1291,325,895,689,2186
310850,201912,1496,4102,1242,3745,48,249,958,2740,1006,2989
310855,201912,3165,8372,2425,7162,175,592,1685,4844,1860,5436
310860,201912,6935,20094,5487,17192,524,1753,3351,10573,3875,12326
310870,201912,1016,2408,761,2026,56,139,559,1496,615,1635
310880,201912,983,2940,757,2473,101,341,451,1433,552,1774
310890,201912,2303,6582,1428,4774,272,984,211,593,483,1577
310900,201912,3916,10985,2559,7913,375,1205,1089,3115,1464,4320
310910,201912,1998,5004,1342,3894,113,400,251,654,364,1054
310920,201912,1904,5014,1431,4264,209,664,790,2294,999,2958
310925,201912,951,2621,751,2284,81,283,491,1414,572,1697
310930,201912,5729,15181,4030,12398,790,2499,1899,6030,2689,8529
310940,201912,6503,15720,5141,13678,199,708,3856,9909,4055,10617
310945,201912,1275,3337,991,2880,112,365,559,1592,671,1957
310950,201912,1905,5651,1202,4036,222,832,417,1241,639,2073
310960,201912,752,2014,409,1291,75,267,88,245,163,512
310970,201912,1136,3379,778,2588,202,726,149,452,351,1178
310980,201912,284,686,181,520,15,53,116,323,131,376
310990,201912,1277,3568,966,3007,169,549,480,1461,649,2010
311000,201912,4015,11279,2899,9361,711,2463,1181,3676,1892,6139
311010,201912,856,2535,678,2161,206,736,278,854,484,1590
311020,201912,1018,2650,632,1928,39,122,344,1031,383,1153
311030,201912,1607,4018,1082,3120,197,654,516,1372,713,2026
311040,201912,303,944,236,785,72,258,67,204,139,462
311050,201912,2741,6807,2022,5728,373,1208,998,2697,1371,3905
311060,201912,3023,7818,2118,6058,316,1043,831,2157,1147,3200
311070,201912,2263,5708,1600,4627,189,695,821,2208,1010,2903
311080,201912,1074,2492,867,2152,44,153,667,1558,711,1711
311090,201912,2004,6412,1556,5559,353,1414,461,1610,814,3024
311100,201912,2298,6602,1301,4479,250,980,223,674,473,1654
311110,201912,3688,7592,2009,5226,373,1043,750,1978,1123,3021
311115,201912,1339,3117,1090,2776,69,183,872,2177,941,2360
311120,201912,6457,16985,4749,13818,712,2360,1756,4474,2468,6834
311130,201912,1875,4899,1394,4216,115,453,764,2226,879,2679
311140,201912,1374,3395,1033,2919,77,254,675,1872,752,2126
311150,201912,1521,4800,1175,4116,193,764,630,2137,823,2901
311160,201912,3647,10513,2493,8323,633,2381,729,2338,1362,4719
311170,201912,886,2263,692,1992,35,100,436,1319,471,1419
311180,201912,1333,3002,813,2216,154,454,363,975,517,1429
311190,201912,941,2581,678,2061,117,401,265,708,382,1109
311200,201912,1935,5267,1346,4103,276,924,461,1256,737,2180
311205,201912,866,2626,701,2288,48,217,429,1331,477,1548
311210,201912,1023,2979,883,2794,117,340,640,2076,757,2416
311220,201912,743,2086,608,1841,51,173,370,1062,421,1235
311230,201912,7676,23147,5680,19030,998,3513,2118,7227,3116,10740
311240,201912,994,2609,753,2260,157,506,326,966,483,1472
311250,201912,975,2808,734,2340,179,544,288,901,467,1445
311260,201912,2544,6323,1575,4610,253,818,660,1785,913,2603
311265,201912,1301,3403,943,2791,43,172,656,1864,699,2036
311270,201912,2987,8890,2572,8191,163,713,1881,5718,2044,6431
311280,201912,1148,2969,508,1655,105,377,49,140,154,517
311290,201912,1841,5601,1671,5243,153,500,1133,3549,1286,4049
311300,201912,4679,13214,3801,11699,212,904,2966,8896,3178,9800
311310,201912,562,1567,468,1398,39,119,268,771,307,890
311320,201912,3090,9504,2594,8371,391,1466,1198,3523,1589,4989
311330,201912,4944,13175,3916,11461,435,1414,2170,6442,2605,7856
311340,201912,10269,29066,7975,24884,2192,7399,2064,6107,4256,13506
311350,201912,2276,5713,1564,4401,141,462,867,2186,1008,2648
311360,201912,1119,2752,686,2045,203,684,212,574,415,1258
311370,201912,4581,11225,3316,9175,158,631,2164,5654,2322,6285
311380,201912,363,1121,264,914,66,231,105,379,171,610
311390,201912,1690,5189,1309,4644,564,2287,310,946,874,3233
311400,201912,1382,3850,988,3083,142,464,398,1120,540,1584
311410,201912,1584,4694,1296,4287,202,777,734,2413,936,3190
311420,201912,1452,4260,971,3239,175,642,216,587,391,1229
311430,201912,3752,9996,2392,7248,490,1517,727,2212,1217,3729
311440,201912,2570,7344,1835,6057,421,1642,517,1619,938,3261
311450,201912,1693,5101,1199,4148,306,1186,312,932,618,2118
311455,201912,987,2242,651,1742,175,475,244,680,419,1155
311460,201912,483,1498,318,1148,68,320,86,265,154,585
311470,201912,481,1508,312,1098,74,300,47,151,121,451
311480,201912,1077,2835,894,2558,56,158,689,1990,745,2148
311490,201912,231,685,174,570,30,116,82,237,112,353
311500,201912,429,1063,320,901,27,87,196,530,223,617
311510,201912,3125,8211,2053,6290,299,1033,836,2388,1135,3421
311520,201912,576,1662,510,1526,71,264,296,842,367,1106
311530,201912,8797,20475,5347,14811,1301,3998,1396,3687,2697,7685
311535,201912,769,2100,484,1511,77,255,167,477,244,732
311540,201912,501,1568,438,1450,83,301,272,881,355,1182
311545,201912,2069,5890,1752,5408,95,357,1338,4046,1433,4403
311547,201912,1470,3788,1263,3462,47,135,871,2433,918,2568
311550,201912,2716,7661,2123,6525,322,1125,908,2652,1230,3777
311560,201912,289,640,181,480,22,72,100,231,122,303
311570,201912,1748,4073,1217,3338,45,137,951,2653,996,2790
311580,201912,2187,4045,1405,3123,138,286,955,2132,1093,2418
311590,201912,495,1317,394,1169,64,217,216,627,280,844
311600,201912,1769,3963,1485,3603,56,130,1272,3037,1328,3167
311610,201912,2235,7371,1823,6450,222,852,987,3450,1209,4302
311615,201912,3067,8849,2465,7818,126,484,1908,5927,2034,6411
311620,201912,440,1160,377,1083,11,43,314,892,325,935
311630,201912,1322,3650,1052,3109,94,302,688,1956,782,2258
311640,201912,560,1536,419,1278,63,223,198,562,261,785
311650,201912,1842,4798,1510,4275,126,407,1016,2792,1142,3199
311660,201912,2765,7884,1959,6306,359,1273,502,1381,861,2654
311670,201912,1518,3998,1085,3226,158,535,459,1371,617,1906
311680,201912,2134,6143,1563,5082,181,595,1004,3256,1185,3851
311690,201912,593,1271,449,1089,38,80,329,840,367,920
311700,201912,2232,5370,1722,4648,28,134,1444,3777,1472,3911
311710,201912,1504,4311,1037,3435,246,898,398,1282,644,2180
311720,201912,394,1187,310,1027,21,89,181,581,202,670
311730,201912,3940,10082,2434,7177,725,2288,463,1387,1188,3675
311740,201912,846,2268,704,2094,31,82,616,1875,647,1957
311750,201912,3826,11566,3065,10171,431,1569,1738,5522,2169,7091
311760,201912,595,1705,487,1508,71,282,232,617,303,899
311770,201912,2035,5884,1564,5015,254,891,726,2222,980,3113
311780,201912,1267,3658,818,2721,175,661,237,685,412,1346
311783,201912,2216,6097,1777,5327,47,216,1412,4066,1459,4282
311787,201912,689,1987,499,1542,71,242,205,538,276,780
311790,201912,1465,3944,926,2948,239,846,252,764,491,1610
311800,201912,4801,14403,3813,12246,818,2807,643,1794,1461,4601
311810,201912,944,2891,735,2507,58,232,468,1566,526,1798
311820,201912,787,1938,569,1585,77,249,346,909,423,1158
311830,201912,8436,24356,5566,18057,1558,5455,658,2042,2216,7497
311840,201912,3422,8854,2788,7929,259,775,2023,5714,2282,6489
311850,201912,330,894,265,770,14,41,177,497,191,538
311860,201912,56817,144194,42574,119611,6440,19489,23445,62940,29885,82429
311870,201912,1892,5031,1232,3811,207,715,457,1278,664,1993
311880,201912,6256,16251,5195,14757,290,769,3903,11239,4193,12008
311890,201912,1608,3943,1230,3386,83,275,872,2285,955,2560
311900,201912,724,1893,532,1617,54,191,362,1076,416,1267
311910,201912,4219,10828,3132,9385,559,1662,1559,4799,2118,6461
311920,201912,2014,5471,1580,4819,116,328,994,3085,1110,3413
311930,201912,3548,8460,2510,6959,816,2431,734,1919,1550,4350
311940,201912,14516,38520,10453,30703,1533,5014,4780,13065,6313,18079
311950,201912,2176,6013,1595,5002,92,393,1034,3173,1126,3566
311960,201912,492,1222,393,1070,25,104,251,610,276,714
311970,201912,434,1406,294,1049,52,211,67,204,119,415
311980,201912,438,1190,219,747,27,95,68,231,95,326
311990,201912,551,1295,343,983,71,250,148,374,219,624
311995,201912,951,2659,470,1526,20,64,64,157,84,221
312000,201912,605,1606,497,1448,49,153,324,940,373,1093
312010,201912,924,2603,700,2204,53,189,428,1296,481,1485
312015,201912,1355,4016,1181,3719,59,277,927,2826,986,3103
312020,201912,1387,4268,1044,3548,228,823,265,851,493,1674
312030,201912,2021,5031,1745,4716,26,106,1605,4314,1631,4420
312040,201912,861,2562,588,1994,67,238,258,861,325,1099
312050,201912,1184,3770,935,3263,215,877,276,854,491,1731
312060,201912,874,2163,567,1775,148,451,261,841,409,1292
312070,201912,866,2527,607,2003,56,202,308,965,364,1167
312080,201912,2694,6628,1982,5566,116,385,1262,3370,1378,3755
312083,201912,860,2254,631,1894,57,208,408,1166,465,1374
312087,201912,2409,6350,1949,5616,48,164,1528,4387,1576,4551
312090,201912,9657,25652,7319,21816,1137,3768,3545,10288,4682,14056
312100,201912,1513,4478,1133,3771,103,444,615,1969,718,2413
312110,201912,1000,3122,822,2747,198,769,281,829,479,1598
312120,201912,784,2138,527,1680,157,581,162,426,319,1007
312125,201912,1715,4452,1405,3997,116,385,1039,2843,1155,3228
312130,201912,955,2349,706,1937,55,168,292,733,347,901
312140,201912,706,2053,578,1794,119,417,255,725,374,1142
312150,201912,455,1286,380,1119,13,63,271,735,284,798
312160,201912,8055,22433,5947,18613,766,2806,2840,8377,3606,11183
312170,201912,892,2432,669,1986,41,154,441,1266,482,1420
312180,201912,1341,3641,1040,3048,151,475,516,1452,667,1927
312190,201912,619,1760,419,1347,76,269,122,370,198,639
312200,201912,4672,12624,3642,10962,1092,3293,1310,4015,2402,7308
312210,201912,1336,3062,938,2471,37,114,690,1783,727,1897
312220,201912,1725,5330,1469,4831,116,411,913,3003,1029,3414
312230,201912,12541,32896,8024,24444,2000,6806,1554,4091,3554,10897
312235,201912,1891,4901,1488,4273,85,315,1063,2956,1148,3271
312240,201912,690,2244,509,1844,114,468,141,478,255,946
312245,201912,2560,6774,2064,6004,64,221,1666,4809,1730,5030
312247,201912,923,2301,642,1870,124,384,323,946,447,1330
312250,201912,986,2623,617,1875,80,252,239,718,319,970
312260,201912,870,2430,678,2122,40,167,498,1504,538,1671
312270,201912,697,1915,524,1580,29,123,294,803,323,926
312280,201912,421,1236,316,1040,98,330,45,137,143,467
312290,201912,734,2186,583,1898,118,439,189,582,307,1021
312300,201912,971,2964,625,2089,161,587,116,319,277,906
312310,201912,825,2610,652,2239,107,405,291,961,398,1366
312320,201912,1886,4902,1337,3909,329,1000,292,833,621,1833
312330,201912,856,2541,671,2158,67,231,410,1289,477,1520
312340,201912,264,687,184,551,43,154,73,191,116,345
312350,201912,250,520,179,441,16,50,125,291,141,341
312352,201912,1620,4823,1419,4461,92,306,872,2906,964,3212
312360,201912,2553,7498,1815,5998,368,1324,522,1655,890,2979
312370,201912,1781,4762,1434,4158,192,621,812,2233,1004,2854
312380,201912,2161,4890,1763,4384,8,30,1565,3853,1573,3883
312385,201912,1240,3437,930,2854,157,509,435,1312,592,1821
312390,201912,1885,5466,1382,4504,211,804,494,1441,705,2245
312400,201912,2833,8290,2302,7306,703,2388,724,2270,1427,4658
312410,201912,11497,31946,9238,28037,1662,5231,4989,14931,6651,20162
312420,201912,3658,10137,3015,9026,563,1849,1579,4582,2142,6431
312430,201912,7785,20804,6238,17997,416,1414,4324,12136,4740,13550
312440,201912,877,2845,668,2358,362,1336,74,227,436,1563
312450,201912,1149,3423,868,2916,249,900,289,998,538,1898
312460,201912,435,1148,292,924,37,128,152,494,189,622
312470,201912,476,1158,298,839,36,115,115,283,151,398
312480,201912,1072,2658,731,2149,100,316,351,988,451,1304
312490,201912,2061,5032,1543,4246,205,588,832,2226,1037,2814
312500,201912,937,2341,744,2056,47,168,507,1377,554,1545
312510,201912,3655,9795,2596,7761,698,1989,707,2165,1405,4154
312520,201912,165,474,131,413,34,114,54,166,88,280
312530,201912,596,1460,500,1341,16,55,440,1187,456,1242
312540,201912,1522,4331,998,3223,149,535,530,1648,679,2183
312550,201912,746,2029,553,1625,46,148,344,926,390,1074
312560,201912,1952,5021,1554,4401,71,229,1187,3371,1258,3600
312570,201912,2126,5313,1601,4647,455,1378,630,1852,1085,3230
312580,201912,608,1706,430,1318,59,209,199,559,258,768
312590,201912,1598,4725,1262,4033,93,414,775,2293,868,2707
312595,201912,1844,5572,1540,5035,278,860,898,3079,1176,3939
312600,201912,1085,2655,526,1657,106,391,125,397,231,788
312610,201912,6122,15657,3800,11169,571,1813,1313,3619,1884,5432
312620,201912,2553,6576,1816,5547,54,248,1442,4456,1496,4704
312630,201912,272,819,195,677,36,151,77,254,113,405
312640,201912,525,1441,351,1138,45,148,129,435,174,583
312650,201912,2071,5388,1384,4061,70,224,960,2689,1030,2913
312660,201912,1320,3234,972,2634,77,251,663,1703,740,1954
312670,201912,4842,12962,3979,11566,182,814,2856,7888,3038,8702
312675,201912,1235,3306,992,2928,58,201,788,2295,846,2496
312680,201912,1377,3916,1143,3542,59,262,927,2774,986,3036
312690,201912,2804,6015,2166,5243,59,168,1792,4335,1851,4503
312695,201912,950,2641,784,2352,35,94,600,1809,635,1903
312700,201912,2047,5452,1472,4394,155,543,840,2359,995,2902
312705,201912,1332,3323,1112,2971,20,71,972,2571,992,2642
312707,201912,1370,4034,1036,3420,65,322,649,2012,714,2334
312710,201912,6582,15128,3781,10653,997,3017,1051,3062,2048,6079
312720,201912,1056,2895,784,2444,101,342,476,1426,577,1768
312730,201912,1636,3899,1159,3233,91,297,675,1806,766,2103
312733,201912,1399,3693,1031,2997,38,148,701,1924,739,2072
312735,201912,629,1724,522,1518,69,231,331,852,400,1083
312737,201912,809,1869,542,1466,70,207,324,830,394,1037
312738,201912,616,1592,427,1261,46,160,230,633,276,793
312740,201912,428,1059,241,734,55,187,60,147,115,334
312750,201912,1427,4314,1120,3738,195,713,481,1489,676,2202
312760,201912,1810,5369,1251,4181,222,796,451,1443,673,2239
312770,201912,44018,106265,26342,75541,5644,17186,8618,24138,14262,41324
312780,201912,2429,7311,2038,6649,236,849,1309,4232,1545,5081
312790,201912,258,626,139,433,9,43,46,116,55,159
312800,201912,4935,14115,3711,11698,920,3072,1238,3792,2158,6864
312810,201912,1599,4257,1023,3287,251,905,346,996,597,1901
312820,201912,1745,4750,1385,4076,45,174,1026,2932,1071,3106
312825,201912,1328,3155,1129,2884,24,87,955,2382,979,2469
312830,201912,2793,7906,1560,5293,336,1280,373,1187,709,2467
312840,201912,1239,3479,938,2929,111,435,461,1349,572,1784
312850,201912,885,2161,606,1736,26,111,359,941,385,1052
312860,201912,1215,3088,796,2451,210,681,183,533,393,1214
312870,201912,6085,16562,3585,11595,632,2233,801,2464,1433,4697
312880,201912,1418,3559,1080,2985,40,150,628,1731,668,1881
312890,201912,2163,5578,1493,4383,107,315,767,2281,874,2596
312900,201912,1175,3003,935,2702,76,245,530,1655,606,1900
312910,201912,1606,2978,807,1907,143,284,331,764,474,1048
312920,201912,982,2669,652,2094,129,486,255,742,384,1228
312930,201912,2204,5507,1685,4734,367,1064,765,2131,1132,3195
312940,201912,940,2620,725,2289,84,322,359,1064,443,1386
312950,201912,3160,7916,2003,5975,529,1718,620,1761,1149,3479
312960,201912,1788,4780,1492,4315,77,204,1151,3420,1228,3624
312965,201912,1643,4668,1357,4200,119,404,926,2801,1045,3205
312970,201912,1257,3581,972,3101,160,613,520,1538,680,2151
312980,201912,22342,62166,17740,53691,3306,11047,8774,24871,12080,35918
312990,201912,457,1192,278,866,49,178,128,380,177,558
313000,201912,472,1353,347,1113,31,133,200,595,231,728
313005,201912,2501,7246,2084,6525,158,489,1470,4559,1628,5048
313010,201912,4815,13444,3811,11749,694,2354,2187,6565,2881,8919
313020,201912,941,2883,617,2116,110,409,112,333,222,742
313030,201912,1118,2632,735,2046,66,239,477,1249,543,1488
313040,201912,785,2431,626,2075,46,189,363,1139,409,1328
313050,201912,1718,4823,1179,3991,198,808,369,1106,567,1914
313055,201912,1874,5115,1664,4799,59,191,1404,4011,1463,4202
313060,201912,978,2372,654,1838,188,610,151,335,339,945
313065,201912,1625,4919,1405,4538,59,248,1058,3319,1117,3567
313070,201912,951,2514,704,2067,71,218,404,1157,475,1375
313080,201912,382,1058,264,812,55,199,97,252,152,451
313090,201912,4948,13389,4183,12125,373,1251,2740,7801,3113,9052
313100,201912,1332,3471,1014,3002,32,137,767,2206,799,2343
313110,201912,1463,3911,1028,3121,92,350,582,1639,674,1989
313115,201912,2481,7287,1992,6320,274,946,1038,3106,1312,4052
313120,201912,3744,8823,2704,7442,250,799,1716,4684,1966,5483
313130,201912,29917,78396,22432,64230,2528,8198,12524,33785,15052,41983
313140,201912,588,1318,352,966,27,80,233,638,260,718
313150,201912,1346,3806,969,3076,281,959,243,701,524,1660
313160,201912,1047,2664,796,2254,30,109,589,1622,619,1731
313170,201912,11242,32378,7774,25570,1386,4928,2963,9115,4349,14043
313180,201912,2153,5717,1496,4416,187,582,833,2411,1020,2993
313190,201912,4192,12073,2952,9493,557,1915,1007,3011,1564,4926
313200,201912,1079,3060,931,2805,19,83,784,2277,803,2360
313210,201912,3700,10853,2994,9599,368,1353,1786,5497,2154,6850
313220,201912,1745,4621,1107,3359,174,601,436,1156,610,1757
313230,201912,2971,8309,2428,7657,58,223,2004,6410,2062,6633
313240,201912,9404,23192,5614,16965,984,3399,2327,6416,3311,9815
313250,201912,6154,18070,4599,14799,818,2694,2037,6438,2855,9132
313260,201912,608,1611,416,1252,56,216,192,536,248,752
313270,201912,5606,14425,4427,12701,589,1717,2880,8407,3469,10124
313280,201912,439,1251,271,890,37,127,112,357,149,484
313290,201912,931,2917,686,2486,230,900,214,745,444,1645
313300,201912,1570,4236,1108,3401,295,964,237,624,532,1588
313310,201912,1069,3188,797,2587,123,464,214,591,337,1055
313320,201912,2131,5654,1485,4593,271,938,624,1921,895,2859
313330,201912,4033,10706,3032,9174,165,678,1967,5870,2132,6548
313340,201912,1362,3090,956,2514,89,245,661,1734,750,1979
313350,201912,2395,6826,1509,4758,201,699,557,1547,758,2246
313360,201912,1325,3287,859,2514,143,498,426,1163,569,1661
313370,201912,1355,3875,1118,3397,139,502,620,1739,759,2241
313375,201912,1685,4367,982,3051,184,630,207,605,391,1235
313380,201912,5896,14989,4085,11565,769,2401,1848,4679,2617,7080
313390,201912,828,2658,716,2469,48,224,471,1548,519,1772
313400,201912,3687,9156,2811,7922,167,523,2156,5954,2323,6477
313410,201912,1285,3370,962,2785,66,234,695,1963,761,2197
313420,201912,14941,33471,7177,20179,1628,5086,1025,2800,2653,7886
313430,201912,902,2692,670,2205,121,483,272,795,393,1278
313440,201912,6220,13532,4012,10604,353,983,2502,6564,2855,7547
313450,201912,698,1906,465,1413,81,264,157,407,238,671
313460,201912,2112,6121,1677,5416,347,1271,777,2375,1124,3646
313470,201912,2850,7340,2218,6410,271,770,1371,4018,1642,4788
313480,201912,963,2776,511,1724,79,289,130,400,209,689
313490,201912,2366,5698,1067,3353,316,1114,150,470,466,1584
313500,201912,436,1271,333,1028,39,120,127,376,166,496
313505,201912,9833,26217,8310,24139,344,1250,6652,19228,6996,20478
313507,201912,1463,3857,1180,3414,28,112,935,2648,963,2760
313510,201912,13125,36404,10286,30984,1269,4104,4961,14530,6230,18634
313520,201912,14036,40014,11127,34883,646,2431,8118,24852,8764,27283
313530,201912,523,1544,385,1240,40,142,150,435,190,577
313535,201912,2353,6497,1968,5754,247,645,1240,3618,1487,4263
313540,201912,757,2260,577,1817,114,370,243,708,357,1078
313545,201912,1170,3879,969,3454,154,578,519,1767,673,2345
313550,201912,1716,5260,1401,4510,329,1183,694,2125,1023,3308
313560,201912,2633,5231,1935,4380,60,112,1625,3692,1685,3804
313570,201912,931,2796,751,2450,178,605,312,960,490,1565
313580,201912,5543,14731,4168,12398,517,1651,2342,7027,2859,8678
313590,201912,961,2777,759,2479,203,705,329,1132,532,1837
313600,201912,3828,10426,3168,9378,95,399,2631,7640,2726,8039
313610,201912,992,2523,787,2160,92,275,487,1269,579,1544
313620,201912,5476,14635,4209,12308,582,1844,2339,6546,2921,8390
313630,201912,8573,20824,5824,16635,619,2046,3355,9336,3974,11382
313640,201912,1033,2428,621,1876,166,507,216,683,382,1190
313650,201912,1725,5222,1381,4632,93,374,909,3056,1002,3430
313652,201912,752,2417,674,2241,115,416,413,1331,528,1747
313655,201912,1143,2926,893,2595,44,142,701,2024,745,2166
313657,201912,1222,3251,946,2802,42,170,699,1957,741,2127
313660,201912,874,2471,699,2137,87,324,410,1173,497,1497
313665,201912,4590,12423,3460,10321,429,1423,2078,5932,2507,7355
313670,201912,48150,118613,29551,86305,4580,14661,12719,34960,17299,49621
313680,201912,1008,2702,826,2419,66,218,537,1520,603,1738
313690,201912,794,2524,595,2127,146,565,158,536,304,1101
313695,201912,1762,4851,1339,4154,85,269,906,2799,991,3068
313700,201912,3008,9714,2566,9109,264,992,1897,6716,2161,7708
313710,201912,1345,3136,950,2597,78,219,636,1752,714,1971
313720,201912,5342,14779,3664,11273,587,2046,1502,4168,2089,6214
313730,201912,1292,2953,957,2489,76,171,642,1654,718,1825
313740,201912,1624,5801,1302,4957,319,1375,220,730,539,2105
313750,201912,1942,5250,1460,4343,274,897,669,1861,943,2758
313753,201912,2100,5038,1365,3845,128,384,779,2125,907,2509
313760,201912,5013,13918,3646,11236,793,2645,1506,4350,2299,6995
313770,201912,3945,11148,3075,9724,209,711,2228,7095,2437,7806
313780,201912,4100,10982,2910,8945,249,912,800,2516,1049,3428
313790,201912,476,1497,417,1387,47,180,229,735,276,915
313800,201912,1379,3221,996,2655,129,397,528,1326,657,1723
313810,201912,1576,4038,1229,3540,54,213,926,2591,980,2804
313820,201912,17055,43088,10214,28722,1668,4919,3083,8251,4751,13170
313830,201912,391,1136,263,834,56,182,88,253,144,435
313835,201912,918,2721,740,2383,64,253,402,1218,466,1471
313840,201912,6738,17701,4806,14366,1224,3850,1017,3088,2241,6938
313850,201912,939,2325,743,2045,134,451,367,883,501,1334
313860,201912,2565,6967,1874,5612,302,1030,759,2097,1061,3127
313862,201912,1424,3020,642,1835,44,134,329,914,373,1048
313865,201912,2465,6636,2020,5894,96,305,1508,4319,1604,4624
313867,201912,1205,3670,998,3282,137,453,662,2198,799,2651
313868,201912,1703,5258,1385,4603,49,242,1062,3413,1111,3655
313870,201912,770,2102,553,1698,101,324,204,565,305,889
313880,201912,1527,4083,1114,3373,172,571,513,1401,685,1972
313890,201912,1991,4378,1469,3698,54,174,1077,2638,1131,2812
313900,201912,3970,11645,2781,9184,723,2639,685,2073,1408,4712
313910,201912,609,1818,451,1507,95,354,99,311,194,665
313920,201912,2910,9082,2414,8027,493,1628,1206,4010,1699,5638
313925,201912,1562,4016,1233,3412,184,486,783,2162,967,2648
313930,201912,4676,14179,3732,12443,282,1085,2427,7975,2709,9060
313940,201912,8606,25071,6002,20445,854,3491,1484,5513,2338,9004
313950,201912,5160,11598,3620,9641,430,1421,2138,5605,2568,7026
313960,201912,5482,13586,3586,10350,804,2597,1101,2878,1905,5475
313970,201912,1448,3955,1200,3526,19,61,756,2181,775,2242
313980,201912,1353,3541,877,2758,137,494,338,1006,475,1500
313990,201912,1824,5910,1280,4612,354,1424,382,1209,736,2633
314000,201912,9471,24710,7801,21853,569,2034,5230,14335,5799,16369
314010,201912,1467,3556,1135,3087,49,169,841,2221,890,2390
314015,201912,1904,5305,1412,4437,192,725,737,2241,929,2966
314020,201912,483,1332,299,981,61,246,60,210,121,456
314030,201912,739,2127,580,1821,55,186,309,953,364,1139
314040,201912,632,1709,499,1449,73,239,267,740,340,979
314050,201912,1773,4781,1253,3797,162,568,636,1797,798,2365
314053,201912,1798,5362,1423,4609,270,870,716,2426,986,3296
314055,201912,2289,6130,1920,5556,47,178,1567,4531,1614,4709
314060,201912,1242,3338,913,2801,34,143,628,1897,662,2040
314070,201912,4493,12461,3458,10538,721,2187,1498,4471,2219,6658
314080,201912,2122,5614,1373,4256,188,705,568,1569,756,2274
314085,201912,2091,6037,1688,5393,248,833,925,2992,1173,3825
314090,201912,4379,12105,3716,11056,236,897,2360,7064,2596,7961
314100,201912,3167,7513,2409,6445,60,174,1828,4862,1888,5036
314110,201912,4442,12672,3567,10936,397,1426,2059,5907,2456,7333
314120,201912,833,1953,324,984,72,258,66,185,138,443
314130,201912,620,1606,368,1136,25,103,208,633,233,736
314140,201912,4595,13146,3549,11059,489,1627,1743,5307,2232,6934
314150,201912,1491,3755,1076,3021,87,252,715,1950,802,2202
314160,201912,2181,5855,1555,4685,214,714,653,1957,867,2671
314170,201912,940,2685,749,2298,48,172,465,1333,513,1505
314180,201912,5438,15223,4342,13410,380,1281,2558,7888,2938,9169
314190,201912,606,1517,410,1212,73,235,182,494,255,729
314200,201912,2877,8091,2332,7142,138,493,1663,4953,1801,5446
314210,201912,1974,5240,1532,4414,166,511,772,2172,938,2683
314220,201912,1301,3612,909,2916,195,724,333,973,528,1697
314225,201912,1077,3085,884,2774,77,216,632,2027,709,2243
314230,201912,754,1953,610,1771,72,236,393,1170,465,1406
314240,201912,1010,2758,772,2391,192,617,299,932,491,1549
314250,201912,508,1422,311,1011,47,152,116,344,163,496
314260,201912,935,2582,728,2279,154,524,403,1215,557,1739
314270,201912,3264,9315,2642,8333,89,377,1941,6034,2030,6411
314280,201912,3338,7735,2142,5868,255,778,1113,2877,1368,3655
314290,201912,4518,11735,3658,10188,294,855,2488,6784,2782,7639
314300,201912,1867,5388,1206,3937,254,920,386,1188,640,2108
314310,201912,4192,11021,2771,8539,891,2981,447,1202,1338,4183
314315,201912,916,3176,774,2867,56,273,530,1887,586,2160
314320,201912,2889,7925,1807,5828,345,1218,634,1980,979,3198
314330,201912,49015,137581,36174,114391,9887,32504,7521,24876,17408,57380
314340,201912,2277,5630,1280,3801,272,945,323,796,595,1741
314345,201912,1388,4172,1120,3677,156,530,640,2073,796,2603
314350,201912,861,2366,558,1816,111,386,131,374,242,760
314360,201912,573,1656,342,1144,50,181,105,319,155,500
314370,201912,703,1909,551,1675,31,118,398,1166,429,1284
314380,201912,1140,3117,728,2336,165,613,173,535,338,1148
314390,201912,12499,32137,7717,23117,1610,5187,2337,6299,3947,11486
314400,201912,3978,11910,2990,9976,785,2712,1075,3722,1860,6434
314410,201912,2720,7594,1834,5905,261,951,640,2152,901,3103
314420,201912,821,2019,594,1677,31,134,407,1072,438,1206
314430,201912,7390,18461,5057,14400,771,2327,2263,6134,3034,8461
314435,201912,1654,4501,1292,3866,54,200,943,2787,997,2987
314437,201912,923,2375,647,1890,65,215,318,913,383,1128
314440,201912,620,1786,429,1381,120,420,86,238,206,658
314450,201912,1364,3659,1129,3287,114,382,659,1841,773,2223
314460,201912,3248,9941,2288,7821,575,2075,517,1716,1092,3791
314465,201912,2196,6370,1860,5716,52,198,1391,4131,1443,4329
314467,201912,861,2312,714,2068,20,66,573,1603,593,1669
314470,201912,2128,6179,1684,5245,285,982,761,2191,1046,3173
314480,201912,6418,18478,4506,14376,767,2735,1580,4446,2347,7181
314490,201912,986,2712,722,2137,63,207,453,1277,516,1484
314500,201912,1700,4154,1204,3418,281,775,441,1291,722,2066
314505,201912,2017,4992,1631,4441,110,316,1159,3082,1269,3398
314510,201912,1844,4844,1264,3951,241,838,555,1713,796,2551
314520,201912,4800,14841,3384,11708,685,2599,415,1249,1100,3848
314530,201912,5456,17702,4858,16518,350,1480,3498,11608,3848,13088
314535,201912,2589,6743,2052,5941,100,357,1556,4461,1656,4818
314537,201912,1113,3204,845,2749,54,214,583,1857,637,2071
314540,201912,386,972,254,741,16,57,136,370,152,427
314545,201912,1818,4491,1596,4216,36,100,1353,3688,1389,3788
314550,201912,631,1571,468,1330,40,151,249,637,289,788
314560,201912,3987,12170,2892,9648,482,1785,994,3029,1476,4814
314570,201912,305,838,220,680,28,103,95,293,123,396
314580,201912,425,1277,321,1063,89,305,92,305,181,610
314585,201912,639,2026,476,1650,66,279,206,681,272,960
314587,201912,1997,5456,1496,4648,202,582,844,2687,1046,3269
314590,201912,3766,10397,2569,8059,367,1282,1078,3147,1445,4429
314600,201912,1845,5134,1039,3508,212,780,130,403,342,1183
314610,201912,8708,22114,5838,17855,1072,3784,2434,7361,3506,11145
314620,201912,2184,5178,1696,4546,44,157,1397,3691,1441,3848
314625,201912,1509,4234,1268,3896,34,206,1061,3194,1095,3400
314630,201912,5283,13655,4271,12290,113,472,3528,10139,3641,10611
314640,201912,640,1570,456,1274,61,202,245,637,306,839
314650,201912,824,1908,482,1367,52,168,245,603,297,771
314655,201912,1582,4366,1106,3497,171,529,536,1672,707,2201
314660,201912,334,779,213,556,11,22,130,324,141,346
314670,201912,1672,3821,1122,3025,21,65,726,1937,747,2002
314675,201912,1711,4576,1450,4133,83,286,1113,3058,1196,3344
314690,201912,2081,5841,1570,5043,441,1559,507,1605,948,3164
314700,201912,10001,28300,6292,20865,1236,4526,1781,5710,3017,10236
314710,201912,7587,21400,5290,16459,970,3289,1676,4599,2646,7888
314720,201912,2054,6089,1351,4579,293,1109,356,1139,649,2248
314730,201912,2106,5718,1461,4469,289,945,498,1425,787,2370
314740,201912,2839,8051,2183,6828,279,938,1113,3416,1392,4354
314750,201912,316,876,239,720,25,88,135,359,160,447
314760,201912,1801,5484,1130,3887,177,705,261,733,438,1438
314770,201912,1088,3194,541,1756,45,159,162,491,207,650
314780,201912,349,828,226,638,41,137,121,302,162,439
314790,201912,9992,27030,6624,20686,1497,5369,2127,6083,3624,11452
314795,201912,1447,3891,1204,3458,30,137,942,2591,972,2728
314800,201912,10687,27211,6092,18452,1166,3864,1366,3645,2532,7509
314810,201912,8512,22806,6017,18319,1534,4999,1963,5796,3497,10795
314820,201912,1137,2848,876,2451,52,200,557,1491,609,1691
314830,201912,1450,4447,1192,3934,232,843,554,1805,786,2648
314840,201912,866,2757,676,2432,53,265,474,1628,527,1893
314850,201912,1959,4717,1561,4197,38,127,1341,3625,1379,3752
314860,201912,3174,9516,2605,8404,226,902,1740,5445,1966,6347
314870,201912,6280,16155,4691,13972,282,923,3437,10290,3719,11213
314875,201912,1725,5200,1498,4899,105,290,1210,4020,1315,4310
314880,201912,836,2052,632,1733,29,90,395,1082,424,1172
314890,201912,422,1256,308,999,48,180,123,366,171,546
314900,201912,663,1804,503,1528,89,300,199,581,288,881
314910,201912,1614,4632,1177,3896,228,867,533,1636,761,2503
314915,201912,2182,6513,1808,5854,128,421,1197,3823,1325,4244
314920,201912,472,1230,301,959,8,28,199,647,207,675
314930,201912,5306,15192,3917,12524,693,2394,1516,4527,2209,6921
314940,201912,388,997,317,873,30,78,201,524,231,602
314950,201912,479,1227,302,921,30,123,153,414,183,537
314960,201912,793,1941,602,1615,27,86,442,1130,469,1216
314970,201912,856,2463,629,1988,128,450,265,761,393,1211
314980,201912,1423,3702,1011,3078,202,700,435,1292,637,1992
314990,201912,2348,6810,1559,4977,327,1136,311,875,638,2011
314995,201912,1614,4496,1269,3883,47,199,834,2436,881,2635
315000,201912,1123,2892,789,2354,64,210,513,1495,577,1705
315010,201912,376,1049,272,858,42,151,132,390,174,541
315015,201912,2231,6364,1918,5827,189,650,1239,3697,1428,4347
315020,201912,770,2264,542,1737,74,302,227,642,301,944
315030,201912,570,1529,366,1132,82,256,81,231,163,487
315040,201912,794,2287,655,2006,87,291,403,1224,490,1515
315050,201912,1196,3090,833,2484,59,218,440,1269,499,1487
315053,201912,1104,2899,824,2394,51,160,483,1342,534,1502
315057,201912,1672,5169,1364,4584,145,491,907,3078,1052,3569
315060,201912,557,1694,397,1362,77,281,102,329,179,610
315070,201912,523,1385,351,1076,85,296,93,258,178,554
315080,201912,2801,8084,2099,6684,303,1023,1182,3628,1485,4651
315090,201912,797,2445,575,1998,89,339,208,683,297,1022
315100,201912,1227,3709,745,2584,141,559,306,948,447,1507
315110,201912,1733,4289,1248,3523,139,382,611,1770,750,2152
315120,201912,11522,27387,8267,22331,1162,2947,4336,12135,5498,15082
315130,201912,1361,3897,1097,3408,132,477,449,1316,581,1793
315140,201912,2884,8030,2172,6730,398,1365,1059,3055,1457,4420
315150,201912,4267,10339,2896,8084,461,1493,1344,3577,1805,5070
315160,201912,1637,4081,1047,3108,240,753,458,1334,698,2087
315170,201912,1407,4462,941,3319,225,862,204,691,429,1553
315180,201912,16526,40442,8223,24627,1167,3925,2498,6513,3665,10438
315190,201912,2106,4688,1617,4039,193,462,1178,2970,1371,3432
315200,201912,3757,10927,2665,8895,802,2877,655,2087,1457,4964
315210,201912,7852,20680,5287,15145,645,2001,2581,6731,3226,8732
315213,201912,1109,2911,939,2677,18,59,763,2153,781,2212
315217,201912,2690,7991,2037,6850,93,476,1395,4474,1488,4950
315220,201912,8168,22327,6348,19070,1241,3957,2589,7770,3830,11727
315230,201912,3114,7310,2577,6610,157,267,2005,5415,2162,5682
315240,201912,2422,7121,1999,6361,453,1506,984,3107,1437,4613
315250,201912,11813,32268,8143,25120,1361,4553,3415,10044,4776,14597
315260,201912,945,2639,475,1580,87,287,32,85,119,372
315270,201912,806,2344,547,1820,78,282,175,499,253,781
315280,201912,2863,7210,1619,4890,400,1320,257,766,657,2086
315290,201912,1176,2922,687,2128,196,686,182,532,378,1218
315300,201912,630,1526,406,1195,99,333,181,528,280,861
315310,201912,1276,3602,928,2922,75,263,510,1519,585,1782
315320,201912,669,1965,456,1530,69,275,195,601,264,876
315330,201912,751,2593,400,1607,68,307,119,426,187,733
315340,201912,3043,7430,2155,6115,206,642,1260,3538,1466,4180
315350,201912,1560,4287,1190,3693,175,626,653,1986,828,2612
315360,201912,1665,4983,1199,3969,178,634,487,1509,665,2143
315370,201912,446,1309,348,1104,63,183,145,452,208,635
315380,201912,178,528,131,415,31,98,26,56,57,154
315390,201912,1098,3171,830,2639,149,544,354,1025,503,1569
315400,201912,3950,11021,3071,9368,450,1439,1605,4711,2055,6150
315410,201912,2269,5261,1686,4408,462,1287,238,678,700,1965
315415,201912,1290,3547,1026,3144,209,753,420,1306,629,2059
315420,201912,1276,3700,821,2786,168,602,141,448,309,1050
315430,201912,3594,8764,2486,7046,437,1464,1073,2828,1510,4292
315440,201912,991,2670,784,2318,74,256,451,1247,525,1503
315445,201912,1961,4763,1379,3915,89,295,990,2753,1079,3048
315450,201912,2223,6255,1790,5558,240,702,1089,3412,1329,4114
315460,201912,34896,98832,28404,86740,4780,16339,14741,42256,19521,58595
315470,201912,552,1587,395,1217,31,111,234,680,265,791
315480,201912,1199,3481,809,2620,160,541,251,778,411,1319
315490,201912,2911,7308,1944,5749,290,873,686,1987,976,2860
315500,201912,496,1350,292,893,41,149,130,342,171,491
315510,201912,1221,3235,1032,2958,24,111,883,2476,907,2587
315520,201912,1043,2874,808,2461,58,215,591,1741,649,1956
315530,201912,570,1650,443,1414,134,478,199,594,333,1072
315540,201912,1365,3735,920,2876,100,378,403,1233,503,1611
315550,201912,1893,4920,1163,3569,246,844,292,874,538,1718
315560,201912,6227,19102,5232,17247,300,966,3472,11614,3772,12580
315570,201912,1958,5374,1574,4736,92,368,942,2732,1034,3100
315580,201912,2555,6141,1889,5074,283,897,742,1868,1025,2765
315590,201912,869,2291,671,1972,75,268,353,969,428,1237
315600,201912,2420,7711,1723,6314,259,902,903,3450,1162,4352
315610,201912,904,2319,656,1843,110,383,287,691,397,1074
315620,201912,438,1219,327,1042,43,153,204,664,247,817
315630,201912,914,2445,708,2100,134,420,296,803,430,1223
315640,201912,353,893,266,784,29,111,158,434,187,545
315645,201912,950,2481,629,1937,158,523,157,467,315,990
315650,201912,1735,4246,1363,3723,34,121,1114,2937,1148,3058
315660,201912,2424,5952,1786,4842,98,290,1278,3339,1376,3629
315670,201912,13467,37296,10078,30979,2026,6446,4440,13141,6466,19587
315680,201912,3025,8899,2180,7250,328,1236,1053,3332,1381,4568
315690,201912,3106,7614,1781,5329,398,1201,549,1772,947,2973
315700,201912,7756,21900,5746,17776,930,3069,2561,7528,3491,10597
315710,201912,1840,4612,1281,3741,45,217,904,2509,949,2726
315720,201912,4346,12173,3624,10852,176,738,2573,7364,2749,8102
315725,201912,2013,5434,1512,4516,140,403,1026,3121,1166,3524
315727,201912,561,1459,407,1200,57,194,167,469,224,663
315730,201912,589,1853,510,1687,84,316,196,610,280,926
315733,201912,1252,3186,835,2423,129,454,318,870,447,1324
315737,201912,1116,3246,863,2730,35,146,605,1851,640,1997
315740,201912,870,2447,671,2026,86,307,402,1125,488,1432
315750,201912,1255,3356,975,2867,89,275,601,1781,690,2056
315760,201912,1130,2700,996,2524,49,138,837,2084,886,2222
315765,201912,1870,4987,1514,4522,27,107,1326,3946,1353,4053
315770,201912,969,2763,737,2433,293,1060,142,377,435,1437
315780,201912,27514,76237,22865,67864,1439,5317,15506,43945,16945,49262
315790,201912,3546,10990,2979,9882,379,1320,1742,5867,2121,7187
315800,201912,1216,4388,852,3369,136,608,240,840,376,1448
315810,201912,1311,3290,1069,2863,56,193,820,2089,876,2282
315820,201912,2588,7127,2077,6361,174,640,1415,4274,1589,4914
315830,201912,1210,3569,814,2719,82,298,296,939,378,1237
315840,201912,808,1970,520,1433,40,130,259,661,299,791
315850,201912,1121,3382,888,2952,175,637,432,1341,607,1978
315860,201912,469,1360,319,1076,74,268,91,276,165,544
315870,201912,452,1181,353,1026,25,86,244,665,269,751
315880,201912,1053,2771,692,2136,93,353,162,457,255,810
315890,201912,1629,4715,1285,4209,320,1137,623,2002,943,3139
315895,201912,5970,16171,4379,12999,429,1449,2280,6266,2709,7715
315900,201912,805,2082,690,1912,57,170,513,1375,570,1545
315910,201912,514,1459,430,1320,58,203,292,867,350,1070
315920,201912,1502,3860,804,2485,134,479,253,726,387,1205
315930,201912,1087,2478,701,1891,126,330,305,829,431,1159
315935,201912,801,2430,628,2101,124,443,212,705,336,1148
315940,201912,584,1648,458,1442,51,174,240,719,291,893
315950,201912,1156,3174,948,2842,89,264,714,2140,803,2404
315960,201912,4352,12388,2506,8518,809,3161,186,384,995,3545
315970,201912,627,1663,487,1476,60,209,324,981,384,1190
315980,201912,4220,9221,2216,5915,393,1119,779,1898,1172,3017
315990,201912,3618,9219,2776,7762,254,772,1609,4373,1863,5145
316000,201912,519,1361,387,1166,54,200,183,513,237,713
316010,201912,816,2155,589,1771,40,144,370,1030,410,1174
316020,201912,922,2831,734,2457,80,329,433,1361,513,1690
316030,201912,2743,7744,2040,6472,240,787,1274,4101,1514,4888
316040,201912,2405,6905,1725,5595,321,1163,401,1127,722,2290
316045,201912,2048,5357,1850,5111,75,169,1575,4471,1650,4640
316050,201912,359,1025,263,848,37,136,144,442,181,578
316060,201912,676,1737,489,1448,23,104,338,948,361,1052
316070,201912,5311,14975,4277,12955,753,2378,1981,5802,2734,8180
316080,201912,703,2205,533,1846,126,465,78,262,204,727
316090,201912,405,1209,282,940,37,145,135,396,172,541
316095,201912,1287,4015,1007,3309,265,906,328,1056,593,1962
316100,201912,2426,7234,1686,5556,310,1107,600,1801,910,2908
316105,201912,846,2265,652,1972,38,129,453,1409,491,1538
316110,201912,13286,38941,11016,35067,848,3127,7384,23232,8232,26359
316120,201912,1127,3274,685,2187,120,401,197,520,317,921
316130,201912,1226,2777,760,2018,60,189,444,1141,504,1330
316140,201912,1146,3102,720,2300,101,358,360,1123,461,1481
316150,201912,1819,4027,1489,3604,180,560,609,1393,789,1953
316160,201912,1002,2792,807,2444,47,172,525,1533,572,1705
316165,201912,856,2149,640,1794,99,336,326,848,425,1184
316170,201912,1115,2824,829,2382,57,206,556,1541,613,1747
316180,201912,1299,3715,837,2730,138,541,154,450,292,991
316190,201912,2575,7353,1441,4599,217,715,527,1498,744,2213
316200,201912,3226,9371,2294,7621,571,2014,447,1469,1018,3483
316210,201912,4459,13211,3094,10027,1152,4000,203,546,1355,4546
316220,201912,600,1834,390,1341,96,370,42,164,138,534
316225,201912,1511,3467,1113,2805,42,165,850,1988,892,2153
316230,201912,398,1090,294,910,29,95,173,539,202,634
316240,201912,5600,16263,4850,14956,383,1311,3643,11029,4026,12340
316245,201912,2964,9787,2626,9188,138,809,1962,6474,2100,7283
316250,201912,9973,24343,6857,19302,1509,4607,2356,6472,3865,11079
316255,201912,2963,8234,2553,7573,134,438,1897,5671,2031,6109
316257,201912,1310,3264,908,2540,137,386,464,1255,601,1641
316260,201912,1968,5167,1490,4355,118,371,802,2397,920,2768
316265,201912,1142,3085,882,2642,24,87,636,1842,660,1929
316270,201912,3602,11278,3040,9989,510,1793,1421,4444,1931,6237
316280,201912,2834,8307,2393,7440,333,1116,1314,3939,1647,5055
316290,201912,3481,9619,2734,8202,307,1089,1157,3341,1464,4430
316292,201912,4956,13316,3916,11532,486,1571,2570,7263,3056,8834
316294,201912,802,2394,581,1997,98,377,151,496,249,873
316295,201912,2904,8221,2352,7251,149,574,1623,4727,1772,5301
316300,201912,981,2905,801,2607,50,195,562,1810,612,2005
316310,201912,812,2157,501,1600,103,402,83,223,186,625
316320,201912,608,1717,453,1451,51,204,214,662,265,866
316330,201912,1046,2802,770,2300,48,194,560,1592,608,1786
316340,201912,1008,2791,733,2267,74,303,404,1166,478,1469
316350,201912,1262,3620,1041,3256,96,327,714,2210,810,2537
316360,201912,632,1671,499,1447,49,154,360,1009,409,1163
316370,201912,4886,13310,3551,10757,708,2462,1224,3261,1932,5723
316380,201912,1697,4064,1304,3502,48,112,947,2543,995,2655
316390,201912,810,2178,569,1740,224,779,100,274,324,1053
316400,201912,1142,3271,706,2358,117,428,235,705,352,1133
316410,201912,1075,3125,895,2843,66,218,690,2165,756,2383
316420,201912,1893,5231,1633,4893,50,195,1352,3966,1402,4161
316430,201912,867,2309,527,1663,96,343,161,477,257,820
316440,201912,704,2242,549,1964,125,513,110,366,235,879
316443,201912,536,1511,391,1231,99,349,79,230,178,579
316447,201912,1873,5113,1614,4683,34,129,1338,3807,1372,3936
316450,201912,2150,6586,1603,5430,212,765,960,3181,1172,3946
316460,201912,1024,2656,815,2307,141,443,496,1316,637,1759
316470,201912,6492,18768,4516,14533,779,2839,1700,5027,2479,7866
316480,201912,202,556,169,506,39,116,83,243,122,359
316490,201912,314,849,218,674,28,95,85,220,113,315
316500,201912,1129,3613,713,2562,151,588,157,529,308,1117
316510,201912,719,2364,567,2068,120,456,248,915,368,1371
316520,201912,1141,2878,876,2424,121,413,429,1090,550,1503
316530,201912,1061,2817,768,2284,86,336,383,1007,469,1343
316540,201912,823,2191,646,1911,114,389,294,798,408,1187
316550,201912,1386,4093,1175,3674,63,232,884,2725,947,2957
316553,201912,3710,11210,2538,8340,445,1622,842,2486,1287,4108
316555,201912,2438,7941,2213,7626,115,418,1775,6171,1890,6589
316556,201912,556,1347,382,1047,28,86,222,566,250,652
316557,201912,983,3098,836,2832,316,1142,227,757,543,1899
316560,201912,335,948,226,770,57,244,64,177,121,421
316570,201912,1191,3515,979,3116,241,784,363,1156,604,1940
316580,201912,378,811,222,555,35,100,111,262,146,362
316590,201912,1300,3422,900,2614,167,441,470,1319,637,1760
316600,201912,946,2960,805,2654,129,459,418,1353,547,1812
316610,201912,565,1815,473,1672,51,230,285,966,336,1196
316620,201912,1998,5482,1707,5078,93,297,1288,3853,1381,4150
316630,201912,1565,4692,1246,4090,332,1104,484,1708,816,2812
316640,201912,145,384,110,327,18,60,49,123,67,183
316650,201912,1021,3304,812,2961,69,277,503,1871,572,2148
316660,201912,188,477,77,237,7,24,11,33,18,57
316670,201912,1807,4609,1305,3773,315,987,474,1332,789,2319
316680,201912,2181,5549,1627,4554,103,311,1244,3404,1347,3715
316690,201912,1269,3710,959,3090,186,659,422,1324,608,1983
316695,201912,1002,2928,818,2585,37,152,549,1704,586,1856
316700,201912,379,896,313,817,14,46,234,569,248,615
316710,201912,2984,9892,2230,8279,470,1854,850,3137,1320,4991
316720,201912,20050,55505,14296,44046,2665,8737,5838,17086,8503,25823
316730,201912,408,1148,322,975,43,145,160,445,203,590
316740,201912,685,2062,587,1897,67,260,359,1158,426,1418
316750,201912,380,1138,289,963,61,248,130,390,191,638
316760,201912,3612,11475,2875,9933,1140,4268,633,2058,1773,6326
316770,201912,1543,3611,1199,3137,24,78,1008,2673,1032,2751
316780,201912,543,1653,422,1408,153,572,65,192,218,764
316790,201912,689,1869,470,1425,110,348,132,363,242,711
316800,201912,6051,17249,4738,14803,458,1672,2493,7479,2951,9151
316805,201912,1012,2231,801,2002,64,180,616,1546,680,1726
316810,201912,644,1807,424,1332,82,296,204,593,286,889
316820,201912,312,756,157,467,10,37,72,202,82,239
316830,201912,695,1926,555,1692,71,264,347,1004,418,1268
316840,201912,2745,7283,2189,6303,206,741,1443,3946,1649,4687
316850,201912,1945,5160,1355,4073,219,710,586,1716,805,2426
316860,201912,18693,48823,13659,41116,2285,7918,6219,18158,8504,26076
316870,201912,7430,20494,5399,16536,852,2905,2404,6813,3256,9718
316880,201912,800,2188,637,1958,133,455,287,837,420,1292
316890,201912,1106,2482,630,1824,100,364,357,928,457,1292
316900,201912,2183,6013,1653,4934,333,1102,538,1467,871,2569
316905,201912,526,1572,407,1332,103,372,159,527,262,899
316910,201912,872,2325,532,1709,139,487,45,131,184,618
316920,201912,1622,4115,1056,3201,202,660,430,1277,632,1937
316930,201912,7552,21998,5337,17848,1146,4125,1330,4273,2476,8398
316935,201912,3964,10860,2826,8666,508,1684,1140,3356,1648,5040
316940,201912,6425,19076,4819,15614,783,2823,1838,5534,2621,8357
316950,201912,1849,4366,1413,3754,48,151,1158,3016,1206,3167
316960,201912,5068,11540,3610,9447,377,1088,2378,6069,2755,7157
316970,201912,3604,10411,3106,9430,512,1638,1268,3681,1780,5319
316980,201912,669,2026,488,1666,158,600,67,232,225,832
316990,201912,10568,29157,7235,22068,1991,6532,997,2689,2988,9221
317000,201912,2563,7635,2251,7172,178,540,1643,5242,1821,5782
317005,201912,2594,7484,2016,6256,321,1041,1045,3164,1366,4205
317010,201912,23836,56120,14157,41118,3038,9597,5131,15295,8169,24892
317020,201912,63279,151182,34935,100926,6540,20622,10539,27954,17079,48576
317030,201912,649,1765,504,1565,19,85,389,1191,408,1276
317040,201912,10855,27755,7426,21786,1674,5238,2686,8019,4360,13257
317043,201912,847,1933,605,1595,61,165,425,1115,486,1280
317047,201912,1156,2798,781,2174,94,263,478,1296,572,1559
317050,201912,1174,3629,797,2725,105,358,329,999,434,1357
317052,201912,2318,6641,1838,5847,286,919,1101,3506,1387,4425
317057,201912,1778,4381,1280,3539,39,153,832,2239,871,2392
317060,201912,443,1174,262,799,35,124,115,315,150,439
317065,201912,1201,3542,965,3083,48,178,594,1762,642,1940
317070,201912,7462,20662,5054,15899,999,3549,1379,4046,2378,7595
317075,201912,888,2323,608,1807,104,352,240,641,344,993
317080,201912,6001,14243,4340,11508,1202,3425,1374,3461,2576,6886
317090,201912,4403,13355,3905,12523,305,951,2842,9107,3147,10058
317100,201912,2630,6268,1639,4608,384,1139,595,1608,979,2747
317103,201912,1977,5723,1652,5182,103,515,1203,3559,1306,4074
317107,201912,1377,3712,1044,3050,67,258,647,1674,714,1932
317110,201912,719,1664,352,1083,50,181,118,375,168,556
317115,201912,1069,3076,895,2756,48,131,626,1944,674,2075
317120,201912,12389,34487,9588,29747,1184,4256,5310,15926,6494,20182
317130,201912,10678,24915,6346,17798,1093,3364,2119,5832,3212,9196
317140,201912,730,1900,557,1628,39,111,370,1114,409,1225
317150,201912,998,2394,733,2045,31,105,567,1546,598,1651
317160,201912,3610,8791,2311,6700,182,577,1277,3729,1459,4306
317170,201912,1856,4700,1269,3641,210,702,503,1237,713,1939
317180,201912,1862,5957,1347,4668,266,988,345,1124,611,2112
317190,201912,1231,3339,898,2805,103,334,519,1602,622,1936
317200,201912,4905,12987,3636,10735,1022,3276,699,1868,1721,5144
317210,201912,1169,2859,882,2471,30,114,650,1832,680,1946
317220,201912,252,784,209,691,55,181,75,266,130,447
320010,201912,4521,13263,3570,11339,384,1362,2293,7122,2677,8484
320013,201912,1766,5000,1118,3653,179,590,519,1738,698,2328
320016,201912,3019,7785,2318,6702,144,395,1807,5212,1951,5607
320020,201912,3852,10232,2779,8363,654,2123,996,3085,1650,5208
320030,201912,1558,4544,1045,3457,195,702,368,1149,563,1851
320035,201912,1813,5072,1473,4468,374,1264,643,1882,1017,3146
320040,201912,3891,11212,3146,9780,430,1443,1734,5213,2164,6656
320050,201912,1751,3997,1488,3609,205,594,870,2028,1075,2622
320060,201912,11692,32790,8529,26390,1348,4587,3970,11604,5318,16191
320070,201912,1454,4137,974,3139,184,662,338,1035,522,1697
320080,201912,5526,14380,3814,10946,836,2532,1375,3771,2211,6303
320090,201912,8115,21887,5253,15886,1201,3912,1915,5367,3116,9279
320100,201912,2758,7837,2190,6797,382,1317,1158,3521,1540,4838
320110,201912,1520,3800,1108,3113,179,540,554,1496,733,2036
320115,201912,1778,5797,1507,5327,650,2418,420,1543,1070,3961
320120,201912,20018,52028,13472,40030,2029,6540,6059,17211,8088,23751
320130,201912,43067,121575,34990,106592,4902,16403,20106,59397,25008,75800
320140,201912,2963,8559,2161,6868,355,1281,912,2853,1267,4134
320150,201912,13152,34622,8947,26218,2374,7512,1565,4125,3939,11637
320160,201912,5545,15805,4026,12822,686,2319,1862,5842,2548,8161
320170,201912,1458,4295,1059,3500,285,945,428,1464,713,2409
320180,201912,702,2252,565,1974,203,752,151,495,354,1247
320190,201912,2702,8743,2045,7215,491,1823,540,1812,1031,3635
320200,201912,1079,2992,774,2421,188,648,270,852,458,1500
320210,201912,4453,11449,3359,9490,548,1693,1775,4778,2323,6471
320220,201912,2573,6961,1897,5790,358,1200,883,2580,1241,3780
320225,201912,1343,4230,909,3161,334,1237,177,610,511,1847
320230,201912,4650,13145,3478,11126,842,2914,1326,4136,2168,7050
320240,201912,14926,38716,10866,31971,2624,8342,3829,10940,6453,19282
320245,201912,3003,9077,2369,7740,941,3202,463,1474,1404,4676
320250,201912,2012,5776,1292,4016,304,1049,353,989,657,2038
320255,201912,1707,5485,1491,5099,459,1585,715,2551,1174,4136
320260,201912,1049,3145,732,2356,174,646,203,548,377,1194
320265,201912,2410,7533,1962,6626,921,3281,357,1192,1278,4473
320270,201912,2205,6393,1632,5229,372,1277,664,2124,1036,3401
320280,201912,6569,17873,5169,15382,1177,3742,2169,6273,3346,10015
320290,201912,1315,3955,823,2728,230,823,197,613,427,1436
320300,201912,3480,10783,2791,9293,826,2966,609,1873,1435,4839
320305,201912,5068,14511,3874,12110,758,2554,1872,5639,2630,8193
320310,201912,1950,5499,1308,4096,247,812,565,1700,812,2512
320313,201912,2328,5942,1413,4108,297,981,348,926,645,1907
320316,201912,1482,4231,1199,3727,186,601,711,2213,897,2814
320320,201912,21196,56216,14636,44641,3476,11069,5434,16535,8910,27604
320330,201912,2943,8046,2259,6789,453,1355,1149,3516,1602,4871
320332,201912,6066,16987,4741,14593,1210,3962,2139,6552,3349,10514
320334,201912,1736,5052,1188,3885,258,1011,255,652,513,1663
320335,201912,1424,4227,916,3017,230,820,218,656,448,1476
320340,201912,4699,12003,3880,10747,501,1506,2254,6276,2755,7782
320350,201912,5235,13201,3578,10093,470,1387,1852,5004,2322,6391
320360,201912,1429,3649,1029,2883,124,330,516,1396,640,1726
320370,201912,2390,7629,1848,6398,582,2085,600,2058,1182,4143
320380,201912,2450,6687,2015,5951,251,792,1256,3628,1507,4420
320390,201912,7120,19545,5161,15538,1086,3460,2046,5796,3132,9256
320400,201912,3198,9192,2454,7610,693,2272,886,2644,1579,4916
320405,201912,4455,11895,3283,9865,564,1817,1485,4372,2049,6189
320410,201912,4762,12460,3529,10436,633,1850,1751,5395,2384,7245
320420,201912,2936,7819,2205,6572,689,2306,419,1200,1108,3506
320425,201912,2062,4949,1547,4097,90,261,1042,2676,1132,2937
320430,201912,2907,7360,2264,6149,309,946,1448,3747,1757,4693
320435,201912,2240,7049,1744,6057,612,2216,535,1881,1147,4097
320440,201912,1375,3811,977,3028,154,515,430,1286,584,1801
320450,201912,1603,4693,1235,3990,299,1083,534,1597,833,2680
320455,201912,3966,12116,2574,8765,675,2451,664,2094,1339,4545
320460,201912,2085,6245,1421,4764,348,1238,350,1100,698,2338
320465,201912,1195,3446,888,2835,130,446,481,1527,611,1973
320470,201912,3695,10277,2506,7719,596,1953,585,1613,1181,3566
320480,201912,1643,4600,1341,4075,217,758,742,2169,959,2927
320490,201912,20719,54803,14795,44088,2616,8557,6098,17815,8714,26372
320495,201912,1360,3749,912,2863,193,698,334,990,527,1688
320500,201912,51970,139678,41081,120248,6036,19100,23495,65757,29531,84857
320501,201912,4349,12626,3099,10322,885,3288,1050,3400,1935,6688
320503,201912,1990,6034,1375,4686,402,1476,445,1402,847,2878
320506,201912,2521,7576,1705,5731,518,1864,180,600,698,2464
320510,201912,9870,27052,7869,23465,928,3200,4808,13803,5736,17003
320515,201912,1721,4773,1294,3879,363,1181,415,1196,778,2377
320517,201912,2120,6470,1649,5460,553,1985,449,1440,1002,3425
320520,201912,35168,92266,25521,75586,4701,15214,10669,30436,15370,45650
320530,201912,30531,81975,23513,69202,2396,8343,14453,40053,16849,48396
330010,201912,21337,57673,17124,50400,2540,7954,10602,30482,13142,38436
330015,201912,1501,3747,1147,3171,201,633,619,1622,820,2255
330020,201912,20198,50642,17017,45981,2402,7362,11889,31180,14291,38542
330022,201912,1920,5136,1436,4292,251,762,811,2408,1062,3170
330023,201912,4953,11913,3417,9662,612,1882,1788,4883,2400,6765
330025,201912,4968,12184,3241,9279,942,2898,977,2691,1919,5589
330030,201912,10362,27927,7668,23305,855,3008,4623,13380,5478,16388
330040,201912,14613,38351,11418,32732,1158,3750,7503,20581,8661,24331
330045,201912,84477,200626,68813,180341,5376,14217,54198,140783,59574,155000
330050,201912,2503,6674,1804,5466,386,1240,825,2374,1211,3614
330060,201912,4823,12967,3932,11388,794,2537,1733,4622,2527,7159
330070,201912,22814,58621,18251,51707,3008,9040,10550,29570,13558,38610
330080,201912,8814,22494,7469,20526,957,2776,5097,13828,6054,16604
330090,201912,3490,7310,2233,5588,139,379,1517,3767,1656,4146
330093,201912,2490,6146,1787,5095,130,395,1315,3744,1445,4139
330095,201912,1227,3505,929,2914,80,302,549,1578,629,1880
330100,201912,70097,187506,58951,170496,3802,13127,44477,126305,48279,139432
330110,201912,2068,5864,1698,5227,276,934,911,2705,1187,3639
330115,201912,2166,5406,1614,4591,245,792,954,2601,1199,3393
330120,201912,3555,8065,2575,6737,263,772,1698,4276,1961,5048
330130,201912,4013,11026,3285,9919,479,1517,2036,6096,2515,7613
330140,201912,3591,9475,2816,8310,420,1355,1743,5010,2163,6365
330150,201912,2163,5795,1629,4917,324,1034,752,2216,1076,3250
330160,201912,1385,3802,1033,3164,178,595,541,1581,719,2176
330170,201912,104009,262967,83046,233741,11638,32493,54760,155778,66398,188271
330180,201912,2080,5080,1569,4314,109,343,1049,2779,1158,3122
330185,201912,9739,24749,8032,22253,568,1918,6252,16821,6820,18739
330187,201912,4260,10976,3306,9421,458,1445,1934,5452,2392,6897
330190,201912,32242,79166,27192,72038,2062,5924,21318,55668,23380,61592
330200,201912,15672,40513,12708,36702,2573,7136,7878,23327,10451,30463
330205,201912,2049,5151,1540,4283,87,288,1058,2832,1145,3120
330210,201912,3359,8488,2402,6764,354,1118,1149,2979,1503,4097
330220,201912,11415,28881,7876,22760,1775,5682,2672,7092,4447,12774
330225,201912,3742,9601,2793,8115,218,764,1971,5549,2189,6313
330227,201912,17565,42662,14758,39129,653,1982,12589,32873,13242,34855
330230,201912,1697,3917,1181,3246,105,308,787,2132,892,2440
330240,201912,23736,62200,19058,54530,2563,7990,12176,33869,14739,41859
330245,201912,1676,4195,967,2932,192,621,354,1073,546,1694
330250,201912,37134,96420,30616,86553,5653,16275,18098,51170,23751,67445
330260,201912,4229,10605,3160,9097,372,1209,2081,5757,2453,6966
330270,201912,28241,61217,16738,43312,2895,8036,7036,17587,9931,25623
330280,201912,2381,6351,1751,5243,184,608,1030,2962,1214,3570
330285,201912,22794,55426,17865,48157,1569,4920,12870,33463,14439,38383
330290,201912,3687,9096,2928,8070,323,1010,2021,5402,2344,6412
330300,201912,5760,13706,4035,11121,328,1025,2721,7349,3049,8374
330310,201912,2418,6082,1773,5012,117,301,1203,3384,1320,3685
330320,201912,16237,39067,12419,34172,1483,4088,8905,24577,10388,28665
330330,201912,35834,79935,27238,68076,2616,7166,19463,47518,22079,54684
330340,201912,14618,36455,10371,29562,1725,5437,5177,14061,6902,19498
330350,201912,126183,298254,102716,269015,7068,19370,82882,215867,89950,235237
330360,201912,7551,18308,6419,16887,233,629,5420,14178,5653,14807
330370,201912,4784,13776,3498,11506,807,2726,1449,4946,2256,7672
330380,201912,5392,14656,3967,12045,736,2545,1896,5462,2632,8007
330385,201912,3955,11510,3194,10367,776,2765,1482,4759,2258,7524
330390,201912,25833,70809,19434,59250,2870,9949,10802,31031,13672,40980
330395,201912,3199,8005,2596,7189,167,518,1857,5029,2024,5547
330400,201912,3159,8515,2677,7723,156,574,1994,5433,2150,6007
330410,201912,2927,8063,2180,6713,419,1428,1020,2975,1439,4403
330411,201912,2791,7560,2133,6269,153,518,1488,4201,1641,4719
330412,201912,1494,4307,1189,3778,138,505,716,2136,854,2641
330414,201912,23158,58871,18387,52208,1719,5000,13220,37190,14939,42190
330415,201912,4083,11138,3109,9408,333,1044,1831,5543,2164,6587
330420,201912,10631,26495,7076,20557,941,3059,3453,9399,4394,12458
330430,201912,9433,22894,7901,20713,366,1192,6107,15463,6473,16655
330440,201912,2356,6409,1720,5317,308,1123,940,2757,1248,3880
330450,201912,1312,3828,1032,3329,140,490,545,1721,685,2211
330452,201912,16152,41664,12647,36133,1762,5601,7841,21690,9603,27291
330455,201912,553651,1323720,415792,1118974,61987,177148,258216,681549,320203,858697
330460,201912,1199,3279,879,2787,158,533,469,1444,627,1977
330470,201912,4880,12350,3473,10123,1103,3296,1085,3204,2188,6500
330475,201912,9228,24233,7377,21745,1222,4090,4622,13320,5844,17410
330480,201912,5973,15524,4988,14062,405,1274,3427,9399,3832,10673
330490,201912,113618,263329,91461,232750,10314,27604,65148,163491,75462,191095
330500,201912,7153,17907,5940,16199,647,1971,4245,11368,4892,13339
330510,201912,39600,99453,29381,84681,5392,16456,17241,49006,22633,65462
330513,201912,1250,3275,963,2839,209,668,480,1411,689,2079
330515,201912,2522,6726,2001,5952,412,1314,1054,3050,1466,4364
330520,201912,11185,29860,8971,26243,1233,3987,5400,15294,6633,19281
330530,201912,1670,4141,1192,3368,249,755,543,1498,792,2253
330540,201912,2945,7831,2208,6514,552,1688,909,2607,1461,4295
330550,201912,8841,23590,6771,20692,2001,6600,2614,7871,4615,14471
330555,201912,16569,36010,13604,32427,931,2514,10784,25732,11715,28246
330560,201912,4256,11459,3395,9974,525,1594,1979,5654,2504,7248
330570,201912,2777,7670,2261,6823,359,1170,1434,4259,1793,5429
330575,201912,5493,14307,4696,12901,305,956,3697,9798,4002,10754
330580,201912,16251,44023,12174,36370,2354,7571,5653,16139,8007,23710
330590,201912,1440,3941,1203,3623,220,665,759,2308,979,2973
330600,201912,11724,31220,9217,27047,1032,3427,5636,16108,6668,19535
330610,201912,9311,24947,7452,21959,631,2209,5123,14633,5754,16842
330615,201912,2089,5714,1576,4996,307,998,960,3107,1267,4105
330620,201912,3943,11397,3074,9855,719,2500,1288,3851,2007,6351
330630,201912,24603,62197,18958,53066,1544,5116,13308,35793,14852,40909
350010,201912,2110,5465,1010,3050,224,706,150,323,374,1029
350020,201912,684,1757,361,1106,48,142,151,426,199,568
350030,201912,3714,10436,2668,8513,672,2302,1019,3085,1691,5387
350040,201912,688,1999,385,1337,58,228,123,337,181,565
350050,201912,1171,2957,748,2185,176,589,244,574,420,1163
350055,201912,920,2417,678,2024,78,258,388,1082,466,1340
350060,201912,113,279,72,215,10,36,40,121,50,157
350070,201912,3505,9268,2114,6632,420,1473,626,1770,1046,3243
350075,201912,579,1730,415,1395,168,603,35,107,203,710
350080,201912,660,1722,396,1229,58,204,153,433,211,637
350090,201912,631,1496,354,994,73,225,140,358,213,583
350100,201912,2146,5801,1415,4444,120,459,832,2478,952,2937
350110,201912,481,1238,321,942,19,70,185,532,204,602
350115,201912,1289,3763,1034,3198,195,677,530,1484,725,2161
350120,201912,636,1494,321,886,37,118,159,393,196,511
350130,201912,3062,8209,2367,6900,423,1288,1130,3122,1553,4410
350140,201912,755,2158,480,1583,53,238,250,745,303,983
350150,201912,488,1502,390,1312,97,310,97,306,194,616
350160,201912,11112,27679,7069,20301,917,3026,4190,11336,5107,14362
350170,201912,1995,5850,1543,4823,301,980,639,1872,940,2852
350180,201912,1041,2573,499,1499,109,329,93,262,202,591
350190,201912,2872,8185,1939,6149,374,1369,796,2105,1170,3474
350200,201912,419,1188,324,1015,20,69,212,627,232,696
350210,201912,5524,12744,3600,9796,516,1507,2138,5589,2654,7096
350220,201912,2860,7840,1861,5816,429,1422,610,1707,1039,3129
350230,201912,981,2590,801,2318,162,509,423,1184,585,1693
350240,201912,670,1957,409,1333,86,275,116,361,202,636
350250,201912,2354,6983,1718,5848,634,2324,276,988,910,3312
350260,201912,789,1903,484,1362,54,162,299,817,353,979
350270,201912,4543,12348,3522,10359,558,1760,1810,4970,2368,6730
350275,201912,2389,6472,1860,5582,318,1084,1067,3007,1385,4091
350280,201912,18818,42183,10535,28585,1888,5439,3901,10161,5789,15600
350290,201912,3108,8604,2042,6374,395,1348,809,2331,1204,3679
350300,201912,655,1784,465,1410,75,237,230,647,305,884
350310,201912,846,2445,600,1914,105,402,235,660,340,1062
350315,201912,552,1438,350,1072,27,104,162,455,189,559
350320,201912,14318,37185,10382,30055,2323,7360,3686,9938,6009,17298
350330,201912,14047,34759,9654,26111,1157,3443,5948,15114,7105,18557
350335,201912,360,1027,267,845,34,122,137,409,171,531
350340,201912,1145,2953,658,2045,118,405,253,717,371,1122
350350,201912,760,1957,582,1756,76,277,333,972,409,1249
350360,201912,1082,3230,808,2639,220,724,241,789,461,1513
350370,201912,609,1539,412,1174,156,426,106,313,262,739
350380,201912,4388,11833,2846,8781,802,2474,656,2077,1458,4551
350390,201912,9704,26193,7411,22113,1801,5569,3074,8959,4875,14528
350395,201912,430,1102,208,667,23,67,73,210,96,277
350400,201912,7990,19965,5350,15460,1342,4176,1504,4165,2846,8341
350410,201912,9479,26638,6621,20914,1461,5117,2358,6832,3819,11949
350420,201912,699,1880,476,1426,86,287,115,307,201,594
350430,201912,642,1749,508,1519,72,256,304,810,376,1066
350440,201912,1862,4746,1471,4151,111,361,979,2692,1090,3053
350450,201912,6731,18619,5137,15762,1130,3767,2099,6002,3229,9769
350460,201912,1687,4392,810,2539,135,445,162,430,297,875
350470,201912,267,683,196,558,9,34,131,356,140,390
350480,201912,945,2431,566,1721,119,418,100,253,219,671
350490,201912,1873,4990,1295,4002,308,988,384,1089,692,2077
350500,201912,680,1817,499,1466,79,256,243,662,322,918
350510,201912,1123,2928,798,2315,101,342,456,1261,557,1603
350520,201912,2096,6492,1591,5446,260,991,711,2204,971,3195
350530,201912,2714,6850,1918,5317,218,664,1110,2874,1328,3538
350535,201912,1393,3866,1185,3559,173,591,734,2110,907,2701
350540,201912,1772,4469,1268,3672,181,560,751,2114,932,2674
350550,201912,8471,21030,5750,16397,638,2149,3313,8758,3951,10907
350560,201912,3919,11112,3055,9499,299,996,1866,5605,2165,6601
350570,201912,23957,67479,18894,57304,3723,12343,9249,26692,12972,39035
350580,201912,1946,5354,1005,3249,264,933,167,443,431,1376
350590,201912,4821,13251,3414,10039,500,1672,1955,5274,2455,6946
350600,201912,36814,85736,21839,58957,3288,9856,10374,25595,13662,35451
350610,201912,6591,18244,4613,14200,867,2890,2061,6047,2928,8937
350620,201912,398,1000,231,737,25,91,129,391,154,482
350630,201912,1444,3818,1035,3062,75,282,656,1802,731,2084
350635,201912,8236,20795,6070,17317,1051,3336,3396,9099,4447,12435
350640,201912,933,2540,473,1470,70,223,146,385,216,608
350650,201912,7902,21357,5163,15756,1067,3505,1794,5043,2861,8548
350660,201912,4609,12118,3450,10135,604,1789,1762,5152,2366,6941
350670,201912,1861,4923,1492,4373,158,494,996,2900,1154,3394
350680,201912,1127,3019,712,2234,155,497,267,802,422,1299
350690,201912,1250,3296,877,2644,146,473,476,1376,622,1849
350700,201912,4781,12170,3196,9640,579,1957,1410,3977,1989,5934
350710,201912,2750,7635,2259,6752,374,1295,1223,3403,1597,4698
350715,201912,834,2397,668,2074,70,284,350,982,420,1266
350720,201912,164,424,114,332,18,52,32,74,50,126
350730,201912,599,1630,485,1421,28,114,358,982,386,1096
350740,201912,1600,4370,1044,3183,201,643,315,888,516,1531
350745,201912,541,1428,304,934,30,112,153,437,183,549
350750,201912,9912,26005,7352,21404,1312,4386,3253,8397,4565,12783
350760,201912,13565,34248,9240,26565,2167,6808,3286,8485,5453,15293
350770,201912,944,2376,578,1724,42,139,356,1033,398,1172
350775,201912,674,1625,443,1256,47,138,210,576,257,714
350780,201912,1989,4979,1365,4046,248,814,481,1597,729,2411
350790,201912,1689,4557,1015,3280,203,702,248,652,451,1354
350800,201912,3261,9611,2765,8703,316,1112,1774,5409,2090,6521
350810,201912,2602,6512,2021,5650,263,737,1155,3254,1418,3991
350820,201912,907,2129,492,1382,49,159,235,603,284,762
350830,201912,834,2353,440,1459,76,244,130,377,206,621
350840,201912,2984,8873,2130,7153,521,1930,852,2589,1373,4519
350850,201912,6660,18815,5003,15684,1065,3621,2090,6303,3155,9924
350860,201912,3529,9574,3018,8837,141,519,2265,6519,2406,7038
350870,201912,2654,7539,1910,6300,277,1041,1008,3218,1285,4259
350880,201912,1246,3625,950,3007,230,745,282,859,512,1604
350890,201912,540,1398,332,964,49,156,124,329,173,485
350900,201912,6777,18671,4095,12742,1028,3472,1141,3205,2169,6677
350910,201912,876,2232,733,1995,97,283,506,1346,603,1629
350920,201912,11754,29432,9763,26078,478,1573,7816,20056,8294,21629
350925,201912,4422,12155,3097,9651,594,1979,1426,4087,2020,6066
350930,201912,1468,3811,969,2843,115,351,554,1590,669,1941
350940,201912,2235,6024,1717,5133,203,661,1056,3043,1259,3704
350945,201912,839,2353,612,1906,97,360,315,881,412,1241
350950,201912,84558,220077,63391,178848,8720,27085,37950,101740,46670,128825
350960,201912,6242,17142,4758,14279,593,2031,2831,8030,3424,10061
350970,201912,3524,10139,2522,8072,768,2730,454,1232,1222,3962
350980,201912,619,1710,486,1463,140,444,209,620,349,1064
350990,201912,1759,5011,1265,4160,300,1104,439,1346,739,2450
350995,201912,762,2388,675,2213,54,211,466,1461,520,1672
351000,201912,2786,7284,1922,5704,354,1130,704,1988,1058,3118
351010,201912,320,787,204,581,21,68,114,310,135,378
351015,201912,772,2331,604,1974,88,330,282,822,370,1152
351020,201912,8941,24612,6589,20456,1357,4334,3169,9555,4526,13889
351030,201912,2649,7943,2105,6823,323,1155,1132,3560,1455,4715
351040,201912,4888,12275,4048,10973,211,710,3284,8603,3495,9313
351050,201912,17468,42699,11756,33436,2427,7255,4944,13785,7371,21040
351060,201912,47853,121210,35832,100229,4003,12327,23600,63741,27603,76068
351070,201912,1472,3681,775,2420,194,657,132,393,326,1050
351080,201912,2731,6748,1925,5743,237,858,1241,3480,1478,4338
351090,201912,320,942,219,745,49,161,56,192,105,353
351100,201912,2527,6815,1559,4829,345,1118,440,1425,785,2543
351110,201912,5912,15220,3705,11018,654,2134,1557,4307,2211,6441
351120,201912,770,1987,501,1522,61,189,196,585,257,774
351130,201912,1105,2903,463,1499,95,323,96,286,191,609
351140,201912,1902,5482,1343,4354,293,1053,487,1421,780,2474
351150,201912,2141,6244,1364,4490,252,908,527,1552,779,2460
351160,201912,1105,3456,816,2761,184,654,227,680,411,1334
351170,201912,1373,3831,1183,3480,105,339,813,2310,918,2649
351190,201912,1011,2804,610,1950,114,374,210,610,324,984
351200,201912,1597,3854,1171,3201,97,297,799,2058,896,2355
351210,201912,1517,3760,885,2504,74,241,531,1411,605,1652
351220,201912,3210,9171,2709,8307,342,1072,1753,5335,2095,6407
351230,201912,1797,4944,1281,4002,249,886,556,1566,805,2452
351240,201912,2359,6049,1373,3916,286,856,556,1424,842,2280
351250,201912,1081,2885,610,1915,78,254,219,680,297,934
351260,201912,904,2325,633,1825,140,389,219,638,359,1027
351270,201912,397,1090,323,964,36,121,193,506,229,627
351280,201912,3827,10155,2839,8250,541,1654,1320,3660,1861,5314
351290,201912,1183,3005,784,2280,127,390,420,1172,547,1562
351300,201912,16457,45326,10809,34083,2051,6976,4413,13371,6464,20347
351310,201912,3293,8256,2418,6826,192,671,1705,4532,1897,5203
351320,201912,917,2693,644,2089,126,435,224,650,350,1085
351330,201912,483,1131,394,967,33,94,280,612,313,706
351340,201912,6338,18259,4982,15817,1234,4065,2148,6769,3382,10834
351350,201912,11673,29584,9527,26044,1074,3157,6866,18211,7940,21368
351360,201912,3788,10264,3090,9158,752,2391,1146,3159,1898,5550
351370,201912,2099,5942,1354,4345,342,1168,416,1198,758,2366
351380,201912,47141,115630,32411,88952,4552,13400,17857,46695,22409,60095
351385,201912,302,786,147,445,26,78,43,123,69,201
351390,201912,1375,3365,791,2463,127,463,442,1283,569,1746
351400,201912,925,2594,730,2190,135,402,432,1258,567,1660
351410,201912,2633,7425,1826,5791,329,1054,686,2125,1015,3179
351420,201912,369,882,186,554,28,74,101,290,129,364
351430,201912,927,2571,697,2177,69,220,450,1367,519,1587
351440,201912,3329,8894,2072,6187,380,1189,569,1451,949,2640
351450,201912,1708,4579,1063,3308,218,741,169,419,387,1160
351460,201912,816,2153,611,1793,151,437,327,948,478,1385
351470,201912,1183,3032,884,2511,86,283,552,1478,638,1761
351480,201912,2533,7490,1967,6470,370,1326,821,2523,1191,3849
351490,201912,1928,5539,1621,4952,84,339,1268,3702,1352,4041
351492,201912,336,931,273,788,9,27,192,549,201,576
351495,201912,192,510,136,393,15,39,73,207,88,246
351500,201912,36567,91471,26422,73528,4236,12650,15161,40128,19397,52778
351510,201912,12778,31998,9057,25364,1166,3726,5583,14882,6749,18608
351512,201912,478,1288,313,926,54,157,103,274,157,431
351515,201912,3251,7292,1839,5022,339,1014,537,1531,876,2545
351518,201912,2421,6180,1513,4493,209,703,827,2220,1036,2923
351519,201912,719,2007,406,1349,80,263,59,187,139,450
351520,201912,1180,2937,449,1405,57,198,179,490,236,688
351530,201912,349,937,188,585,26,85,77,185,103,270
351535,201912,1947,4723,1350,3695,212,638,691,1772,903,2410
351540,201912,2277,5749,1431,4233,315,1068,444,1140,759,2208
351550,201912,6763,16967,4359,12439,450,1514,2432,6400,2882,7914
351560,201912,441,1266,343,1070,88,311,93,261,181,572
351565,201912,195,567,151,486,33,122,44,128,77,250
351570,201912,19843,54163,14488,42752,1704,5453,8786,24731,10490,30184
351580,201912,257,661,142,435,13,42,62,196,75,238
351590,201912,504,1146,259,709,24,83,140,345,164,428
351600,201912,1334,3477,1000,2866,94,305,632,1696,726,2001
351610,201912,763,1808,456,1254,30,99,251,639,281,738
351620,201912,21903,58998,15669,47616,2664,9136,6913,18839,9577,27975
351630,201912,25697,68950,20165,58994,3216,9882,12173,34534,15389,44416
351640,201912,16302,43785,12312,36118,1281,4279,8224,23107,9505,27386
351650,201912,386,1022,158,525,19,69,38,106,57,175
351660,201912,757,2164,447,1422,86,286,64,163,150,449
351670,201912,5700,15423,3678,10986,791,2381,1603,4475,2394,6856
351680,201912,432,1247,257,827,49,161,55,135,104,296
351685,201912,428,1247,335,1083,92,296,101,292,193,588
351690,201912,1039,2655,595,1742,91,298,241,636,332,934
351700,201912,1319,3346,928,2630,131,367,535,1448,666,1815
351710,201912,757,2032,502,1549,44,159,258,710,302,869
351720,201912,1429,3718,901,2761,147,484,347,1007,494,1491
351730,201912,894,2361,732,2092,63,226,490,1333,553,1559
351740,201912,3553,9008,2720,7386,478,1408,1358,3400,1836,4808
351750,201912,1294,3440,785,2507,155,516,289,912,444,1428
351760,201912,3257,9215,2280,7156,489,1724,810,2283,1299,4007
351770,201912,1775,5312,1429,4615,287,969,722,2282,1009,3251
351780,201912,1316,3388,712,2166,113,396,237,678,350,1074
351790,201912,1334,3172,1031,2764,171,464,603,1637,774,2101
351800,201912,500,1164,235,669,20,55,87,213,107,268
351810,201912,1016,2662,803,2315,40,126,572,1563,612,1689
351820,201912,2501,7082,1697,5476,439,1552,358,1070,797,2622
351830,201912,4460,12119,3337,10099,328,1197,2037,5835,2365,7032
351840,201912,8371,23572,6198,19361,949,3286,3122,9111,4071,12397
351850,201912,1670,4518,1032,3235,183,660,330,873,513,1533
351860,201912,2798,8193,2127,6894,381,1312,1129,3669,1510,4981
351870,201912,23316,60372,17254,50054,4841,14364,6673,19773,11514,34137
351880,201912,118914,313771,86058,254859,21669,69813,34849,98135,56518,167948
351885,201912,898,2457,696,2090,75,267,442,1254,517,1521
351890,201912,754,2007,475,1520,117,386,71,194,188,580
351900,201912,1077,2907,821,2508,120,367,449,1370,569,1737
351905,201912,401,1106,256,806,19,67,101,271,120,338
351907,201912,21359,56367,16052,46610,1908,6057,10207,28539,12115,34596
351910,201912,1336,3526,907,2595,76,244,512,1324,588,1568
351920,201912,830,2210,597,1753,84,291,283,760,367,1051
351925,201912,862,2375,653,1968,94,307,320,888,414,1195
351930,201912,3209,9065,2860,8401,576,1696,1895,5493,2471,7189
351940,201912,1093,2869,769,2305,123,395,380,1114,503,1509
351950,201912,1597,3740,1133,3036,70,203,764,1978,834,2181
351960,201912,5282,13482,3731,10652,821,2530,1637,4303,2458,6833
351970,201912,6850,20660,5435,18072,890,3302,2957,9535,3847,12837
351980,201912,1057,2480,645,1800,84,269,365,940,449,1209
351990,201912,1425,3377,972,2677,63,237,455,1116,518,1353
352000,201912,2543,7340,2152,6516,270,942,1388,3917,1658,4859
352010,201912,2168,5921,1713,5126,443,1445,346,1064,789,2509
352020,201912,1468,4046,1101,3402,183,605,523,1518,706,2123
352030,201912,5444,14578,4217,12554,841,2776,2123,6092,2964,8868
352040,201912,2792,7627,1792,5506,280,936,627,1651,907,2587
352042,201912,3099,7622,1901,5605,387,1264,788,2237,1175,3501
352044,201912,2092,5630,1119,3704,187,696,243,723,430,1419
352050,201912,11920,31847,7221,22334,1837,6448,1217,3134,3054,9582
352060,201912,712,1936,504,1530,68,226,227,635,295,861
352070,201912,865,1764,536,1318,62,165,255,537,317,702
352080,201912,455,1155,268,776,29,91,104,269,133,360
352090,201912,1436,4242,1147,3620,144,540,524,1481,668,2021
352100,201912,3036,8640,2459,7530,572,1894,1132,3284,1704,5178
352110,201912,578,1721,432,1413,96,324,172,525,268,849
352115,201912,494,1375,401,1228,55,193,227,685,282,878
352120,201912,856,2589,676,2210,84,294,394,1203,478,1497
352130,201912,1898,5408,1214,3679,207,664,483,1362,690,2026
352140,201912,1258,3340,813,2450,142,463,375,1076,517,1539
352150,201912,830,2244,627,1882,90,288,396,1154,486,1442
352160,201912,985,2445,701,2008,83,286,382,1037,465,1323
352170,201912,2958,8066,2271,6645,355,1180,1285,3429,1640,4609
352180,201912,2580,7041,1960,5844,469,1561,569,1457,1038,3018
352190,201912,1193,3237,905,2781,160,483,429,1358,589,1841
352200,201912,359,1078,251,855,35,135,91,295,126,430
352210,201912,19137,45819,14749,39788,1136,3359,11220,29752,12356,33111
352215,201912,570,1511,491,1403,61,201,340,933,401,1134
352220,201912,18253,46103,11686,33959,2807,8571,4141,11407,6948,19978
352230,201912,12955,38160,9671,31749,2314,8475,3456,10461,5770,18936
352240,201912,10630,27771,7943,23067,1790,5832,3313,8782,5103,14614
352250,201912,23479,66035,18454,56944,3227,10598,10727,32424,13954,43022
352260,201912,4903,12451,3257,9165,492,1619,1852,4686,2344,6305
352265,201912,903,2551,791,2380,49,195,586,1705,635,1900
352270,201912,1454,4403,1053,3505,228,830,356,1104,584,1934
352280,201912,2415,6200,1813,5282,195,709,1045,2792,1240,3501
352290,201912,1152,3396,915,2908,135,491,467,1323,602,1814
352300,201912,908,2457,584,1759,81,281,302,836,383,1117
352310,201912,45781,122130,32869,98627,8326,25535,13894,41772,22220,67307
352320,201912,6355,16973,4756,13719,749,2405,2463,6444,3212,8849
352330,201912,2201,5866,1626,5039,314,1144,806,2322,1120,3466
352340,201912,5480,14529,3866,11542,658,2255,1899,5200,2557,7455
352350,201912,2152,6203,1667,5095,199,742,893,2429,1092,3171
352360,201912,1249,3351,1032,2959,90,316,767,2097,857,2413
352370,201912,1062,3051,911,2779,23,101,709,2103,732,2204
352380,201912,814,2249,602,1850,124,394,208,608,332,1002
352390,201912,15626,38424,10258,28907,1686,5166,5600,14866,7286,20032
352400,201912,3505,9724,2850,8455,592,2038,1515,4154,2107,6192
352410,201912,3181,8236,2369,6833,227,794,1441,3939,1668,4733
352420,201912,832,2043,567,1624,98,300,206,561,304,861
352430,201912,7627,19272,5278,15053,1227,3914,2338,6256,3565,10170
352440,201912,17639,48279,12870,38836,3163,9929,4861,14159,8024,24088
352450,201912,806,2055,385,1258,51,181,119,360,170,541
352460,201912,2922,8160,1939,6287,403,1442,731,2211,1134,3653
352470,201912,3308,8322,2360,6753,298,971,1318,3506,1616,4477
352480,201912,3633,8703,2305,6303,370,1150,1101,2729,1471,3879
352490,201912,707,2091,548,1775,100,347,253,768,353,1115
352500,201912,10460,27095,6797,20115,2954,9538,783,1349,3737,10887
352510,201912,3559,9627,2605,7959,589,1939,1143,3290,1732,5229
352520,201912,2627,7038,2001,5912,395,1320,1081,2884,1476,4204
352530,201912,9630,25523,5907,17940,1151,3955,1422,3552,2573,7507
352540,201912,535,1618,375,1239,65,237,113,331,178,568
352550,201912,971,2771,667,2148,139,487,201,579,340,1066
352560,201912,590,1640,437,1334,73,237,204,575,277,812
352570,201912,2053,5969,1269,4256,328,1188,149,431,477,1619
352580,201912,652,1682,526,1454,58,195,337,884,395,1079
352585,201912,262,754,191,608,16,64,107,302,123,366
352590,201912,12828,33793,8737,25827,2401,7685,3720,10195,6121,17880
352600,201912,1956,5316,1502,4436,180,590,895,2475,1075,3065
352610,201912,3012,8449,2208,6980,469,1670,887,2601,1356,4271
352620,201912,5657,14733,4274,12617,1276,3825,1609,4787,2885,8612
352630,201912,820,2071,607,1739,106,356,274,701,380,1057
352640,201912,2966,7700,2071,6113,226,687,1177,3333,1403,4020
352650,201912,583,1657,391,1210,57,204,149,433,206,637
352660,201912,1024,3044,805,2572,162,533,356,1096,518,1629
352670,201912,8898,24309,5467,17311,1521,5077,959,2923,2480,8000
352680,201912,3189,9581,2204,7249,355,1387,1078,3222,1433,4609
352690,201912,26834,67900,20043,55759,1538,5067,13712,36442,15250,41509
352700,201912,560,1399,402,1170,151,495,86,232,237,727
352710,201912,4972,12997,3418,10091,824,2687,1410,3811,2234,6498
352720,201912,7740,21417,5854,17724,2632,8043,1018,2832,3650,10875
352725,201912,536,1342,277,812,17,50,136,380,153,430
352730,201912,2756,7867,2265,6710,331,1091,1351,3669,1682,4760
352740,201912,2248,5329,1626,4392,177,555,967,2475,1144,3030
352750,201912,400,1005,220,680,34,113,90,245,124,358
352760,201912,1643,4622,1201,3704,144,471,611,1844,755,2315
352770,201912,891,2406,576,1775,119,381,226,661,345,1042
352780,201912,626,1799,427,1395,82,271,120,386,202,657
352790,201912,433,1172,284,852,30,102,110,294,140,396
352800,201912,1265,3929,877,3008,246,886,122,359,368,1245
352810,201912,1111,2657,680,1867,83,239,400,1032,483,1271
352820,201912,515,1371,327,1039,72,233,69,239,141,472
352830,201912,574,1458,242,747,23,78,50,127,73,205
352840,201912,3863,11141,3106,9754,1077,3664,982,2967,2059,6631
352850,201912,10608,26201,6889,20050,1940,6116,2100,5501,4040,11617
352860,201912,1016,2806,704,2205,147,491,235,693,382,1184
352870,201912,891,2230,606,1627,40,133,404,1025,444,1158
352880,201912,1778,4197,1211,3195,172,476,734,1828,906,2304
352885,201912,305,874,224,721,24,84,129,394,153,478
352890,201912,689,1630,422,1086,43,122,242,560,285,682
352900,201912,17787,46602,11467,33952,1923,6088,5095,14122,7018,20210
352910,201912,441,1163,213,660,21,66,62,173,83,239
352920,201912,2678,6929,1902,5519,148,466,1269,3552,1417,4018
352930,201912,5630,15301,4045,12134,734,2400,1863,5186,2597,7586
352940,201912,22078,61274,15652,47296,3482,11525,5941,16842,9423,28367
352950,201912,478,1272,265,851,70,235,34,94,104,329
352960,201912,718,1944,371,1195,59,209,82,234,141,443
352965,201912,266,716,145,481,43,140,35,104,78,244
352970,201912,2996,7164,2231,5908,261,733,1438,3762,1699,4495
352980,201912,1393,3721,1070,3209,264,844,535,1554,799,2398
352990,201912,4087,11509,3182,9998,645,2249,1580,4745,2225,6994
353000,201912,458,1260,230,714,35,114,58,148,93,262
353010,201912,2486,6221,1579,4595,366,1196,619,1632,985,2828
353020,201912,3656,9503,2011,6008,297,1015,698,1923,995,2938
353030,201912,4247,10970,2794,8284,694,2218,720,2044,1414,4262
353040,201912,627,1488,443,1209,59,176,263,669,322,845
353050,201912,5130,14899,3609,11705,729,2573,1583,4896,2312,7469
353060,201912,48233,123575,38945,108455,2848,9586,28891,77357,31739,86943
353070,201912,9356,26774,6388,20331,1314,4556,2404,7049,3718,11605
353080,201912,4054,11368,2685,8624,521,1882,1027,2883,1548,4765
353090,201912,544,1669,397,1342,36,131,227,741,263,872
353100,201912,296,807,124,400,25,85,33,83,58,168
353110,201912,7596,20701,6038,18357,1191,3691,3256,10128,4447,13819
353120,201912,400,1015,278,799,40,134,113,287,153,421
353130,201912,2397,5749,1496,4246,407,1271,476,1244,883,2515
353140,201912,2667,6669,1875,5233,132,439,1269,3334,1401,3773
353150,201912,1492,3703,1029,2938,201,609,448,1193,649,1802
353160,201912,554,1446,386,1166,70,237,160,442,230,679
353170,201912,512,1407,383,1214,84,300,170,515,254,815
353180,201912,9678,23936,7397,20196,722,2236,5448,14396,6170,16632
353190,201912,3214,8709,2503,7279,300,952,1525,4171,1825,5123
353200,201912,2019,5390,929,3011,156,553,221,648,377,1201
353205,201912,345,1058,284,912,55,194,136,426,191,620
353210,201912,962,2247,588,1616,30,97,379,1011,409,1108
353215,201912,388,1100,295,914,48,158,136,375,184,533
353220,201912,741,2024,425,1323,95,282,52,151,147,433
353230,201912,808,2254,631,1971,176,599,241,684,417,1283
353240,201912,2284,6258,1807,5397,250,860,1049,2985,1299,3845
353250,201912,1269,2852,738,1950,101,290,400,1002,501,1292
353260,201912,1139,2685,609,1784,96,321,284,789,380,1110
353270,201912,682,1740,555,1509,43,139,382,982,425,1121
353280,201912,716,1939,480,1484,103,324,145,416,248,740
353282,201912,1769,5022,1476,4464,169,577,898,2558,1067,3135
353284,201912,358,835,173,481,22,83,73,175,95,258
353286,201912,161,408,95,298,18,58,40,127,58,185
353290,201912,1526,4041,895,2743,141,443,301,852,442,1295
353300,201912,1816,4923,1292,3860,210,703,579,1546,789,2249
353310,201912,390,955,268,734,22,78,179,463,201,541
353320,201912,660,1657,552,1490,11,40,477,1282,488,1322
353325,201912,653,1919,425,1406,97,303,156,501,253,804
353330,201912,522,1329,332,952,44,131,177,468,221,599
353340,201912,2806,7615,1909,5850,421,1417,837,2400,1258,3817
353350,201912,3373,8870,2246,6539,496,1585,609,1526,1105,3111
353360,201912,585,1663,449,1414,57,187,242,756,299,943
353370,201912,545,1589,438,1412,33,108,306,943,339,1051
353380,201912,268,809,210,683,30,106,104,309,134,415
353390,201912,5721,14297,4082,11435,507,1601,2261,5976,2768,7577
353400,201912,416,1169,307,949,50,181,104,267,154,448
353410,201912,505,1361,381,1135,66,212,215,631,281,843
353420,201912,453,1217,256,770,60,168,18,39,78,207
353430,201912,2165,6077,1587,4986,372,1275,643,1880,1015,3155
353440,201912,64341,175566,44643,136145,7711,25351,22994,66211,30705,91562
353450,201912,379,977,249,745,37,132,116,316,153,448
353460,201912,3249,8843,2296,6913,167,609,1095,3184,1262,3793
353470,201912,7682,20341,5318,15842,928,3123,2180,5916,3108,9039
353475,201912,1401,3631,957,2714,148,468,474,1230,622,1698
353480,201912,1614,4335,1248,3674,67,246,852,2400,919,2646
353490,201912,1084,2881,674,2059,101,332,284,817,385,1149
353500,201912,1021,2395,751,1982,166,444,412,1086,578,1530
353510,201912,802,2436,552,1804,129,465,143,396,272,861
353520,201912,1079,2842,667,2067,87,307,303,862,390,1169
353530,201912,2436,6500,1844,5394,251,815,956,2593,1207,3408
353540,201912,2034,5578,1647,4941,270,852,938,2738,1208,3590
353550,201912,5828,15147,4539,12996,776,2356,2516,6915,3292,9271
353560,201912,2030,5614,1459,4678,452,1581,363,1054,815,2635
353570,201912,570,1462,413,1208,46,137,253,695,299,832
353580,201912,2025,5340,1542,4444,350,1000,727,2046,1077,3046
353590,201912,710,1898,450,1376,98,326,169,515,267,841
353600,201912,1753,4371,1299,3555,160,432,696,1855,856,2287
353610,201912,553,1644,383,1302,86,354,107,330,193,684
353620,201912,2642,7168,1796,5596,367,1288,583,1621,950,2909
353625,201912,481,1180,299,856,19,60,196,555,215,615
353630,201912,1251,3924,1004,3349,230,852,333,1007,563,1859
353640,201912,1366,3530,1079,3087,153,466,610,1722,763,2188
353650,201912,8383,22611,5964,17751,656,2189,3465,9635,4121,11824
353657,201912,378,992,254,770,30,93,106,297,136,390
353660,201912,1254,2719,832,2117,350,873,217,536,567,1409
353670,201912,4039,11343,3056,9352,614,2078,1512,4283,2126,6361
353680,201912,663,1772,477,1489,86,288,260,773,346,1061
353690,201912,451,1153,182,565,16,49,32,87,48,136
353700,201912,2007,5307,1626,4639,132,431,1173,3216,1305,3647
353710,201912,4507,9988,2476,6404,236,663,1545,3598,1781,4261
353715,201912,439,1162,243,771,13,52,75,220,88,272
353720,201912,1911,5210,1451,4505,184,643,873,2649,1057,3292
353730,201912,4310,11570,3151,9362,491,1663,1516,4113,2007,5776
353740,201912,1995,5316,1351,4131,333,1107,441,1219,774,2326
353750,201912,796,2431,541,1918,135,510,95,362,230,872
353760,201912,12551,29647,9432,25236,1781,4930,5214,13556,6995,18486
353770,201912,717,2162,379,1281,65,236,58,169,123,405
353780,201912,5162,14618,3923,12069,826,2839,1771,4975,2597,7814
353790,201912,2534,7802,1802,6213,513,2004,375,1122,888,3126
353800,201912,17365,46252,13120,39077,1985,6283,7152,21189,9137,27472
353810,201912,1096,2968,707,2151,113,389,294,844,407,1233
353820,201912,1715,4730,1155,3556,261,855,368,1067,629,1922
353830,201912,625,1562,434,1242,76,227,193,518,269,745
353850,201912,1602,4524,1196,3715,286,919,414,1258,700,2177
353860,201912,2539,7150,1936,6017,467,1656,844,2347,1311,4003
353870,201912,28592,75958,19579,57799,2685,8939,10101,27095,12786,36034
353880,201912,2988,8385,2306,7032,192,703,1407,4104,1599,4807
353890,201912,2421,5394,1558,4142,144,393,1041,2649,1185,3042
353900,201912,732,2054,505,1589,88,307,194,561,282,868
353910,201912,2058,5863,1665,5206,218,812,1083,3280,1301,4092
353920,201912,1785,4964,1217,3825,276,986,325,845,601,1831
353930,201912,4198,11192,2726,8456,530,1873,1035,2828,1565,4701
353940,201912,1087,3160,726,2390,141,475,241,730,382,1205
353950,201912,3130,8551,2375,7148,438,1454,1314,3635,1752,5089
353960,201912,725,1904,467,1399,91,297,179,503,270,800
353970,201912,685,1646,498,1365,42,124,329,870,371,994
353980,201912,14991,38445,11245,31582,906,2877,7885,21314,8791,24191
353990,201912,907,2231,524,1512,84,259,245,670,329,929
354000,201912,2478,6041,1295,3738,290,876,214,584,504,1460
354010,201912,350,919,249,751,37,125,141,410,178,535
354020,201912,3388,9517,2595,7773,676,2165,1026,2816,1702,4981
354025,201912,730,2007,452,1461,72,267,102,311,174,578
354030,201912,497,1101,250,682,50,145,116,306,166,451
354040,201912,809,1912,500,1374,27,94,354,933,381,1027
354050,201912,966,2744,656,2169,163,565,193,639,356,1204
354060,201912,3447,9851,2276,7302,544,1837,768,2280,1312,4117
354070,201912,3491,9451,2335,7158,437,1526,892,2304,1329,3830
354075,201912,2499,7336,1884,6138,242,923,1052,3315,1294,4238
354080,201912,1361,3756,880,2797,184,631,199,561,383,1192
354085,201912,414,883,321,764,1,3,233,516,234,519
354090,201912,1539,4357,1318,3889,98,309,995,2897,1093,3206
354100,201912,18958,52609,12839,41426,2921,10117,4867,15564,7788,25681
354105,201912,1525,3845,987,2829,132,378,450,1204,582,1582
354110,201912,483,1337,313,1015,52,182,102,333,154,515
354120,201912,1455,3938,930,2797,184,596,324,850,508,1446
354130,201912,5642,14940,3507,10699,928,3025,220,421,1148,3446
354140,201912,19184,46918,12176,34025,2206,6745,5033,12955,7239,19700
354150,201912,3046,7339,2207,5949,502,1386,864,2276,1366,3662
354160,201912,2962,8624,2130,6893,629,2186,591,1746,1220,3932
354165,201912,605,1835,448,1509,83,326,223,699,306,1025
354170,201912,1622,4549,1325,3953,82,295,854,2425,936,2720
354180,201912,413,1141,288,870,54,167,115,311,169,478
354190,201912,1472,4187,978,3119,71,260,403,1257,474,1517
354200,201912,851,2126,650,1798,77,227,404,1068,481,1295
354210,201912,737,1979,577,1702,42,151,412,1134,454,1285
354220,201912,3050,8321,2178,6518,400,1274,1048,2977,1448,4251
354230,201912,720,1825,554,1610,40,160,388,1062,428,1222
354240,201912,1575,4421,1007,3214,181,645,304,841,485,1486
354250,201912,516,1287,313,961,93,290,72,234,165,524
354260,201912,8166,21832,6061,18034,1321,4158,2462,7076,3783,11234
354270,201912,1034,3143,807,2689,192,620,307,1008,499,1628
354280,201912,759,1950,633,1762,59,206,394,1022,453,1228
354290,201912,885,2817,726,2469,122,418,364,1269,486,1687
354300,201912,3556,10515,2978,9424,911,2868,1009,3183,1920,6051
354310,201912,656,1960,521,1681,123,419,185,552,308,971
354320,201912,904,2243,555,1618,75,264,225,585,300,849
354323,201912,456,1120,301,836,34,77,128,345,162,422
354325,201912,1226,3647,847,2815,152,504,324,1045,476,1549
354330,201912,9060,23168,5704,16131,736,2465,3283,8577,4019,11042
354340,201912,30300,77403,19801,58381,3469,11314,9522,26630,12991,37944
354350,201912,1167,3015,909,2556,92,284,619,1660,711,1944
354360,201912,607,1582,320,1076,59,206,59,192,118,398
354370,201912,986,2875,779,2521,132,460,434,1370,566,1830
354380,201912,733,1962,513,1590,93,358,117,288,210,646
354390,201912,13374,32617,8110,23106,1592,4785,2988,8077,4580,12862
354400,201912,1549,5002,1167,4073,205,769,409,1384,614,2153
354410,201912,5518,15196,4018,12066,924,2956,1691,4850,2615,7806
354420,201912,1473,3885,1055,3080,131,403,646,1807,777,2210
354425,201912,2634,6505,1805,5021,438,1239,731,2038,1169,3277
354430,201912,1558,4173,1175,3506,135,469,680,1890,815,2359
354440,201912,562,1501,338,1022,54,196,148,404,202,600
354450,201912,416,1092,213,698,36,125,56,160,92,285
354460,201912,884,2232,558,1637,81,249,301,853,382,1102
354470,201912,487,1244,301,855,21,70,144,363,165,433
354480,201912,1168,2657,743,1985,65,183,497,1267,562,1450
354490,201912,794,2391,556,1847,114,402,235,729,349,1131
354500,201912,1980,5648,1601,5052,491,1676,368,1168,859,2844
354510,201912,734,2072,568,1718,59,191,298,818,357,1009
354515,201912,318,948,228,748,39,140,90,289,129,429
354520,201912,6569,18351,4306,13256,644,2253,2339,6689,2983,8942
354530,201912,4188,12145,3120,9945,758,2464,1212,3829,1970,6293
354540,201912,1308,3484,929,2800,226,719,329,994,555,1713
354550,201912,528,1400,397,1130,54,164,227,608,281,772
354560,201912,2067,5090,1077,3108,152,456,531,1433,683,1889
354570,201912,1207,3046,457,1329,85,268,62,177,147,445
354580,201912,9027,23661,5642,17141,879,2941,2783,8039,3662,10980
354600,201912,1782,4891,1331,4000,153,530,845,2400,998,2930
354610,201912,408,1067,217,657,28,92,92,262,120,354
354620,201912,421,1235,261,903,46,180,91,278,137,458
354625,201912,316,868,167,546,28,101,30,69,58,170
354630,201912,1915,5787,1497,4902,541,1840,243,737,784,2577
354640,201912,3117,9043,2208,7131,386,1394,756,2247,1142,3641
354650,201912,875,2283,683,1953,59,168,424,1208,483,1376
354660,201912,3743,8826,1882,5596,183,653,885,2397,1068,3050
354670,201912,1067,2980,712,2254,145,491,253,718,398,1209
354680,201912,4918,13201,3752,11208,909,2825,1848,5624,2757,8449
354690,201912,514,1643,345,1237,79,292,97,341,176,633
354700,201912,879,2334,606,1796,89,286,297,830,386,1116
354710,201912,476,1291,324,986,48,166,139,365,187,531
354720,201912,320,774,130,388,43,136,27,79,70,215
354730,201912,9664,27326,7026,22113,1020,3525,3853,11674,4873,15199
354740,201912,313,867,120,422,21,86,18,60,39,146
354750,201912,2442,6401,1490,4549,267,873,620,1688,887,2561
354760,201912,1937,5332,1309,4093,328,1097,390,1120,718,2217
354765,201912,360,950,130,425,20,65,25,68,45,133
354770,201912,2310,5728,1633,4564,306,941,759,1967,1065,2908
354780,201912,54210,139108,39670,109453,4753,14674,23861,61577,28614,76251
354790,201912,985,2755,763,2374,93,322,447,1328,540,1650
354800,201912,2558,6687,1948,5666,505,1502,808,2218,1313,3720
354805,201912,1342,3094,877,2379,103,281,481,1191,584,1472
354810,201912,648,1881,342,1208,43,169,72,229,115,398
354820,201912,929,2710,649,2136,126,455,157,428,283,883
354830,201912,458,1137,275,792,54,163,91,247,145,410
354840,201912,902,2233,483,1398,43,141,277,750,320,891
354850,201912,21404,55970,14441,42962,1768,6073,8556,23859,10324,29932
354860,201912,1688,4802,1021,3343,196,703,311,901,507,1604
354870,201912,56881,144600,42953,118052,5019,15126,25949,67278,30968,82404
354880,201912,5745,14345,2581,7394,329,1087,918,2113,1247,3200
354890,201912,16985,42635,12796,35412,1785,5556,7460,19794,9245,25350
354900,201912,401,1028,249,758,42,135,64,177,106,312
354910,201912,5232,13957,2956,9622,673,2311,448,1393,1121,3704
354920,201912,452,1196,186,633,24,92,42,140,66,232
354925,201912,281,812,161,537,22,78,35,103,57,181
354930,201912,398,942,213,626,13,47,101,265,114,312
354940,201912,2200,6729,1499,5090,508,1852,256,790,764,2642
354950,201912,1429,3778,1114,3310,65,275,807,2241,872,2516
354960,201912,891,2379,664,2031,57,207,395,1145,452,1352
354970,201912,4149,11732,3152,9916,401,1387,1914,5822,2315,7209
354980,201912,31560,75474,20108,55180,2315,7521,11606,29481,13921,37002
354990,201912,61633,157815,44516,125789,4107,13285,28050,74761,32157,88046
354995,201912,2774,6411,2057,5435,200,656,1450,3616,1650,4272
355000,201912,1554,3933,1155,3336,184,618,540,1430,724,2048
355010,201912,3711,10188,2098,6702,713,2348,208,693,921,3041
355020,201912,3527,10029,2505,8155,649,2286,820,2529,1469,4815
355030,201912,1344548,3322612,925377,2484011,148922,437600,451650,1112279,600572,1549879
355040,201912,2821,7278,2205,6432,353,1012,1439,4251,1792,5263
355050,201912,936,2220,653,1768,176,508,256,637,432,1145
355060,201912,5946,16332,4279,13089,738,2597,2073,5729,2811,8326
355070,201912,8500,22275,6659,19195,788,2631,4170,11274,4958,13905
355080,201912,912,2636,544,1892,107,407,80,211,187,618
355090,201912,1105,3250,808,2715,222,714,221,787,443,1501
355100,201912,22493,59236,17027,50839,2909,9168,10049,29650,12958,38818
355110,201912,872,2443,619,2021,187,677,102,308,289,985
355120,201912,696,1830,483,1499,38,134,190,550,228,684
355130,201912,870,1914,387,1037,26,79,217,545,243,624
355140,201912,1788,4167,1495,3739,109,338,1213,2925,1322,3263
355150,201912,4341,11547,3377,9784,393,1262,2123,5879,2516,7141
355160,201912,1880,5214,1307,4140,325,1138,306,929,631,2067
355170,201912,9754,25212,7401,21118,1519,4658,3791,10425,5310,15083
355180,201912,2716,7404,1870,5915,414,1450,666,1907,1080,3357
355190,201912,1870,4909,1452,4249,339,1010,757,2329,1096,3339
355200,201912,834,2591,697,2365,186,695,283,889,469,1584
355210,201912,2859,7908,2192,6479,412,1391,1111,3061,1523,4452
355220,201912,44155,118598,33749,97964,8270,25478,13503,36040,21773,61518
355230,201912,1136,2852,592,1761,101,292,201,563,302,855
355240,201912,23837,63197,16013,47247,2333,7516,8379,23345,10712,30861
355250,201912,36905,99601,26181,78289,6667,20984,9610,27201,16277,48185
355255,201912,722,1814,367,1130,61,199,132,380,193,579
355260,201912,1422,3606,1000,2848,133,464,579,1517,712,1981
355270,201912,1203,3553,885,2865,215,718,284,847,499,1565
355280,201912,28775,74943,19434,56442,3047,9516,9114,24929,12161,34445
355290,201912,871,2431,625,1960,139,415,254,770,393,1185
355300,201912,1218,3600,926,2985,177,613,301,919,478,1532
355310,201912,998,2739,728,2273,93,285,410,1290,503,1575
355320,201912,524,1388,378,1112,68,231,156,375,224,606
355330,201912,2554,6711,1907,5537,145,531,1381,3810,1526,4341
355340,201912,3926,8736,2983,7441,382,865,1855,4708,2237,5573
355350,201912,1321,3880,956,3130,213,735,325,1038,538,1773
355360,201912,1180,3026,878,2557,114,358,525,1503,639,1861
355365,201912,374,991,184,631,43,134,28,98,71,232
355370,201912,5484,13957,4119,11818,990,2649,1816,5704,2806,8353
355380,201912,2910,7920,2123,6377,413,1337,737,1921,1150,3258
355385,201912,1405,3747,1129,3320,108,398,708,1920,816,2318
355390,201912,792,2177,548,1620,119,385,227,612,346,997
355395,201912,1909,5308,1275,4006,212,710,456,1270,668,1980
355400,201912,9030,26366,7016,22189,1814,6507,2363,6602,4177,13109
355410,201912,21443,58845,13389,43082,3019,10654,3278,10406,6297,21060
355420,201912,633,2059,501,1782,140,558,126,422,266,980
355430,201912,3713,9467,2730,7693,700,1937,1205,3382,1905,5319
355440,201912,810,2228,472,1490,77,250,141,410,218,660
355450,201912,3235,8432,1978,5883,384,1206,771,2071,1155,3277
355460,201912,505,1243,304,894,38,132,149,404,187,536
355465,201912,382,1046,281,866,46,149,129,390,175,539
355470,201912,1114,2899,598,1835,174,587,177,475,351,1062
355475,201912,356,839,278,722,18,41,203,517,221,558
355480,201912,3679,10387,2983,9316,455,1628,1901,5723,2356,7351
355490,201912,958,2570,494,1543,39,137,250,712,289,849
355495,201912,764,2173,540,1762,69,249,193,589,262,838
355500,201912,6737,17646,3731,11445,585,1991,1213,3394,1798,5385
355510,201912,1318,3276,793,2336,112,380,329,863,441,1243
355520,201912,389,861,169,491,29,84,49,124,78,208
355530,201912,407,928,138,400,19,70,57,146,76,216
355535,201912,506,1394,373,1169,78,301,159,442,237,743
355540,201912,10297,26533,8290,23512,1382,4236,5113,14027,6495,18263
355550,201912,639,1907,518,1679,73,259,268,820,341,1079
355560,201912,1109,2885,568,1808,127,452,37,119,164,571
355570,201912,250,717,127,421,23,79,33,100,56,179
355580,201912,1217,3016,790,2275,143,458,338,909,481,1367
355590,201912,179,448,135,375,17,52,79,204,96,256
355600,201912,1469,3615,958,2736,192,586,403,1115,595,1701
355610,201912,1740,4376,1137,3274,140,441,573,1559,713,2000
355620,201912,4535,12316,3237,9680,379,1381,1749,4765,2128,6146
355630,201912,2289,6337,1531,4839,259,852,738,2286,997,3138
355635,201912,891,2620,636,2102,127,465,186,543,313,1008
355640,201912,2827,8030,1858,6024,371,1304,509,1565,880,2869
355645,201912,4258,12027,3064,9876,441,1524,1660,5248,2101,6772
355650,201912,6558,17885,5075,15081,1461,4496,1785,4760,3246,9256
355660,201912,1306,3443,873,2603,137,487,296,864,433,1351
355670,201912,3488,9501,2192,6493,291,1038,1105,2842,1396,3880
355680,201912,2921,8097,1142,3791,305,1059,124,427,429,1486
355690,201912,782,2342,482,1725,112,420,15,31,127,451
355695,201912,239,687,133,443,11,53,23,50,34,103
355700,201912,7045,20447,5576,17056,1003,3188,2878,8334,3881,11522
355710,201912,8488,20094,5116,13811,830,2450,2220,5340,3050,7790
355715,201912,469,1227,237,735,54,184,45,116,99,300
355720,201912,1465,4204,1130,3572,185,625,598,1757,783,2382
355730,201912,925,2616,725,2206,144,473,312,870,456,1343
410010,201912,1243,3434,912,2730,199,647,182,515,381,1162
410020,201912,974,3096,741,2522,267,846,178,630,445,1476
410030,201912,1501,4214,1260,3821,182,626,656,1980,838,2606
410040,201912,11783,33150,8386,26502,1842,6184,2644,7749,4486,13933
410045,201912,863,2305,578,1769,82,290,200,567,282,857
410050,201912,2406,6093,1532,4492,302,973,457,1221,759,2194
410060,201912,2045,5915,1525,4796,365,1191,472,1430,837,2621
410070,201912,1811,4664,1253,3591,214,699,476,1244,690,1943
410080,201912,1390,3702,961,2878,198,614,347,1030,545,1644
410090,201912,1069,2798,914,2537,85,230,562,1629,647,1859
410100,201912,1861,5440,1192,3771,174,626,173,504,347,1130
410105,201912,475,1228,243,741,34,113,66,192,100,305
410110,201912,3076,7926,2063,5892,294,910,841,2262,1135,3172
410115,201912,545,1414,377,1110,53,177,134,373,187,550
410120,201912,2386,7026,2064,6485,513,1768,939,2846,1452,4614
410130,201912,1148,3158,983,2826,220,694,460,1224,680,1918
410140,201912,14286,34822,8285,23768,1622,5038,1918,4947,3540,9985
410150,201912,16394,39115,7428,20948,1273,3929,1681,4333,2954,8262
410160,201912,2891,8103,2290,7010,508,1710,793,2425,1301,4135
410165,201912,725,1955,600,1700,55,186,358,948,413,1134
410170,201912,2550,6675,1638,4671,378,1169,145,427,523,1596
410180,201912,14752,41565,11069,33630,1580,5235,5800,16419,7380,21654
410185,201912,445,1287,297,917,54,174,88,251,142,425
410190,201912,2260,5689,1586,4456,326,930,433,1174,759,2104
410200,201912,4932,11637,2581,7442,434,1463,481,1351,915,2814
410210,201912,3035,7709,1809,5386,299,1021,613,1584,912,2605
410220,201912,506,1296,314,933,47,155,65,186,112,341
410230,201912,1643,4443,1226,3560,165,563,674,1819,839,2382
410240,201912,4710,12738,3173,9698,832,2812,244,708,1076,3520
410250,201912,2578,6220,1837,4956,136,472,893,2336,1029,2808
410260,201912,1820,4617,1129,3304,205,618,488,1405,693,2023
410270,201912,461,1225,317,958,45,158,113,321,158,479
410275,201912,615,1762,394,1275,53,186,187,566,240,752
410280,201912,2255,6091,1459,4468,226,770,566,1594,792,2364
410290,201912,3135,8891,2076,6541,566,1799,561,1747,1127,3546
410300,201912,639,1628,502,1394,38,117,248,646,286,763
410302,201912,396,983,191,590,29,94,94,277,123,371
410304,201912,1212,3203,991,2775,120,332,579,1575,699,1907
410305,201912,1703,4163,1138,3317,137,435,680,1920,817,2355
410310,201912,2607,7518,2000,6243,370,1241,856,2648,1226,3889
410315,201912,715,1726,361,1126,131,410,80,244,211,654
410320,201912,1083,3025,702,2204,106,381,121,373,227,754
410322,201912,556,1488,280,842,29,98,134,367,163,465
410330,201912,1493,3704,1010,2755,168,504,300,810,468,1314
410335,201912,845,2327,648,1937,93,301,287,797,380,1098
410337,201912,804,1955,542,1437,54,144,232,581,286,725
410340,201912,461,1291,302,896,28,97,141,347,169,444
410345,201912,2411,6242,1198,3542,249,772,349,928,598,1700
410347,201912,694,1771,483,1371,47,161,151,421,198,582
410350,201912,1277,3266,886,2587,114,352,362,1005,476,1357
410360,201912,4256,10358,3247,8628,339,1011,1932,4909,2271,5920
410370,201912,12597,34549,7849,22964,1004,3242,3179,8211,4183,11453
410380,201912,1429,3697,1031,2926,146,452,374,969,520,1421
410390,201912,2597,6754,1615,4889,395,1333,439,1201,834,2534
410395,201912,850,2488,681,2117,133,457,297,909,430,1366
410400,201912,5547,14883,4091,12114,672,2120,1858,5255,2530,7375
410405,201912,787,1915,587,1623,118,371,246,634,364,1005
410410,201912,1197,3247,1116,3126,169,578,694,1994,863,2572
410420,201912,8833,25005,6500,20204,1128,3869,2236,6216,3364,10085
410425,201912,2965,8475,2032,6503,351,1249,742,2148,1093,3397
410430,201912,12750,32367,8433,24201,1432,4496,2847,7669,4279,12165
410440,201912,2315,7008,1949,6298,300,1078,1018,3226,1318,4304
410442,201912,2157,6704,1757,5778,501,1662,533,1707,1034,3369
410445,201912,2241,6563,1655,5396,333,1217,394,1349,727,2566
410450,201912,1437,3618,1002,2850,185,600,344,896,529,1496
410460,201912,1943,4831,1491,4119,169,491,723,1933,892,2424
410465,201912,2600,7638,1965,6345,369,1233,676,2046,1045,3279
410470,201912,1983,5584,1372,4376,380,1373,210,687,590,2060
410480,201912,36844,87818,18536,54453,3052,10039,3998,9962,7050,20001
410490,201912,10879,30518,7453,23151,1429,4807,2793,8178,4222,12985
410500,201912,1701,4632,1129,3460,246,889,323,838,569,1727
410510,201912,1910,4777,1226,3448,244,678,346,984,590,1662
410520,201912,3051,9704,2705,8978,889,3035,966,3258,1855,6293
410530,201912,1614,4055,731,2118,108,304,171,409,279,713
410540,201912,2552,6911,1761,5321,296,973,837,2447,1133,3420
410550,201912,7084,19118,4383,12973,776,2488,1175,3017,1951,5505
410560,201912,1410,3721,1017,2914,227,702,364,905,591,1607
410570,201912,2491,6929,1792,5624,504,1866,194,654,698,2520
410580,201912,24569,64578,17504,51266,3618,11249,7326,19974,10944,31223
410590,201912,1542,4466,981,3062,155,504,289,802,444,1306
410600,201912,1776,4825,1320,3921,284,808,477,1454,761,2262
410610,201912,716,1893,507,1488,56,194,221,620,277,814
410620,201912,2168,6422,1352,4442,300,1071,243,751,543,1822
410630,201912,2363,6347,1481,4472,290,986,276,685,566,1671
410640,201912,4640,11000,2914,7983,689,2163,392,1047,1081,3210
410645,201912,1030,3002,835,2733,270,903,350,1169,620,2072
410650,201912,2075,5749,1351,4213,285,954,467,1344,752,2298
410655,201912,907,2205,623,1678,24,82,322,821,346,903
410657,201912,601,1606,368,1124,57,212,140,356,197,568
410660,201912,3247,8428,1728,5043,317,976,429,1181,746,2157
410670,201912,1045,2624,603,1735,130,382,224,590,354,972
410680,201912,2632,8021,1837,5990,473,1560,353,1181,826,2741
410685,201912,554,1425,410,1169,98,323,162,408,260,731
410690,201912,122513,304388,76736,216796,12980,41703,27592,68177,40572,109880
410700,201912,2412,6172,2001,5516,281,814,1069,2848,1350,3662
410710,201912,819,2086,519,1533,79,240,232,662,311,902
410712,201912,627,1855,513,1613,131,449,183,551,314,1000
410715,201912,835,2427,495,1636,81,276,162,505,243,781
410720,201912,3126,8019,2325,6411,318,1026,505,1310,823,2336
410725,201912,1064,2666,590,1745,116,360,89,216,205,576
410730,201912,618,1648,463,1346,103,345,93,268,196,613
410740,201912,928,2606,665,2105,93,325,271,839,364,1164
410750,201912,1739,4452,1356,3748,217,667,594,1546,811,2213
410752,201912,357,906,161,491,19,64,72,204,91,268
410753,201912,260,794,181,613,26,102,41,124,67,226
410754,201912,1096,2855,880,2517,60,155,609,1837,669,1992
410755,201912,571,1485,390,1122,57,179,166,420,223,599
410760,201912,3325,8650,2284,6746,601,2016,490,1293,1091,3309
410765,201912,12429,35296,9382,29116,1585,5397,1799,5000,3384,10397
410770,201912,1027,2462,685,1869,70,205,356,958,426,1163
410773,201912,1276,3430,1091,3128,116,373,675,1870,791,2243
410775,201912,1458,3692,1252,3377,79,229,789,2101,868,2330
410780,201912,626,1570,396,1102,62,184,99,269,161,453
410785,201912,728,1951,535,1600,92,308,186,549,278,857
410790,201912,707,2017,558,1720,164,552,64,145,228,697
410800,201912,3346,7499,2632,6401,50,173,1697,4017,1747,4190
410810,201912,379,1029,282,835,26,82,131,367,157,449
410820,201912,793,2258,399,1248,86,271,73,206,159,477
410830,201912,32858,80996,21134,60591,4540,14733,7069,19005,11609,33738
410832,201912,966,2534,753,2151,86,285,433,1145,519,1430
410840,201912,7795,20147,4417,13422,852,2804,1150,3143,2002,5947
410845,201912,1126,2904,862,2477,161,475,366,1032,527,1507
410850,201912,2219,6457,1908,5879,318,1065,929,2775,1247,3840
410855,201912,774,1947,487,1389,45,131,235,630,280,761
410860,201912,4289,11078,3398,9554,385,1193,1850,5054,2235,6247
410865,201912,1343,4044,1167,3679,139,496,693,2207,832,2703
410870,201912,1280,3466,1064,3104,71,224,729,2092,800,2316
410880,201912,4278,11808,2907,9138,508,1752,443,1518,951,3270
410890,201912,967,2733,690,2169,156,546,185,574,341,1120
410895,201912,969,3159,795,2748,261,969,150,485,411,1454
410900,201912,855,2277,550,1663,103,312,100,240,203,552
410910,201912,369,867,210,565,11,37,131,328,142,365
410920,201912,835,1996,546,1524,75,232,253,692,328,924
410930,201912,1607,4236,1114,3335,278,969,233,671,511,1640
410940,201912,21995,61055,15453,48706,3253,11324,4660,14387,7913,25711
410950,201912,1917,5630,1692,5270,55,200,1389,4260,1444,4460
410960,201912,7068,17990,4442,13297,1042,3427,1600,4671,2642,8098
410965,201912,999,2591,698,2013,89,286,389,1098,478,1384
410970,201912,3865,10505,2633,8077,607,2225,360,931,967,3156
410975,201912,1295,3285,953,2710,104,315,441,1255,545,1570
410980,201912,6876,17478,4217,12487,527,1741,1777,4892,2304,6633
410990,201912,1329,3305,855,2527,237,810,250,675,487,1485
411000,201912,597,1616,382,1187,51,185,116,311,167,496
411005,201912,405,1088,244,734,47,148,56,152,103,300
411007,201912,2247,6354,1813,5564,427,1379,623,1909,1050,3288
411010,201912,4176,12661,3219,10588,828,2955,361,1077,1189,4032
411020,201912,2277,6589,1838,5776,532,1748,511,1541,1043,3289
411030,201912,721,1791,474,1268,33,121,266,633,299,754
411040,201912,923,2342,429,1223,44,136,143,342,187,478
411050,201912,1818,5794,1475,4967,405,1458,230,664,635,2122
411060,201912,1789,4683,1107,3325,255,907,172,459,427,1366
411065,201912,370,981,242,735,35,119,102,295,137,414
411070,201912,6670,17408,5226,14879,750,2396,2508,6876,3258,9272
411080,201912,2129,5638,1631,4736,430,1409,326,901,756,2310
411090,201912,821,2159,510,1544,36,137,142,406,178,543
411095,201912,1544,3655,1020,2813,119,364,355,929,474,1293
411100,201912,1105,2896,727,2206,85,290,223,687,308,977
411110,201912,635,1646,262,824,36,99,18,40,54,139
411120,201912,1191,3400,946,2892,322,1116,207,550,529,1666
411125,201912,5057,14984,4416,13699,925,2908,2134,6835,3059,9743
411130,201912,686,1865,471,1432,85,238,179,569,264,807
411140,201912,2247,6968,1853,6076,552,1934,494,1577,1046,3511
411150,201912,3780,9824,2474,7087,512,1695,242,521,754,2216
411155,201912,964,2471,546,1662,75,219,229,662,304,881
411160,201912,359,834,227,635,32,100,48,140,80,240
411170,201912,712,2145,514,1666,108,332,166,535,274,867
411180,201912,5305,14223,3975,11756,628,2046,1800,4979,2428,7025
411190,201912,1573,4093,1150,3313,182,560,458,1224,640,1784
411200,201912,4920,13426,3274,10207,846,2883,601,1614,1447,4497
411210,201912,2893,6403,1837,4747,344,994,559,1327,903,2321
411220,201912,842,2212,593,1713,137,427,171,472,308,899
411230,201912,820,2208,559,1686,113,362,216,644,329,1006
411240,201912,1553,3780,927,2559,94,309,461,1163,555,1472
411250,201912,2188,5880,1588,4772,319,1104,492,1420,811,2524
411260,201912,321,867,197,606,24,64,76,218,100,282
411270,201912,1985,5412,1466,4336,232,704,693,1906,925,2610
411275,201912,1392,3236,917,2437,150,464,407,1011,557,1475
411280,201912,1332,3638,850,2667,233,746,115,351,348,1097
411290,201912,771,2056,484,1479,46,131,245,777,291,908
411295,201912,1204,3033,859,2335,104,293,384,991,488,1284
411300,201912,1021,2545,616,1744,62,198,257,637,319,835
411310,201912,861,2038,645,1710,44,112,290,758,334,870
411320,201912,5263,13880,3714,10971,682,2113,1511,4029,2193,6142
411325,201912,1422,4043,1189,3623,197,590,672,2102,869,2692
411330,201912,3367,9149,2387,7304,554,1842,737,2251,1291,4093
411340,201912,828,2265,473,1458,66,225,168,492,234,717
411342,201912,1003,2425,569,1565,96,287,244,644,340,931
411345,201912,1074,2799,783,2314,71,229,553,1628,624,1857
411350,201912,2600,7191,1620,5116,421,1442,210,612,631,2054
411360,201912,654,1592,460,1288,66,190,149,407,215,597
411370,201912,52055,128779,36143,101119,2735,9309,21521,56317,24256,65626
411373,201912,1362,3476,1080,3032,88,297,585,1656,673,1953
411375,201912,1089,2754,765,2132,127,366,290,767,417,1133
411380,201912,1107,2606,704,1822,38,113,413,986,451,1099
411390,201912,1543,4274,1153,3386,192,623,462,1184,654,1807
411400,201912,2222,5629,1669,4566,188,614,832,2148,1020,2762
411410,201912,2309,6440,1646,4962,355,1179,372,1095,727,2274
411420,201912,4008,9955,2059,6121,305,1022,372,852,677,1874
411430,201912,3378,9237,2514,7537,574,1877,895,2452,1469,4329
411435,201912,421,1188,257,827,48,144,81,220,129,364
411440,201912,2447,6989,1934,5954,385,1305,690,2084,1075,3389
411450,201912,2517,6703,1883,5646,256,750,1016,3094,1272,3844
411460,201912,3776,9937,2139,6613,398,1415,397,1151,795,2566
411470,201912,731,1917,513,1472,94,281,186,486,280,767
411480,201912,4501,12367,3171,9775,676,2450,994,2750,1670,5200
411490,201912,1626,4224,1219,3513,158,534,496,1282,654,1816
411500,201912,1310,3543,837,2503,148,490,166,423,314,913
411510,201912,2241,5828,1754,4946,390,1276,401,1149,791,2425
411520,201912,30360,74187,16400,46443,2046,6623,6155,15501,8201,22124
411530,201912,895,2372,524,1639,100,347,90,248,190,595
411535,201912,465,1361,241,802,27,97,54,141,81,238
411540,201912,2811,6923,1821,5055,209,679,881,2336,1090,3015
411545,201912,918,2648,752,2346,72,220,488,1534,560,1754
411550,201912,680,1753,468,1329,75,238,89,260,164,498
411560,201912,1923,5160,1060,3283,159,547,87,252,246,799
411570,201912,6994,16535,4439,12450,978,2971,844,2287,1822,5258
411573,201912,757,2065,633,1868,94,294,334,964,428,1258
411575,201912,1846,5114,1349,4085,278,889,312,926,590,1815
411580,201912,4470,10276,2482,7164,365,1277,455,1174,820,2451
411585,201912,632,1856,268,898,68,236,50,153,118,389
411590,201912,373,1050,252,778,26,86,132,362,158,448
411600,201912,290,735,175,548,41,129,52,158,93,287
411605,201912,1560,3606,908,2511,117,405,482,1308,599,1713
411610,201912,2417,5911,1670,4489,85,292,1071,2663,1156,2955
411620,201912,2814,7560,2365,6835,417,1273,1307,3738,1724,5011
411630,201912,741,1938,476,1425,73,252,159,425,232,677
411640,201912,470,1242,317,902,44,144,122,317,166,461
411650,201912,219,652,131,442,27,96,22,59,49,155
411660,201912,889,2253,622,1764,43,132,305,837,348,969
411670,201912,1323,3316,870,2374,103,306,399,1011,502,1317
411680,201912,1471,3949,1084,3180,151,514,483,1370,634,1884
411690,201912,3564,9262,2626,7614,555,1668,795,2397,1350,4065
411695,201912,669,2047,407,1335,43,151,168,526,211,677
411700,201912,1609,4237,1014,3068,228,750,142,398,370,1148
411705,201912,1869,5843,1554,5288,307,994,853,3126,1160,4120
411710,201912,1825,4683,1198,3455,296,872,199,564,495,1436
411720,201912,1080,2557,750,1954,130,357,308,742,438,1099
411721,201912,926,2370,669,1884,134,372,159,454,293,826
411722,201912,760,2074,391,1159,55,192,142,341,197,533
411725,201912,1157,3312,763,2503,173,594,169,576,342,1170
411727,201912,1488,4176,927,2932,217,718,163,480,380,1198
411729,201912,714,1737,435,1187,54,195,161,381,215,576
411730,201912,5200,13981,3840,11260,858,2672,1540,4401,2398,7073
411740,201912,541,1415,261,791,54,157,61,170,115,327
411745,201912,735,2106,464,1458,66,223,83,195,149,418
411750,201912,5002,13284,3470,10178,451,1426,1712,4695,2163,6121
411760,201912,6795,18312,5110,15296,1724,5323,993,3294,2717,8617
411770,201912,2944,8663,2058,6620,513,1765,286,841,799,2606
411780,201912,2824,8082,2354,7134,651,2078,791,2378,1442,4456
411790,201912,2820,6870,1436,4293,312,1053,200,494,512,1547
411800,201912,981,2768,670,2048,110,357,136,398,246,755
411810,201912,1529,4043,1091,3136,175,509,518,1422,693,1931
411820,201912,11034,32061,8762,27773,2294,7725,3562,11002,5856,18727
411830,201912,592,1447,404,1127,74,215,94,290,168,505
411840,201912,11752,31655,7460,22380,1315,4267,1932,5284,3247,9551
411845,201912,504,1452,246,804,32,125,45,135,77,260
411850,201912,7328,18951,4838,14422,1262,4176,749,1995,2011,6171
411860,201912,694,2004,494,1567,79,261,127,356,206,617
411870,201912,616,1828,415,1352,87,310,96,276,183,586
411880,201912,2166,5524,1541,4474,235,765,495,1397,730,2162
411885,201912,1048,2727,720,2113,92,304,245,672,337,976
411890,201912,1166,3125,735,2264,138,477,68,176,206,653
411900,201912,794,2226,448,1446,103,355,59,187,162,542
411910,201912,907,2705,632,2086,158,579,202,605,360,1184
411915,201912,15275,37696,9492,26976,1510,4812,3527,8918,5037,13730
411920,201912,1052,3193,866,2784,205,745,289,866,494,1611
411925,201912,470,1243,317,951,64,212,130,364,194,576
411930,201912,5008,15619,4163,13911,1787,6502,253,975,2040,7477
411940,201912,3261,9836,2459,7985,604,2055,745,2165,1349,4220
411950,201912,13348,36464,10721,31970,1688,5605,5949,17041,7637,22646
411960,201912,5840,15888,4570,13231,856,2757,1701,4598,2557,7355
411965,201912,418,1174,284,901,38,134,111,315,149,449
411970,201912,1056,2496,784,2113,158,400,316,980,474,1380
411980,201912,1470,3718,1033,2951,265,772,364,996,629,1768
411990,201912,37892,100390,23359,72612,4512,15388,7934,23349,12446,38737
411995,201912,2971,7543,2151,6217,628,2008,588,1595,1216,3603
412000,201912,1981,4550,1373,3511,35,108,970,2334,1005,2442
412010,201912,588,1842,411,1442,59,225,107,302,166,527
412015,201912,545,1536,441,1344,54,184,264,799,318,983
412020,201912,439,1224,253,824,38,155,109,335,147,490
412030,201912,615,1732,408,1325,66,222,115,362,181,584
412033,201912,837,2269,569,1684,60,178,201,528,261,706
412035,201912,770,2067,479,1522,56,214,254,764,310,978
412040,201912,585,1581,354,1091,51,160,71,214,122,374
412050,201912,1682,4247,1108,3168,220,707,274,779,494,1486
412060,201912,7076,21171,5801,18517,1556,5593,1610,4863,3166,10456
412065,201912,618,1717,423,1279,91,288,114,347,205,635
412070,201912,1123,2891,840,2322,111,329,345,892,456,1221
412080,201912,1987,5674,1207,3931,187,628,199,589,386,1217
412085,201912,285,698,86,273,10,25,14,35,24,60
412090,201912,5797,15133,4255,12206,1158,3473,1480,4287,2638,7760
412100,201912,1578,4419,1157,3616,336,1131,254,866,590,1997
412110,201912,853,2266,581,1698,82,250,203,565,285,815
412120,201912,1932,5677,1459,4695,280,1001,415,1160,695,2161
412125,201912,648,1852,453,1434,98,317,118,347,216,664
412130,201912,732,1893,485,1410,77,228,125,375,202,603
412135,201912,605,1607,260,784,39,118,89,249,128,367
412140,201912,1628,4017,1007,2871,192,664,208,533,400,1197
412150,201912,2758,7359,2284,6480,320,1037,1377,3674,1697,4711
412160,201912,963,3008,554,1906,105,396,99,306,204,702
412170,201912,4189,11751,3471,10520,712,2336,1433,3993,2145,6329
412175,201912,1307,3803,1064,3376,223,726,457,1464,680,2190
412180,201912,1647,4609,1155,3647,151,563,516,1485,667,2048
412190,201912,3353,8419,2426,6758,324,985,1084,2989,1408,3974
412200,201912,1723,5211,1213,3967,337,1194,196,584,533,1778
412210,201912,620,1535,349,1013,53,169,113,297,166,466
412215,201912,3365,9144,2625,7708,684,1944,1115,3656,1799,5600
412217,201912,921,2429,763,2158,57,177,500,1375,557,1552
412220,201912,5801,16277,4561,13890,1125,3426,1476,4737,2601,8163
412230,201912,2574,7705,2019,6580,360,1333,550,1533,910,2866
412240,201912,6762,17387,4133,12197,729,2344,1247,3379,1976,5723
412250,201912,1991,5107,1449,4087,341,993,343,919,684,1912
412260,201912,1209,3277,834,2452,147,451,241,673,388,1124
412265,201912,868,2421,694,2113,135,438,292,839,427,1277
412270,201912,946,2594,574,1787,74,263,215,594,289,857
412280,201912,431,1213,329,1034,67,223,98,277,165,500
412290,201912,986,2535,643,1889,97,306,198,559,295,865
412300,201912,1690,4382,1108,3284,246,757,238,708,484,1465
412310,201912,746,2057,600,1777,75,289,264,720,339,1009
412320,201912,818,2106,533,1533,70,252,184,528,254,780
412330,201912,1486,4020,973,2989,193,650,323,1009,516,1659
412340,201912,1125,3183,660,2121,106,383,112,340,218,723
412350,201912,2839,7438,1734,5222,360,1103,318,883,678,1986
412360,201912,253,691,164,499,6,28,91,257,97,285
412370,201912,823,2379,532,1740,107,383,43,153,150,536
412380,201912,1534,4197,1039,3151,283,892,144,489,427,1381
412382,201912,511,1295,319,951,45,155,126,334,171,489
412385,201912,2186,6083,1730,5176,542,1527,522,1729,1064,3256
412390,201912,2386,5874,1899,5123,325,887,766,2104,1091,2991
412395,201912,701,2001,465,1454,52,152,191,594,243,746
412400,201912,872,2347,612,1816,123,402,162,484,285,886
412402,201912,1946,4876,1281,3726,306,926,166,481,472,1407
412405,201912,3002,7992,1898,5800,492,1804,48,135,540,1939
412410,201912,5709,15104,4056,12222,767,2658,1283,3640,2050,6298
412420,201912,502,1313,318,931,23,80,145,369,168,449
412430,201912,550,1390,318,926,25,84,146,411,171,495
412440,201912,2693,7546,1743,5601,447,1534,281,917,728,2451
412450,201912,383,1134,242,753,42,123,22,46,64,169
412460,201912,1022,2737,790,2326,142,459,363,1050,505,1509
412470,201912,1516,4972,1222,4276,320,1164,277,971,597,2135
412480,201912,969,2617,598,1782,115,370,162,444,277,814
412490,201912,1234,3150,951,2609,123,351,500,1301,623,1652
412500,201912,1907,4879,1391,3864,299,811,394,1040,693,1851
412510,201912,1910,5918,1274,4221,289,1025,124,341,413,1366
412520,201912,1287,3377,653,1943,163,477,57,156,220,633
412530,201912,652,1729,460,1323,71,226,108,301,179,527
412535,201912,804,2101,527,1546,84,270,116,296,200,566
412540,201912,1192,3135,815,2368,86,315,280,846,366,1161
412545,201912,683,1759,452,1263,70,192,154,417,224,609
412550,201912,30332,82105,20157,60884,3501,11483,7737,21447,11238,32930
412555,201912,267,703,170,482,17,46,50,108,67,154
412560,201912,4720,13849,3376,10616,558,1932,1027,3231,1585,5163
412570,201912,4244,10987,2261,6955,517,1767,282,955,799,2722
412575,201912,968,2480,751,2082,77,236,428,1118,505,1354
412580,201912,1418,3766,959,2834,97,341,489,1380,586,1721
412590,201912,416,1096,213,667,32,110,19,44,51,154
412600,201912,1429,3992,1036,3168,173,606,406,1156,579,1762
412610,201912,770,2053,532,1535,51,148,271,707,322,855
412620,201912,1227,3262,895,2721,166,590,299,847,465,1437
412625,201912,8801,23640,5152,16055,741,2601,323,888,1064,3489
412627,201912,1127,3191,678,2217,135,465,182,588,317,1053
412630,201912,2862,8405,2000,6472,395,1299,633,1855,1028,3154
412635,201912,367,990,244,720,38,133,78,184,116,317
412640,201912,1018,2695,532,1617,63,192,147,415,210,607
412650,201912,1579,4405,1229,3654,225,738,452,1175,677,1913
412660,201912,2398,6204,1603,4637,261,806,480,1256,741,2062
412665,201912,371,963,274,772,45,134,125,335,170,469
412667,201912,1668,4428,1223,3544,174,550,501,1387,675,1937
412670,201912,795,1940,511,1445,88,288,164,420,252,708
412680,201912,1723,4666,1134,3478,152,527,427,1180,579,1707
412690,201912,942,2558,691,2040,104,322,278,778,382,1100
412700,201912,2005,5350,1620,4715,202,691,870,2438,1072,3129
412710,201912,5863,17349,4280,13801,854,3081,1197,3452,2051,6533
412720,201912,1187,3523,881,2814,141,478,175,469,316,947
412730,201912,2256,6087,1372,4184,263,881,417,1194,680,2075
412740,201912,1822,5114,1194,3747,222,798,171,544,393,1342
412750,201912,3833,10184,3154,9162,323,1109,2054,5635,2377,6744
412760,201912,2891,7907,2342,6939,415,1373,1241,3460,1656,4833
412770,201912,10306,26183,5148,15727,742,2389,1178,3085,1920,5474
412780,201912,1188,3163,854,2543,184,600,334,967,518,1567
412785,201912,1990,4992,1361,3853,167,488,807,2249,974,2737
412788,201912,1278,3628,1025,3139,279,858,430,1282,709,2140
412790,201912,1268,3365,657,2049,105,381,215,599,320,980
412795,201912,1299,3380,656,2005,105,361,129,366,234,727
412796,201912,2229,6518,1807,5648,385,1269,579,1701,964,2970
412800,201912,3386,8289,2213,6051,268,830,964,2359,1232,3189
412810,201912,11180,28557,6688,19202,844,2818,2500,6351,3344,9169
412820,201912,6434,17747,4419,13595,1058,3445,1286,3921,2344,7366
412830,201912,336,962,221,701,32,98,56,182,88,280
412840,201912,1791,4564,1230,3436,141,441,502,1319,643,1760
412850,201912,2828,7506,2013,6021,322,1028,814,2380,1136,3408
412853,201912,1558,3943,1272,3385,188,550,635,1514,823,2064
412855,201912,1209,3248,761,2258,140,487,233,648,373,1135
412860,201912,785,1961,529,1548,79,257,282,781,361,1038
412862,201912,694,1693,448,1271,84,246,190,521,274,767
412863,201912,1230,3756,1123,3575,182,591,708,2236,890,2827
412865,201912,727,1983,517,1563,122,374,151,468,273,842
412870,201912,877,2277,625,1859,175,596,123,372,298,968
412880,201912,800,2185,504,1551,94,319,81,219,175,538
420005,201912,436,1301,229,812,33,124,107,379,140,503
420010,201912,3300,8108,2117,6079,150,480,1541,4427,1691,4907
420020,201912,460,1435,279,975,48,195,57,161,105,356
420030,201912,87,290,59,230,16,69,17,63,33,132
420040,201912,533,1654,305,1122,53,209,26,80,79,289
420050,201912,705,1649,444,1178,61,196,269,636,330,832
420055,201912,169,497,86,296,19,81,31,89,50,170
420060,201912,105,293,56,169,12,41,16,35,28,76
420070,201912,699,2171,515,1748,120,430,188,618,308,1048
420075,201912,78,210,36,113,8,25,8,17,16,42
420080,201912,328,958,253,792,69,234,96,300,165,534
420090,201912,412,1298,228,823,57,225,48,162,105,387
420100,201912,1211,3230,997,2894,52,184,799,2280,851,2464
420110,201912,240,776,215,721,47,182,93,285,140,467
420120,201912,484,1335,309,947,59,212,132,342,191,554
420125,201912,338,1058,236,825,59,218,104,340,163,558
420127,201912,279,764,91,313,20,74,21,71,41,145
420130,201912,2842,7981,2088,6637,312,1231,1045,3075,1357,4306
420140,201912,3474,9471,2431,7633,666,2374,332,1024,998,3398
420150,201912,616,1594,403,1220,46,152,235,692,281,844
420160,201912,217,537,85,270,11,35,23,70,34,105
420165,201912,152,434,81,265,20,69,25,72,45,141
420170,201912,267,824,166,575,22,66,38,114,60,180
420180,201912,172,543,98,363,13,46,26,92,39,138
420190,201912,187,618,113,418,40,165,22,72,62,237
420195,201912,1354,3558,953,2870,296,1035,115,278,411,1313
420200,201912,3958,9878,2192,6478,317,1158,856,2109,1173,3267
420205,201912,1637,4441,1085,3343,166,528,590,1819,756,2347
420207,201912,1731,4583,1042,3232,200,714,417,1219,617,1933
420208,201912,311,884,180,641,39,153,75,259,114,412
420209,201912,133,449,82,291,22,87,24,84,46,171
420210,201912,2784,7201,1742,5475,352,1213,792,2425,1144,3638
420213,201912,747,2342,611,2058,137,499,300,992,437,1491
420215,201912,191,579,123,425,32,126,18,51,50,177
420220,201912,240,725,140,493,24,98,66,207,90,305
420230,201912,4748,13165,3517,10782,549,1825,1847,5461,2396,7286
420240,201912,12369,34179,7285,22551,966,3419,3565,9759,4531,13178
420243,201912,378,1090,301,936,45,151,174,514,219,665
420245,201912,1287,3379,874,2644,70,267,506,1451,576,1718
420250,201912,445,1282,370,1151,65,234,187,529,252,763
420253,201912,491,1220,342,996,37,117,191,560,228,677
420257,201912,165,435,105,324,22,79,53,157,75,236
420260,201912,1075,2877,758,2401,130,458,454,1417,584,1875
420270,201912,493,1313,221,667,32,111,83,243,115,354
420280,201912,1118,3342,815,2721,167,621,260,854,427,1475
420285,201912,77,202,41,125,8,36,9,22,17,58
420287,201912,449,1045,306,827,80,219,109,299,189,518
420290,201912,4234,12125,3118,9549,466,1676,1754,4894,2220,6570
420300,201912,6909,19648,3747,12114,749,2682,961,2752,1710,5434
420310,201912,822,1934,392,1100,49,147,193,495,242,642
420315,201912,770,2184,507,1673,115,406,208,694,323,1100
420320,201912,4564,12848,3306,10602,974,3466,772,2254,1746,5720
420325,201912,263,758,186,611,31,109,78,237,109,346
420330,201912,871,2632,559,1932,107,420,169,505,276,925
420340,201912,949,2679,677,2158,163,539,85,236,248,775
420350,201912,1244,3285,869,2580,76,263,583,1696,659,1959
420360,201912,2529,7206,1303,4411,255,950,129,418,384,1368
420370,201912,996,2726,773,2342,94,338,487,1406,581,1744
420380,201912,4329,11669,2822,8839,618,2084,995,2972,1613,5056
420390,201912,1078,2607,709,1820,126,399,322,568,448,967
420395,201912,954,2778,599,2014,100,393,77,196,177,589
420400,201912,875,2547,570,1856,103,377,191,583,294,960
420410,201912,502,1374,377,1123,37,125,244,698,281,823
420415,201912,281,855,208,690,53,196,76,255,129,451
420417,201912,613,1833,475,1545,127,414,168,562,295,976
420419,201912,142,507,103,399,40,165,7,24,47,189
420420,201912,10438,27428,6638,20345,1960,6715,1759,4882,3719,11597
420425,201912,643,1707,417,1254,42,150,192,555,234,705
420430,201912,3039,8338,1742,5444,403,1340,544,1534,947,2874
420435,201912,261,670,114,381,14,47,56,184,70,231
420440,201912,691,1933,428,1365,110,398,174,502,284,900
420445,201912,266,668,157,451,30,95,63,166,93,261
420450,201912,657,1936,462,1497,88,355,165,459,253,814
420455,201912,1927,4851,1363,3945,193,695,669,1797,862,2492
420460,201912,8668,23384,6294,18933,1005,3364,3095,8892,4100,12256
420470,201912,590,1565,314,1011,64,237,69,184,133,421
420475,201912,64,165,26,84,7,23,3,10,10,33
420480,201912,5536,13781,3228,9791,675,2227,997,3002,1672,5229
420490,201912,351,1031,245,807,58,219,89,297,147,516
420500,201912,1378,3928,880,2937,157,573,365,1220,522,1793
420510,201912,163,466,81,268,12,51,24,69,36,120
420515,201912,42,107,27,75,1,1,13,38,14,39
420517,201912,739,2076,634,1884,52,148,477,1425,529,1573
420519,201912,287,689,193,549,26,82,101,298,127,380
420520,201912,309,833,141,485,25,90,12,42,37,132
420530,201912,773,2254,519,1709,93,363,182,517,275,880
420535,201912,218,639,86,296,13,49,40,129,53,178
420540,201912,33600,80154,20109,56727,3258,10296,7051,16772,10309,27068
420543,201912,208,627,156,498,21,67,86,266,107,333
420545,201912,1084,3238,801,2606,156,537,317,945,473,1482
420550,201912,3418,9254,2066,6855,364,1371,863,2897,1227,4268
420555,201912,292,847,196,642,28,106,106,328,134,434
420560,201912,406,1016,264,797,58,185,141,418,199,603
420570,201912,2060,5831,1540,4806,288,993,643,1901,931,2894
420580,201912,1786,4611,1209,3690,293,959,413,1270,706,2229
420590,201912,2847,7667,1575,4848,301,1091,403,927,704,2018
420600,201912,942,2772,707,2297,110,409,361,1132,471,1541
420610,201912,354,1042,190,658,44,158,62,221,106,379
420620,201912,653,1626,409,1216,95,296,165,477,260,773
420630,201912,818,2464,574,1854,75,276,337,1021,412,1297
420640,201912,488,1363,211,758,60,215,19,61,79,276
420650,201912,3318,8889,1869,5742,291,999,690,1800,981,2799
420660,201912,354,915,215,634,47,143,55,147,102,290
420665,201912,567,1496,347,1102,66,236,145,406,211,642
420670,201912,1333,3663,848,2683,134,515,333,927,467,1442
420675,201912,154,435,83,290,21,91,35,103,56,194
420680,201912,335,774,157,516,27,108,72,220,99,328
420690,201912,817,2497,469,1628,70,294,110,303,180,597
420700,201912,2706,7175,1976,5896,258,854,1065,3057,1323,3911
420710,201912,801,2324,589,1845,60,242,348,993,408,1235
420720,201912,1244,3445,860,2772,189,627,396,1231,585,1858
420730,201912,2822,7459,2069,6204,348,1134,1120,3232,1468,4366
420740,201912,532,1639,321,1147,99,370,32,128,131,498
420750,201912,1831,5404,1148,3768,197,758,449,1336,646,2094
420757,201912,75,179,35,110,4,8,16,49,20,57
420760,201912,344,1018,148,467,37,131,32,79,69,210
420765,201912,397,1182,198,670,23,99,92,296,115,395
420768,201912,1256,3641,1072,3321,148,446,768,2361,916,2807
420770,201912,429,1170,198,699,28,109,87,294,115,403
420775,201912,274,831,190,632,44,168,42,110,86,278
420780,201912,857,2364,491,1564,118,397,92,264,210,661
420785,201912,183,491,124,368,17,56,59,144,76,200
420790,201912,990,3081,718,2500,131,533,361,1192,492,1725
420800,201912,672,1698,303,938,78,272,69,203,147,475
420810,201912,1412,4485,1117,3859,327,1280,352,1027,679,2307
420820,201912,11307,28464,7815,22612,1552,5069,3560,9304,5112,14373
420830,201912,3350,8979,2396,7212,466,1543,995,2892,1461,4435
420840,201912,488,1443,219,800,67,272,26,81,93,353
420845,201912,2211,5753,1277,4021,238,907,506,1506,744,2413
420850,201912,1026,3376,617,2264,121,486,102,339,223,825
420860,201912,290,752,151,500,33,119,36,107,69,226
420870,201912,779,2140,572,1744,147,543,245,669,392,1212
420880,201912,942,2915,719,2455,156,622,261,820,417,1442
420890,201912,7462,20320,4308,13687,684,2409,1436,3971,2120,6380
420895,201912,157,462,94,302,21,71,29,95,50,166
420900,201912,1353,3383,760,2318,109,399,318,827,427,1226
420910,201912,27166,71867,16146,50005,2556,9012,6263,17310,8819,26322
420915,201912,529,1921,374,1466,60,238,190,754,250,992
420917,201912,332,833,167,470,26,75,80,230,106,305
420920,201912,76,207,23,86,0,0,4,10,4,10
420930,201912,16620,43569,11330,34055,2086,6929,4951,14060,7037,20989
420940,201912,2612,6454,1455,4416,374,1277,247,596,621,1873
420945,201912,129,375,98,301,24,87,40,104,64,191
420950,201912,318,923,166,557,24,93,40,119,64,212
420960,201912,989,2467,667,1897,118,409,278,676,396,1085
420970,201912,2293,6523,1500,4927,440,1498,278,933,718,2431
420980,201912,257,851,226,789,114,396,64,242,178,638
420985,201912,305,890,145,523,34,124,44,140,78,264
420990,201912,325,1003,167,605,31,112,29,89,60,201
421000,201912,503,1567,330,1160,74,282,83,261,157,543
421003,201912,462,1066,131,377,10,32,26,62,36,94
421005,201912,60,169,46,145,10,32,24,74,34,106
421010,201912,3106,8620,2172,6862,465,1653,568,1588,1033,3241
421020,201912,367,1137,277,966,42,175,142,468,184,643
421030,201912,741,2294,560,1900,169,642,172,536,341,1178
421040,201912,700,1611,399,1154,31,102,245,696,276,798
421050,201912,968,2687,593,1806,116,385,200,538,316,923
421055,201912,163,448,77,245,11,40,36,100,47,140
421060,201912,567,1686,349,1156,69,254,138,404,207,658
421070,201912,610,1866,319,1120,73,273,76,270,149,543
421080,201912,473,1372,390,1203,47,168,240,738,287,906
421085,201912,368,1078,122,451,21,78,15,43,36,121
421090,201912,246,626,143,428,14,48,51,134,65,182
421100,201912,855,1914,331,994,102,355,69,168,171,523
421105,201912,1483,4106,999,3109,171,540,439,1301,610,1841
421110,201912,1041,2850,852,2576,26,70,622,1988,648,2058
421120,201912,877,2736,616,2116,96,368,205,649,301,1017
421125,201912,269,706,190,557,69,224,66,156,135,380
421130,201912,4471,13272,3614,11542,909,3290,1751,5238,2660,8528
421140,201912,333,903,176,556,28,94,54,155,82,249
421145,201912,428,1202,266,849,60,213,112,327,172,540
421150,201912,558,1509,308,981,64,235,115,328,179,563
421160,201912,517,1391,353,1078,46,153,226,676,272,829
421165,201912,188,561,116,388,24,80,47,154,71,234
421170,201912,1066,2806,803,2399,139,401,480,1478,619,1879
421175,201912,1031,2606,613,1937,121,429,259,780,380,1209
421180,201912,369,954,195,607,37,145,72,201,109,346
421185,201912,311,841,202,607,28,97,117,345,145,442
421187,201912,280,852,162,540,30,103,52,159,82,262
421189,201912,360,1043,271,862,47,148,100,306,147,454
421190,201912,9956,27046,6345,20103,1254,4345,2032,5930,3286,10275
421200,201912,639,1899,508,1637,57,207,309,967,366,1174
421205,201912,176,474,131,398,28,97,65,184,93,281
421210,201912,1064,2795,618,2007,135,433,220,735,355,1168
421220,201912,1287,3968,983,3280,224,810,286,871,510,1681
421223,201912,355,996,213,709,53,170,98,333,151,503
421225,201912,887,2663,752,2417,137,494,433,1391,570,1885
421227,201912,910,2401,503,1574,88,306,213,667,301,973
421230,201912,595,1595,359,1152,69,249,120,382,189,631
421240,201912,265,796,109,403,14,62,17,61,31,123
421250,201912,1759,4518,1180,3565,163,560,612,1780,775,2340
421260,201912,173,504,42,168,11,49,11,42,22,91
421265,201912,610,1622,554,1551,7,23,517,1453,524,1476
421270,201912,329,886,137,498,18,65,56,197,74,262
421280,201912,1626,4584,1185,3762,203,788,614,1800,817,2588
421290,201912,801,2193,420,1294,78,251,98,282,176,533
421300,201912,271,720,125,412,18,69,25,84,43,153
421310,201912,183,534,128,424,25,88,67,224,92,312
421315,201912,217,608,134,411,38,111,38,121,76,232
421320,201912,597,1781,276,918,41,140,44,102,85,242
421330,201912,588,1760,421,1403,79,304,123,388,202,692
421335,201912,345,1045,278,921,68,257,112,361,180,618
421340,201912,1263,3613,888,2870,175,633,346,1024,521,1657
421350,201912,1315,3455,841,2606,184,667,338,958,522,1625
421360,201912,2229,6096,1275,4088,253,997,472,1295,725,2292
421370,201912,534,1798,307,1168,63,255,75,248,138,503
421380,201912,758,2059,643,1860,85,286,397,1114,482,1400
421390,201912,180,487,57,195,13,41,19,49,32,90
421400,201912,292,938,195,707,34,134,93,324,127,458
421410,201912,208,555,80,281,16,64,24,73,40,137
421415,201912,190,583,99,333,24,76,20,57,44,133
421420,201912,489,1364,392,1176,37,125,242,696,279,821
421430,201912,110,344,81,275,9,33,23,70,32,103
421440,201912,610,1639,360,1168,80,253,148,470,228,723
421450,201912,416,1232,241,821,34,141,38,142,72,283
421460,201912,344,1017,188,675,23,89,36,102,59,191
421470,201912,254,741,137,476,27,97,51,179,78,276
421480,201912,2682,7237,1670,5253,367,1371,615,1735,982,3106
421490,201912,110,353,64,225,6,24,20,49,26,73
421500,201912,2070,6161,1407,4761,387,1527,317,945,704,2472
421505,201912,298,849,246,769,36,128,158,471,194,599
421507,201912,397,1147,213,722,57,203,65,206,122,409
421510,201912,268,787,150,488,26,98,75,220,101,318
421520,201912,467,1236,275,797,30,94,167,459,197,553
421530,201912,302,934,166,598,31,143,46,137,77,280
421535,201912,380,1021,223,728,36,140,113,343,149,483
421540,201912,265,643,129,412,17,61,45,133,62,194
421545,201912,691,2056,505,1703,114,455,230,713,344,1168
421550,201912,1917,5252,1517,4634,266,867,854,2577,1120,3444
421555,201912,187,593,70,263,14,60,9,24,23,84
421560,201912,75,256,46,179,13,53,12,42,25,95
421565,201912,897,2348,589,1845,152,528,161,504,313,1032
421567,201912,436,1478,269,983,104,397,63,209,167,606
421568,201912,323,973,237,771,33,127,112,346,145,473
421569,201912,181,513,74,250,18,62,34,112,52,174
421570,201912,981,2671,678,2085,174,605,194,547,368,1152
421575,201912,270,812,194,612,32,119,82,221,114,340
421580,201912,3200,8978,2020,6457,375,1403,759,2055,1134,3458
421590,201912,134,426,101,341,36,132,26,74,62,206
421600,201912,511,1406,335,1037,81,269,93,240,174,509
421605,201912,713,1871,488,1493,88,240,238,765,326,1005
421610,201912,989,2721,600,1954,112,393,177,556,289,949
421620,201912,3819,10189,2115,6953,479,1752,550,1724,1029,3476
421625,201912,168,472,65,213,13,42,14,45,27,87
421630,201912,2302,6119,1302,4075,239,872,411,1073,650,1945
421635,201912,240,655,154,465,21,65,89,252,110,317
421640,201912,681,1884,479,1558,104,372,189,613,293,985
421650,201912,2183,6017,1343,4394,314,1189,361,987,675,2176
421660,201912,8824,24868,6047,19393,951,3457,2522,7391,3473,10848
421670,201912,732,2120,493,1552,83,289,245,756,328,1045
421680,201912,964,2715,721,2263,193,661,318,895,511,1556
421690,201912,1225,3585,828,2719,158,598,304,989,462,1587
421700,201912,471,1434,259,909,53,194,82,268,135,462
421710,201912,215,681,90,308,19,70,27,87,46,157
421715,201912,96,277,73,222,17,45,47,140,64,185
421720,201912,1841,5090,1016,3272,256,916,281,787,537,1703
421725,201912,217,537,105,337,20,72,40,93,60,165
421730,201912,378,1087,199,590,26,84,100,278,126,362
421740,201912,626,1743,405,1261,110,351,97,266,207,617
421750,201912,856,2015,369,1100,80,263,140,379,220,642
421755,201912,161,434,87,262,15,63,42,106,57,169
421760,201912,857,2301,527,1686,94,342,180,486,274,828
421770,201912,2325,6248,1650,5037,422,1300,584,1910,1006,3210
421775,201912,180,469,112,334,18,56,54,148,72,204
421780,201912,796,2394,498,1726,104,412,197,640,301,1052
421790,201912,746,1929,417,1333,95,319,196,613,291,932
421795,201912,200,553,129,384,24,86,44,116,68,202
421800,201912,2449,6726,1728,5381,238,871,945,2770,1183,3641
421810,201912,599,1671,400,1288,51,186,237,743,288,929
421820,201912,939,2748,505,1673,104,390,143,381,247,771
421825,201912,1293,3672,1140,3426,123,397,789,2310,912,2707
421830,201912,1970,5982,1593,5250,315,1119,707,2252,1022,3371
421835,201912,197,493,105,329,20,72,30,83,50,155
421840,201912,211,680,135,490,29,111,32,110,61,221
421850,201912,363,1033,193,668,44,169,61,163,105,332
421860,201912,307,879,173,598,22,90,59,180,81,270
421870,201912,3882,9926,2645,7507,500,1677,1230,3078,1730,4755
421875,201912,217,627,99,338,14,52,27,70,41,122
421880,201912,534,1521,340,1098,97,360,66,221,163,581
421885,201912,195,557,119,385,29,100,36,108,65,208
421890,201912,774,2399,564,1968,113,453,266,867,379,1320
421895,201912,398,1047,327,951,38,124,218,658,256,782
421900,201912,943,2447,629,1800,97,322,276,713,373,1035
421910,201912,293,871,195,652,39,150,52,153,91,303
421915,201912,370,1058,195,635,39,126,26,75,65,201
421917,201912,571,1367,308,1009,116,413,70,238,186,651
421920,201912,382,1191,270,954,115,428,73,252,188,680
421930,201912,2390,6100,1110,3555,278,1004,261,729,539,1733
421935,201912,394,1267,306,1061,62,230,167,546,229,776
421940,201912,313,937,122,413,22,85,34,100,56,185
421950,201912,2949,7389,1464,4528,311,1079,348,942,659,2021
421960,201912,175,450,89,288,20,75,22,60,42,135
421970,201912,1818,4717,1009,3044,217,764,351,887,568,1651
421985,201912,281,741,151,479,15,51,58,173,73,224
422000,201912,1799,4798,1423,4156,156,530,944,2710,1100,3240
430003,201912,530,1478,341,1109,69,247,140,442,209,689
430005,201912,266,705,167,524,33,115,79,235,112,350
430010,201912,1677,4164,1334,3600,143,430,946,2458,1089,2888
430020,201912,560,1301,415,1096,50,161,273,685,323,846
430030,201912,983,2340,522,1514,144,451,162,430,306,881
430040,201912,9787,23925,5501,16086,1433,4535,587,1853,2020,6388
430045,201912,509,1293,337,970,21,72,217,610,238,682
430047,201912,246,522,88,241,20,61,24,65,44,126
430050,201912,857,2188,470,1385,107,331,119,328,226,659
430055,201912,237,601,107,321,11,46,62,169,73,215
430057,201912,83,182,27,73,6,22,6,13,12,35
430060,201912,16003,43568,12110,37228,2622,8544,5464,16723,8086,25267
430063,201912,836,2354,648,1946,125,370,361,1079,486,1449
430064,201912,983,2743,716,2165,208,651,262,763,470,1414
430066,201912,99,218,71,174,5,12,54,122,59,134
430070,201912,692,1749,81,277,8,30,16,47,24,77
430080,201912,782,1942,461,1308,80,264,226,552,306,816
430085,201912,861,1991,509,1409,100,293,216,576,316,869
430087,201912,499,1278,400,1138,66,189,247,711,313,900
430090,201912,535,1367,164,515,14,56,58,166,72,222
430100,201912,657,1598,351,1000,66,221,143,346,209,567
430105,201912,1083,2914,663,2178,129,484,300,961,429,1445
430107,201912,167,498,95,309,18,69,25,61,43,130
430110,201912,2069,5206,1473,4317,226,717,805,2320,1031,3037
430120,201912,1256,3744,760,2480,138,476,339,1105,477,1581
430130,201912,3295,7757,2401,6478,936,2525,442,1447,1378,3972
430140,201912,889,2478,606,1916,142,446,286,878,428,1324
430150,201912,542,1397,276,846,64,208,95,283,159,491
430155,201912,249,639,107,326,19,54,21,55,40,109
430160,201912,18212,44179,13945,37830,1764,5181,7909,21358,9673,26539
430163,201912,2645,6529,1757,5050,94,300,1219,3486,1313,3786
430165,201912,322,787,83,271,17,42,14,39,31,81
430170,201912,897,2382,302,1054,57,210,49,155,106,365
430175,201912,641,1958,524,1698,140,463,246,769,386,1232
430180,201912,639,1578,506,1352,65,178,347,914,412,1092
430185,201912,470,1133,268,760,60,165,72,172,132,337
430187,201912,666,1559,461,1287,74,223,231,680,305,903
430190,201912,1350,3647,1062,3170,231,752,487,1380,718,2132
430192,201912,135,367,46,136,7,20,10,25,17,45
430195,201912,387,1156,43,157,7,19,7,22,14,41
430200,201912,1072,3235,848,2820,278,964,242,819,520,1783
430205,201912,458,1223,392,1093,13,43,335,911,348,954
430210,201912,4712,12126,3071,8643,609,1821,999,2318,1608,4139
430215,201912,301,780,183,538,41,127,71,210,112,337
430220,201912,624,1537,156,534,28,122,29,72,57,194
430222,201912,171,496,121,381,11,42,49,148,60,190
430223,201912,234,632,184,541,19,64,119,342,138,406
430225,201912,13,26,9,19,1,2,8,17,9,19
430230,201912,1735,4925,1485,4532,132,434,1104,3345,1236,3779
430235,201912,289,844,187,603,44,162,56,158,100,320
430237,201912,515,1255,354,984,22,69,242,645,264,714
430240,201912,1107,2512,596,1643,77,262,324,819,401,1081
430245,201912,670,1973,508,1660,158,515,224,756,382,1271
430250,201912,889,2252,625,1812,221,703,47,118,268,821
430258,201912,114,305,87,252,9,21,47,146,56,167
430260,201912,617,1651,427,1278,62,192,237,702,299,894
430265,201912,201,583,136,454,27,92,42,137,69,229
430270,201912,2696,6808,2115,5869,390,1179,1243,3339,1633,4518
430280,201912,4948,11873,3325,8999,728,2002,1394,3713,2122,5715
430290,201912,2137,4986,1758,4535,50,173,1505,3782,1555,3955
430300,201912,9081,23613,6814,19528,1145,3557,3525,9900,4670,13457
430310,201912,10859,27202,6895,19592,941,3023,3276,8616,4217,11639
430320,201912,951,2518,500,1573,73,214,265,848,338,1062
430330,201912,632,1574,379,1051,64,196,177,429,241,625
430340,201912,703,1545,358,1007,51,155,206,554,257,709
430350,201912,6834,17965,4944,14389,904,2755,2538,7126,3442,9881
430355,201912,326,833,104,337,19,57,16,46,35,103
430360,201912,814,1947,521,1433,108,340,208,516,316,856
430367,201912,305,728,155,439,36,109,71,198,107,307
430370,201912,460,1240,195,608,41,132,46,125,87,257
430380,201912,656,1630,310,976,74,278,81,234,155,512
430390,201912,2958,7219,1586,4624,282,932,200,396,482,1328
430400,201912,1061,2266,811,1904,62,172,603,1348,665,1520
430410,201912,531,1284,353,984,48,154,218,584,266,738
430420,201912,2591,7243,1949,5785,536,1663,807,2277,1343,3940
430430,201912,599,1528,279,847,69,203,63,189,132,392
430435,201912,1452,3729,1078,3105,202,616,536,1549,738,2165
430440,201912,3609,10152,2653,8303,342,1218,1547,4747,1889,5965
430450,201912,6539,16765,5081,14116,728,2271,2775,7421,3503,9692
430460,201912,28971,74884,20257,60041,3867,12653,9510,26826,13377,39479
430461,201912,315,816,89,281,12,40,29,76,41,116
430462,201912,231,620,127,414,17,56,43,146,60,202
430463,201912,5095,13880,3708,11341,761,2575,1691,4947,2452,7522
430465,201912,417,1095,338,950,52,169,210,564,262,733
430466,201912,3914,9993,3014,8466,759,2204,1391,3705,2150,5909
430467,201912,478,1174,323,923,44,149,167,452,211,601
430468,201912,1270,3129,969,2668,96,281,601,1615,697,1896
430469,201912,625,1737,73,251,8,29,13,17,21,46
430470,201912,5330,13823,3428,10367,1031,3358,908,2560,1939,5918
430471,201912,504,1472,411,1295,65,226,225,672,290,898
430480,201912,742,1987,368,1162,48,162,83,238,131,400
430485,201912,171,463,60,196,15,44,8,26,23,70
430490,201912,390,1018,207,617,25,89,100,264,125,353
430495,201912,359,986,201,654,25,86,77,241,102,327
430500,201912,974,2562,656,2006,211,689,185,508,396,1197
430510,201912,23669,62445,16294,47465,2913,9632,7112,18890,10025,28522
430511,201912,320,949,117,405,15,59,16,45,31,104
430512,201912,925,2115,701,1781,177,449,250,645,427,1094
430513,201912,768,1935,346,1011,49,157,176,488,225,645
430515,201912,363,1028,252,791,35,101,129,407,164,508
430517,201912,1043,3242,769,2596,137,459,388,1341,525,1800
430520,201912,1251,3274,605,1837,104,346,128,345,232,691
430530,201912,974,2499,362,1131,73,223,93,282,166,505
430535,201912,3076,8112,2152,6365,319,988,1085,3105,1404,4093
430537,201912,316,1122,288,1032,22,68,232,834,254,902
430540,201912,558,1382,323,975,48,146,156,464,204,610
430543,201912,720,1322,397,945,56,111,192,501,248,612
430544,201912,641,1862,437,1387,102,319,187,594,289,913
430545,201912,2142,5661,1561,4734,312,962,770,2400,1082,3362
430550,201912,369,1034,234,738,45,142,84,252,129,394
430558,201912,108,244,43,119,5,10,12,33,17,43
430560,201912,335,755,134,409,16,52,43,126,59,178
430570,201912,783,1915,534,1454,95,293,273,695,368,988
430580,201912,852,2130,595,1721,143,448,264,738,407,1186
430583,201912,196,487,33,109,3,11,6,18,9,29
430585,201912,224,547,112,304,15,41,53,131,68,172
430587,201912,202,572,136,424,18,53,59,186,77,239
430590,201912,1382,3303,1139,2930,53,154,950,2404,1003,2558
430593,201912,18,63,12,41,1,3,6,19,7,22
430595,201912,411,983,87,285,4,19,25,63,29,82
430597,201912,405,1074,204,618,20,66,71,167,91,233
430600,201912,1808,4657,768,2260,144,462,221,610,365,1072
430605,201912,1114,3074,785,2416,111,406,344,1005,455,1411
430607,201912,521,1235,410,1054,25,74,298,752,323,826
430610,201912,5507,13185,3557,10129,1034,3221,738,2119,1772,5340
430613,201912,256,600,64,181,9,28,17,39,26,67
430620,201912,588,1469,425,1153,60,180,239,597,299,777
430630,201912,417,1151,112,365,19,66,24,68,43,134
430632,201912,503,1343,208,644,24,80,97,281,121,361
430635,201912,524,1273,377,1020,45,127,266,715,311,842
430637,201912,447,1108,345,950,39,126,217,568,256,694
430640,201912,1011,2617,560,1678,80,250,195,550,275,800
430642,201912,339,936,248,721,44,122,134,365,178,487
430645,201912,162,382,53,148,11,33,17,49,28,82
430650,201912,1532,4528,1222,3997,322,1066,579,1972,901,3038
430655,201912,265,659,151,429,24,77,71,175,95,252
430660,201912,4847,12684,3573,10447,830,2603,1545,4435,2375,7038
430670,201912,633,1552,466,1248,29,79,288,778,317,857
430673,201912,536,1223,197,577,39,121,74,198,113,319
430675,201912,220,631,51,180,9,33,24,82,33,115
430676,201912,4502,11454,3469,9805,437,1383,2186,5989,2623,7372
430680,201912,907,2459,530,1656,156,501,131,395,287,896
430690,201912,2801,7679,2190,6544,745,2310,585,1689,1330,3999
430692,201912,204,635,150,540,10,45,108,386,118,431
430693,201912,973,2584,558,1718,109,397,147,404,256,801
430695,201912,459,1186,241,719,33,93,128,366,161,459
430697,201912,385,968,287,806,72,187,138,421,210,608
430700,201912,6469,16222,3430,10441,764,2481,549,1600,1313,4081
430705,201912,399,974,184,552,23,81,76,205,99,286
430710,201912,1636,3593,1121,2861,146,412,658,1648,804,2060
430720,201912,711,1708,353,1068,56,167,173,526,229,693
430730,201912,1027,2804,680,2128,98,287,360,1126,458,1413
430740,201912,585,1620,289,973,52,183,79,278,131,461
430745,201912,403,1100,221,683,37,130,73,190,110,320
430750,201912,1304,3378,901,2666,188,581,481,1375,669,1956
430755,201912,453,1107,278,747,18,57,163,404,181,461
430760,201912,1973,4969,1493,4199,365,1093,635,1704,1000,2797
430770,201912,5964,15100,4505,12854,605,1964,2816,7748,3421,9712
430780,201912,1899,4674,1063,3210,225,735,383,1114,608,1849
430781,201912,433,1209,231,721,33,102,68,185,101,287
430783,201912,390,884,216,607,23,82,130,347,153,429
430786,201912,32,109,21,83,4,16,4,20,8,36
430790,201912,4250,10479,2827,7943,353,1179,1701,4443,2054,5622
430800,201912,747,1765,540,1431,38,105,357,943,395,1048
430805,201912,386,1037,226,686,23,84,142,399,165,483
430807,201912,401,942,193,549,15,50,92,233,107,283
430810,201912,743,1774,250,786,31,121,91,269,122,390
430820,201912,1273,3371,667,2172,143,487,165,524,308,1011
430825,201912,248,617,78,200,13,33,24,56,37,89
430830,201912,1635,4754,1300,4093,64,230,928,2886,992,3116
430840,201912,925,2399,671,1938,91,288,454,1271,545,1559
430843,201912,118,283,43,122,5,17,20,51,25,68
430845,201912,397,952,248,689,60,177,92,242,152,419
430850,201912,2284,5996,1518,4487,228,733,660,1950,888,2683
430860,201912,884,2046,397,1135,49,173,188,458,237,631
430865,201912,486,1225,357,1003,59,182,197,529,256,711
430870,201912,612,1601,245,786,38,141,81,231,119,372
430880,201912,1328,3099,868,2379,147,429,456,1205,603,1634
430885,201912,176,473,84,287,9,33,48,164,57,197
430890,201912,997,2504,625,1846,60,258,121,326,181,584
430900,201912,2926,6453,1949,5004,180,542,1258,3036,1438,3578
430905,201912,760,1933,454,1335,86,274,167,460,253,734
430910,201912,1477,3938,992,2925,161,561,473,1241,634,1802
430912,201912,490,1356,315,1012,27,82,213,694,240,776
430915,201912,487,1493,346,1211,123,442,101,351,224,793
430920,201912,22772,58037,16931,48012,2445,7661,10087,27652,12532,35313
430925,201912,112,250,41,122,5,13,17,52,22,65
430930,201912,9951,23636,6079,17534,1181,3479,2514,7531,3695,11010
430940,201912,1031,2746,557,1680,161,508,123,301,284,809
430950,201912,720,1729,440,1225,37,131,271,680,308,811
430955,201912,301,803,75,240,18,56,18,46,36,102
430957,201912,178,612,163,574,27,99,95,330,122,429
430960,201912,1323,3168,732,2064,156,473,323,886,479,1359
430965,201912,1586,3791,1195,3173,66,192,937,2501,1003,2693
430970,201912,362,896,174,507,28,85,85,226,113,311
430975,201912,479,1474,359,1184,79,271,167,538,246,809
430980,201912,376,864,204,573,30,96,94,236,124,332
430990,201912,545,1563,314,997,35,111,157,494,192,605
430995,201912,552,1429,391,1161,48,154,209,601,257,755
431000,201912,1327,3157,507,1505,88,284,38,98,126,382
431010,201912,2006,5184,1155,3701,225,789,189,516,414,1305
431020,201912,8044,17649,4564,12200,1058,3171,1522,3524,2580,6695
431030,201912,323,881,144,491,24,87,24,72,48,159
431033,201912,3443,8246,2063,6008,486,1462,710,2088,1196,3550
431036,201912,336,724,68,191,7,19,20,48,27,67
431040,201912,891,2290,557,1664,90,299,233,640,323,939
431041,201912,451,1038,324,852,25,62,195,506,220,568
431043,201912,372,894,177,557,37,128,83,260,120,388
431046,201912,110,286,44,136,3,8,11,33,14,41
431050,201912,1338,3278,940,2634,163,480,483,1363,646,1843
431053,201912,597,1641,304,990,67,244,93,274,160,518
431055,201912,571,1410,471,1259,49,119,345,920,394,1039
431057,201912,255,728,114,383,23,76,34,104,57,180
431060,201912,5091,13479,3364,10405,843,2816,844,2603,1687,5419
431065,201912,408,1049,283,839,51,156,115,333,166,489
431070,201912,427,1217,229,755,54,192,49,155,103,347
431075,201912,219,658,134,454,23,78,40,132,63,210
431080,201912,574,1588,372,1148,76,262,124,365,200,627
431085,201912,695,1856,434,1229,68,189,218,605,286,794
431087,201912,422,1189,333,1005,23,62,230,715,253,777
431090,201912,402,939,141,446,26,83,42,133,68,216
431100,201912,3285,7355,2225,5891,339,941,1095,2921,1434,3862
431110,201912,1354,3152,893,2348,271,722,334,835,605,1557
431112,201912,512,1496,419,1307,83,286,215,641,298,927
431113,201912,344,959,294,863,49,157,178,510,227,667
431115,201912,975,2794,740,2347,108,404,424,1263,532,1667
431120,201912,2252,6392,1506,4833,490,1778,343,963,833,2741
431123,201912,376,1060,234,749,43,123,132,440,175,563
431125,201912,988,2935,739,2415,273,870,242,844,515,1714
431127,201912,228,584,52,167,8,26,9,24,17,50
431130,201912,2938,7662,2102,6176,333,1120,1114,3149,1447,4269
431140,201912,5008,11889,2728,7493,354,1046,1192,2887,1546,3933
431142,201912,488,1311,353,1059,54,166,210,630,264,796
431150,201912,1000,2698,687,2094,136,446,287,849,423,1295
431160,201912,668,1918,434,1397,74,263,137,435,211,698
431162,201912,502,1209,253,747,23,80,147,402,170,482
431164,201912,181,415,34,106,8,24,5,11,13,35
431170,201912,484,1359,329,1022,102,312,85,256,187,568
431171,201912,611,1451,492,1293,98,235,297,799,395,1034
431173,201912,398,1052,288,875,85,291,110,309,195,600
431175,201912,1098,2640,645,1844,110,330,233,627,343,957
431177,201912,697,1988,512,1671,134,477,268,852,402,1329
431179,201912,339,735,79,231,13,42,17,44,30,86
431180,201912,2187,5539,1261,3709,330,940,330,987,660,1927
431190,201912,433,1165,202,642,26,89,59,149,85,238
431198,201912,328,981,263,859,99,342,73,259,172,601
431200,201912,359,915,66,200,13,37,6,17,19,54
431205,201912,194,544,89,304,24,88,31,108,55,196
431210,201912,586,1500,463,1320,115,325,227,677,342,1002
431213,201912,245,660,176,528,13,40,88,278,101,318
431215,201912,573,1360,233,681,26,84,111,304,137,388
431217,201912,158,415,102,313,5,22,61,170,66,192
431220,201912,571,1484,324,984,36,136,181,505,217,641
431225,201912,1514,3619,1123,2945,107,301,790,2080,897,2381
431230,201912,664,1920,487,1491,61,215,293,851,354,1066
431235,201912,150,379,20,66,2,5,3,14,5,19
431237,201912,308,992,254,865,49,182,131,429,180,611
431238,201912,28,72,21,55,6,14,7,17,13,31
431240,201912,3975,10074,2996,8474,504,1578,1587,4327,2091,5905
431242,201912,264,724,219,643,51,161,110,314,161,475
431244,201912,317,766,145,415,22,81,56,130,78,211
431245,201912,1256,2945,767,2079,84,244,393,1008,477,1252
431247,201912,223,600,110,343,21,74,31,75,52,149
431250,201912,1582,4068,1132,3420,256,786,572,1788,828,2574
431260,201912,222,626,130,433,20,86,47,142,67,228
431261,201912,227,715,183,637,16,64,98,326,114,390
431262,201912,375,1033,167,544,14,47,111,362,125,409
431265,201912,1500,3542,554,1640,71,252,197,496,268,748
431267,201912,258,700,142,422,4,18,101,268,105,286
431270,201912,2657,6118,1370,3893,342,1022,417,1200,759,2222
431275,201912,130,374,66,211,22,69,10,31,32,100
431280,201912,224,597,59,192,7,25,8,15,15,40
431290,201912,300,875,190,601,34,116,37,94,71,210
431295,201912,72,192,20,68,1,4,8,25,9,29
431300,201912,307,776,51,158,5,18,13,29,18,47
431301,201912,301,857,59,192,9,21,5,15,14,36
431303,201912,562,1495,316,950,23,76,143,402,166,478
431306,201912,2078,4901,1167,3344,176,559,466,1191,642,1750
431308,201912,25,78,23,74,10,35,10,31,20,66
431310,201912,509,1453,357,1096,41,141,167,479,208,620
431320,201912,591,1618,272,916,39,124,46,142,85,266
431330,201912,1606,3823,715,2118,169,583,235,601,404,1184
431333,201912,217,588,98,290,16,45,38,106,54,151
431335,201912,40,116,22,75,4,8,2,5,6,13
431337,201912,2530,6811,1787,5529,374,1302,850,2516,1224,3818
431339,201912,382,1011,272,803,77,240,114,324,191,564
431340,201912,18893,46098,12548,35150,2319,7099,5310,13900,7629,20999
431342,201912,439,956,316,782,15,39,280,688,295,727
431344,201912,387,994,214,642,8,29,127,359,135,388
431346,201912,248,610,86,277,15,53,28,92,43,145
431349,201912,657,1726,337,1007,86,255,123,363,209,618
431350,201912,3907,10251,2798,8267,421,1388,1436,4114,1857,5502
431360,201912,573,1377,276,793,77,232,81,227,158,459
431365,201912,1824,4434,1454,3924,122,370,1073,2872,1195,3242
431370,201912,4164,10434,2904,8267,699,2075,1289,3782,1988,5857
431380,201912,783,2131,634,1882,38,129,442,1299,480,1428
431390,201912,2455,5988,1400,4062,177,608,629,1581,806,2189
431395,201912,1210,3099,837,2503,195,608,361,1100,556,1708
431400,201912,326,921,162,522,31,93,35,107,66,200
431402,201912,829,1891,583,1509,74,210,382,953,456,1163
431403,201912,178,501,138,425,23,82,67,168,90,250
431405,201912,4360,11591,3270,9759,634,2109,1522,4281,2156,6390
431406,201912,503,1469,357,1143,78,237,178,588,256,825
431407,201912,458,1274,295,921,59,206,139,414,198,620
431410,201912,16098,41150,10062,29914,1579,5410,4825,13309,6404,18719
431413,201912,235,610,56,185,5,14,14,49,19,63
431415,201912,664,1629,393,1171,78,268,175,460,253,728
431417,201912,544,1205,357,922,51,149,201,510,252,659
431420,201912,1489,3460,1093,2880,173,466,579,1521,752,1987
431430,201912,521,1346,227,739,34,127,69,182,103,309
431440,201912,28949,68723,19818,53851,3587,10458,7583,19371,11170,29829
431442,201912,105,282,44,144,6,16,8,22,14,38
431445,201912,396,1133,120,408,17,53,10,32,27,85
431446,201912,281,821,194,639,39,137,94,294,133,431
431447,201912,655,1773,381,1182,77,259,138,431,215,690
431449,201912,721,1910,416,1248,81,233,170,510,251,743
431450,201912,2135,4508,1677,3861,97,238,1287,2873,1384,3111
431454,201912,33,104,29,95,6,19,10,35,16,54
431455,201912,587,1417,280,767,35,105,141,346,176,451
431460,201912,2761,6877,1941,5390,520,1520,543,1524,1063,3044
431470,201912,1388,3914,972,3011,183,574,437,1374,620,1948
431475,201912,253,716,36,145,4,18,5,16,9,34
431477,201912,395,1033,222,666,38,112,93,239,131,351
431478,201912,274,714,50,157,14,40,6,16,20,56
431480,201912,3010,7650,2275,6462,550,1610,1111,3158,1661,4768
431490,201912,106793,254884,80780,213689,6397,19990,58527,148511,64924,168501
431500,201912,485,1227,344,958,60,171,184,490,244,661
431505,201912,295,717,194,555,18,57,128,359,146,416
431507,201912,334,791,129,381,42,133,38,102,80,235
431510,201912,1492,3913,990,2907,216,699,373,1066,589,1765
431513,201912,218,491,117,317,9,22,80,214,89,236
431514,201912,93,239,59,176,4,11,42,122,46,133
431515,201912,466,1180,319,905,62,175,168,471,230,646
431517,201912,70,204,55,168,10,30,21,60,31,90
431520,201912,420,1038,154,496,25,88,60,165,85,253
431530,201912,3902,8286,2178,5802,527,1419,520,1393,1047,2812
431531,201912,202,519,121,355,12,40,55,148,67,188
431532,201912,543,1270,304,837,71,218,123,319,194,537
431535,201912,240,636,96,312,20,71,20,53,40,124
431540,201912,1779,5730,1650,5542,60,252,1339,4504,1399,4756
431545,201912,343,894,54,171,9,28,12,35,21,63
431550,201912,1946,5042,1472,4156,248,775,742,1995,990,2770
431555,201912,663,1502,405,1063,23,79,255,653,278,732
431560,201912,21424,52795,13798,40401,2843,8763,4532,13945,7375,22708
431570,201912,4610,11163,3524,9599,418,1290,2408,6295,2826,7585
431575,201912,224,573,165,467,36,90,47,130,83,220
431580,201912,565,1442,315,927,39,144,171,468,210,612
431590,201912,595,1638,439,1314,95,299,176,539,271,838
431595,201912,344,946,213,654,47,144,87,248,134,392
431600,201912,1268,2952,885,2422,227,675,335,955,562,1630
431610,201912,1315,3420,875,2575,137,384,453,1365,590,1749
431620,201912,442,1153,191,575,35,114,73,202,108,316
431630,201912,1270,3193,552,1671,95,321,202,550,297,871
431640,201912,6019,14909,5123,13730,558,1551,3685,9961,4243,11512
431642,201912,525,1302,312,854,21,52,171,430,192,482
431643,201912,353,884,145,433,17,48,48,142,65,190
431645,201912,1788,4069,1383,3493,77,244,1076,2664,1153,2908
431647,201912,228,587,80,240,9,28,16,43,25,71
431650,201912,128,340,83,259,10,36,44,125,54,161
431660,201912,868,2335,432,1409,72,273,116,344,188,617
431670,201912,1107,2658,693,1909,100,285,373,990,473,1275
431673,201912,228,570,76,262,13,42,14,46,27,88
431675,201912,542,1325,93,304,11,49,19,48,30,97
431680,201912,7180,18671,5097,14671,1246,3694,2149,6090,3395,9784
431690,201912,22053,54665,14016,39980,3081,9312,5237,14964,8318,24276
431695,201912,147,346,85,247,16,60,44,97,60,157
431697,201912,452,1074,333,887,51,124,188,517,239,641
431700,201912,1356,3537,1124,3106,159,415,677,1859,836,2274
431710,201912,12013,29654,8266,24092,1621,4979,3860,11510,5481,16489
431720,201912,5737,14672,3320,9731,848,2634,549,1398,1397,4032
431725,201912,24,63,18,53,5,14,7,21,12,35
431730,201912,3694,9077,2254,6681,543,1718,698,2192,1241,3910
431740,201912,4914,11835,3117,8695,896,2853,736,1706,1632,4559
431750,201912,7121,18417,5454,15744,1197,3714,2416,6835,3613,10549
431755,201912,313,846,61,214,6,20,12,43,18,63
431760,201912,5334,12008,3367,8892,346,1081,2021,4994,2367,6075
431770,201912,1816,4359,1411,3814,86,295,1071,2801,1157,3096
431775,201912,195,512,90,282,20,56,16,46,36,102
431780,201912,1971,5008,1218,3553,215,706,510,1415,725,2121
431790,201912,791,2158,550,1668,103,313,245,715,348,1028
431795,201912,229,585,101,304,22,69,30,83,52,152
431800,201912,7668,18839,4664,13861,1288,4353,547,1684,1835,6037
431805,201912,302,712,80,265,6,21,30,93,36,114
431810,201912,3194,7676,1976,5398,374,1079,839,2197,1213,3276
431820,201912,2121,5823,1655,5048,483,1522,572,1846,1055,3368
431830,201912,8639,18989,6204,15625,1605,4635,1994,5001,3599,9636
431840,201912,2509,6700,1987,5823,332,979,1191,3497,1523,4476
431842,201912,590,1482,187,592,23,83,62,176,85,259
431843,201912,323,866,240,692,29,99,121,320,150,419
431844,201912,209,544,58,196,14,53,21,74,35,127
431845,201912,510,1350,350,1023,26,76,203,590,229,666
431846,201912,284,743,237,671,11,35,207,581,218,616
431848,201912,112,286,64,191,8,26,8,19,16,45
431849,201912,399,967,57,170,1,1,6,20,7,21
431850,201912,3945,10841,2984,8872,716,2294,937,2753,1653,5047
431860,201912,631,1563,350,1007,60,181,187,511,247,692
431861,201912,94,263,51,161,13,43,16,44,29,87
431862,201912,424,1350,344,1208,72,288,172,578,244,866
431870,201912,17799,46325,14170,40318,1861,5929,8441,23119,10302,29048
431880,201912,3927,10156,2699,7887,444,1494,1212,3355,1656,4849
431890,201912,4145,10539,2482,7287,747,2397,414,1338,1161,3735
431900,201912,965,2470,590,1751,89,304,303,841,392,1145
431910,201912,753,1812,240,679,50,138,64,140,114,278
431912,201912,442,1243,341,1061,68,221,203,624,271,845
431915,201912,1030,2609,807,2239,28,93,610,1648,638,1741
431920,201912,1167,2842,971,2572,28,79,831,2189,859,2268
431930,201912,652,1749,426,1335,125,354,199,648,324,1002
431935,201912,82,230,50,158,15,53,10,32,25,85
431936,201912,299,873,163,525,38,127,58,172,96,299
431937,201912,165,408,100,265,17,55,44,92,61,147
431940,201912,2851,6824,1605,4507,183,576,804,2158,987,2734
431950,201912,1744,4695,1398,4125,458,1358,527,1563,985,2921
431960,201912,2805,7000,1989,5488,583,1652,518,1418,1101,3070
431970,201912,421,1069,144,445,40,122,35,95,75,217
431971,201912,58,151,29,94,4,17,5,10,9,27
431973,201912,470,1509,386,1345,39,144,282,979,321,1123
431975,201912,107,225,20,70,4,17,3,7,7,24
431980,201912,1006,2661,763,2238,166,514,347,977,513,1491
431990,201912,5671,13686,3631,10615,511,1736,1676,4656,2187,6392
432000,201912,10427,25299,7336,20316,1807,5061,3169,8862,4976,13923
432010,201912,1998,5059,1447,4051,217,683,839,2212,1056,2895
432020,201912,1765,4484,1081,3122,219,660,481,1299,700,1959
432023,201912,506,1220,247,704,40,125,116,293,156,418
432026,201912,997,2776,693,2182,175,550,240,744,415,1294
432030,201912,325,823,176,523,25,71,94,280,119,351
432032,201912,342,885,228,665,28,97,120,319,148,416
432035,201912,647,1844,558,1694,184,559,214,686,398,1245
432040,201912,1077,2435,344,1070,58,202,113,311,171,513
432045,201912,175,477,99,320,23,76,36,120,59,196
432050,201912,465,1216,337,976,79,227,138,411,217,638
432055,201912,593,1624,387,1206,127,416,87,239,214,655
432057,201912,225,602,159,437,27,63,65,169,92,232
432060,201912,452,1085,138,432,33,113,43,116,76,229
432065,201912,210,596,142,446,27,83,56,168,83,251
432067,201912,713,2077,598,1818,52,183,433,1267,485,1450
432070,201912,1671,4434,1042,3162,243,802,316,870,559,1672
432080,201912,4129,10095,3089,8350,562,1757,1425,3651,1987,5408
432085,201912,356,919,238,728,73,223,92,296,165,519
432090,201912,1295,3276,843,2427,168,527,423,1154,591,1681
432100,201912,935,2438,417,1328,83,284,76,195,159,479
432110,201912,2057,5570,1345,4232,331,1189,121,350,452,1539
432120,201912,2722,7491,2075,6320,416,1405,764,2236,1180,3641
432130,201912,2464,6439,2020,5776,626,1819,859,2510,1485,4329
432132,201912,184,524,109,356,20,67,48,130,68,197
432135,201912,980,2369,621,1721,36,116,451,1230,487,1346
432140,201912,1487,4488,1107,3722,157,560,674,2256,831,2816
432143,201912,1370,3613,1039,3087,76,246,686,2017,762,2263
432145,201912,1341,3554,740,2252,115,381,227,576,342,957
432146,201912,100,277,61,207,21,74,18,56,39,130
432147,201912,481,1401,285,957,94,340,67,194,161,534
432149,201912,416,1053,198,594,13,39,97,279,110,318
432150,201912,2897,7555,2061,5999,462,1511,742,2075,1204,3586
432160,201912,5025,13494,3623,11107,943,3141,1243,3620,2186,6761
432162,201912,268,586,33,94,7,19,5,14,12,33
432163,201912,129,326,24,70,0,0,3,6,3,6
432166,201912,576,1651,426,1323,74,245,144,404,218,649
432170,201912,1291,3474,779,2485,149,527,285,839,434,1366
432180,201912,2591,6337,1314,3833,256,797,444,1150,700,1947
432183,201912,353,1039,221,723,60,225,65,195,125,420
432185,201912,788,2034,440,1349,35,124,238,688,273,812
432190,201912,1690,4161,1058,3112,216,710,503,1385,719,2095
432195,201912,926,2312,577,1666,162,430,207,633,369,1063
432200,201912,3078,8082,2150,6517,378,1152,1152,3562,1530,4714
432210,201912,363,958,211,650,38,144,99,260,137,404
432215,201912,615,1800,551,1704,52,142,401,1262,453,1404
432218,201912,256,647,108,312,16,54,48,125,64,179
432220,201912,3478,8275,2556,6816,433,1225,1422,3714,1855,4939
432225,201912,84,246,60,192,13,45,31,100,44,145
432230,201912,696,1654,365,1029,52,155,154,395,206,550
432232,201912,485,1193,285,833,62,201,105,281,167,482
432234,201912,264,666,107,313,20,46,16,42,36,88
432235,201912,71,195,19,59,4,12,6,24,10,36
432237,201912,337,869,290,788,10,21,235,625,245,646
432240,201912,14538,37146,10505,31496,782,2630,6694,20863,7476,23493
432250,201912,4551,13649,3614,11778,1002,3353,1432,4690,2434,8043
432252,201912,427,1023,251,706,34,100,129,352,163,452
432253,201912,942,2933,558,1934,148,547,37,117,185,664
432254,201912,690,1648,136,434,29,92,17,42,46,134
432255,201912,106,268,57,171,5,17,30,78,35,95
432260,201912,4586,11952,3255,9377,968,2877,941,2636,1909,5513
432270,201912,1749,4961,1342,4126,415,1392,247,707,662,2099
432280,201912,1161,2961,563,1723,93,313,207,537,300,850
432285,201912,173,507,22,66,1,3,3,5,4,8
432290,201912,331,943,167,541,58,184,32,77,90,261
432300,201912,25204,64818,18535,53683,2839,9243,10586,29428,13425,38671
432310,201912,770,2125,547,1704,50,159,372,1162,422,1321
432320,201912,209,484,67,196,8,31,26,67,34,98
432330,201912,211,483,59,183,7,19,14,42,21,61
432335,201912,197,561,61,224,6,27,12,37,18,64
432340,201912,315,754,127,401,12,39,44,128,56,167
432345,201912,639,1481,563,1388,22,59,449,1085,471,1144
432350,201912,336,891,174,568,29,104,68,211,97,315
432360,201912,224,667,42,142,2,8,17,54,19,62
432370,201912,304,747,190,551,17,52,127,360,144,412
432375,201912,473,1191,342,934,64,157,170,481,234,638
432377,201912,180,560,31,108,5,20,2,4,7,24
432380,201912,1590,4268,994,3134,179,648,497,1492,676,2140
500020,201912,2450,6382,1688,5034,196,673,991,2849,1187,3522
500025,201912,1235,2977,741,2063,64,192,417,1117,481,1309
500060,201912,7437,21132,5007,16012,637,2129,2931,9622,3568,11751
500070,201912,4169,10919,2845,8629,525,1622,1219,3800,1744,5422
500080,201912,1359,3435,861,2540,164,544,357,934,521,1478
500085,201912,1982,4947,1286,3783,297,920,623,1754,920,2674
500090,201912,1940,5246,1289,4093,236,780,480,1577,716,2357
500100,201912,3514,8991,2613,7478,461,1480,1246,3367,1707,4847
500110,201912,7479,19390,4664,14836,1067,3717,1381,5100,2448,8817
500124,201912,1984,5946,1562,5198,258,800,848,2966,1106,3766
500150,201912,1290,2959,780,2191,158,458,279,765,437,1223
500190,201912,4329,10872,2784,8159,665,1979,779,2226,1444,4205
500200,201912,2147,5150,1534,4118,167,479,943,2390,1110,2869
500210,201912,4506,11223,3201,9443,836,2495,1395,4194,2231,6689
500215,201912,1325,3771,912,2980,93,345,474,1544,567,1889
500220,201912,2417,6877,1496,5066,268,965,376,1229,644,2194
500230,201912,2106,4934,1528,4102,196,514,994,2640,1190,3154
500240,201912,3489,10483,2352,8070,390,1474,898,3180,1288,4654
500260,201912,3042,6529,1827,4821,260,677,945,2415,1205,3092
500270,201912,133708,315700,75378,213889,13417,41600,27073,72140,40490,113740
500280,201912,1217,3096,803,2432,100,329,475,1397,575,1726
500290,201912,3523,8309,1869,5547,348,1186,578,1530,926,2716
500295,201912,3176,7776,1853,5339,309,988,711,1773,1020,2761
500310,201912,913,1941,602,1542,100,211,303,814,403,1025
500315,201912,3508,10036,2739,8816,252,804,1883,6248,2135,7052
500320,201912,17928,49583,12198,39886,3226,10977,4218,14578,7444,25555
500325,201912,4185,9441,2819,7574,247,693,1843,5009,2090,5702
500330,201912,6632,15238,4210,11579,322,980,2354,6629,2676,7609
500345,201912,1976,4864,1243,3681,297,908,418,1210,715,2118
500348,201912,2352,6075,1785,5131,252,739,1001,2928,1253,3667
500350,201912,1246,3398,647,2061,74,243,285,888,359,1131
500370,201912,24177,63028,16218,49591,2300,7987,8284,25203,10584,33190
500375,201912,2416,6435,1533,4562,306,974,494,1387,800,2361
500380,201912,3404,8541,2245,6546,642,2004,565,1659,1207,3663
500390,201912,503,1096,307,842,52,167,181,489,233,656
500400,201912,1309,3387,822,2420,153,498,270,734,423,1232
500410,201912,2377,5979,1655,4856,169,494,972,2940,1141,3434
500430,201912,2566,6375,1670,4992,229,804,712,2215,941,3019
500440,201912,1113,2725,658,1987,91,305,251,816,342,1121
500450,201912,1401,3527,749,2279,149,478,162,469,311,947
500460,201912,3623,9827,2123,6807,377,1353,677,2143,1054,3496
500470,201912,2407,6553,1428,4502,429,1504,293,789,722,2293
500480,201912,2140,6466,1806,5919,158,557,1311,4383,1469,4940
500490,201912,971,2285,531,1607,123,447,149,442,272,889
500500,201912,4247,11486,2651,8817,953,3677,464,1575,1417,5252
500510,201912,678,1735,423,1239,28,98,256,730,284,828
500515,201912,1768,4451,1324,3737,143,441,824,2230,967,2671
500520,201912,2938,9502,2305,8257,642,2330,954,3577,1596,5907
500525,201912,844,2547,682,2289,61,224,416,1418,477,1642
500540,201912,4387,11441,2544,8091,681,2660,242,691,923,3351
500560,201912,5259,14659,4182,13230,278,954,3299,10568,3577,11522
500568,201912,4313,9455,2477,6723,586,1717,858,2327,1444,4044
500570,201912,7424,17473,4248,11919,832,2547,1416,3693,2248,6240
500580,201912,2991,8052,2159,6574,460,1474,1033,3121,1493,4595
500600,201912,3035,7631,2081,6152,442,1327,898,2750,1340,4077
500620,201912,7246,19414,4703,14457,1077,3475,1638,4927,2715,8402
500625,201912,486,1330,273,846,51,168,94,254,145,422
500627,201912,714,1866,411,1298,62,204,146,461,208,665
500630,201912,6308,14757,3488,9953,716,2236,1042,2984,1758,5220
500635,201912,2869,9083,2195,8177,169,701,1545,6192,1714,6893
500640,201912,1675,3695,1081,2885,41,135,738,1919,779,2054
500660,201912,16746,44420,11272,35994,3677,13148,2749,9018,6426,22166
500690,201912,2209,6135,1431,4823,552,2143,90,203,642,2346
500710,201912,2845,7782,2138,6500,637,2035,640,1840,1277,3875
500720,201912,4829,12284,2991,9175,696,2270,879,2719,1575,4989
500730,201912,930,2353,541,1642,67,186,193,603,260,789
500740,201912,4499,10801,3021,8383,394,1149,1593,4452,1987,5601
500750,201912,920,2374,583,1736,91,277,219,576,310,853
500755,201912,849,2256,444,1465,86,308,84,244,170,552
500769,201912,4774,11787,2420,7226,474,1604,385,883,859,2487
500770,201912,1444,3936,906,2956,169,622,304,980,473,1602
500780,201912,1229,3045,770,2246,161,511,212,582,373,1093
500790,201912,7339,19463,5602,16541,1129,3593,2834,8382,3963,11975
500793,201912,1932,4977,1300,3854,370,1182,365,983,735,2165
500795,201912,2546,6526,2075,5913,92,264,1776,5161,1868,5425
500797,201912,668,1699,435,1273,123,377,151,444,274,821
500800,201912,2934,6790,1774,5057,573,1895,221,692,794,2587
500830,201912,17180,43661,11310,32733,2358,7406,4298,11612,6656,19018
500840,201912,1361,3336,765,2179,89,260,315,853,404,1113
510010,201912,1825,4117,1162,3232,110,309,810,2275,920,2584
510020,201912,3459,8852,1763,5404,368,1213,382,1044,750,2257
510025,201912,6680,16599,3979,11984,612,2049,1583,4585,2195,6634
510030,201912,2296,5198,1468,3971,327,888,531,1437,858,2325
510035,201912,1185,3098,718,2342,75,267,439,1498,514,1765
510040,201912,2195,4965,1575,4147,150,392,998,2713,1148,3105
510050,201912,2019,4358,1292,3377,151,452,884,2239,1035,2691
510060,201912,1371,3481,963,2806,202,655,287,775,489,1430
510080,201912,1212,3205,762,2420,253,839,214,587,467,1426
510100,201912,651,1544,432,1188,53,151,228,604,281,755
510120,201912,249,472,135,338,3,12,105,267,108,279
510125,201912,2081,5157,1606,4453,176,649,822,2124,998,2773
510130,201912,1429,3608,972,2860,214,691,297,877,511,1568
510140,201912,2965,7790,1987,6531,735,2819,669,2011,1404,4830
510160,201912,1670,4348,1199,3723,168,501,847,2682,1015,3183
510170,201912,4452,11819,3181,9733,778,2475,1265,3967,2043,6442
510180,201912,13670,31408,7992,22745,1842,5688,2311,7510,4153,13198
510185,201912,1676,4407,1069,3518,438,1435,283,1185,721,2620
510190,201912,1963,5703,1249,4419,358,1392,216,821,574,2213
510250,201912,15484,39972,11764,34542,2212,6776,6252,19074,8464,25850
510260,201912,1976,8201,1583,7470,272,1388,940,4834,1212,6222
510263,201912,3071,8581,1789,5928,308,1147,218,634,526,1781
510267,201912,4629,13357,2604,8783,537,1913,306,981,843,2894
510268,201912,1265,3098,935,2579,118,310,605,1656,723,1966
510269,201912,992,2727,590,1935,155,553,184,560,339,1113
510270,201912,2821,8132,1890,6398,350,1306,759,2494,1109,3800
510279,201912,1746,4548,1089,3383,221,764,457,1358,678,2122
510285,201912,1053,2804,718,2232,232,797,152,420,384,1217
510300,201912,3638,9257,2638,7883,400,1229,1526,4769,1926,5998
510305,201912,1446,4015,839,2813,184,648,193,723,377,1371
510310,201912,906,2266,597,1736,179,550,163,487,342,1037
510320,201912,3572,9083,2410,7011,544,1715,628,1848,1172,3563
510325,201912,4317,12794,3180,10720,928,3281,997,3461,1925,6742
510330,201912,2728,8279,1793,6573,349,1304,661,2749,1010,4053
510335,201912,4605,13286,3375,11335,529,1902,1899,6538,2428,8440
510336,201912,461,1307,328,1091,60,195,153,547,213,742
510337,201912,1544,4604,1004,3602,397,1551,185,674,582,2225
510340,201912,89641,199869,52587,144474,13230,42858,15002,37978,28232,80836
510343,201912,1025,2829,685,2172,130,458,288,862,418,1320
510345,201912,1219,3476,891,2820,165,530,395,1213,560,1743
510350,201912,2765,7259,1722,5468,380,1261,663,2094,1043,3355
510360,201912,1847,3856,1139,3015,69,139,817,2307,886,2446
510370,201912,1711,5004,1205,4099,171,654,708,2452,879,3106
510380,201912,540,1366,283,895,55,199,103,319,158,518
510385,201912,1212,4109,861,3417,96,439,539,2202,635,2641
510390,201912,1157,3207,771,2664,239,799,302,1156,541,1955
510395,201912,721,1624,466,1247,28,74,276,795,304,869
510410,201912,4611,12925,3310,10561,631,2082,1767,5805,2398,7887
510420,201912,2269,4883,1525,3876,117,347,992,2511,1109,2858
510450,201912,478,1176,257,759,68,197,41,140,109,337
510452,201912,692,1948,467,1507,61,213,244,769,305,982
510454,201912,883,2469,652,2067,64,178,428,1424,492,1602
510455,201912,873,2464,614,1931,99,358,239,682,338,1040
510460,201912,1757,4336,1214,3515,92,324,785,2168,877,2492
510480,201912,4606,11232,2920,8042,573,1766,1147,3025,1720,4791
510490,201912,1675,4391,1215,3784,195,624,742,2334,937,2958
510500,201912,1528,3831,889,2742,167,539,309,961,476,1500
510510,201912,3320,9828,2393,8092,637,2380,724,2585,1361,4965
510515,201912,5256,13740,3266,9980,805,2697,769,2105,1574,4802
510517,201912,1017,2977,763,2528,239,891,136,384,375,1275
510520,201912,2092,4234,1154,3066,82,231,602,1709,684,1940
510523,201912,1012,2624,728,2137,154,428,388,1179,542,1607
510525,201912,6429,17875,4682,14390,793,2711,2142,6204,2935,8915
510530,201912,536,1372,380,1140,32,106,233,676,265,782
510550,201912,2389,7066,1666,5764,410,1478,699,2451,1109,3929
510558,201912,2130,5749,1523,4787,215,645,685,2344,900,2989
510560,201912,1633,4687,924,3248,194,763,241,902,435,1665
510562,201912,5155,13748,3560,10739,904,2978,1179,3682,2083,6660
510590,201912,3080,7662,2182,6502,182,591,1543,4652,1725,5243
510600,201912,1439,3276,898,2453,176,494,380,1041,556,1535
510610,201912,2755,6700,1830,5412,182,608,1129,3358,1311,3966
510615,201912,2474,6327,1589,4829,293,898,816,2556,1109,3454
510617,201912,940,2837,696,2427,103,416,429,1553,532,1969
510618,201912,1213,3246,804,2508,175,619,383,1154,558,1773
510619,201912,742,1899,458,1400,71,240,108,303,179,543
510620,201912,1349,3032,602,1848,162,603,38,77,200,680
510621,201912,1450,3900,854,2760,186,669,261,800,447,1469
510622,201912,4411,12530,2959,9342,1043,3515,420,1193,1463,4708
510623,201912,2608,6555,1759,5188,411,1466,496,1389,907,2855
510624,201912,1632,4123,671,2280,89,326,159,474,248,800
510625,201912,2780,6807,1420,4344,256,917,323,977,579,1894
510626,201912,1483,3582,873,2604,257,869,210,610,467,1479
510627,201912,591,1537,322,1000,87,295,78,252,165,547
510628,201912,1504,3447,948,2677,198,593,370,1035,568,1628
510629,201912,1548,4461,1116,3641,234,828,406,1304,640,2132
510630,201912,3179,8968,1791,6226,425,1571,310,1164,735,2735
510631,201912,571,1377,398,1120,13,39,305,876,318,915
510637,201912,3267,7980,2291,6514,595,1875,647,1828,1242,3703
510642,201912,5257,15302,3994,13352,1046,3756,1643,5637,2689,9393
510645,201912,812,1721,472,1270,108,308,210,523,318,831
510650,201912,6974,18037,5499,16391,633,1707,3805,12421,4438,14128
510665,201912,1776,3930,1018,2703,137,390,445,1210,582,1600
510670,201912,420,904,237,637,24,66,135,371,159,437
510675,201912,5718,15942,3759,12179,1144,4082,568,1770,1712,5852
510677,201912,2044,5312,1376,4285,211,742,701,2135,912,2877
510680,201912,675,1777,366,1168,75,264,75,220,150,484
510682,201912,1564,4637,1118,3856,370,1416,243,808,613,2224
510685,201912,554,1611,392,1269,57,202,193,617,250,819
510700,201912,3918,9576,2704,7828,291,958,1916,5483,2207,6441
510704,201912,10458,24662,6559,17886,1412,4150,1791,4679,3203,8829
510706,201912,1940,5792,1343,4820,251,924,715,2765,966,3689
510710,201912,2571,6548,1622,4719,357,1096,554,1535,911,2631
510715,201912,575,1289,416,1073,41,118,197,512,238,630
510718,201912,2343,5266,1293,3865,432,1275,395,1463,827,2738
510719,201912,416,876,241,641,27,70,140,356,167,426
510720,201912,909,2151,573,1638,108,352,254,677,362,1029
510724,201912,746,2034,490,1551,80,279,243,737,323,1016
510726,201912,1093,1990,552,1318,60,158,286,680,346,838
510729,201912,595,1408,251,766,37,129,57,184,94,313
510730,201912,2872,7020,1890,5430,275,888,902,2520,1177,3408
510735,201912,1011,2943,759,2580,77,308,548,1853,625,2161
510740,201912,860,2120,521,1480,87,249,247,697,334,946
510757,201912,533,1693,420,1505,144,574,145,484,289,1058
510760,201912,41514,92225,23356,63573,5089,15846,7197,17843,12286,33689
510770,201912,4245,9623,2844,7878,260,684,1920,5561,2180,6245
510774,201912,340,892,224,681,38,118,109,335,147,453
510775,201912,605,1630,386,1257,86,309,80,243,166,552
510776,201912,435,1090,295,824,76,214,96,286,172,500
510777,201912,1518,4062,1066,3461,142,533,694,2213,836,2746
510779,201912,627,1680,468,1427,48,147,283,901,331,1048
510780,201912,3628,9387,2604,7912,596,1791,1179,3992,1775,5783
510785,201912,1986,5292,1105,3628,290,1015,177,656,467,1671
510787,201912,2533,7220,1628,5280,571,1954,184,586,755,2540
510788,201912,623,1478,417,1160,63,179,187,595,250,774
510790,201912,16764,43801,9547,29884,2083,7298,1464,3989,3547,11287
510792,201912,8510,23109,5014,16256,1044,3789,894,2592,1938,6381
510794,201912,1196,3228,766,2464,248,888,159,427,407,1315
510795,201912,7906,21075,4991,15660,1165,4052,1281,3915,2446,7967
510800,201912,1674,4360,1046,3264,380,1185,127,389,507,1574
510805,201912,1499,4173,976,3151,219,783,286,796,505,1579
510810,201912,640,1322,396,984,108,282,162,400,270,682
510820,201912,760,1468,410,1017,26,81,217,545,243,626
510830,201912,835,2043,581,1704,52,142,406,1256,458,1398
510835,201912,556,1354,358,1063,44,144,201,580,245,724
510840,201912,50232,108652,33790,88253,6482,16025,17399,49619,23881,65644
510850,201912,1798,4306,975,2969,331,1148,99,236,430,1384
510860,201912,2311,6191,1409,4639,447,1701,129,412,576,2113
510880,201912,674,1937,494,1588,122,407,188,615,310,1022
510885,201912,534,1303,355,1043,64,215,121,346,185,561
510890,201912,625,1834,458,1544,100,366,212,702,312,1068
510895,201912,1229,3189,785,2444,173,640,318,904,491,1544
520005,201912,2379,6238,1818,5545,530,1627,792,2701,1322,4328
520010,201912,2174,6337,1525,5024,375,1388,434,1242,809,2630
520013,201912,2734,7106,1777,5325,393,1186,500,1648,893,2834
520015,201912,508,1283,357,1061,78,248,130,396,208,644
520017,201912,1102,2874,814,2426,101,325,532,1550,633,1875
520020,201912,391,908,291,779,29,101,210,537,239,638
520025,201912,32960,92547,28111,85640,2832,9406,20223,61181,23055,70587
520030,201912,5412,14022,4259,12375,337,1085,2972,8561,3309,9646
520050,201912,412,958,257,691,12,33,154,429,166,462
520055,201912,1628,4004,1057,2917,78,205,601,1603,679,1808
520060,201912,1429,4007,1025,3245,275,957,245,767,520,1724
520080,201912,1829,4705,1340,4040,241,742,638,2103,879,2845
520082,201912,879,2256,680,1917,79,211,363,1069,442,1280
520085,201912,804,2157,613,1842,109,343,288,822,397,1165
520090,201912,830,1630,559,1327,56,95,430,1067,486,1162
520110,201912,38103,103124,25779,82309,8150,29473,2130,6155,10280,35628
520120,201912,200,480,108,324,14,49,39,115,53,164
520130,201912,3590,8876,2761,7558,533,1490,1202,3333,1735,4823
520140,201912,39785,107523,27263,85537,9940,33693,3506,11310,13446,45003
520145,201912,560,1330,378,1060,62,196,210,543,272,739
520150,201912,612,1394,439,1167,80,210,238,648,318,858
520160,201912,778,1797,550,1440,104,252,255,706,359,958
520170,201912,5054,10217,3314,8202,194,534,2515,6111,2709,6645
520180,201912,2092,5800,1698,5212,327,1108,911,2753,1238,3861
520215,201912,1754,4245,1220,3400,306,921,434,1158,740,2079
520235,201912,595,1375,333,959,36,127,130,354,166,481
520250,201912,1471,3806,1038,3118,336,1094,236,738,572,1832
520260,201912,818,1910,497,1373,98,268,202,575,300,843
520280,201912,680,1696,501,1416,102,288,236,703,338,991
520310,201912,1110,2432,694,1811,161,480,261,709,422,1189
520320,201912,1626,4402,1217,3734,148,513,661,1977,809,2490
520330,201912,3804,10375,2703,8524,420,1606,1366,4189,1786,5795
520340,201912,2344,5223,1446,3957,173,435,855,2454,1028,2889
520350,201912,2807,6754,1976,5455,601,1736,737,2049,1338,3785
520355,201912,1776,4872,1245,3807,360,1197,361,1012,721,2209
520357,201912,746,1784,528,1457,38,97,389,1103,427,1200
520360,201912,689,1808,503,1487,146,451,134,422,280,873
520380,201912,1375,3422,795,2328,86,274,395,1074,481,1348
520390,201912,1005,2210,577,1671,168,527,183,569,351,1096
520393,201912,519,1241,340,953,44,147,157,400,201,547
520396,201912,793,2079,654,1855,44,142,466,1282,510,1424
520400,201912,1580,3937,1187,3386,162,496,778,2232,940,2728
520410,201912,1907,4260,1084,2988,176,529,469,1242,645,1771
520420,201912,356,813,270,672,26,68,203,478,229,546
520425,201912,1385,3360,808,2334,214,637,212,590,426,1227
520430,201912,2196,5007,1154,3403,223,783,47,121,270,904
520440,201912,2953,7141,1720,4948,426,1342,451,1235,877,2577
520450,201912,11956,28732,7645,21963,2425,7586,1283,3781,3708,11367
520455,201912,663,1819,471,1515,127,445,134,436,261,881
520460,201912,984,2327,755,2029,83,194,592,1628,675,1822
520465,201912,766,1977,604,1748,92,296,401,1111,493,1407
520470,201912,2088,5447,1595,4787,415,1235,717,2332,1132,3567
520480,201912,900,2499,601,1980,192,630,133,487,325,1117
520485,201912,1558,4352,1287,3973,184,581,892,2733,1076,3314
520490,201912,3929,10819,2892,9188,973,3181,1062,3513,2035,6694
520495,201912,1550,3382,1155,2854,49,127,920,2271,969,2398
520500,201912,1281,3410,846,2568,199,655,336,1025,535,1680
520505,201912,715,1627,483,1317,67,190,293,789,360,979
520510,201912,7634,19160,4910,14850,1144,3848,1349,4362,2493,8210
520520,201912,1126,2892,820,2398,194,598,274,814,468,1412
520530,201912,1934,5712,1410,4817,447,1589,449,1672,896,3261
520540,201912,2811,7464,1658,5108,316,1054,371,1088,687,2142
520545,201912,939,2472,699,2074,149,433,271,823,420,1256
520547,201912,778,2116,611,1830,152,466,288,862,440,1328
520549,201912,12808,34787,10396,31098,1528,4833,6778,20165,8306,24998
520551,201912,4409,11993,3651,10876,402,1403,2576,7479,2978,8882
520552,201912,836,2159,680,1955,140,391,396,1211,536,1602
520570,201912,544,1211,352,938,92,217,131,396,223,613
520580,201912,2137,5007,1618,4368,112,364,1176,3113,1288,3477
520590,201912,1144,2943,779,2324,235,713,194,589,429,1302
520620,201912,8075,21931,6241,19210,1589,5031,2767,8747,4356,13778
520630,201912,700,1801,428,1306,77,234,82,250,159,484
520640,201912,2377,5884,1775,4842,438,1179,726,2043,1164,3222
520650,201912,854,2024,597,1648,97,264,300,880,397,1144
520660,201912,517,1239,250,750,52,181,61,173,113,354
520670,201912,910,2542,769,2341,77,247,492,1458,569,1705
520680,201912,692,1731,501,1429,86,233,248,726,334,959
520690,201912,341,803,229,639,68,176,66,207,134,383
520710,201912,399,960,274,741,9,21,194,514,203,535
520725,201912,1547,3647,1045,2822,126,386,645,1666,771,2052
520735,201912,726,1791,470,1368,106,298,166,521,272,819
520740,201912,2047,4649,1516,4010,263,645,843,2389,1106,3034
520750,201912,655,1594,454,1269,76,206,224,639,300,845
520753,201912,1311,3495,981,2864,190,583,388,1068,578,1651
520760,201912,1166,2606,1017,2421,34,63,925,2231,959,2294
520780,201912,1471,3445,1032,2830,107,317,509,1347,616,1664
520790,201912,3360,7943,2297,6248,294,795,1282,3659,1576,4454
520800,201912,15725,40941,12062,35489,1968,5967,6998,21172,8966,27139
520810,201912,1256,2679,892,2257,151,407,555,1464,706,1871
520815,201912,584,1740,409,1381,72,265,111,392,183,657
520830,201912,1829,3901,1261,3252,46,125,1031,2613,1077,2738
520840,201912,2492,6739,1991,6081,852,2789,525,1722,1377,4511
520850,201912,658,1699,455,1392,162,563,103,332,265,895
520860,201912,6313,17051,4566,14205,1175,3906,1685,5198,2860,9104
520870,201912,100121,234067,65211,181122,15323,45911,22284,60420,37607,106331
520880,201912,6550,18779,4979,15967,1177,3918,1824,5866,3001,9784
520890,201912,3867,9432,2558,7355,549,1691,1061,3058,1610,4749
520910,201912,4542,11526,2814,8447,702,2292,628,1863,1330,4155
520915,201912,681,1884,387,1211,65,219,129,391,194,610
520920,201912,4355,9854,2935,7998,370,1028,1669,4657,2039,5685
520929,201912,686,1601,473,1260,87,210,223,649,310,859
520940,201912,964,2554,742,2241,47,153,543,1610,590,1763
520945,201912,481,1086,386,946,23,51,274,657,297,708
520960,201912,997,2485,766,2103,135,353,457,1258,592,1611
520970,201912,2440,6773,1901,5880,488,1682,492,1604,980,3286
520980,201912,779,1898,553,1583,108,336,224,605,332,941
520990,201912,2959,7990,2353,7195,333,1004,1514,4705,1847,5709
520993,201912,1052,2489,698,1924,93,296,397,1043,490,1339
520995,201912,2227,5693,1651,4885,273,807,668,2038,941,2845
521000,201912,8467,22159,5503,16755,1174,3718,1656,4996,2830,8714
521010,201912,3657,9443,2670,7733,277,806,1535,4392,1812,5198
521015,201912,769,1905,517,1451,40,125,327,873,367,998
521020,201912,3094,7993,1761,5357,528,1753,141,445,669,2198
521030,201912,497,1073,322,813,59,124,137,388,196,512
521040,201912,7600,18476,5485,15148,1162,3355,2325,6527,3487,9882
521056,201912,890,2355,686,2046,221,650,195,650,416,1300
521060,201912,958,2528,700,2057,50,146,366,1086,416,1232
521080,201912,1104,2410,542,1499,73,227,232,553,305,780
521090,201912,3215,8665,2107,6465,615,1999,262,843,877,2842
521100,201912,1744,4053,1212,3298,197,536,702,1930,899,2466
521120,201912,4671,10901,3261,9141,211,533,1634,5260,1845,5793
521130,201912,951,2139,546,1469,19,55,296,841,315,896
521140,201912,1224,3154,860,2495,115,351,414,1200,529,1551
521150,201912,12379,27065,7416,19993,1299,4056,3489,9468,4788,13524
521160,201912,624,1298,428,1006,46,104,285,650,331,754
521170,201912,1021,2404,725,1949,60,173,499,1306,559,1479
521180,201912,6970,19458,5660,17142,951,3137,2896,8496,3847,11633
521190,201912,10372,26218,5746,18190,1473,4929,1166,3905,2639,8834
521200,201912,723,1791,482,1381,49,140,268,763,317,903
521205,201912,611,1516,456,1266,16,50,338,899,354,949
521210,201912,703,1784,390,1143,93,290,70,165,163,455
521220,201912,3701,9119,2351,6919,467,1553,767,2171,1234,3724
521225,201912,342,757,251,655,36,99,152,391,188,490
521230,201912,1278,3324,1134,3145,387,1079,563,1655,950,2734
521250,201912,29834,80900,22846,70503,8554,27632,6666,21831,15220,49463
521260,201912,568,1329,404,1065,54,144,230,595,284,739
521270,201912,1785,4525,1519,4200,86,221,1156,3206,1242,3427
521280,201912,1810,4855,1334,4058,326,1084,524,1611,850,2695
521290,201912,464,1098,314,899,46,156,183,509,229,665
521295,201912,1077,2333,829,2064,56,118,665,1729,721,1847
521300,201912,1865,4621,1446,4034,274,717,890,2557,1164,3274
521305,201912,693,1675,469,1324,57,149,275,782,332,931
521308,201912,4680,12560,3250,9820,320,973,1858,5518,2178,6491
521310,201912,8285,21187,5520,16449,1222,3959,2225,6329,3447,10288
521340,201912,410,963,287,772,21,60,204,534,225,594
521350,201912,2028,5193,1525,4425,142,507,1061,2939,1203,3446
521370,201912,1237,3164,717,2246,204,744,93,310,297,1054
521375,201912,1315,3238,881,2602,201,581,272,890,473,1471
521377,201912,1477,3140,1047,2609,76,139,851,2216,927,2355
521380,201912,6112,16301,3883,12066,415,1425,1006,3311,1421,4736
521385,201912,637,1540,480,1333,63,165,272,818,335,983
521390,201912,696,1716,480,1382,141,453,173,512,314,965
521400,201912,2551,5882,1935,5127,218,578,1353,3663,1571,4241
521405,201912,1284,3279,931,2686,182,529,440,1260,622,1789
521410,201912,779,2083,584,1745,108,301,297,952,405,1253
521440,201912,1210,3071,838,2484,275,894,239,711,514,1605
521450,201912,3843,11512,2778,9371,714,2464,731,2571,1445,5035
521460,201912,5689,15100,3945,11964,1374,4334,872,2691,2246,7025
521470,201912,651,1756,379,1184,47,144,127,388,174,532
521480,201912,348,865,199,580,38,114,61,170,99,284
521483,201912,2422,5787,1633,4534,363,1064,625,1700,988,2764
521486,201912,1745,4105,1278,3448,75,211,938,2517,1013,2728
521487,201912,418,1009,287,824,51,159,137,399,188,558
521490,201912,888,2386,641,1975,40,150,458,1364,498,1514
521500,201912,2128,5315,1539,4351,103,363,1084,2974,1187,3337
521520,201912,736,1698,509,1357,78,222,213,571,291,793
521523,201912,11271,35182,9262,31804,2543,9521,2483,8816,5026,18337
521525,201912,1047,2391,759,1989,77,209,534,1385,611,1594
521530,201912,2267,5889,1271,3815,269,847,319,978,588,1825
521540,201912,821,2070,524,1569,73,257,241,751,314,1008
521550,201912,1502,3762,793,2351,146,487,215,655,361,1142
521560,201912,4419,11734,2995,9790,491,1861,1511,5151,2002,7012
521565,201912,622,1506,474,1301,74,189,289,782,363,971
521570,201912,3492,9380,2218,6938,434,1570,241,792,675,2362
521580,201912,500,1222,274,827,38,125,78,205,116,330
521590,201912,635,1505,464,1261,90,268,255,675,345,943
521600,201912,384,1048,234,733,42,109,90,288,132,397
521630,201912,1668,3660,988,2641,199,569,340,873,539,1442
521640,201912,1793,4215,1203,3352,268,804,396,1068,664,1872
521645,201912,550,1440,343,1062,80,222,117,367,197,589
521680,201912,1102,3364,829,2804,240,883,118,424,358,1307
521690,201912,520,1315,439,1197,63,182,265,710,328,892
521710,201912,3176,7939,1935,5838,360,1222,462,1303,822,2525
521720,201912,2195,5121,1413,3916,158,483,805,2224,963,2707
521730,201912,3558,10079,2671,8503,771,2809,664,1764,1435,4573
521740,201912,3880,10159,2870,8666,726,2377,1058,3324,1784,5701
521760,201912,14769,40792,11270,35300,2977,10250,4125,13372,7102,23622
521770,201912,2903,7039,1890,5329,587,1792,457,1289,1044,3081
521800,201912,6162,16703,4437,13805,1059,3383,1641,5557,2700,8940
521805,201912,501,1193,357,987,116,310,146,409,262,719
521810,201912,636,1493,431,1206,64,180,239,683,303,863
521830,201912,5376,14951,4241,13206,303,1160,3030,9224,3333,10384
521839,201912,674,1671,477,1326,83,260,240,595,323,855
521850,201912,5422,12819,3236,9396,564,1824,402,1086,966,2910
521860,201912,1619,4254,1091,3320,194,647,341,1007,535,1654
521870,201912,678,1886,467,1473,98,349,117,322,215,671
521878,201912,647,1668,454,1300,65,220,234,608,299,828
521880,201912,18371,44515,12009,34696,3079,9404,4084,12038,7163,21442
521890,201912,3019,7879,1939,5902,551,1807,341,939,892,2746
521900,201912,1547,3650,885,2637,286,827,126,396,412,1223
521910,201912,1225,2610,767,2051,75,201,434,1230,509,1431
521920,201912,445,1251,322,1026,61,224,141,429,202,653
521925,201912,743,1961,544,1660,92,288,284,854,376,1142
521930,201912,5280,12785,3374,9811,892,2462,1275,4063,2167,6525
521935,201912,961,2321,642,1740,66,188,370,943,436,1131
521940,201912,1256,2830,814,2225,189,573,326,867,515,1440
521945,201912,533,1468,411,1250,97,299,209,656,306,955
521950,201912,740,1803,520,1462,130,390,226,586,356,976
521960,201912,708,1852,446,1345,51,170,242,679,293,849
521970,201912,2549,6227,2009,5586,160,443,1533,4314,1693,4757
521971,201912,736,1736,496,1383,131,351,143,405,274,756
521973,201912,1247,3253,949,2777,44,164,683,1949,727,2113
521975,201912,11781,31100,9597,28022,1498,4631,6062,17686,7560,22317
521980,201912,2533,5926,1904,5085,151,372,1427,3887,1578,4259
521990,201912,1071,2992,830,2566,168,534,334,1032,502,1566
522000,201912,2471,6698,1975,6047,245,738,1317,4152,1562,4890
522005,201912,333,805,246,675,51,134,119,338,170,472
522010,201912,3901,9568,2683,7588,647,1974,904,2477,1551,4451
522015,201912,957,2495,677,2050,176,521,261,820,437,1341
522020,201912,5315,12721,3450,9750,719,2144,1390,3997,2109,6141
522026,201912,670,1890,473,1509,82,277,162,501,244,778
522028,201912,433,1122,311,901,57,172,133,370,190,542
522040,201912,3067,6960,2138,5704,271,774,1416,3711,1687,4485
522045,201912,17246,48237,12392,39289,2978,10128,3341,10265,6319,20393
522050,201912,959,2519,642,1999,171,592,220,632,391,1224
522060,201912,2850,7525,1948,5993,174,544,1118,3554,1292,4098
522068,201912,1810,4676,1402,4177,143,382,1047,3190,1190,3572
522070,201912,609,1513,489,1326,19,59,407,1080,426,1139
522100,201912,702,1820,461,1418,57,195,244,729,301,924
522108,201912,949,2498,732,2179,56,237,577,1634,633,1871
522119,201912,1495,3775,1111,3262,179,548,596,1808,775,2356
522130,201912,385,952,263,781,39,115,153,487,192,602
522140,201912,17093,45603,11762,36014,3106,10180,3061,8941,6167,19121
522145,201912,800,1962,538,1568,134,380,221,659,355,1039
522150,201912,1044,2565,718,2026,197,544,212,634,409,1178
522155,201912,1020,2550,757,2122,135,361,431,1233,566,1594
522157,201912,550,1351,451,1216,24,82,350,945,374,1027
522160,201912,6018,15613,3787,11459,1042,3411,290,952,1332,4363
522170,201912,2661,6810,1941,5727,311,953,1073,3190,1384,4143
522180,201912,440,1050,276,774,63,187,33,108,96,295
522185,201912,17596,43989,12304,36622,4998,16004,2737,8771,7735,24775
522190,201912,764,1847,513,1402,101,280,191,510,292,790
522200,201912,1655,4704,1047,3483,216,780,161,481,377,1261
522205,201912,1609,3768,1212,3225,119,351,848,2232,967,2583
522220,201912,1283,3219,927,2661,148,433,499,1467,647,1900
522230,201912,1123,2907,901,2585,203,709,452,1205,655,1914
530010,201912,170094,460653,136260,408575,21935,71767,77440,228074,99375,299841
